,date,home_station,home_transactions,work_transactions,other_transactions,total
0,2020-07-08,(09002) Consuelo,503,287,305,1095
1,2020-09-15,(09002) Consuelo,519,254,329,1102
2,2020-08-14,(09118) Marly,1415,931,719,3065
3,2020-06-03,(07504) TERREROS,5133,3003,2412,10548
4,2020-08-13,(07504) TERREROS,5838,3159,2772,11769
5,2020-08-26,(07504) TERREROS,5724,3150,2657,11531
6,2020-07-31,(09119) Calle 57,517,345,331,1193
7,2020-08-12,(09119) Calle 57,554,364,319,1237
8,2020-09-10,(09119) Calle 57,585,331,418,1334
9,2020-02-15,(14005) Las Aguas,1145,806,1275,3226
10,2020-02-20,(06104) Gobernación,1438,838,568,2844
11,2020-01-27,(09000) Cabecera Usme - alimentacion,24121,13756,15149,53026
12,2020-09-05,(10000) Portal 20 de Julio - alimentacion,3743,1598,2729,8070
13,2020-04-08,(05000) Portal Américas - alimentacion,5895,2753,2546,11194
14,2020-09-07,(05000) Portal Américas - alimentacion,11257,6280,6443,23980
15,2020-04-16,(06107) Ciudad Universitaria,118,77,75,270
16,2020-08-07,(07503) SAN MATEO,4024,2159,2050,8233
17,2020-09-07,(09001) Molinos,2644,1374,1941,5959
18,2020-09-11,(09001) Molinos,2760,1362,1776,5898
19,2020-03-04,(07112) COMUNEROS,3812,2275,2319,8406
20,2020-01-06,(04103) Las Ferias,256,126,204,586
21,2020-02-20,(09104) Restrepo,4987,3096,3749,11832
22,2020-02-19,(09000) Cabecera Usme,5476,3490,4068,13034
23,2020-04-26,(10000) Portal 20 de Julio - alimentacion,1226,473,628,2327
24,2020-02-29,(07005) ALQUERIA,1757,902,1112,3771
25,2020-10-06,(02105) Calle 142,979,554,807,2340
26,2020-03-17,(07001) PERDOMO,2716,1584,1629,5929
27,2020-09-11,(07001) PERDOMO,1032,571,754,2357
28,2020-10-02,(40003) Mirador del Paraiso,1925,1092,1400,4417
29,2020-07-20,(09104) Restrepo,425,259,355,1039
30,2020-02-11,(10006) San Victorino,2634,1399,1256,5289
31,2020-10-07,(05002) Tintal,2997,1750,2244,6991
32,2020-02-20,(09117) Calle 45,6704,4294,2866,13864
33,2020-03-04,(09117) Calle 45,6564,4269,3181,14014
34,2020-03-07,(02000) Cabecera Autopista Norte - alimentacion,14808,6634,10029,31471
35,2020-09-23,(07000) Portal Sur - alimentacion,9620,5102,5504,20226
36,2020-02-11,(07102) NQS - CALLE 75,1584,1054,961,3599
37,2020-06-23,(07102) NQS - CALLE 75,447,303,256,1006
38,2020-08-13,(07102) NQS - CALLE 75,342,226,214,782
39,2020-01-11,(02304) Heroes,1550,1209,1326,4085
40,2020-09-10,(02103) Mazurén,195,122,187,504
41,2020-10-06,(07000) Portal Sur - alimentacion,9469,4879,5995,20343
42,2020-09-14,(09103) Olaya,1041,583,652,2276
43,2020-09-22,(09103) Olaya,1100,647,719,2466
44,2020-09-16,(14001) La Sabana,169,110,134,413
45,2020-06-07,(07002) MADELENA,188,91,120,399
46,2020-09-24,(02000) Cabecera Autopista Norte,1593,991,1200,3784
47,2020-01-22,(02001) Centro Comercial Santa Fe,4477,2758,2492,9727
48,2020-07-11,(09001) Molinos,2248,1110,1758,5116
49,2020-01-31,(07109) CAD,2702,1764,1779,6245
50,2020-01-16,(04000) Cabecera Calle 80,6343,3592,4483,14418
51,2020-09-18,(08000) Portal Tunal - alimentacion,7096,3916,4662,15674
52,2020-08-30,(09110) Avenida Jimenez,539,422,437,1398
53,2020-01-25,(09114) Calle 26,677,536,970,2183
54,2020-01-20,(10001) Country Sur,4681,2045,2522,9248
55,2020-05-22,(12001) Carrera 43,363,211,177,751
56,2020-01-22,(10006) San Victorino,2076,1102,1228,4406
57,2020-07-15,(06105) Quinta Paredes,125,65,64,254
58,2020-02-07,(02302) Virrey,3814,2596,1899,8309
59,2020-09-10,(02000) Cabecera Autopista Norte - intermunicipal,527,314,442,1283
60,2020-02-29,(10000) Portal 20 de Julio,5546,2313,3602,11461
61,2020-06-19,(10000) Portal 20 de Julio,2421,1151,1241,4813
62,2020-07-05,(09004) Santa Lucía,881,393,604,1878
63,2020-06-08,(03000) Portal Suba - alimentacion,5820,3356,3143,12319
64,2020-01-15,(07008) NQS - Calle 30 Sur,1599,831,979,3409
65,2020-01-28,(06108) Concejo de Bogotá,888,456,478,1822
66,2020-07-19,(10002) Av. Primero de Mayo,462,247,335,1044
67,2020-03-24,(02000) Cabecera Autopista Norte,986,664,734,2384
68,2020-08-25,(02000) Cabecera Autopista Norte - alimentacion,4322,2294,2523,9139
69,2020-10-10,(06102) Salitre El Greco,197,141,184,522
70,2020-05-05,(09000) Cabecera Usme,1020,635,784,2439
71,2020-07-10,(09123) Calle 76,1100,783,638,2521
72,2020-01-10,(04102) Avenida Boyaca,2035,1161,1284,4480
73,2020-02-07,(03011) SUBA - CALLE 100,2630,1398,1512,5540
74,2020-01-04,(02300) Calle 100,1609,1214,1466,4289
75,2020-03-04,(02300) Calle 100,7031,4662,3824,15517
76,2020-01-23,(03012) SUBA - CALLE 95,1357,878,973,3208
77,2020-10-05,(10000) Portal 20 de Julio,2627,1225,1758,5610
78,2020-03-07,(07006) General Santander,1648,750,1263,3661
79,2020-05-27,(09104) Restrepo,1243,745,938,2926
80,2020-06-15,(05005) Transversal 86,108,42,61,211
81,2020-05-05,(10008) San Diego,182,112,127,421
82,2020-01-25,(02304) Heroes,1741,1374,1462,4577
83,2020-09-17,(02304) Heroes,971,664,543,2178
84,2020-03-11,(06101) El Tiempo,2754,1559,1314,5627
85,2020-02-02,(02205) Calle 106,223,213,412,848
86,2020-08-01,(03001) LA CAMPIÑA,543,280,347,1170
87,2020-02-13,(03011) SUBA - CALLE 100,2794,1392,1496,5682
88,2020-02-25,(07108) Av. El Dorado,1014,606,590,2210
89,2020-06-08,(07000) Portal Sur,1733,1091,1010,3834
90,2020-04-09,(02101) Toberín,152,130,139,421
91,2020-03-17,(06101) El Tiempo,1373,779,712,2864
92,2020-07-16,(10003) Ciudad Jardín,157,73,100,330
93,2020-04-29,(02304) Heroes,469,335,267,1071
94,2020-08-19,(04104) Avenida 68,615,281,374,1270
95,2020-04-06,(02000) Cabecera Autopista Norte - alimentacion,2672,1387,1335,5394
96,2020-09-19,(12001) Carrera 43,300,182,282,764
97,2020-06-01,(05001) Patio Bonito,1168,687,846,2701
98,2020-05-17,(04100) Carrera 77,253,148,192,593
99,2020-09-30,(09121) Las Flores,775,493,624,1892
100,2020-10-05,(06104) Gobernación,304,192,182,678
101,2020-04-02,(05001) Patio Bonito,852,453,490,1795
102,2020-04-15,(07113) SANTA ISABEL,189,125,124,438
103,2020-04-22,(04108) El Polo,252,174,111,537
104,2020-03-12,(07008) NQS - Calle 30 Sur,113,358,307,778
105,2020-06-26,(02302) Virrey,710,504,357,1571
106,2020-03-13,(12003) Ricaurte,553,27,145,725
107,2020-07-05,(03013) RIO NEGRO,79,58,86,223
108,2020-10-09,(07103) AV. CHILE,982,607,712,2301
109,2020-05-01,(06108) Concejo de Bogotá,68,51,39,158
110,2020-08-24,(02001) Centro Comercial Santa Fe,419,259,291,969
111,2020-05-20,(02101) Toberín,1147,784,645,2576
112,2020-02-01,(08002) Biblioteca,589,301,504,1394
113,2020-06-09,(03011) SUBA - CALLE 100,472,229,240,941
114,2020-08-03,(05107) Américas - Cr.53,340,189,211,740
115,2020-04-03,(05105) Pradera,367,243,150,760
116,2020-05-08,(40001) Juan Pablo II,356,233,188,777
117,2020-08-13,(05000) Portal Américas,2717,1696,1878,6291
118,2020-08-25,(03006) NIZA - CALLE 127,452,256,214,922
119,2020-05-17,(10000) Portal 20 de Julio - alimentacion,1230,511,785,2526
120,2020-05-15,(02200) Alcalá,1391,980,737,3108
121,2020-04-30,(07000) Portal Sur,1096,678,593,2367
122,2020-05-09,(06000) Portal Eldorado - alimentacion,2136,957,989,4082
123,2020-02-25,(09111) Calle 19,2453,1455,1523,5431
124,2020-03-27,(04000) Cabecera Calle 80,465,340,339,1144
125,2020-04-08,(04000) Cabecera Calle 80,478,310,394,1182
126,2020-06-11,(09114) Calle 26,293,198,175,666
127,2020-06-20,(09121) Las Flores,536,388,379,1303
128,2020-08-17,(07003) SEVILLANA,121,61,86,268
129,2020-06-08,(02302) Virrey,633,409,313,1355
130,2020-06-21,(06109) Centro Memoria,85,56,73,214
131,2020-05-21,(06109) Centro Memoria,262,143,101,506
132,2020-08-18,(03003) 21 ANGELES,299,174,155,628
133,2020-05-30,(07110) PALOQUEMAO,443,273,193,909
134,2020-04-10,(06000) Portal Eldorado,204,130,109,443
135,2020-03-22,(09119) Calle 57,128,68,69,265
136,2020-05-28,(07110) PALOQUEMAO,627,340,240,1207
137,2020-10-08,(04101) Minuto de Dios,423,230,420,1073
138,2020-04-24,(04104) Avenida 68,382,216,176,774
139,2020-05-21,(03005) SUBA - AV. BOYACA,349,218,204,771
140,2020-03-08,(07006) General Santander - alimentacion,268,154,336,758
141,2020-05-04,(12000) Puente Aranda,50,34,32,116
142,2020-07-07,(12000) Puente Aranda,101,44,44,189
143,2020-03-24,(03005) SUBA - AV. BOYACA,337,253,287,877
144,2020-09-01,(02102) Calle 161,233,156,168,557
145,2020-10-07,(02102) Calle 161,297,165,271,733
146,2020-04-08,(12004) Carrera 22,38,43,40,121
147,2020-08-06,(07107) U. NACIONAL,316,177,188,681
148,2020-05-29,(10009) Museo Nacional,492,290,269,1051
149,2020-09-05,(10009) Museo Nacional,300,239,386,925
150,2020-10-04,(06001) Modelia,115,64,139,318
151,2020-06-05,(02300) Calle 100,1212,767,583,2562
152,2020-08-22,(07200) Tygua-San José,187,104,119,410
153,2020-07-22,(04002) Carrera 90,661,366,387,1414
154,2020-05-14,(07003) SEVILLANA,344,173,160,677
155,2020-07-12,(02001) Centro Comercial Santa Fe,155,113,159,427
156,2020-05-23,(12002) CDS - Carrera 32,116,82,53,251
157,2020-03-27,(40001) Juan Pablo II,227,127,135,489
158,2020-09-11,(09122) Calle 72,1223,801,840,2864
159,2020-04-28,(06002) Normandía,183,114,98,395
160,2020-06-19,(06002) Normandía,324,193,195,712
161,2020-08-18,(03010) PUENTE LARGO,343,205,217,765
162,2020-08-26,(06001) Modelia,360,207,218,785
163,2020-08-16,(07002) MADELENA,194,95,162,451
164,2020-05-18,(09117) Calle 45,623,384,299,1306
165,2020-07-09,(07101) CASTELLANA,226,121,113,460
166,2020-03-23,(09121) Las Flores,206,132,105,443
167,2020-07-26,(03011) SUBA - CALLE 100,154,76,81,311
168,2020-07-26,(09110) Avenida Jimenez,131,122,193,446
169,2020-03-20,(03012) SUBA - CALLE 95,136,108,67,311
170,2020-07-06,(07006) General Santander,575,380,329,1284
171,2020-01-12,(05101) Mandalay - Cr.73,123,56,111,290
172,2020-10-04,(03011) SUBA - CALLE 100,162,107,203,472
173,2020-04-07,(12001) Carrera 43,227,167,130,524
174,2020-06-10,(14004) Museo del Oro,0,137,276,413
175,2020-05-01,(07005) ALQUERIA,149,88,88,325
176,2020-08-07,(02201) Prado,287,213,229,729
177,2020-03-28,(04104) Avenida 68,222,144,118,484
178,2020-04-11,(10004) Policarpa,63,40,65,168
179,2020-06-02,(04001) Quirigua,373,227,215,815
180,2020-04-03,(10006) San Victorino,171,137,153,461
181,2020-06-05,(06103) CAN,382,227,185,794
182,2020-04-26,(50003) Corral Molinos,333,157,230,720
183,2020-04-12,(09121) Las Flores,141,105,84,330
184,2020-05-24,(07009) SENA,142,85,96,323
185,2020-08-02,(04106) Carrera 47,86,52,63,201
186,2020-04-03,(07201) Guatoque -Veraguas,68,47,66,181
187,2020-06-14,(02103) Mazurén,37,27,50,114
188,2020-08-28,(14004) Museo del Oro,294,197,236,727
189,2020-05-31,(12007) Zona Industrial,22,38,46,106
190,2020-05-05,(06106) Recinto Ferial,171,105,68,344
191,2020-07-13,(07006) General Santander - alimentacion,267,170,190,627
192,2020-08-24,(05102) Av. Américas - Av. Boyacá,217,102,144,463
193,2020-05-25,(40002) Manitas,151,78,94,323
194,2020-04-02,(04101) Minuto de Dios,129,107,113,349
195,2020-07-15,(05101) Mandalay - Cr.73,103,58,53,214
196,2020-09-27,(06109) Centro Memoria,70,42,103,215
197,2020-01-26,(09105) Río Fucha,117,78,209,404
198,2020-02-16,(10004) Policarpa,255,123,262,640
199,2020-06-02,(07101) CASTELLANA,165,94,103,362
200,2020-07-19,(05103) Marsella,95,49,62,206
201,2020-05-15,(03010) PUENTE LARGO,273,177,129,579
202,2020-05-03,(12001) Carrera 43,32,41,51,124
203,2020-07-05,(07107) U. NACIONAL,92,66,61,219
204,2020-04-17,(50006) Corral Carrera 77,5,3,5,13
205,2020-08-31,(03014) SAN MARTIN,0,13,38,51
206,2020-10-12,(03014) SAN MARTIN,0,9,28,37
207,2020-08-30,(04107) Escuela Militar,32,21,36,89
208,2020-05-10,(03004) GRATAMIRA,10,6,9,25
209,2020-05-27,(04000) Cabecera Calle 80 - alimentacion,3375,1966,2080,7421
210,2020-06-27,(04000) Cabecera Calle 80 - alimentacion,3169,1682,2257,7108
211,2020-02-14,(07005) ALQUERIA,2765,1482,1366,5613
212,2020-01-29,(09002) Consuelo,1434,746,813,2993
213,2020-10-02,(02502) Terminal,542,388,593,1523
214,2020-02-25,(03000) Portal Suba - alimentacion,29633,18085,16906,64624
215,2020-01-30,(09122) Calle 72,7026,4621,3871,15518
216,2020-09-30,(05000) Portal Américas,3979,2224,2704,8907
217,2020-01-08,(03010) PUENTE LARGO,1474,896,893,3263
218,2020-03-23,(04002) Carrera 90,137,81,75,293
219,2020-07-23,(10000) Portal 20 de Julio - alimentacion,3014,1376,1900,6290
220,2020-01-24,(09100) Calle 40 Sur,6871,3633,4025,14529
221,2020-01-17,(07503) SAN MATEO,37583,20165,17271,75019
222,2020-06-09,(07503) SAN MATEO,9806,6150,5255,21211
223,2020-03-16,(05001) Patio Bonito,5447,2944,2788,11179
224,2020-02-12,(02201) Prado,6251,4014,3034,13299
225,2020-08-19,(07112) COMUNEROS,751,434,403,1588
226,2020-01-30,(07103) AV. CHILE,3637,2216,1846,7699
227,2020-07-23,(05100) Banderas P. Central,525,343,329,1197
228,2020-06-18,(09115) Calle 34,690,433,379,1502
229,2020-03-03,(05100) Banderas P. Central - alimentacion,15904,9227,9020,34151
230,2020-01-07,(07009) SENA,2162,1335,1503,5000
231,2020-01-17,(06102) Salitre El Greco,1260,723,691,2674
232,2020-02-15,(07005) ALQUERIA,1765,873,1077,3715
233,2020-01-24,(02205) Calle 106,2490,1629,1285,5404
234,2020-03-02,(40003) Mirador del Paraiso,4622,2648,2674,9944
235,2020-10-11,(04101) Minuto de Dios,115,74,239,428
236,2020-01-21,(04104) Avenida 68,2249,1256,1161,4666
237,2020-01-13,(06002) Normandía,1892,1158,1074,4124
238,2020-02-04,(06002) Normandía,2674,1604,1418,5696
239,2020-02-28,(09110) Avenida Jimenez,5017,3511,2992,11520
240,2020-08-24,(07110) PALOQUEMAO,592,368,224,1184
241,2020-08-19,(10000) Portal 20 de Julio - alimentacion,3783,1700,2266,7749
242,2020-02-04,(06106) Recinto Ferial,1622,904,826,3352
243,2020-04-27,(07102) NQS - CALLE 75,41,121,58,220
244,2020-02-05,(50003) Corral Molinos,3309,2258,3651,9218
245,2020-04-10,(07111) NQS - RICAURTE,55,71,52,178
246,2020-08-22,(07111) NQS - RICAURTE,893,576,449,1918
247,2020-09-23,(07002) MADELENA,1052,599,730,2381
248,2020-10-07,(02200) Alcalá,2239,1430,1535,5204
249,2020-05-13,(02000) Cabecera Autopista Norte,970,631,590,2191
250,2020-07-05,(09113) Calle 22,204,115,203,522
251,2020-06-02,(08000) Portal Tunal - alimentacion,5938,3283,3004,12225
252,2020-04-14,(05000) Portal Américas,1273,904,1091,3268
253,2020-08-05,(05000) Portal Américas,2184,1445,1697,5326
254,2020-01-14,(04000) Cabecera Calle 80,6143,3630,4289,14062
255,2020-06-12,(07112) COMUNEROS,812,448,435,1695
256,2020-08-12,(07112) COMUNEROS,832,461,425,1718
257,2020-08-09,(09001) Molinos,682,311,545,1538
258,2020-04-24,(04002) Carrera 90,411,244,195,850
259,2020-03-04,(40003) Mirador del Paraiso,4698,2675,2623,9996
260,2020-01-25,(04001) Quirigua,1028,520,790,2338
261,2020-07-18,(12001) Carrera 43,273,165,137,575
262,2020-09-02,(10002) Av. Primero de Mayo,2203,1137,1466,4806
263,2020-02-04,(06111) Universidades,6126,3704,2664,12494
264,2020-03-12,(06111) Universidades,1808,377,510,2695
265,2020-01-01,(07505) LEON XIII,676,357,683,1716
266,2020-09-18,(02304) Heroes,981,654,671,2306
267,2020-06-08,(03000) Portal Suba,1196,758,774,2728
268,2020-04-25,(10000) Portal 20 de Julio - alimentacion,2176,932,1168,4276
269,2020-05-13,(02000) Cabecera Autopista Norte - alimentacion,3787,2083,1917,7787
270,2020-02-25,(10010) San Bernardo,1826,1056,1386,4268
271,2020-03-31,(10002) Av. Primero de Mayo,1109,573,604,2286
272,2020-02-14,(02502) Terminal,5262,3295,3020,11577
273,2020-07-20,(07504) TERREROS,1481,818,890,3189
274,2020-10-01,(08001) Parque el Tunal,541,287,400,1228
275,2020-06-19,(07010) Bosa,779,385,474,1638
276,2020-05-17,(02105) Calle 142,138,118,133,389
277,2020-03-08,(02101) Toberín,1775,761,2245,4781
278,2020-08-03,(02201) Prado,677,451,420,1548
279,2020-03-04,(07001) PERDOMO,4537,2798,2641,9976
280,2020-08-07,(06002) Normandía,113,75,83,271
281,2020-02-15,(02000) Cabecera Autopista Norte,5184,2632,4214,12030
282,2020-09-17,(40003) Mirador del Paraiso,1716,1023,1371,4110
283,2020-09-05,(05103) Marsella,406,174,263,843
284,2020-08-25,(02300) Calle 100,1047,733,628,2408
285,2020-09-03,(03012) SUBA - CALLE 95,333,188,206,727
286,2020-02-22,(06000) Portal Eldorado,2819,1969,2459,7247
287,2020-02-14,(02104) Calle 146,9001,5551,5784,20336
288,2020-06-29,(08000) Portal Tunal,297,149,137,583
289,2020-08-11,(07104) Simon Bolivar,353,268,280,901
290,2020-09-13,(07104) Simon Bolivar,139,97,159,395
291,2020-05-17,(09104) Restrepo,344,234,294,872
292,2020-06-06,(05005) Transversal 86,229,107,132,468
293,2020-09-07,(05005) Transversal 86,405,216,287,908
294,2020-01-24,(08000) Portal Tunal,2070,1115,1041,4226
295,2020-02-12,(08000) Portal Tunal,2398,1268,1033,4699
296,2020-08-20,(03009) Av. Suba- Calle 116,528,311,225,1064
297,2020-06-26,(04101) Minuto de Dios,364,211,253,828
298,2020-09-16,(06000) Portal Eldorado - alimentacion,4263,2197,2548,9008
299,2020-01-24,(04108) El Polo,1814,1174,1173,4161
300,2020-08-19,(04108) El Polo,499,284,203,986
301,2020-02-25,(12007) Zona Industrial,1329,805,606,2740
302,2020-04-18,(07201) Guatoque -Veraguas,59,41,31,131
303,2020-06-09,(05001) Patio Bonito,1443,781,900,3124
304,2020-05-06,(06000) Portal Eldorado - alimentacion,2777,1365,1129,5271
305,2020-06-06,(07010) Bosa,520,266,337,1123
306,2020-08-07,(07010) Bosa,251,114,174,539
307,2020-10-09,(04100) Carrera 77,1541,797,1305,3643
308,2020-09-10,(04100) Carrera 77,1203,637,830,2670
309,2020-04-14,(07000) Portal Sur - alimentacion,4083,2204,1601,7888
310,2020-07-05,(02101) Toberín,339,197,374,910
311,2020-05-04,(02304) Heroes,529,383,312,1224
312,2020-06-25,(07104) Simon Bolivar,645,409,267,1321
313,2020-03-03,(07109) CAD,2791,1722,1463,5976
314,2020-06-28,(02000) Cabecera Autopista Norte,390,264,296,950
315,2020-07-02,(09000) Cabecera Usme,1843,1181,1241,4265
316,2020-03-01,(10009) Museo Nacional,320,309,619,1248
317,2020-02-11,(04105) Carrera 53,1578,847,753,3178
318,2020-08-17,(02200) Alcalá,567,425,355,1347
319,2020-05-07,(10001) Country Sur,712,347,483,1542
320,2020-05-26,(10001) Country Sur,1025,450,624,2099
321,2020-07-29,(09116) Avenida 39,319,197,222,738
322,2020-09-03,(09116) Avenida 39,397,237,294,928
323,2020-10-12,(07003) SEVILLANA,141,64,182,387
324,2020-09-07,(02105) Calle 142,780,537,582,1899
325,2020-02-26,(04101) Minuto de Dios,3630,2134,1746,7510
326,2020-08-02,(06100) Av. Rojas,28,19,42,89
327,2020-02-02,(02302) Virrey,365,331,565,1261
328,2020-05-16,(03010) PUENTE LARGO,187,136,96,419
329,2020-05-19,(03009) Av. Suba- Calle 116,439,250,203,892
330,2020-05-27,(03009) Av. Suba- Calle 116,443,300,178,921
331,2020-02-15,(10008) San Diego,658,476,667,1801
332,2020-04-22,(09000) Cabecera Usme,921,560,655,2136
333,2020-08-10,(03002) SUBA - TV- 91,597,392,397,1386
334,2020-03-26,(07103) AV. CHILE,364,322,246,932
335,2020-03-31,(06102) Salitre El Greco,158,109,83,350
336,2020-03-11,(07105) MOVISTAR ARENA,1289,824,694,2807
337,2020-03-26,(10005) Bicentenario,46,34,37,117
338,2020-07-10,(40002) Manitas,446,274,257,977
339,2020-03-24,(05100) Banderas P. Central,729,397,593,1719
340,2020-01-25,(10003) Ciudad Jardín,563,270,502,1335
341,2020-10-03,(02001) Centro Comercial Santa Fe,434,240,480,1154
342,2020-05-23,(04100) Carrera 77,724,371,472,1567
343,2020-10-11,(04100) Carrera 77,452,200,506,1158
344,2020-09-29,(09122) Calle 72,1383,892,1054,3329
345,2020-05-03,(02200) Alcalá,386,305,206,897
346,2020-03-19,(04107) Escuela Militar,322,219,236,777
347,2020-10-10,(10009) Museo Nacional,253,249,433,935
348,2020-03-02,(04102) Avenida Boyaca,2963,1810,1654,6427
349,2020-06-03,(06111) Universidades,0,120,349,469
350,2020-08-18,(09115) Calle 34,604,373,405,1382
351,2020-09-21,(09115) Calle 34,539,358,409,1306
352,2020-07-06,(03006) NIZA - CALLE 127,519,295,289,1103
353,2020-02-24,(09111) Calle 19,2426,1393,1540,5359
354,2020-09-21,(07005) ALQUERIA,445,237,310,992
355,2020-01-04,(05101) Mandalay - Cr.73,215,92,159,466
356,2020-07-30,(06104) Gobernación,254,152,97,503
357,2020-05-05,(06109) Centro Memoria,197,126,97,420
358,2020-06-14,(09123) Calle 76,208,159,183,550
359,2020-07-23,(06104) Gobernación,220,145,90,455
360,2020-05-17,(02302) Virrey,171,115,82,368
361,2020-05-09,(07201) Guatoque -Veraguas,80,65,77,222
362,2020-05-14,(07105) MOVISTAR ARENA,199,130,107,436
363,2020-09-21,(07105) MOVISTAR ARENA,220,121,147,488
364,2020-08-19,(07002) MADELENA,734,436,476,1646
365,2020-10-05,(09114) Calle 26,366,257,375,998
366,2020-04-30,(03003) 21 ANGELES,204,92,96,392
367,2020-05-21,(04001) Quirigua,301,204,169,674
368,2020-09-05,(10007) Las Nieves,557,376,404,1337
369,2020-04-22,(12003) Ricaurte,162,140,83,385
370,2020-04-18,(08002) Biblioteca,115,80,74,269
371,2020-01-27,(12000) Puente Aranda,285,152,192,629
372,2020-04-03,(08001) Parque el Tunal,242,134,145,521
373,2020-05-09,(02102) Calle 161,102,64,70,236
374,2020-08-26,(09113) Calle 22,367,206,331,904
375,2020-06-29,(02103) Mazurén,41,27,45,113
376,2020-09-06,(07005) ALQUERIA,183,102,209,494
377,2020-07-20,(04106) Carrera 47,105,62,59,226
378,2020-06-20,(07200) Tygua-San José,206,110,146,462
379,2020-09-15,(40001) Juan Pablo II,550,337,381,1268
380,2020-09-07,(09117) Calle 45,694,429,485,1608
381,2020-07-31,(02300) Calle 100,1045,691,588,2324
382,2020-05-12,(09115) Calle 34,521,344,290,1155
383,2020-05-14,(07004) VENECIA,764,436,378,1578
384,2020-05-04,(07010) Bosa,403,241,278,922
385,2020-02-05,(12002) CDS - Carrera 32,618,389,337,1344
386,2020-08-14,(07006) General Santander,529,298,294,1121
387,2020-01-06,(40001) Juan Pablo II,366,172,308,846
388,2020-09-13,(09119) Calle 57,224,126,228,578
389,2020-04-21,(03011) SUBA - CALLE 100,257,148,140,545
390,2020-06-19,(04102) Avenida Boyaca,394,222,263,879
391,2020-09-06,(14004) Museo del Oro,43,41,100,184
392,2020-04-29,(03009) Av. Suba- Calle 116,333,233,152,718
393,2020-01-04,(06001) Modelia,501,338,539,1378
394,2020-02-16,(07107) U. NACIONAL,291,238,464,993
395,2020-04-06,(04103) Las Ferias,192,121,118,431
396,2020-08-07,(10003) Ciudad Jardín,92,41,61,194
397,2020-04-30,(04102) Avenida Boyaca,196,113,109,418
398,2020-09-25,(40002) Manitas,464,286,333,1083
399,2020-08-25,(14004) Museo del Oro,226,129,166,521
400,2020-06-29,(10004) Policarpa,101,59,90,250
401,2020-06-08,(10005) Bicentenario,100,46,75,221
402,2020-04-17,(06001) Modelia,266,188,138,592
403,2020-09-27,(07010) Bosa,0,90,323,413
404,2020-09-07,(07006) General Santander,576,345,373,1294
405,2020-08-28,(10004) Policarpa,243,108,154,505
406,2020-01-03,(14001) La Sabana,145,109,179,433
407,2020-04-23,(06111) Universidades,0,76,186,262
408,2020-06-11,(03004) GRATAMIRA,31,16,23,70
409,2020-07-17,(06103) CAN,329,203,170,702
410,2020-08-05,(07007) NQS - Calle 38A Sur,298,202,228,728
411,2020-02-02,(06109) Centro Memoria,192,127,240,559
412,2020-03-20,(03005) SUBA - AV. BOYACA,184,148,128,460
413,2020-01-05,(09003) Socorro,398,178,349,925
414,2020-05-25,(06111) Universidades,0,32,137,169
415,2020-04-05,(07506) DESPENSA,74,41,47,162
416,2020-08-11,(06105) Quinta Paredes,120,91,69,280
417,2020-01-16,(03014) SAN MARTIN,236,138,153,527
418,2020-07-12,(09116) Avenida 39,88,60,90,238
419,2020-08-16,(03004) GRATAMIRA,0,10,16,26
420,2020-09-12,(03005) SUBA - AV. BOYACA,398,204,316,918
421,2020-05-03,(02000) Cabecera Autopista Norte - intermunicipal,38,36,31,105
422,2020-03-29,(12007) Zona Industrial,25,22,17,64
423,2020-06-24,(07006) General Santander - alimentacion,360,229,247,836
424,2020-04-06,(06106) Recinto Ferial,130,90,72,292
425,2020-07-12,(04105) Carrera 53,94,42,70,206
426,2020-04-12,(09111) Calle 19,109,69,102,280
427,2020-03-22,(06111) Universidades,0,30,74,104
428,2020-08-15,(07101) CASTELLANA,107,64,80,251
429,2020-05-01,(10003) Ciudad Jardín,56,27,40,123
430,2020-04-12,(07200) Tygua-San José,34,21,31,86
431,2020-05-16,(06107) Ciudad Universitaria,91,79,83,253
432,2020-07-05,(10007) Las Nieves,104,75,118,297
433,2019-12-31,(04103) Las Ferias,18,14,23,55
434,2020-01-29,(50006) Corral Carrera 77,26,16,45,87
435,2020-03-23,(12007) Zona Industrial,40,39,49,128
436,2020-05-16,(03014) SAN MARTIN,21,9,17,47
437,2020-09-07,(03004) GRATAMIRA,0,19,30,49
438,2020-10-13,(02204) Pepe Sierra,0,1,0,1
439,2020-09-16,(09002) Consuelo,519,299,359,1177
440,2020-08-01,(07504) TERREROS,4179,2061,2172,8412
441,2020-01-11,(10000) Portal 20 de Julio - alimentacion,7703,3182,5132,16017
442,2020-01-29,(10000) Portal 20 de Julio - alimentacion,10743,5453,7181,23377
443,2020-01-16,(03002) SUBA - TV- 91,3823,2082,2233,8138
444,2020-01-16,(09114) Calle 26,2373,1683,1551,5607
445,2020-06-22,(04000) Cabecera Calle 80 - alimentacion,1204,694,892,2790
446,2020-04-17,(05000) Portal Américas - alimentacion,6179,3307,2724,12210
447,2020-04-02,(04000) Cabecera Calle 80 - alimentacion,1741,975,1047,3763
448,2020-04-13,(04000) Cabecera Calle 80 - alimentacion,1812,1086,1127,4025
449,2020-04-19,(04000) Cabecera Calle 80 - alimentacion,543,320,340,1203
450,2020-02-21,(02000) Cabecera Autopista Norte - alimentacion,23418,12753,12911,49082
451,2020-01-28,(09118) Marly,6381,4300,3656,14337
452,2020-02-08,(07010) Bosa,1604,792,1193,3589
453,2020-03-09,(05000) Portal Américas,307,4130,2808,7245
454,2020-01-22,(07000) Portal Sur - alimentacion,26586,15503,13637,55726
455,2020-03-15,(07112) COMUNEROS,686,353,661,1700
456,2020-10-10,(07503) SAN MATEO,10678,4865,7002,22545
457,2020-01-21,(05100) Banderas P. Central,5341,1601,1982,8924
458,2020-06-09,(09100) Calle 40 Sur,1674,989,987,3650
459,2020-10-10,(09100) Calle 40 Sur,1499,761,1410,3670
460,2020-10-02,(09000) Cabecera Usme,2065,1193,1673,4931
461,2020-01-25,(07009) SENA,2030,1038,1394,4462
462,2020-02-03,(10002) Av. Primero de Mayo,8245,4249,4570,17064
463,2020-03-08,(07000) Portal Sur - alimentacion,7235,2872,4993,15100
464,2020-09-19,(05100) Banderas P. Central,745,347,637,1729
465,2020-01-08,(07113) SANTA ISABEL,1435,842,1030,3307
466,2020-07-29,(40003) Mirador del Paraiso,1608,991,1009,3608
467,2020-06-11,(09109) Tercer Milenio,358,221,235,814
468,2020-08-09,(04101) Minuto de Dios,52,35,75,162
469,2020-08-23,(07504) TERREROS,1528,734,957,3219
470,2020-03-12,(02101) Toberín,1098,3468,2044,6610
471,2020-01-20,(02204) Pepe Sierra,4777,3164,2271,10212
472,2020-02-09,(09000) Cabecera Usme,1286,609,1375,3270
473,2020-03-03,(09115) Calle 34,4660,2788,2499,9947
474,2020-01-10,(06002) Normandía,1548,904,998,3450
475,2020-02-20,(09103) Olaya,4189,2498,2353,9040
476,2020-04-08,(07000) Portal Sur - alimentacion,3738,1938,1585,7261
477,2020-06-09,(07000) Portal Sur - alimentacion,7332,4242,3421,14995
478,2020-09-17,(09103) Olaya,1111,607,717,2435
479,2020-09-09,(09103) Olaya,1088,581,720,2389
480,2020-07-30,(14001) La Sabana,152,102,91,345
481,2020-05-07,(07002) MADELENA,470,256,293,1019
482,2020-05-31,(07002) MADELENA,162,69,125,356
483,2020-08-12,(07002) MADELENA,761,434,460,1655
484,2020-02-29,(02001) Centro Comercial Santa Fe,2181,1008,1906,5095
485,2020-08-31,(07010) Bosa,659,306,456,1421
486,2020-09-01,(07010) Bosa,670,331,416,1417
487,2020-06-26,(08000) Portal Tunal - alimentacion,6736,3837,3745,14318
488,2020-03-13,(09110) Avenida Jimenez,2157,136,524,2817
489,2020-08-05,(09110) Avenida Jimenez,1345,963,735,3043
490,2020-02-10,(05107) Américas - Cr.53,2757,1577,1406,5740
491,2020-03-06,(05107) Américas - Cr.53,2420,1338,1449,5207
492,2020-08-30,(09001) Molinos,822,368,731,1921
493,2020-09-16,(07506) DESPENSA,453,300,336,1089
494,2020-01-07,(10000) Portal 20 de Julio - alimentacion,8272,4009,6398,18679
495,2020-02-05,(06000) Portal Eldorado,6919,4043,2895,13857
496,2020-09-09,(06000) Portal Eldorado,981,614,539,2134
497,2020-03-12,(05002) Tintal,278,2758,1845,4881
498,2020-09-23,(12001) Carrera 43,522,339,323,1184
499,2020-08-31,(10002) Av. Primero de Mayo,2157,1088,1332,4577
500,2020-03-28,(10006) San Victorino,87,82,100,269
501,2020-04-17,(02000) Cabecera Autopista Norte - intermunicipal,152,113,130,395
502,2020-03-24,(09101) Quiroga,368,187,296,851
503,2020-03-18,(08002) Biblioteca,601,354,374,1329
504,2020-03-19,(08002) Biblioteca,574,311,348,1233
505,2020-02-17,(02001) Centro Comercial Santa Fe,4876,3212,2654,10742
506,2020-03-10,(40003) Mirador del Paraiso,193,1284,894,2371
507,2020-01-11,(08001) Parque el Tunal,894,423,596,1913
508,2020-01-25,(09116) Avenida 39,636,549,898,2083
509,2020-01-23,(09113) Calle 22,1307,803,1099,3209
510,2020-02-15,(09123) Calle 76,2267,1775,2195,6237
511,2020-04-18,(09004) Santa Lucía,903,471,495,1869
512,2020-04-12,(10001) Country Sur,194,90,114,398
513,2020-02-11,(03003) 21 ANGELES,1824,940,1019,3783
514,2020-03-02,(09120) Calle 63,7012,4429,3746,15187
515,2020-09-24,(14004) Museo del Oro,419,277,343,1039
516,2020-01-30,(05103) Marsella,2841,1640,1459,5940
517,2020-06-10,(02201) Prado,904,584,473,1961
518,2020-07-18,(02201) Prado,623,407,328,1358
519,2020-07-08,(08001) Parque el Tunal,496,297,341,1134
520,2020-07-19,(40003) Mirador del Paraiso,417,230,319,966
521,2020-01-19,(09107) Hortúa,492,282,579,1353
522,2020-08-07,(09107) Hortúa,284,179,207,670
523,2020-03-14,(05101) Mandalay - Cr.73,399,192,316,907
524,2020-04-27,(05002) Tintal,1112,97,130,1339
525,2020-03-03,(05105) Pradera,2580,1588,1207,5375
526,2020-01-01,(02000) Cabecera Autopista Norte - alimentacion,2302,1048,2695,6045
527,2020-07-28,(02300) Calle 100,1149,733,610,2492
528,2020-02-15,(03012) SUBA - CALLE 95,787,553,824,2164
529,2020-06-27,(50002) Corral Calle 40 Sur,17,4,21,42
530,2020-01-04,(04106) Carrera 47,504,257,375,1136
531,2020-03-12,(02104) Calle 146,575,2011,1215,3801
532,2020-01-31,(02202) Calle 127,5755,3645,2960,12360
533,2020-03-17,(10008) San Diego,883,527,512,1922
534,2020-08-24,(06109) Centro Memoria,236,139,116,491
535,2020-04-06,(09002) Consuelo,236,105,146,487
536,2020-04-03,(08000) Portal Tunal,357,198,190,745
537,2020-04-17,(08000) Portal Tunal,470,225,193,888
538,2020-07-25,(08000) Portal Tunal,460,192,177,829
539,2020-07-15,(02205) Calle 106,340,215,194,749
540,2020-02-23,(12000) Puente Aranda,32,31,62,125
541,2020-06-27,(05002) Tintal,2146,1049,1286,4481
542,2020-03-15,(05002) Tintal,1425,743,1467,3635
543,2020-08-14,(09101) Quiroga,527,255,353,1135
544,2020-06-12,(07010) Bosa,731,383,402,1516
545,2020-10-01,(06000) Portal Eldorado,978,660,738,2376
546,2020-06-17,(08002) Biblioteca,309,176,195,680
547,2020-09-16,(04000) Cabecera Calle 80,1243,721,1047,3011
548,2020-09-08,(09117) Calle 45,654,451,521,1626
549,2020-01-02,(03010) PUENTE LARGO,847,523,579,1949
550,2020-04-21,(07000) Portal Sur,881,578,560,2019
551,2020-05-29,(07000) Portal Sur,1674,1023,975,3672
552,2020-01-18,(09115) Calle 34,1194,939,1459,3592
553,2020-09-22,(07104) Simon Bolivar,628,378,358,1364
554,2020-07-29,(10005) Bicentenario - alimentacion,189,101,185,475
555,2020-05-14,(09109) Tercer Milenio,274,174,165,613
556,2020-08-23,(04002) Carrera 90,171,105,134,410
557,2020-01-11,(02200) Alcalá,4639,2502,3224,10365
558,2020-10-12,(03003) 21 ANGELES,106,47,108,261
559,2020-02-19,(04105) Carrera 53,1552,825,763,3140
560,2020-07-17,(02104) Calle 146,668,441,420,1529
561,2020-08-30,(03002) SUBA - TV- 91,259,128,252,639
562,2020-09-10,(02202) Calle 127,1020,668,662,2350
563,2020-03-31,(07505) LEON XIII,1182,607,647,2436
564,2020-05-18,(04100) Carrera 77,1022,553,653,2228
565,2020-08-22,(07101) CASTELLANA,107,71,114,292
566,2020-02-29,(07004) VENECIA,2940,1502,1998,6440
567,2020-04-28,(04108) El Polo,280,183,149,612
568,2020-03-13,(09115) Calle 34,1373,219,476,2068
569,2020-07-03,(10010) San Bernardo,674,348,531,1553
570,2020-07-28,(10010) San Bernardo,587,326,378,1291
571,2020-03-24,(03009) Av. Suba- Calle 116,545,350,333,1228
572,2020-06-02,(03009) Av. Suba- Calle 116,469,315,208,992
573,2020-07-02,(02105) Calle 142,810,499,558,1867
574,2020-04-24,(09002) Consuelo,264,143,128,535
575,2020-09-02,(05107) Américas - Cr.53,447,276,318,1041
576,2020-02-29,(07201) Guatoque -Veraguas,495,289,545,1329
577,2020-04-04,(40002) Manitas,148,65,91,304
578,2020-05-22,(09106) Nariño,335,200,207,742
579,2020-07-22,(02001) Centro Comercial Santa Fe,476,278,299,1053
580,2020-08-28,(02001) Centro Comercial Santa Fe,495,294,359,1148
581,2020-04-28,(05100) Banderas P. Central - alimentacion,1768,861,832,3461
582,2020-05-31,(05100) Banderas P. Central - alimentacion,809,325,423,1557
583,2020-04-21,(07003) SEVILLANA,248,148,129,525
584,2020-07-25,(07003) SEVILLANA,248,146,155,549
585,2020-05-27,(02104) Calle 146,634,439,407,1480
586,2020-06-28,(09004) Santa Lucía,859,378,537,1774
587,2020-04-11,(09101) Quiroga,168,82,97,347
588,2020-06-27,(09117) Calle 45,546,334,431,1311
589,2020-07-18,(04101) Minuto de Dios,196,115,147,458
590,2020-05-21,(02204) Pepe Sierra,619,442,274,1335
591,2020-10-03,(07201) Guatoque -Veraguas,179,109,213,501
592,2020-04-24,(03012) SUBA - CALLE 95,193,121,99,413
593,2020-09-12,(09111) Calle 19,628,385,505,1518
594,2020-03-01,(10007) Las Nieves,185,187,408,780
595,2020-04-27,(09123) Calle 76,80,314,151,545
596,2020-06-30,(04105) Carrera 53,279,143,133,555
597,2020-08-29,(09123) Calle 76,699,551,553,1803
598,2020-08-10,(07107) U. NACIONAL,325,179,198,702
599,2020-06-12,(07105) MOVISTAR ARENA,247,145,151,543
600,2020-08-11,(10002) Av. Primero de Mayo,2103,1033,1316,4452
601,2020-06-13,(07107) U. NACIONAL,237,149,136,522
602,2020-07-19,(04003) Avenida Ciudad de Cali,245,132,204,581
603,2020-05-22,(10006) San Victorino,408,245,256,909
604,2020-05-07,(40001) Juan Pablo II,365,216,232,813
605,2020-09-28,(07009) SENA,705,430,583,1718
606,2020-06-28,(03007) HUMEDAL CORDOBA,35,17,20,72
607,2020-04-17,(09114) Calle 26,170,139,119,428
608,2020-02-07,(50002) Corral Calle 40 Sur,131,96,158,385
609,2020-05-24,(09004) Santa Lucía,659,305,405,1369
610,2020-03-30,(02102) Calle 161,86,74,53,213
611,2020-09-20,(02102) Calle 161,87,48,87,222
612,2020-05-07,(10009) Museo Nacional,374,229,175,778
613,2020-09-16,(06000) Portal Eldorado,955,635,636,2226
614,2020-10-08,(04106) Carrera 47,379,156,262,797
615,2020-03-21,(07102) NQS - CALLE 75,51,48,32,131
616,2020-09-02,(06001) Modelia,399,244,258,901
617,2020-07-18,(04000) Cabecera Calle 80,706,388,546,1640
618,2020-09-10,(07200) Tygua-San José,233,106,175,514
619,2020-05-25,(07112) COMUNEROS,185,120,145,450
620,2020-02-14,(09105) Río Fucha,839,429,534,1802
621,2020-08-01,(02000) Cabecera Autopista Norte - intermunicipal,322,190,254,766
622,2020-01-26,(06108) Concejo de Bogotá,117,77,183,377
623,2020-01-01,(12002) CDS - Carrera 32,24,19,39,82
624,2020-05-26,(02502) Terminal,354,259,269,882
625,2020-03-20,(03002) SUBA - TV- 91,363,240,164,767
626,2020-05-30,(03002) SUBA - TV- 91,500,294,296,1090
627,2020-09-03,(07004) VENECIA,1066,652,631,2349
628,2020-09-02,(06002) Normandía,324,182,195,701
629,2020-09-21,(06002) Normandía,266,146,169,581
630,2020-08-31,(14004) Museo del Oro,331,205,233,769
631,2020-04-22,(09108) Hospital,40,32,35,107
632,2020-03-29,(03012) SUBA - CALLE 95,41,25,26,92
633,2020-05-21,(02502) Terminal,307,215,227,749
634,2020-08-12,(04000) Cabecera Calle 80 - intermunicipal,326,169,280,775
635,2020-09-20,(05100) Banderas P. Central - alimentacion,1187,472,938,2597
636,2020-06-15,(07108) Av. El Dorado,36,24,33,93
637,2020-07-29,(09111) Calle 19,753,455,446,1654
638,2020-06-24,(07506) DESPENSA,518,276,244,1038
639,2020-05-10,(03006) NIZA - CALLE 127,120,66,44,230
640,2020-09-13,(09111) Calle 19,221,132,257,610
641,2020-07-16,(06105) Quinta Paredes,120,75,74,269
642,2020-09-05,(07109) CAD,416,308,392,1116
643,2020-06-28,(07506) DESPENSA,166,74,88,328
644,2020-06-04,(06102) Salitre El Greco,196,110,87,393
645,2020-07-18,(06102) Salitre El Greco,147,93,106,346
646,2020-04-15,(07010) Bosa,293,173,208,674
647,2020-06-18,(03010) PUENTE LARGO,372,240,200,812
648,2020-04-29,(04001) Quirigua,221,137,133,491
649,2020-08-12,(04001) Quirigua,290,179,208,677
650,2020-02-02,(10005) Bicentenario,75,65,124,264
651,2020-10-01,(03004) GRATAMIRA,0,23,55,78
652,2020-06-18,(03004) GRATAMIRA,28,20,27,75
653,2020-04-01,(07104) Simon Bolivar,175,125,130,430
654,2020-08-11,(02102) Calle 161,220,126,164,510
655,2020-07-12,(06111) Universidades,108,65,186,359
656,2020-03-26,(04102) Avenida Boyaca,128,90,98,316
657,2020-09-13,(07006) General Santander,192,85,176,453
658,2020-05-25,(10006) San Victorino,82,59,88,229
659,2020-09-08,(04000) Cabecera Calle 80 - intermunicipal,384,185,340,909
660,2020-09-14,(07113) SANTA ISABEL,389,252,310,951
661,2020-08-09,(12004) Carrera 22,51,48,53,152
662,2020-04-19,(07007) NQS - Calle 38A Sur,70,58,35,163
663,2020-10-10,(06105) Quinta Paredes,110,66,124,300
664,2020-05-01,(02102) Calle 161,53,40,34,127
665,2020-04-19,(06104) Gobernación,50,36,25,111
666,2020-09-12,(05103) Marsella,367,160,282,809
667,2020-06-01,(03009) Av. Suba- Calle 116,446,274,235,955
668,2020-05-11,(06106) Recinto Ferial,203,111,86,400
669,2020-07-11,(10003) Ciudad Jardín,180,91,150,421
670,2020-08-21,(05103) Marsella,411,195,224,830
671,2020-03-29,(06107) Ciudad Universitaria,24,18,22,64
672,2020-04-08,(04102) Avenida Boyaca,127,70,102,299
673,2020-04-12,(08001) Parque el Tunal,73,48,38,159
674,2020-10-12,(06002) Normandía,127,81,132,340
675,2020-08-01,(07200) Tygua-San José,164,93,131,388
676,2020-09-06,(12002) CDS - Carrera 32,19,38,31,88
677,2020-04-10,(04102) Avenida Boyaca,44,33,25,102
678,2020-06-07,(06111) Universidades,0,45,145,190
679,2020-04-08,(05102) Av. Américas - Av. Boyacá,113,63,62,238
680,2020-07-17,(03014) SAN MARTIN,23,14,27,64
681,2020-05-03,(07106) EL CAMPIN,79,58,53,190
682,2020-04-26,(07003) SEVILLANA,64,41,41,146
683,2020-05-03,(03003) 21 ANGELES,58,22,36,116
684,2020-03-08,(12000) Puente Aranda,39,36,67,142
685,2020-06-07,(06104) Gobernación,41,31,45,117
686,2020-08-09,(02102) Calle 161,54,26,63,143
687,2019-12-31,(03010) PUENTE LARGO,22,8,20,50
688,2020-10-09,(03004) GRATAMIRA,0,26,47,73
689,2020-02-29,(04000) Cabecera Calle 80 - alimentacion,13398,5882,11033,30313
690,2020-06-25,(04000) Cabecera Calle 80 - alimentacion,4218,2402,2670,9290
691,2020-09-21,(04000) Cabecera Calle 80 - alimentacion,3699,1935,2507,8141
692,2020-02-05,(09002) Consuelo,1506,808,855,3169
693,2020-02-26,(09002) Consuelo,1446,760,798,3004
694,2020-02-17,(05000) Portal Américas - alimentacion,38186,22619,20832,81637
695,2020-05-05,(09119) Calle 57,336,217,199,752
696,2020-06-10,(09119) Calle 57,557,369,341,1267
697,2020-10-01,(09119) Calle 57,675,459,581,1715
698,2020-08-18,(03000) Portal Suba - alimentacion,5715,3310,3433,12458
699,2020-02-21,(02101) Toberín,14389,8128,7414,29931
700,2020-02-14,(07503) SAN MATEO,41548,23097,18135,82780
701,2020-02-24,(09100) Calle 40 Sur,7541,4446,4223,16210
702,2020-02-12,(08000) Portal Tunal - alimentacion,26015,14214,11822,52051
703,2020-02-20,(02201) Prado,5873,3649,2765,12287
704,2020-07-05,(05005) Transversal 86,0,54,120,174
705,2020-09-29,(07112) COMUNEROS,896,511,669,2076
706,2020-01-19,(08000) Portal Tunal - alimentacion,5585,2324,3938,11847
707,2020-02-20,(07002) MADELENA,5048,2856,2441,10345
708,2020-08-01,(09100) Calle 40 Sur,1287,661,874,2822
709,2020-02-28,(09000) Cabecera Usme,5993,3329,3994,13316
710,2020-08-14,(09000) Cabecera Usme,1627,949,1201,3777
711,2020-04-03,(06000) Portal Eldorado - alimentacion,2229,1020,1003,4252
712,2020-01-15,(09113) Calle 22,1049,747,1008,2804
713,2020-01-23,(04000) Cabecera Calle 80,6859,4044,4616,15519
714,2020-02-14,(02205) Calle 106,2602,1638,1393,5633
715,2020-06-18,(09104) Restrepo,1524,944,1128,3596
716,2020-07-31,(07505) LEON XIII,2455,1314,1081,4850
717,2020-03-18,(02101) Toberín,6021,3688,3059,12768
718,2020-02-17,(02204) Pepe Sierra,5162,3395,2528,11085
719,2020-02-13,(10006) San Victorino,2531,1331,1294,5156
720,2020-03-02,(09110) Avenida Jimenez,5119,3368,2935,11422
721,2020-03-01,(02200) Alcalá,2065,1170,2220,5455
722,2020-02-11,(09004) Santa Lucía,7744,4481,4248,16473
723,2020-04-16,(07102) NQS - CALLE 75,181,132,117,430
724,2020-10-06,(07106) EL CAMPIN,526,350,347,1223
725,2020-08-31,(02103) Mazurén,214,139,212,565
726,2020-02-07,(02001) Centro Comercial Santa Fe,5054,2937,2863,10854
727,2020-01-25,(05100) Banderas P. Central - alimentacion,7961,3568,5225,16754
728,2020-08-20,(14001) La Sabana,174,106,109,389
729,2020-09-04,(02000) Cabecera Autopista Norte,1547,922,1013,3482
730,2020-01-22,(10002) Av. Primero de Mayo,7647,3918,4377,15942
731,2020-10-06,(04000) Cabecera Calle 80,1348,803,1203,3354
732,2020-07-05,(02000) Cabecera Autopista Norte - alimentacion,1916,883,1260,4059
733,2020-07-10,(02000) Cabecera Autopista Norte - alimentacion,5158,2829,2930,10917
734,2020-04-07,(04002) Carrera 90,331,170,145,646
735,2020-07-07,(40003) Mirador del Paraiso,1832,1111,1110,4053
736,2020-09-12,(04000) Cabecera Calle 80,869,448,892,2209
737,2020-07-07,(12001) Carrera 43,442,250,304,996
738,2020-08-29,(12001) Carrera 43,314,158,224,696
739,2020-02-20,(10005) Bicentenario - alimentacion,704,347,481,1532
740,2020-09-29,(02000) Cabecera Autopista Norte - intermunicipal,681,427,558,1666
741,2020-02-05,(02302) Virrey,3990,2668,1836,8494
742,2020-08-19,(02000) Cabecera Autopista Norte - intermunicipal,469,289,374,1132
743,2020-05-24,(03000) Portal Suba - alimentacion,1557,840,848,3245
744,2020-03-12,(10010) San Bernardo,230,257,279,766
745,2020-02-22,(06100) Av. Rojas,869,530,914,2313
746,2020-02-07,(09115) Calle 34,4471,2801,2461,9733
747,2020-08-13,(02303) Calle 85,672,450,363,1485
748,2020-03-08,(08002) Biblioteca,239,100,209,548
749,2020-08-12,(08001) Parque el Tunal,461,240,301,1002
750,2020-03-18,(09116) Avenida 39,1143,796,760,2699
751,2020-02-26,(06108) Concejo de Bogotá,885,424,480,1789
752,2020-06-06,(08001) Parque el Tunal,336,200,198,734
753,2020-05-05,(10002) Av. Primero de Mayo,1430,726,844,3000
754,2020-03-13,(09120) Calle 63,2583,325,686,3594
755,2020-09-29,(14004) Museo del Oro,432,286,371,1089
756,2020-02-18,(06001) Modelia,2646,1625,1250,5521
757,2020-03-13,(09107) Hortúa,320,326,341,987
758,2020-04-14,(09107) Hortúa,427,277,208,912
759,2020-08-11,(09107) Hortúa,563,373,369,1305
760,2020-09-28,(09123) Calle 76,1201,820,784,2805
761,2020-08-12,(05101) Mandalay - Cr.73,126,77,62,265
762,2020-04-22,(05002) Tintal,1396,779,640,2815
763,2020-04-03,(05000) Portal Américas,1263,819,989,3071
764,2020-07-20,(50002) Corral Calle 40 Sur,7,3,6,16
765,2020-02-29,(08000) Portal Tunal,1462,850,975,3287
766,2020-06-14,(08000) Portal Tunal,211,124,111,446
767,2020-04-13,(10002) Av. Primero de Mayo,1156,664,704,2524
768,2020-05-21,(05005) Transversal 86,286,164,134,584
769,2020-07-09,(05005) Transversal 86,0,195,509,704
770,2020-07-15,(05005) Transversal 86,72,161,387,620
771,2020-10-04,(05000) Portal Américas - alimentacion,4095,1690,3195,8980
772,2020-03-01,(08000) Portal Tunal,517,367,421,1305
773,2020-02-03,(06109) Centro Memoria,1134,632,614,2380
774,2020-02-02,(10007) Las Nieves,138,207,462,807
775,2020-08-17,(05000) Portal Américas - alimentacion,3480,1510,1828,6818
776,2020-09-19,(02205) Calle 106,224,184,279,687
777,2020-07-10,(03000) Portal Suba - alimentacion,6776,3902,3939,14617
778,2020-08-29,(05002) Tintal,1897,957,1365,4219
779,2020-06-08,(04108) El Polo,455,285,197,937
780,2020-09-03,(04108) El Polo,512,339,228,1079
781,2020-09-09,(04108) El Polo,530,308,290,1128
782,2020-01-29,(12007) Zona Industrial,1292,826,557,2675
783,2020-02-27,(12007) Zona Industrial,1324,782,633,2739
784,2020-08-21,(07010) Bosa,633,293,392,1318
785,2020-08-11,(07113) SANTA ISABEL,341,196,242,779
786,2020-03-30,(06000) Portal Eldorado,772,565,417,1754
787,2020-09-22,(02200) Alcalá,2079,1346,1339,4764
788,2020-02-11,(06101) El Tiempo,3244,1711,1310,6265
789,2020-06-21,(03007) HUMEDAL CORDOBA,40,28,29,97
790,2020-02-27,(04105) Carrera 53,1521,828,784,3133
791,2020-04-01,(10000) Portal 20 de Julio - alimentacion,2703,947,1526,5176
792,2020-04-14,(02101) Toberín,634,400,421,1455
793,2020-03-16,(02300) Calle 100,4747,3186,2628,10561
794,2020-04-22,(07010) Bosa,327,189,206,722
795,2020-08-24,(10002) Av. Primero de Mayo,1786,909,1096,3791
796,2020-09-07,(07104) Simon Bolivar,607,367,327,1301
797,2020-03-30,(05000) Portal Américas,1226,814,1048,3088
798,2020-04-12,(05000) Portal Américas,428,307,328,1063
799,2020-08-14,(05000) Portal Américas,2743,1745,1930,6418
800,2020-01-10,(06001) Modelia,1533,981,1078,3592
801,2020-03-12,(05103) Marsella,166,610,390,1166
802,2020-01-17,(09117) Calle 45,3357,2397,2556,8310
803,2020-06-26,(06101) El Tiempo,358,236,193,787
804,2020-08-16,(04104) Avenida 68,197,104,115,416
805,2020-01-04,(09119) Calle 57,760,535,765,2060
806,2020-02-07,(12003) Ricaurte,1283,812,681,2776
807,2020-02-13,(03003) 21 ANGELES,1822,920,932,3674
808,2020-04-29,(02202) Calle 127,715,491,345,1551
809,2020-03-25,(03011) SUBA - CALLE 100,334,229,156,719
810,2020-05-10,(09001) Molinos,521,300,357,1178
811,2020-05-15,(03001) LA CAMPIÑA,797,442,381,1620
812,2020-07-14,(07113) SANTA ISABEL,319,194,209,722
813,2020-04-09,(06100) Av. Rojas,34,30,23,87
814,2020-06-10,(02302) Virrey,651,415,332,1398
815,2020-04-18,(07106) EL CAMPIN,125,86,69,280
816,2020-02-10,(07200) Tygua-San José,922,575,595,2092
817,2020-01-04,(06103) CAN,401,308,434,1143
818,2020-07-05,(05002) Tintal,0,246,794,1040
819,2020-09-19,(07103) AV. CHILE,627,458,518,1603
820,2020-05-04,(03006) NIZA - CALLE 127,252,193,143,588
821,2020-08-30,(03006) NIZA - CALLE 127,191,120,116,427
822,2020-09-12,(02104) Calle 146,696,384,532,1612
823,2020-01-16,(07201) Guatoque -Veraguas,853,412,575,1840
824,2020-04-07,(06102) Salitre El Greco,147,110,68,325
825,2020-03-16,(07105) MOVISTAR ARENA,945,621,494,2060
826,2020-04-02,(40002) Manitas,178,89,133,400
827,2020-02-08,(02103) Mazurén,1142,456,1130,2728
828,2020-06-21,(02102) Calle 161,75,43,55,173
829,2020-06-12,(07003) SEVILLANA,417,227,224,868
830,2020-05-28,(02104) Calle 146,618,408,406,1432
831,2020-05-06,(09122) Calle 72,772,548,462,1782
832,2020-07-03,(09113) Calle 22,437,263,388,1088
833,2020-07-29,(10008) San Diego,291,165,176,632
834,2020-08-24,(09120) Calle 63,745,559,615,1919
835,2020-01-25,(10005) Bicentenario,194,164,269,627
836,2020-09-27,(03001) LA CAMPIÑA,342,168,377,887
837,2020-06-23,(05107) Américas - Cr.53,478,274,250,1002
838,2020-08-14,(05107) Américas - Cr.53,418,246,231,895
839,2020-08-03,(09003) Socorro,532,289,328,1149
840,2020-05-23,(03002) SUBA - TV- 91,416,247,291,954
841,2020-09-17,(06111) Universidades,447,241,443,1131
842,2020-09-24,(06111) Universidades,450,244,396,1090
843,2020-01-02,(07005) ALQUERIA,1023,620,783,2426
844,2020-04-17,(02204) Pepe Sierra,412,309,234,955
845,2020-04-26,(07102) NQS - CALLE 75,38,43,37,118
846,2020-04-01,(07000) Portal Sur,859,484,563,1906
847,2020-04-15,(07000) Portal Sur,889,577,528,1994
848,2020-07-24,(09110) Avenida Jimenez,521,443,546,1510
849,2020-09-03,(06105) Quinta Paredes,143,86,92,321
850,2020-04-20,(02201) Prado,442,313,247,1002
851,2020-04-13,(09106) Nariño,201,145,151,497
852,2020-04-17,(09106) Nariño,216,124,160,500
853,2020-09-01,(07004) VENECIA,981,624,612,2217
854,2020-07-21,(09122) Calle 72,980,632,684,2296
855,2020-07-13,(07001) PERDOMO,695,446,396,1537
856,2020-07-29,(05102) Av. Américas - Av. Boyacá,198,114,156,468
857,2020-04-12,(06102) Salitre El Greco,61,38,24,123
858,2020-01-24,(07105) MOVISTAR ARENA,1230,730,772,2732
859,2020-08-24,(07003) SEVILLANA,402,209,214,825
860,2020-04-25,(02200) Alcalá,765,511,376,1652
861,2020-06-12,(09115) Calle 34,669,426,369,1464
862,2020-09-16,(04102) Avenida Boyaca,460,246,315,1021
863,2020-05-21,(03003) 21 ANGELES,264,138,139,541
864,2020-05-28,(03003) 21 ANGELES,286,151,147,584
865,2020-06-09,(03003) 21 ANGELES,300,153,132,585
866,2020-02-23,(07004) VENECIA,1004,463,848,2315
867,2020-06-04,(02502) Terminal,378,245,284,907
868,2020-09-14,(04103) Las Ferias,357,210,223,790
869,2020-05-07,(04104) Avenida 68,454,236,207,897
870,2020-04-14,(10004) Policarpa,103,70,81,254
871,2020-04-16,(10007) Las Nieves,204,153,129,486
872,2020-03-01,(14005) Las Aguas,289,224,609,1122
873,2020-03-17,(07006) General Santander - alimentacion,993,548,565,2106
874,2020-02-06,(12000) Puente Aranda,297,191,205,693
875,2020-08-02,(50003) Corral Molinos,405,208,369,982
876,2020-05-14,(09111) Calle 19,555,336,389,1280
877,2020-08-27,(06001) Modelia,353,217,226,796
878,2020-05-13,(03013) RIO NEGRO,234,152,156,542
879,2020-08-02,(06000) Portal Eldorado,151,132,175,458
880,2020-05-08,(07006) General Santander - alimentacion,250,137,147,534
881,2020-05-24,(09003) Socorro,162,92,100,354
882,2020-04-15,(09002) Consuelo,244,127,127,498
883,2020-08-16,(07004) VENECIA,256,127,208,591
884,2020-09-24,(07200) Tygua-San José,276,147,189,612
885,2020-09-27,(40001) Juan Pablo II,202,87,177,466
886,2020-04-12,(14001) La Sabana,31,25,26,82
887,2020-02-14,(12002) CDS - Carrera 32,595,395,357,1347
888,2020-04-05,(09119) Calle 57,117,70,65,252
889,2020-09-15,(09122) Calle 72,1268,807,893,2968
890,2020-07-08,(06103) CAN,399,220,172,791
891,2020-05-19,(06002) Normandía,262,147,145,554
892,2020-06-15,(04000) Cabecera Calle 80 - intermunicipal,71,43,46,160
893,2020-04-14,(03012) SUBA - CALLE 95,193,124,86,403
894,2020-08-24,(14004) Museo del Oro,165,138,190,493
895,2020-06-04,(05105) Pradera,506,324,229,1059
896,2020-04-27,(02205) Calle 106,47,86,47,180
897,2020-02-14,(03004) GRATAMIRA,346,180,156,682
898,2020-03-21,(07112) COMUNEROS,280,156,152,588
899,2020-08-02,(07000) Portal Sur,410,207,374,991
900,2020-06-30,(06105) Quinta Paredes,143,95,86,324
901,2020-07-04,(40002) Manitas,376,231,256,863
902,2020-07-24,(05103) Marsella,303,154,179,636
903,2020-07-22,(09106) Nariño,353,210,296,859
904,2020-06-14,(04106) Carrera 47,116,45,76,237
905,2020-07-27,(12007) Zona Industrial,230,163,147,540
906,2020-08-14,(05102) Av. Américas - Av. Boyacá,243,120,137,500
907,2020-08-29,(06001) Modelia,247,159,178,584
908,2020-06-29,(09110) Avenida Jimenez,371,290,271,932
909,2020-06-22,(04002) Carrera 90,217,109,143,469
910,2020-05-17,(04003) Avenida Ciudad de Cali,213,141,161,515
911,2020-08-03,(14001) La Sabana,141,95,72,308
912,2020-09-28,(07101) CASTELLANA,270,150,182,602
913,2020-09-13,(06111) Universidades,130,68,225,423
914,2020-08-30,(03004) GRATAMIRA,0,8,21,29
915,2020-03-29,(07001) PERDOMO,134,76,68,278
916,2020-01-26,(10008) San Diego,187,141,299,627
917,2020-07-07,(03005) SUBA - AV. BOYACA,478,277,297,1052
918,2020-04-15,(07200) Tygua-San José,104,60,82,246
919,2020-06-18,(10003) Ciudad Jardín,207,107,131,445
920,2020-04-02,(06103) CAN,309,232,164,705
921,2020-03-13,(07200) Tygua-San José,117,101,131,349
922,2020-04-19,(02201) Prado,167,127,90,384
923,2020-07-20,(02000) Cabecera Autopista Norte - intermunicipal,102,69,104,275
924,2020-08-02,(07101) CASTELLANA,31,24,27,82
925,2020-06-05,(06106) Recinto Ferial,229,143,104,476
926,2020-08-23,(07108) Av. El Dorado,23,26,27,76
927,2020-05-17,(07002) MADELENA,139,65,100,304
928,2020-09-13,(04105) Carrera 53,98,56,91,245
929,2020-04-09,(07009) SENA,119,61,64,244
930,2020-04-22,(10005) Bicentenario,46,24,32,102
931,2020-06-14,(05102) Av. Américas - Av. Boyacá,52,30,51,133
932,2020-01-01,(07104) Simon Bolivar,95,89,220,404
933,2020-04-22,(06105) Quinta Paredes,65,61,40,166
934,2020-06-14,(10004) Policarpa,100,31,72,203
935,2020-08-16,(03005) SUBA - AV. BOYACA,122,56,121,299
936,2020-08-10,(50002) Corral Calle 40 Sur,23,7,25,55
937,2020-05-23,(06106) Recinto Ferial,171,92,83,346
938,2020-08-05,(14005) Las Aguas,168,96,178,442
939,2020-05-21,(03014) SAN MARTIN,28,8,21,57
940,2020-09-09,(04000) Cabecera Calle 80 - alimentacion,4488,2591,3245,10324
941,2020-01-31,(07005) ALQUERIA,2531,1371,1464,5366
942,2020-09-25,(09002) Consuelo,543,287,380,1210
943,2020-03-03,(02502) Terminal,5436,3472,3004,11912
944,2020-07-09,(09118) Marly,1487,970,784,3241
945,2020-09-23,(09119) Calle 57,653,439,540,1632
946,2020-01-18,(04106) Carrera 47,758,370,593,1721
947,2020-01-31,(06104) Gobernación,1295,781,678,2754
948,2020-03-09,(06104) Gobernación,596,95,137,828
949,2020-01-20,(03010) PUENTE LARGO,2015,1321,1210,4546
950,2020-02-14,(03010) PUENTE LARGO,2058,1358,1242,4658
951,2020-03-02,(06107) Ciudad Universitaria,1807,1063,910,3780
952,2020-02-17,(05001) Patio Bonito,7396,4282,3795,15473
953,2020-03-11,(05005) Transversal 86,2725,1488,1256,5469
954,2020-07-02,(05005) Transversal 86,0,219,527,746
955,2020-03-16,(09000) Cabecera Usme,4653,2739,2944,10336
956,2020-09-13,(09113) Calle 22,225,118,205,548
957,2020-02-12,(06102) Salitre El Greco,1599,949,735,3283
958,2020-01-29,(10003) Ciudad Jardín,1032,542,661,2235
959,2020-08-25,(02105) Calle 142,724,453,479,1656
960,2020-09-20,(03000) Portal Suba - alimentacion,2308,968,2039,5315
961,2020-05-12,(07001) PERDOMO,666,388,373,1427
962,2020-05-17,(07001) PERDOMO,199,113,114,426
963,2020-01-15,(02000) Cabecera Autopista Norte,8733,5207,5377,19317
964,2020-03-02,(07113) SANTA ISABEL,2065,1284,1396,4745
965,2020-10-06,(09000) Cabecera Usme - alimentacion,9783,4875,6724,21382
966,2020-06-16,(07505) LEON XIII,2796,1542,1208,5546
967,2020-06-26,(07505) LEON XIII,2912,1602,1347,5861
968,2020-01-12,(02101) Toberín,1702,748,2031,4481
969,2020-01-17,(02204) Pepe Sierra,4382,2846,2279,9507
970,2020-09-22,(02204) Pepe Sierra,841,582,566,1989
971,2020-02-12,(06002) Normandía,2835,1560,1339,5734
972,2020-01-13,(05002) Tintal,9178,5282,5151,19611
973,2020-01-06,(09123) Calle 76,433,355,591,1379
974,2020-06-09,(02000) Cabecera Autopista Norte - alimentacion,4587,2605,2405,9597
975,2020-01-18,(12003) Ricaurte,651,548,571,1770
976,2020-02-18,(12003) Ricaurte,1358,820,679,2857
977,2020-01-19,(07503) SAN MATEO,9451,4075,6274,19800
978,2020-09-18,(07102) NQS - CALLE 75,501,322,320,1143
979,2020-09-24,(07102) NQS - CALLE 75,496,341,284,1121
980,2020-03-02,(02302) Virrey,3833,2519,1864,8216
981,2020-03-06,(02302) Virrey,3631,2544,2036,8211
982,2020-02-14,(07110) PALOQUEMAO,2656,1619,1278,5553
983,2020-02-29,(03001) LA CAMPIÑA,3538,1433,2589,7560
984,2020-08-12,(05100) Banderas P. Central - alimentacion,3052,1611,1635,6298
985,2020-09-06,(09103) Olaya,416,191,315,922
986,2020-10-07,(14001) La Sabana,165,111,121,397
987,2020-10-08,(14001) La Sabana,152,117,138,407
988,2020-06-25,(07002) MADELENA,880,494,507,1881
989,2020-04-23,(02200) Alcalá,916,656,484,2056
990,2020-05-28,(02000) Cabecera Autopista Norte,1137,727,661,2525
991,2020-09-05,(02000) Cabecera Autopista Norte,1139,660,962,2761
992,2020-09-11,(08000) Portal Tunal - alimentacion,6437,3434,3898,13769
993,2020-02-18,(04003) Avenida Ciudad de Cali,5806,3558,3566,12930
994,2020-02-07,(04002) Carrera 90,3876,2157,2156,8189
995,2020-06-15,(03000) Portal Suba,308,184,275,767
996,2020-06-09,(40003) Mirador del Paraiso,1640,1053,985,3678
997,2020-08-10,(40003) Mirador del Paraiso,1607,1020,997,3624
998,2020-10-09,(40003) Mirador del Paraiso,1892,1026,1373,4291
999,2020-02-12,(10000) Portal 20 de Julio,9458,4357,3896,17711
1000,2020-03-07,(02101) Toberín,6259,2811,5293,14363
1001,2020-05-18,(12001) Carrera 43,364,194,204,762
1002,2020-07-03,(12001) Carrera 43,425,250,275,950
1003,2020-03-15,(04104) Avenida 68,485,254,443,1182
1004,2020-03-07,(02205) Calle 106,969,713,919,2601
1005,2020-05-16,(03000) Portal Suba,615,346,449,1410
1006,2020-03-10,(09000) Cabecera Usme - alimentacion,1029,6583,4866,12478
1007,2020-07-09,(08001) Parque el Tunal,516,295,273,1084
1008,2020-08-04,(10000) Portal 20 de Julio,2139,1101,1151,4391
1009,2020-01-04,(09116) Avenida 39,298,255,493,1046
1010,2020-02-22,(02300) Calle 100,2812,2046,2729,7587
1011,2020-02-25,(02104) Calle 146,9619,6164,4811,20594
1012,2020-10-12,(09003) Socorro,230,125,208,563
1013,2020-01-05,(07503) SAN MATEO,7466,3274,4945,15685
1014,2020-09-07,(08001) Parque el Tunal,447,260,293,1000
1015,2020-05-05,(06108) Concejo de Bogotá,115,63,66,244
1016,2020-05-19,(07010) Bosa,568,278,339,1185
1017,2020-05-02,(09004) Santa Lucía,1136,525,601,2262
1018,2020-04-10,(07503) SAN MATEO,2048,1250,868,4166
1019,2020-02-09,(10001) Country Sur,904,374,1046,2324
1020,2020-10-07,(06102) Salitre El Greco,244,150,200,594
1021,2020-09-14,(05005) Transversal 86,390,238,291,919
1022,2020-06-16,(06109) Centro Memoria,277,150,142,569
1023,2020-01-30,(09106) Nariño,1991,1182,1375,4548
1024,2020-05-23,(02205) Calle 106,184,122,112,418
1025,2020-07-23,(02205) Calle 106,301,195,140,636
1026,2020-08-04,(02205) Calle 106,290,200,174,664
1027,2020-10-01,(04002) Carrera 90,898,449,663,2010
1028,2020-01-25,(04003) Avenida Ciudad de Cali,2884,1412,2262,6558
1029,2020-08-26,(09101) Quiroga,464,256,355,1075
1030,2020-01-18,(04108) El Polo,862,591,810,2263
1031,2020-06-24,(04108) El Polo,517,317,258,1092
1032,2020-02-25,(02202) Calle 127,6016,3980,2922,12918
1033,2020-09-22,(02304) Heroes,983,645,626,2254
1034,2020-08-05,(06000) Portal Eldorado - alimentacion,3260,1646,1718,6624
1035,2020-01-07,(07113) SANTA ISABEL,1285,831,1052,3168
1036,2020-08-21,(07113) SANTA ISABEL,337,199,258,794
1037,2020-06-08,(03007) HUMEDAL CORDOBA,153,112,61,326
1038,2020-06-25,(10006) San Victorino,706,333,341,1380
1039,2020-02-12,(03005) SUBA - AV. BOYACA,3012,1706,1625,6343
1040,2020-02-04,(05103) Marsella,3190,1858,1538,6586
1041,2020-05-14,(07110) PALOQUEMAO,548,342,207,1097
1042,2020-07-22,(07104) Simon Bolivar,570,381,282,1233
1043,2020-07-23,(10005) Bicentenario - alimentacion,149,82,131,362
1044,2020-05-10,(05000) Portal Américas,433,345,340,1118
1045,2020-01-04,(02205) Calle 106,464,341,478,1283
1046,2020-01-05,(40003) Mirador del Paraiso,1567,672,1136,3375
1047,2020-09-16,(09109) Tercer Milenio,382,244,256,882
1048,2020-07-22,(05001) Patio Bonito,1536,860,956,3352
1049,2020-03-18,(03003) 21 ANGELES,862,372,412,1646
1050,2020-03-27,(07109) CAD,355,272,215,842
1051,2020-05-01,(09101) Quiroga,155,75,114,344
1052,2020-03-28,(03011) SUBA - CALLE 100,218,135,100,453
1053,2020-05-17,(09002) Consuelo,113,48,66,227
1054,2020-04-05,(04108) El Polo,45,47,20,112
1055,2020-01-31,(07107) U. NACIONAL,2180,1432,1391,5003
1056,2020-01-12,(09117) Calle 45,582,430,851,1863
1057,2020-08-12,(02302) Virrey,602,427,325,1354
1058,2020-03-11,(07200) Tygua-San José,712,492,572,1776
1059,2020-08-09,(10000) Portal 20 de Julio - alimentacion,1356,524,899,2779
1060,2020-09-01,(07106) EL CAMPIN,406,271,234,911
1061,2020-02-01,(06103) CAN,651,533,831,2015
1062,2020-03-20,(09116) Avenida 39,197,154,124,475
1063,2020-04-14,(09116) Avenida 39,190,146,128,464
1064,2020-04-26,(03013) RIO NEGRO,45,33,38,116
1065,2020-03-28,(05102) Av. Américas - Av. Boyacá,92,55,56,203
1066,2020-06-24,(05102) Av. Américas - Av. Boyacá,262,150,165,577
1067,2020-08-08,(07103) AV. CHILE,390,248,323,961
1068,2020-08-13,(03006) NIZA - CALLE 127,355,226,235,816
1069,2020-02-05,(10005) Bicentenario,851,437,357,1645
1070,2020-05-21,(05107) Américas - Cr.53,334,224,190,748
1071,2020-05-30,(05107) Américas - Cr.53,268,164,211,643
1072,2020-09-23,(05107) Américas - Cr.53,495,288,316,1099
1073,2020-04-13,(10010) San Bernardo,409,239,269,917
1074,2020-07-23,(09123) Calle 76,786,559,442,1787
1075,2020-01-05,(07103) AV. CHILE,416,295,485,1196
1076,2020-05-06,(07103) AV. CHILE,639,401,282,1322
1077,2020-02-03,(10008) San Diego,1575,828,819,3222
1078,2020-09-02,(10005) Bicentenario,115,66,88,269
1079,2020-10-06,(10005) Bicentenario,114,75,114,303
1080,2020-06-12,(09117) Calle 45,741,443,434,1618
1081,2020-06-07,(02000) Cabecera Autopista Norte,337,224,243,804
1082,2020-10-05,(07003) SEVILLANA,520,282,379,1181
1083,2020-01-19,(07102) NQS - CALLE 75,202,163,336,701
1084,2020-07-03,(09118) Marly,1487,947,865,3299
1085,2020-07-02,(09120) Calle 63,1221,788,784,2793
1086,2020-09-17,(03011) SUBA - CALLE 100,654,313,330,1297
1087,2020-07-30,(10009) Museo Nacional,464,252,302,1018
1088,2020-10-04,(03000) Portal Suba - alimentacion,2401,1033,2360,5794
1089,2020-03-31,(03012) SUBA - CALLE 95,177,114,117,408
1090,2020-06-11,(07111) NQS - RICAURTE,1124,739,385,2248
1091,2020-05-14,(04002) Carrera 90,534,317,285,1136
1092,2020-04-25,(07000) Portal Sur,653,434,429,1516
1093,2020-05-17,(07110) PALOQUEMAO,140,98,72,310
1094,2020-08-26,(02105) Calle 142,676,466,448,1590
1095,2020-04-29,(09107) Hortúa,455,306,252,1013
1096,2020-05-28,(07200) Tygua-San José,221,107,127,455
1097,2020-02-09,(10009) Museo Nacional,327,303,557,1187
1098,2020-04-30,(09122) Calle 72,723,539,456,1718
1099,2020-07-31,(09002) Consuelo,429,229,268,926
1100,2020-05-22,(07105) MOVISTAR ARENA,221,130,112,463
1101,2020-10-11,(50003) Corral Molinos,531,245,594,1370
1102,2020-08-13,(07003) SEVILLANA,410,243,249,902
1103,2020-10-02,(07104) Simon Bolivar,598,395,443,1436
1104,2020-05-07,(05105) Pradera,460,289,182,931
1105,2020-07-05,(02303) Calle 85,166,140,164,470
1106,2020-01-06,(12001) Carrera 43,126,95,201,422
1107,2020-10-07,(05103) Marsella,575,318,365,1258
1108,2020-07-12,(06000) Portal Eldorado - alimentacion,1514,750,974,3238
1109,2020-08-19,(04100) Carrera 77,1144,618,733,2495
1110,2020-03-26,(08002) Biblioteca,171,92,89,352
1111,2020-03-19,(12000) Puente Aranda,161,106,116,383
1112,2020-08-12,(12000) Puente Aranda,94,51,43,188
1113,2020-03-26,(03005) SUBA - AV. BOYACA,191,143,120,454
1114,2020-08-09,(05102) Av. Américas - Av. Boyacá,61,30,40,131
1115,2020-03-19,(02102) Calle 161,678,397,452,1527
1116,2020-08-24,(12004) Carrera 22,256,150,138,544
1117,2020-04-12,(07102) NQS - CALLE 75,28,28,22,78
1118,2020-06-15,(09107) Hortúa,258,162,153,573
1119,2020-06-27,(08001) Parque el Tunal,387,187,259,833
1120,2020-01-29,(07006) General Santander - alimentacion,1472,873,884,3229
1121,2020-05-03,(02302) Virrey,160,127,86,373
1122,2020-07-27,(02000) Cabecera Autopista Norte - intermunicipal,548,366,385,1299
1123,2020-07-23,(04104) Avenida 68,545,254,284,1083
1124,2020-06-21,(14001) La Sabana,59,41,36,136
1125,2020-06-12,(03005) SUBA - AV. BOYACA,464,244,239,947
1126,2020-03-30,(40001) Juan Pablo II,230,130,134,494
1127,2020-09-26,(07108) Av. El Dorado,106,80,109,295
1128,2020-08-12,(06002) Normandía,255,154,169,578
1129,2020-03-18,(04000) Cabecera Calle 80 - intermunicipal,690,499,858,2047
1130,2020-07-06,(06100) Av. Rojas,252,153,181,586
1131,2020-08-15,(40002) Manitas,330,174,244,748
1132,2020-04-05,(03001) LA CAMPIÑA,184,84,86,354
1133,2020-09-14,(07006) General Santander - alimentacion,374,213,300,887
1134,2020-04-02,(03003) 21 ANGELES,143,96,80,319
1135,2020-01-11,(10003) Ciudad Jardín,467,214,439,1120
1136,2020-06-07,(03001) LA CAMPIÑA,250,113,165,528
1137,2020-04-01,(04104) Avenida 68,283,185,170,638
1138,2020-04-07,(09117) Calle 45,459,317,227,1003
1139,2020-07-18,(03011) SUBA - CALLE 100,319,170,195,684
1140,2020-08-26,(10004) Policarpa,215,108,154,477
1141,2020-05-12,(07006) General Santander - alimentacion,279,149,148,576
1142,2020-04-22,(09115) Calle 34,387,283,228,898
1143,2020-06-19,(06108) Concejo de Bogotá,156,85,84,325
1144,2020-07-31,(03004) GRATAMIRA,21,10,20,51
1145,2020-06-02,(06103) CAN,352,228,158,738
1146,2020-04-09,(07004) VENECIA,196,99,110,405
1147,2020-07-12,(07506) DESPENSA,127,72,108,307
1148,2020-04-20,(06103) CAN,327,208,145,680
1149,2020-09-01,(06103) CAN,410,229,207,846
1150,2020-05-19,(14005) Las Aguas,0,59,170,229
1151,2020-04-27,(02103) Mazurén,50,24,21,95
1152,2020-04-17,(06100) Av. Rojas,118,74,75,267
1153,2020-05-11,(07006) General Santander,352,227,209,788
1154,2020-07-23,(05101) Mandalay - Cr.73,94,49,52,195
1155,2020-06-21,(08002) Biblioteca,113,56,66,235
1156,2020-04-14,(06107) Ciudad Universitaria,114,88,79,281
1157,2020-09-20,(12002) CDS - Carrera 32,34,33,25,92
1158,2020-05-18,(12004) Carrera 22,183,97,92,372
1159,2020-03-20,(12003) Ricaurte,94,68,46,208
1160,2020-06-26,(07201) Guatoque -Veraguas,206,109,136,451
1161,2020-07-04,(09105) Río Fucha,90,41,101,232
1162,2020-03-22,(07105) MOVISTAR ARENA,37,35,38,110
1163,2020-05-24,(06102) Salitre El Greco,61,30,38,129
1164,2020-10-12,(09105) Río Fucha,0,28,74,102
1165,2020-08-12,(06108) Concejo de Bogotá,141,62,80,283
1166,2020-04-09,(03004) GRATAMIRA,10,7,5,22
1167,2020-10-13,(05100) Banderas P. Central,0,1,0,1
1168,2020-06-10,(04000) Cabecera Calle 80 - alimentacion,3809,2189,2321,8319
1169,2020-09-18,(02502) Terminal,512,345,498,1355
1170,2020-08-09,(09118) Marly,425,279,334,1038
1171,2020-03-31,(07504) TERREROS,2349,1322,1359,5030
1172,2020-07-02,(07504) TERREROS,6431,3567,3153,13151
1173,2020-01-23,(09119) Calle 57,2843,2011,1902,6756
1174,2020-03-02,(03000) Portal Suba - alimentacion,28607,17116,16680,62403
1175,2020-03-11,(07503) SAN MATEO,38126,21200,16685,76011
1176,2020-07-07,(07503) SAN MATEO,11993,7122,6020,25135
1177,2020-09-23,(07503) SAN MATEO,13922,7193,6971,28086
1178,2020-02-10,(06104) Gobernación,1458,842,631,2931
1179,2020-09-14,(09001) Molinos,2643,1402,1907,5952
1180,2020-04-30,(04000) Cabecera Calle 80 - alimentacion,2374,1345,1363,5082
1181,2020-02-27,(05001) Patio Bonito,7164,3990,3602,14756
1182,2020-01-16,(07010) Bosa,1984,1114,1389,4487
1183,2020-01-24,(07000) Portal Sur - alimentacion,27466,15145,13890,56501
1184,2020-03-24,(07000) Portal Sur - alimentacion,6210,3136,3128,12474
1185,2020-09-12,(07112) COMUNEROS,725,366,546,1637
1186,2020-02-19,(04100) Carrera 77,7059,4338,3984,15381
1187,2020-01-13,(08000) Portal Tunal - alimentacion,19921,10657,10517,41095
1188,2020-01-27,(10004) Policarpa,764,421,616,1801
1189,2020-10-07,(05100) Banderas P. Central - alimentacion,3728,1996,2615,8339
1190,2020-04-12,(07000) Portal Sur - alimentacion,1419,775,541,2735
1191,2020-03-11,(09104) Restrepo,5022,3036,3814,11872
1192,2020-01-17,(04104) Avenida 68,2959,1528,1764,6251
1193,2020-01-08,(12003) Ricaurte,813,567,503,1883
1194,2020-02-17,(03013) RIO NEGRO,1257,827,917,3001
1195,2020-05-20,(09000) Cabecera Usme - alimentacion,6941,3857,3780,14578
1196,2020-10-12,(09118) Marly,482,319,520,1321
1197,2020-01-22,(02103) Mazurén,3251,2012,1891,7154
1198,2020-05-14,(02103) Mazurén,135,95,98,328
1199,2020-03-09,(02303) Calle 85,2201,131,419,2751
1200,2020-04-20,(14001) La Sabana,87,63,49,199
1201,2020-05-22,(07002) MADELENA,610,347,384,1341
1202,2020-05-26,(02000) Cabecera Autopista Norte,1142,742,711,2595
1203,2020-02-15,(03003) 21 ANGELES,1004,396,680,2080
1204,2020-01-10,(04105) Carrera 53,968,536,612,2116
1205,2020-07-21,(05000) Portal Américas,2448,1600,1690,5738
1206,2020-03-07,(09110) Avenida Jimenez,3353,2362,2308,8023
1207,2020-01-26,(09114) Calle 26,216,193,456,865
1208,2020-02-27,(09114) Calle 26,3364,2194,1734,7292
1209,2020-01-16,(10001) Country Sur,4341,1877,2430,8648
1210,2020-02-01,(03000) Portal Suba,4236,1991,3530,9757
1211,2020-02-12,(03000) Portal Suba,10067,6091,5230,21388
1212,2020-05-18,(40003) Mirador del Paraiso,1485,872,914,3271
1213,2020-07-02,(05002) Tintal,0,1027,2750,3777
1214,2020-10-04,(08000) Portal Tunal - alimentacion,2317,990,1986,5293
1215,2020-02-29,(07505) LEON XIII,6056,2907,3345,12308
1216,2020-06-08,(06105) Quinta Paredes,140,83,90,313
1217,2020-04-02,(06101) El Tiempo,198,165,120,483
1218,2020-07-03,(09101) Quiroga,613,314,437,1364
1219,2020-07-10,(02303) Calle 85,796,507,426,1729
1220,2020-07-28,(02303) Calle 85,688,461,316,1465
1221,2020-02-08,(09004) Santa Lucía,5412,2633,3504,11549
1222,2020-01-09,(10007) Las Nieves,1479,952,964,3395
1223,2020-08-20,(09003) Socorro,544,279,309,1132
1224,2020-01-24,(05102) Av. Américas - Av. Boyacá,1607,916,903,3426
1225,2020-01-27,(07007) NQS - Calle 38A Sur,2011,1191,1185,4387
1226,2020-06-29,(02101) Toberín,329,251,369,949
1227,2020-04-28,(06108) Concejo de Bogotá,106,61,72,239
1228,2020-09-12,(06108) Concejo de Bogotá,90,61,84,235
1229,2020-08-20,(04000) Cabecera Calle 80,999,574,793,2366
1230,2020-08-02,(10001) Country Sur,311,126,267,704
1231,2020-01-26,(03003) 21 ANGELES,375,138,345,858
1232,2020-06-05,(03003) 21 ANGELES,286,153,157,596
1233,2020-05-20,(14004) Museo del Oro,0,87,171,258
1234,2020-04-06,(02201) Prado,395,288,231,914
1235,2020-05-20,(05101) Mandalay - Cr.73,94,55,45,194
1236,2020-05-27,(05002) Tintal,2020,1074,1153,4247
1237,2020-05-30,(02300) Calle 100,763,522,448,1733
1238,2020-10-06,(10000) Portal 20 de Julio,2484,1212,1686,5382
1239,2020-05-02,(04000) Cabecera Calle 80 - alimentacion,1433,785,889,3107
1240,2020-07-12,(08000) Portal Tunal,274,167,153,594
1241,2020-05-23,(09001) Molinos,1683,857,1117,3657
1242,2020-05-28,(05005) Transversal 86,336,156,208,700
1243,2020-07-23,(02000) Cabecera Autopista Norte,1143,673,681,2497
1244,2020-05-28,(07007) NQS - Calle 38A Sur,311,198,231,740
1245,2020-01-25,(09121) Las Flores,1581,1064,1321,3966
1246,2020-08-13,(02205) Calle 106,247,228,249,724
1247,2020-10-01,(06000) Portal Eldorado - alimentacion,4336,2213,2851,9400
1248,2020-10-08,(06000) Portal Eldorado - alimentacion,4367,2158,2920,9445
1249,2020-09-26,(04108) El Polo,357,241,301,899
1250,2020-03-19,(10009) Museo Nacional,1885,1102,975,3962
1251,2020-09-20,(02201) Prado,339,218,358,915
1252,2020-07-14,(07106) EL CAMPIN,414,248,179,841
1253,2020-09-22,(07106) EL CAMPIN,465,297,306,1068
1254,2020-06-08,(07103) AV. CHILE,887,544,419,1850
1255,2020-01-09,(05103) Marsella,1942,1035,1079,4056
1256,2020-02-21,(03007) HUMEDAL CORDOBA,1002,583,522,2107
1257,2020-09-22,(03007) HUMEDAL CORDOBA,169,138,101,408
1258,2020-05-28,(10006) San Victorino,491,252,274,1017
1259,2020-08-12,(10006) San Victorino,690,319,328,1337
1260,2020-02-15,(04104) Avenida 68,1803,990,1397,4190
1261,2020-06-17,(04104) Avenida 68,628,338,368,1334
1262,2020-01-02,(03011) SUBA - CALLE 100,1205,586,756,2547
1263,2020-10-06,(04100) Carrera 77,1477,838,1207,3522
1264,2020-02-14,(03005) SUBA - AV. BOYACA,2825,1626,1530,5981
1265,2020-07-10,(02101) Toberín,1577,948,1087,3612
1266,2020-06-20,(40003) Mirador del Paraiso,1526,935,944,3405
1267,2020-04-28,(07104) Simon Bolivar,264,164,135,563
1268,2020-09-28,(10005) Bicentenario - alimentacion,195,116,222,533
1269,2020-01-06,(10010) San Bernardo,347,213,440,1000
1270,2020-04-28,(09000) Cabecera Usme,987,581,686,2254
1271,2020-01-25,(05103) Marsella,1303,611,900,2814
1272,2020-06-03,(05103) Marsella,275,144,193,612
1273,2020-09-14,(09109) Tercer Milenio,373,220,262,855
1274,2020-03-24,(10010) San Bernardo,523,351,454,1328
1275,2020-07-20,(12001) Carrera 43,59,52,48,159
1276,2020-10-06,(02104) Calle 146,1098,670,923,2691
1277,2020-09-19,(03002) SUBA - TV- 91,688,334,556,1578
1278,2020-09-29,(03002) SUBA - TV- 91,918,553,645,2116
1279,2020-05-13,(02202) Calle 127,887,634,473,1994
1280,2020-01-19,(04001) Quirigua,430,188,435,1053
1281,2020-02-20,(04001) Quirigua,2012,1305,1086,4403
1282,2020-01-08,(09107) Hortúa,1567,987,1144,3698
1283,2020-05-04,(10002) Av. Primero de Mayo,1451,742,802,2995
1284,2020-05-31,(09001) Molinos,677,309,529,1515
1285,2020-07-12,(09001) Molinos,963,434,830,2227
1286,2020-06-16,(02304) Heroes,819,593,456,1868
1287,2020-09-03,(07101) CASTELLANA,232,125,150,507
1288,2020-07-18,(03001) LA CAMPIÑA,660,335,415,1410
1289,2020-07-10,(07003) SEVILLANA,436,248,262,946
1290,2020-01-19,(09120) Calle 63,841,684,1230,2755
1291,2020-05-30,(06100) Av. Rojas,111,66,94,271
1292,2020-09-03,(03013) RIO NEGRO,296,172,230,698
1293,2020-07-06,(10010) San Bernardo,650,359,453,1462
1294,2020-10-12,(02105) Calle 142,255,148,305,708
1295,2020-03-27,(10008) San Diego,109,104,121,334
1296,2020-09-14,(07010) Bosa,0,374,935,1309
1297,2020-03-30,(07005) ALQUERIA,240,150,166,556
1298,2020-09-10,(03006) NIZA - CALLE 127,499,272,265,1036
1299,2020-01-06,(04000) Cabecera Calle 80,955,502,1089,2546
1300,2020-07-24,(03002) SUBA - TV- 91,641,390,368,1399
1301,2020-08-10,(05107) Américas - Cr.53,396,224,252,872
1302,2020-08-10,(02103) Mazurén,155,101,145,401
1303,2020-04-09,(06102) Salitre El Greco,62,49,37,148
1304,2020-03-26,(06109) Centro Memoria,176,129,100,405
1305,2020-05-16,(05002) Tintal,1233,617,638,2488
1306,2020-01-08,(12002) CDS - Carrera 32,397,263,244,904
1307,2020-01-26,(09106) Nariño,418,194,470,1082
1308,2020-09-15,(09106) Nariño,446,228,372,1046
1309,2020-05-09,(05100) Banderas P. Central - alimentacion,1304,622,608,2534
1310,2020-01-30,(07006) General Santander - alimentacion,1435,845,987,3267
1311,2020-06-11,(02300) Calle 100,1254,804,604,2662
1312,2020-10-01,(10008) San Diego,336,190,253,779
1313,2020-05-04,(05002) Tintal,1628,932,859,3419
1314,2020-03-17,(09120) Calle 63,3334,2151,2095,7580
1315,2020-06-16,(10009) Museo Nacional,491,315,299,1105
1316,2020-07-18,(09003) Socorro,361,177,221,759
1317,2020-03-31,(07111) NQS - RICAURTE,355,266,204,825
1318,2020-09-26,(09115) Calle 34,433,302,506,1241
1319,2020-06-25,(07110) PALOQUEMAO,675,438,291,1404
1320,2020-08-28,(07110) PALOQUEMAO,655,397,275,1327
1321,2020-05-17,(02200) Alcalá,406,314,245,965
1322,2020-06-02,(02105) Calle 142,724,418,419,1561
1323,2020-02-26,(12004) Carrera 22,568,435,500,1503
1324,2020-02-18,(07200) Tygua-San José,824,523,561,1908
1325,2020-03-17,(06107) Ciudad Universitaria,658,384,447,1489
1326,2020-08-20,(09004) Santa Lucía,2355,1180,1296,4831
1327,2020-06-27,(09122) Calle 72,916,655,765,2336
1328,2020-01-03,(04003) Avenida Ciudad de Cali,2786,1452,1987,6225
1329,2020-01-05,(10008) San Diego,143,116,233,492
1330,2020-08-18,(04105) Carrera 53,279,145,151,575
1331,2020-03-02,(07006) General Santander - alimentacion,1488,885,1032,3405
1332,2020-01-14,(04102) Avenida Boyaca,2345,1322,1420,5087
1333,2020-07-18,(07003) SEVILLANA,253,142,168,563
1334,2020-08-19,(02200) Alcalá,1633,1099,888,3620
1335,2020-01-16,(07008) NQS - Calle 30 Sur,1613,798,987,3398
1336,2020-06-07,(04003) Avenida Ciudad de Cali,264,141,215,620
1337,2020-06-04,(03003) 21 ANGELES,305,150,147,602
1338,2020-08-12,(03003) 21 ANGELES,275,152,161,588
1339,2020-01-05,(02000) Cabecera Autopista Norte - intermunicipal,454,279,519,1252
1340,2020-05-31,(02302) Virrey,170,131,83,384
1341,2020-06-27,(04108) El Polo,374,220,219,813
1342,2020-08-19,(04103) Las Ferias,344,189,176,709
1343,2020-08-04,(40002) Manitas,375,214,220,809
1344,2020-08-31,(10004) Policarpa,238,114,165,517
1345,2020-02-17,(12000) Puente Aranda,319,184,201,704
1346,2020-08-18,(12000) Puente Aranda,100,51,32,183
1347,2020-07-20,(09004) Santa Lucía,716,314,404,1434
1348,2020-08-30,(05102) Av. Américas - Av. Boyacá,84,47,62,193
1349,2020-04-15,(02102) Calle 161,97,65,65,227
1350,2020-04-28,(09113) Calle 22,262,165,233,660
1351,2020-02-20,(12004) Carrera 22,702,428,478,1608
1352,2020-07-30,(09115) Calle 34,624,394,398,1416
1353,2020-02-29,(10004) Policarpa,584,247,493,1324
1354,2020-09-17,(09111) Calle 19,811,480,552,1843
1355,2020-07-17,(07005) ALQUERIA,491,254,281,1026
1356,2020-03-24,(07009) SENA,499,323,372,1194
1357,2020-02-22,(07200) Tygua-San José,432,277,446,1155
1358,2020-06-05,(07200) Tygua-San José,223,110,138,471
1359,2020-09-14,(07200) Tygua-San José,224,134,173,531
1360,2020-08-09,(03013) RIO NEGRO,63,49,54,166
1361,2020-07-11,(04104) Avenida 68,488,252,305,1045
1362,2020-07-02,(03010) PUENTE LARGO,390,236,236,862
1363,2020-08-03,(40001) Juan Pablo II,500,329,336,1165
1364,2020-10-11,(12007) Zona Industrial,55,45,99,199
1365,2020-09-01,(12002) CDS - Carrera 32,204,133,84,421
1366,2020-03-27,(09000) Cabecera Usme,755,407,503,1665
1367,2020-06-21,(07108) Av. El Dorado,38,31,37,106
1368,2020-09-29,(07108) Av. El Dorado,190,111,149,450
1369,2020-05-08,(06002) Normandía,212,123,144,479
1370,2020-05-23,(10009) Museo Nacional,221,148,166,535
1371,2020-07-22,(07006) General Santander,504,298,289,1091
1372,2020-10-05,(04102) Avenida Boyaca,466,266,364,1096
1373,2020-04-29,(03010) PUENTE LARGO,217,150,118,485
1374,2020-07-21,(14004) Museo del Oro,268,176,190,634
1375,2020-05-02,(09104) Restrepo,631,411,465,1507
1376,2020-04-14,(07010) Bosa,299,183,204,686
1377,2020-04-03,(04000) Cabecera Calle 80 - intermunicipal,97,65,92,254
1378,2020-04-29,(07101) CASTELLANA,98,67,75,240
1379,2020-10-04,(03013) RIO NEGRO,91,52,123,266
1380,2020-09-09,(07200) Tygua-San José,261,162,169,592
1381,2020-07-11,(03011) SUBA - CALLE 100,362,212,255,829
1382,2020-09-20,(06101) El Tiempo,104,86,126,316
1383,2020-08-07,(07109) CAD,203,160,110,473
1384,2020-06-16,(09106) Nariño,385,250,266,901
1385,2020-05-01,(09117) Calle 45,251,175,153,579
1386,2020-07-04,(06001) Modelia,270,188,204,662
1387,2020-06-17,(09113) Calle 22,392,256,332,980
1388,2020-06-03,(40002) Manitas,374,211,249,834
1389,2020-07-20,(08001) Parque el Tunal,120,58,68,246
1390,2020-05-01,(02001) Centro Comercial Santa Fe,97,69,97,263
1391,2020-03-16,(09105) Río Fucha,476,266,318,1060
1392,2020-03-21,(06101) El Tiempo,158,91,94,343
1393,2020-05-18,(06101) El Tiempo,292,188,130,610
1394,2020-09-06,(06101) El Tiempo,102,76,129,307
1395,2020-05-16,(09106) Nariño,260,138,169,567
1396,2020-03-29,(10007) Las Nieves,48,25,38,111
1397,2020-04-12,(09107) Hortúa,160,99,88,347
1398,2020-07-04,(07006) General Santander - alimentacion,311,178,240,729
1399,2020-06-04,(04103) Las Ferias,344,199,186,729
1400,2020-05-02,(08002) Biblioteca,139,78,78,295
1401,2020-05-16,(07006) General Santander,288,140,156,584
1402,2020-03-29,(07111) NQS - RICAURTE,67,75,55,197
1403,2020-08-31,(09105) Río Fucha,0,65,122,187
1404,2020-04-19,(06107) Ciudad Universitaria,37,23,23,83
1405,2020-09-13,(12001) Carrera 43,74,49,107,230
1406,2020-04-18,(09105) Río Fucha,48,33,51,132
1407,2020-08-17,(10004) Policarpa,83,45,71,199
1408,2020-07-26,(07105) MOVISTAR ARENA,56,33,70,159
1409,2020-09-24,(06105) Quinta Paredes,174,99,104,377
1410,2020-07-19,(07002) MADELENA,168,98,138,404
1411,2020-05-31,(07506) DESPENSA,113,52,84,249
1412,2020-07-12,(04101) Minuto de Dios,100,51,120,271
1413,2020-04-19,(06105) Quinta Paredes,25,22,13,60
1414,2020-04-09,(07008) NQS - Calle 30 Sur,69,38,31,138
1415,2020-06-22,(07201) Guatoque -Veraguas,32,29,68,129
1416,2020-08-09,(07201) Guatoque -Veraguas,30,23,50,103
1417,2020-07-06,(03014) SAN MARTIN,27,10,24,61
1418,2020-01-25,(03014) SAN MARTIN,109,56,119,284
1419,2020-04-24,(05101) Mandalay - Cr.73,56,41,22,119
1420,2020-04-09,(04000) Cabecera Calle 80 - intermunicipal,31,17,29,77
1421,2020-09-11,(03004) GRATAMIRA,0,22,29,51
1422,2020-04-19,(02102) Calle 161,33,22,28,83
1423,2019-12-31,(14001) La Sabana,4,2,9,15
1424,2020-09-30,(50006) Corral Carrera 77,6,5,10,21
1425,2020-03-10,(09002) Consuelo,79,337,303,719
1426,2020-07-23,(02502) Terminal,352,248,235,835
1427,2020-04-01,(03013) RIO NEGRO,145,92,109,346
1428,2020-05-15,(07504) TERREROS,4115,2398,2095,8608
1429,2020-01-28,(05000) Portal Américas - alimentacion,35429,20544,19719,75692
1430,2020-02-29,(03002) SUBA - TV- 91,2385,1102,1766,5253
1431,2020-01-07,(09122) Calle 72,4241,2802,2965,10008
1432,2020-03-11,(09122) Calle 72,7777,5122,4214,17113
1433,2020-03-12,(09122) Calle 72,3424,496,899,4819
1434,2020-01-27,(07003) SEVILLANA,1982,1090,1005,4077
1435,2020-03-10,(09114) Calle 26,1880,197,457,2534
1436,2020-02-08,(09000) Cabecera Usme - alimentacion,18252,9210,12775,40237
1437,2020-06-23,(07503) SAN MATEO,11072,7138,5922,24132
1438,2020-02-02,(04000) Cabecera Calle 80 - alimentacion,4955,2105,5423,12483
1439,2020-09-25,(06107) Ciudad Universitaria,212,134,172,518
1440,2020-07-27,(07000) Portal Sur - alimentacion,6496,3843,3229,13568
1441,2020-01-10,(05005) Transversal 86,1919,969,1057,3945
1442,2020-02-07,(09000) Cabecera Usme,5617,3377,4009,13003
1443,2020-06-27,(05100) Banderas P. Central - alimentacion,2340,1140,1435,4915
1444,2020-02-05,(06102) Salitre El Greco,1614,874,724,3212
1445,2020-02-12,(10003) Ciudad Jardín,1163,604,690,2457
1446,2020-01-02,(02205) Calle 106,925,630,660,2215
1447,2020-10-01,(10005) Bicentenario - alimentacion,213,111,217,541
1448,2020-07-19,(07001) PERDOMO,207,106,164,477
1449,2020-06-12,(04101) Minuto de Dios,330,201,217,748
1450,2020-08-26,(07505) LEON XIII,2668,1403,1168,5239
1451,2020-09-08,(03000) Portal Suba - alimentacion,6621,3731,4057,14409
1452,2020-07-25,(02204) Pepe Sierra,499,336,270,1105
1453,2020-03-26,(06002) Normandía,147,89,98,334
1454,2020-06-16,(05002) Tintal,2498,1364,1316,5178
1455,2020-07-17,(02000) Cabecera Autopista Norte - alimentacion,4464,2410,2368,9242
1456,2020-03-11,(07102) NQS - CALLE 75,1448,960,906,3314
1457,2020-08-21,(07102) NQS - CALLE 75,457,279,219,955
1458,2020-02-21,(03013) RIO NEGRO,1213,749,910,2872
1459,2020-02-01,(03007) HUMEDAL CORDOBA,414,253,301,968
1460,2020-01-09,(05001) Patio Bonito,5039,2881,2944,10864
1461,2020-01-28,(02103) Mazurén,3383,2180,1861,7424
1462,2020-03-06,(02303) Calle 85,3563,2487,2040,8090
1463,2020-04-22,(10000) Portal 20 de Julio - alimentacion,2633,1134,1431,5198
1464,2020-03-16,(09103) Olaya,2876,1727,1663,6266
1465,2020-01-14,(14001) La Sabana,300,262,337,899
1466,2020-06-03,(14001) La Sabana,159,97,102,358
1467,2020-08-21,(14001) La Sabana,164,99,99,362
1468,2020-08-29,(07000) Portal Sur - alimentacion,6700,3477,4067,14244
1469,2020-05-13,(07002) MADELENA,531,325,294,1150
1470,2020-06-01,(07002) MADELENA,706,413,396,1515
1471,2020-04-01,(07112) COMUNEROS,388,244,209,841
1472,2020-01-13,(07107) U. NACIONAL,1101,804,943,2848
1473,2020-06-25,(09110) Avenida Jimenez,1383,1041,808,3232
1474,2020-03-15,(03002) SUBA - TV- 91,636,297,616,1549
1475,2020-01-23,(09114) Calle 26,2547,1774,1691,6012
1476,2020-02-28,(40003) Mirador del Paraiso,4925,2722,2597,10244
1477,2020-03-03,(09123) Calle 76,5897,3892,3144,12933
1478,2020-07-23,(12001) Carrera 43,342,187,163,692
1479,2020-06-28,(07505) LEON XIII,763,373,419,1555
1480,2020-09-21,(10002) Av. Primero de Mayo,1901,829,1200,3930
1481,2020-09-25,(10002) Av. Primero de Mayo,2519,1233,1755,5507
1482,2020-01-31,(09107) Hortúa,2300,1331,1579,5210
1483,2020-01-10,(02105) Calle 142,4645,2626,2925,10196
1484,2020-02-05,(06105) Quinta Paredes,1088,646,535,2269
1485,2020-10-10,(02302) Virrey,407,331,440,1178
1486,2020-05-28,(03000) Portal Suba - alimentacion,5174,2977,2755,10906
1487,2020-03-13,(06100) Av. Rojas,389,258,303,950
1488,2020-02-18,(04001) Quirigua,2189,1325,1246,4760
1489,2020-06-24,(02303) Calle 85,774,556,345,1675
1490,2020-02-18,(02001) Centro Comercial Santa Fe,4951,3197,2599,10747
1491,2020-06-14,(10002) Av. Primero de Mayo,544,280,454,1278
1492,2020-03-08,(09004) Santa Lucía,2198,837,1576,4611
1493,2020-08-26,(08001) Parque el Tunal,430,243,239,912
1494,2020-01-29,(05102) Av. Américas - Av. Boyacá,1774,1074,900,3748
1495,2020-01-16,(06108) Concejo de Bogotá,757,377,427,1561
1496,2020-02-18,(06108) Concejo de Bogotá,981,462,434,1877
1497,2020-01-26,(10001) Country Sur,913,378,1002,2293
1498,2020-01-03,(03001) LA CAMPIÑA,3033,1540,1935,6508
1499,2020-01-08,(03001) LA CAMPIÑA,4622,2518,2765,9905
1500,2020-08-21,(02300) Calle 100,1082,747,651,2480
1501,2020-01-18,(03012) SUBA - CALLE 95,704,449,658,1811
1502,2020-06-25,(03012) SUBA - CALLE 95,349,233,192,774
1503,2020-03-01,(50002) Corral Calle 40 Sur,13,11,41,65
1504,2020-01-22,(07006) General Santander,2688,1601,1459,5748
1505,2020-01-24,(07006) General Santander,2731,1522,1500,5753
1506,2020-02-15,(05005) Transversal 86,1451,571,953,2975
1507,2020-01-05,(08000) Portal Tunal,404,281,321,1006
1508,2020-01-04,(12000) Puente Aranda,75,64,97,236
1509,2020-04-06,(09118) Marly,997,700,453,2150
1510,2020-03-18,(04108) El Polo,1085,734,651,2470
1511,2020-04-20,(07201) Guatoque -Veraguas,80,63,56,199
1512,2020-06-21,(07505) LEON XIII,709,391,379,1479
1513,2020-08-07,(07113) SANTA ISABEL,153,82,108,343
1514,2020-03-24,(10006) San Victorino,316,269,325,910
1515,2020-03-04,(03011) SUBA - CALLE 100,2632,1372,1510,5514
1516,2020-01-03,(07108) Av. El Dorado,303,239,318,860
1517,2020-01-23,(07108) Av. El Dorado,868,549,564,1981
1518,2020-02-06,(07108) Av. El Dorado,912,599,603,2114
1519,2020-07-15,(07000) Portal Sur,1565,999,912,3476
1520,2020-04-11,(02101) Toberín,222,161,190,573
1521,2020-01-10,(04103) Las Ferias,1116,638,733,2487
1522,2020-05-24,(02000) Cabecera Autopista Norte - alimentacion,1474,724,724,2922
1523,2020-07-21,(04107) Escuela Militar,120,72,80,272
1524,2020-09-07,(09121) Las Flores,742,452,520,1714
1525,2020-06-26,(09000) Cabecera Usme,1857,1188,1264,4309
1526,2020-07-14,(09000) Cabecera Usme,1068,707,861,2636
1527,2020-03-30,(03000) Portal Suba - alimentacion,3288,1762,1677,6727
1528,2020-05-08,(05103) Marsella,241,122,129,492
1529,2020-05-18,(09109) Tercer Milenio,300,186,193,679
1530,2020-01-22,(03013) RIO NEGRO,1202,753,818,2773
1531,2020-02-01,(06101) El Tiempo,932,629,1056,2617
1532,2020-06-28,(02205) Calle 106,74,65,57,196
1533,2020-05-05,(05100) Banderas P. Central - alimentacion,2025,951,971,3947
1534,2020-01-19,(02302) Virrey,343,340,531,1214
1535,2020-09-20,(09122) Calle 72,391,306,523,1220
1536,2020-05-04,(10010) San Bernardo,485,271,306,1062
1537,2020-05-15,(06107) Ciudad Universitaria,163,101,96,360
1538,2020-02-18,(10005) Bicentenario,866,445,356,1667
1539,2020-09-20,(03002) SUBA - TV- 91,261,127,291,679
1540,2020-03-02,(04000) Cabecera Calle 80 - intermunicipal,2323,1667,2104,6094
1541,2020-07-16,(12007) Zona Industrial,340,204,143,687
1542,2020-06-25,(10005) Bicentenario,115,51,78,244
1543,2020-01-25,(40002) Manitas,920,468,662,2050
1544,2020-02-01,(07006) General Santander - alimentacion,918,524,764,2206
1545,2020-05-19,(02001) Centro Comercial Santa Fe,378,229,259,866
1546,2020-06-22,(02102) Calle 161,67,38,51,156
1547,2020-05-26,(02104) Calle 146,659,432,416,1507
1548,2020-05-30,(10008) San Diego,167,116,107,390
1549,2020-07-03,(10008) San Diego,315,183,219,717
1550,2020-10-05,(10008) San Diego,330,193,228,751
1551,2020-07-06,(03011) SUBA - CALLE 100,578,270,259,1107
1552,2020-01-19,(07003) SEVILLANA,377,186,393,956
1553,2020-03-08,(09115) Calle 34,472,380,769,1621
1554,2020-09-22,(09115) Calle 34,791,472,586,1849
1555,2020-01-23,(03004) GRATAMIRA,302,154,157,613
1556,2020-04-03,(10003) Ciudad Jardín,83,57,54,194
1557,2020-01-08,(07107) U. NACIONAL,912,654,893,2459
1558,2020-07-15,(10001) Country Sur,799,413,479,1691
1559,2020-05-21,(03002) SUBA - TV- 91,589,371,326,1286
1560,2020-07-15,(09103) Olaya,738,447,399,1584
1561,2020-01-21,(07105) MOVISTAR ARENA,916,540,489,1945
1562,2020-09-07,(07201) Guatoque -Veraguas,225,107,178,510
1563,2020-01-03,(07105) MOVISTAR ARENA,640,415,421,1476
1564,2020-05-20,(07105) MOVISTAR ARENA,224,148,119,491
1565,2020-03-15,(09113) Calle 22,490,252,450,1192
1566,2020-06-24,(09115) Calle 34,696,445,424,1565
1567,2020-07-25,(02303) Calle 85,372,244,187,803
1568,2020-05-12,(07104) Simon Bolivar,448,274,217,939
1569,2020-06-30,(04003) Avenida Ciudad de Cali,1109,631,776,2516
1570,2020-03-09,(09111) Calle 19,1038,150,359,1547
1571,2020-09-08,(40001) Juan Pablo II,583,370,382,1335
1572,2020-08-09,(07110) PALOQUEMAO,144,99,90,333
1573,2020-06-08,(03011) SUBA - CALLE 100,457,199,217,873
1574,2020-07-03,(09121) Las Flores,732,495,487,1714
1575,2020-07-30,(40001) Juan Pablo II,519,302,319,1140
1576,2020-04-25,(40002) Manitas,164,89,110,363
1577,2020-06-03,(02104) Calle 146,672,438,439,1549
1578,2020-04-02,(10001) Country Sur,498,238,364,1100
1579,2020-10-08,(14005) Las Aguas,259,163,337,759
1580,2020-06-23,(50003) Corral Molinos,1630,862,1089,3581
1581,2020-08-03,(07109) CAD,518,337,243,1098
1582,2020-05-08,(04107) Escuela Militar,79,60,57,196
1583,2020-06-25,(02502) Terminal,427,317,355,1099
1584,2020-09-29,(06000) Portal Eldorado,937,648,647,2232
1585,2020-08-22,(07105) MOVISTAR ARENA,177,110,135,422
1586,2020-02-11,(07200) Tygua-San José,880,556,553,1989
1587,2020-09-17,(07008) NQS - Calle 30 Sur,357,196,261,814
1588,2020-08-05,(04002) Carrera 90,603,335,337,1275
1589,2020-09-13,(02502) Terminal,85,87,158,330
1590,2020-02-23,(06108) Concejo de Bogotá,123,77,151,351
1591,2020-10-12,(09110) Avenida Jimenez,404,335,456,1195
1592,2020-05-31,(04108) El Polo,74,45,71,190
1593,2020-04-04,(02101) Toberín,351,232,278,861
1594,2020-04-10,(02001) Centro Comercial Santa Fe,40,34,53,127
1595,2020-08-26,(04102) Avenida Boyaca,355,187,231,773
1596,2020-01-05,(03002) SUBA - TV- 91,622,286,624,1532
1597,2020-06-06,(06101) El Tiempo,198,136,153,487
1598,2020-05-01,(05001) Patio Bonito,566,307,311,1184
1599,2020-04-11,(04000) Cabecera Calle 80 - intermunicipal,45,26,33,104
1600,2020-01-12,(09109) Tercer Milenio,303,153,342,798
1601,2020-02-13,(09108) Hospital,274,148,222,644
1602,2020-02-23,(04103) Las Ferias,280,165,297,742
1603,2020-10-04,(09111) Calle 19,192,146,259,597
1604,2020-04-08,(07112) COMUNEROS,406,279,208,893
1605,2020-03-24,(07006) General Santander - alimentacion,305,172,245,722
1606,2020-05-18,(03002) SUBA - TV- 91,620,358,344,1322
1607,2020-01-12,(07005) ALQUERIA,581,293,487,1361
1608,2020-06-12,(03004) GRATAMIRA,38,17,30,85
1609,2020-05-11,(04102) Avenida Boyaca,200,122,128,450
1610,2020-04-05,(10006) San Victorino,43,42,45,130
1611,2020-04-10,(06101) El Tiempo,87,59,39,185
1612,2020-07-12,(04103) Las Ferias,143,62,83,288
1613,2020-03-28,(04106) Carrera 47,120,83,49,252
1614,2020-10-10,(12004) Carrera 22,202,148,164,514
1615,2020-06-29,(04108) El Polo,119,71,100,290
1616,2020-03-30,(07106) EL CAMPIN,124,115,110,349
1617,2020-03-27,(07007) NQS - Calle 38A Sur,174,98,111,383
1618,2020-06-07,(05100) Banderas P. Central,114,56,107,277
1619,2019-12-31,(12004) Carrera 22,4,3,12,19
1620,2020-09-13,(09107) Hortúa,219,127,189,535
1621,2020-04-14,(06104) Gobernación,148,118,65,331
1622,2020-08-02,(08001) Parque el Tunal,128,55,124,307
1623,2020-09-13,(40002) Manitas,0,71,161,232
1624,2020-07-09,(09105) Río Fucha,132,59,88,279
1625,2020-08-02,(06102) Salitre El Greco,75,44,50,169
1626,2020-05-25,(10009) Museo Nacional,88,63,78,229
1627,2020-04-27,(04001) Quirigua,134,24,18,176
1628,2020-08-21,(06105) Quinta Paredes,128,77,67,272
1629,2020-04-13,(12002) CDS - Carrera 32,183,138,53,374
1630,2020-09-20,(06104) Gobernación,49,44,75,168
1631,2020-09-27,(07107) U. NACIONAL,107,74,149,330
1632,2020-04-09,(14005) Las Aguas,0,7,29,36
1633,2020-05-24,(07200) Tygua-San José,44,35,44,123
1634,2020-05-20,(12004) Carrera 22,184,92,86,362
1635,2020-06-21,(10004) Policarpa,88,43,69,200
1636,2020-03-26,(05101) Mandalay - Cr.73,50,31,29,110
1637,2020-08-15,(06101) El Tiempo,213,137,182,532
1638,2020-09-02,(50002) Corral Calle 40 Sur,27,14,27,68
1639,2020-05-08,(03014) SAN MARTIN,25,9,23,57
1640,2020-04-15,(07108) Av. El Dorado,60,37,47,144
1641,2020-10-12,(07108) Av. El Dorado,35,30,62,127
1642,2019-12-31,(08002) Biblioteca,11,13,20,44
1643,2020-05-01,(10008) San Diego,79,63,73,215
1644,2020-04-08,(07201) Guatoque -Veraguas,55,48,76,179
1645,2020-04-13,(50006) Corral Carrera 77,6,3,2,11
1646,2020-07-14,(50006) Corral Carrera 77,6,1,6,13
1647,2020-06-12,(03014) SAN MARTIN,29,15,22,66
1648,2020-01-09,(04000) Cabecera Calle 80 - alimentacion,16144,8895,11177,36216
1649,2020-02-17,(07504) TERREROS,17882,11134,9333,38349
1650,2020-01-17,(05000) Portal Américas - alimentacion,33336,18089,19064,70489
1651,2020-02-10,(10000) Portal 20 de Julio - alimentacion,11281,5691,7583,24555
1652,2020-09-26,(10000) Portal 20 de Julio - alimentacion,3878,1669,2923,8470
1653,2020-09-08,(09119) Calle 57,567,346,440,1353
1654,2020-10-09,(09119) Calle 57,671,450,647,1768
1655,2020-01-31,(02101) Toberín,14442,8457,7621,30520
1656,2020-03-11,(02101) Toberín,14041,8783,7125,29949
1657,2020-02-21,(09100) Calle 40 Sur,7248,3777,4027,15052
1658,2020-02-01,(09118) Marly,3273,2226,2831,8330
1659,2020-09-27,(07112) COMUNEROS,266,123,292,681
1660,2020-02-06,(08000) Portal Tunal - alimentacion,24336,13260,11744,49340
1661,2020-01-20,(09004) Santa Lucía,6735,3766,4107,14608
1662,2020-02-03,(07103) AV. CHILE,3609,2234,1916,7759
1663,2020-08-28,(05100) Banderas P. Central,863,460,631,1954
1664,2020-06-12,(09100) Calle 40 Sur,1767,1022,1100,3889
1665,2020-03-09,(09000) Cabecera Usme,209,1584,1395,3188
1666,2020-06-19,(09000) Cabecera Usme,1801,1102,1269,4172
1667,2020-01-12,(06000) Portal Eldorado - alimentacion,3979,1644,3009,8632
1668,2020-07-04,(09115) Calle 34,433,295,360,1088
1669,2020-01-09,(09113) Calle 22,1006,649,903,2558
1670,2020-05-08,(07000) Portal Sur - alimentacion,5462,3038,2368,10868
1671,2020-01-20,(09118) Marly,5503,3786,3404,12693
1672,2020-07-22,(10000) Portal 20 de Julio - alimentacion,3083,1456,1958,6497
1673,2020-01-14,(02205) Calle 106,2259,1446,1209,4914
1674,2020-01-30,(09000) Cabecera Usme - alimentacion,25308,13830,14986,54124
1675,2020-02-01,(40003) Mirador del Paraiso,4093,1985,2489,8567
1676,2020-08-06,(04100) Carrera 77,989,548,741,2278
1677,2020-01-31,(07505) LEON XIII,8329,4566,3940,16835
1678,2020-07-24,(03000) Portal Suba - alimentacion,5532,3125,2968,11625
1679,2020-05-17,(07504) TERREROS,1014,586,585,2185
1680,2020-03-06,(10006) San Victorino,2155,1360,1381,4896
1681,2020-02-26,(04100) Carrera 77,7140,4018,4067,15225
1682,2020-08-23,(07102) NQS - CALLE 75,83,58,87,228
1683,2020-10-10,(07102) NQS - CALLE 75,282,240,321,843
1684,2020-05-28,(03013) RIO NEGRO,263,181,149,593
1685,2020-01-31,(02103) Mazurén,3281,1898,1862,7041
1686,2020-04-11,(09104) Restrepo,446,304,360,1110
1687,2020-10-09,(05100) Banderas P. Central - alimentacion,3838,1924,2791,8553
1688,2020-02-07,(14001) La Sabana,600,390,387,1377
1689,2020-02-03,(07002) MADELENA,4988,2926,2646,10560
1690,2020-05-30,(07002) MADELENA,469,263,301,1033
1691,2020-08-23,(07002) MADELENA,171,88,157,416
1692,2020-10-08,(07106) EL CAMPIN,504,322,354,1180
1693,2020-02-11,(07107) U. NACIONAL,2652,1678,1494,5824
1694,2020-10-12,(07109) CAD,200,118,177,495
1695,2020-08-21,(05000) Portal Américas,2742,1659,1917,6318
1696,2020-03-13,(04000) Cabecera Calle 80,762,1251,1296,3309
1697,2020-01-04,(02000) Cabecera Autopista Norte - alimentacion,8340,3726,5411,17477
1698,2020-05-22,(08000) Portal Tunal - alimentacion,5396,2891,2753,11040
1699,2020-09-18,(09110) Avenida Jimenez,1532,1120,986,3638
1700,2020-04-03,(09111) Calle 19,227,168,215,610
1701,2020-07-01,(09111) Calle 19,819,528,500,1847
1702,2020-09-25,(40003) Mirador del Paraiso,1898,1081,1316,4295
1703,2020-05-19,(12001) Carrera 43,382,222,187,791
1704,2020-07-27,(12001) Carrera 43,352,204,215,771
1705,2020-01-19,(04104) Avenida 68,620,343,639,1602
1706,2020-03-02,(06111) Universidades,5536,3493,2584,11613
1707,2020-07-19,(06105) Quinta Paredes,36,29,23,88
1708,2020-05-19,(02000) Cabecera Autopista Norte - intermunicipal,389,283,283,955
1709,2020-10-09,(02000) Cabecera Autopista Norte - intermunicipal,693,440,669,1802
1710,2020-02-25,(09119) Calle 57,3982,2457,2035,8474
1711,2020-01-22,(07000) Portal Sur,7402,4496,4277,16175
1712,2020-09-15,(07000) Portal Sur,2111,1297,1398,4806
1713,2020-01-22,(07004) VENECIA,4374,2508,2460,9342
1714,2020-02-14,(02300) Calle 100,7061,4645,4022,15728
1715,2020-05-08,(09107) Hortúa,463,301,228,992
1716,2020-07-22,(08001) Parque el Tunal,366,214,232,812
1717,2020-09-09,(08001) Parque el Tunal,523,276,336,1135
1718,2020-10-12,(09000) Cabecera Usme - alimentacion,2965,1333,2490,6788
1719,2020-03-04,(06103) CAN,2582,1565,1193,5340
1720,2020-02-07,(06108) Concejo de Bogotá,882,459,497,1838
1721,2020-02-15,(06108) Concejo de Bogotá,340,223,377,940
1722,2020-05-21,(06108) Concejo de Bogotá,124,76,63,263
1723,2020-10-03,(03003) 21 ANGELES,315,137,246,698
1724,2020-08-21,(02201) Prado,811,580,486,1877
1725,2020-01-30,(02304) Heroes,4408,3075,2175,9658
1726,2020-02-14,(10007) Las Nieves,2041,1290,1282,4613
1727,2020-08-07,(03000) Portal Suba - alimentacion,2174,1159,1305,4638
1728,2020-08-06,(09107) Hortúa,540,320,333,1193
1729,2020-05-25,(05002) Tintal,634,301,312,1247
1730,2020-01-28,(03011) SUBA - CALLE 100,2597,1322,1403,5322
1731,2020-02-04,(03011) SUBA - CALLE 100,2779,1374,1466,5619
1732,2020-05-05,(03012) SUBA - CALLE 95,228,133,125,486
1733,2020-05-08,(03012) SUBA - CALLE 95,256,135,115,506
1734,2020-07-08,(03012) SUBA - CALLE 95,369,219,217,805
1735,2020-09-21,(03012) SUBA - CALLE 95,294,185,187,666
1736,2020-06-05,(05101) Mandalay - Cr.73,90,48,58,196
1737,2020-02-19,(14005) Las Aguas,3682,2177,1874,7733
1738,2020-07-10,(08000) Portal Tunal,812,369,297,1478
1739,2020-05-26,(09001) Molinos,2131,1278,1430,4839
1740,2020-05-01,(05005) Transversal 86,103,52,55,210
1741,2020-05-17,(05005) Transversal 86,73,34,44,151
1742,2020-08-10,(02202) Calle 127,1031,741,533,2305
1743,2020-02-12,(09106) Nariño,2122,1334,1439,4895
1744,2020-02-10,(03009) Av. Suba- Calle 116,2734,1678,1421,5833
1745,2020-03-02,(03009) Av. Suba- Calle 116,2528,1601,1431,5560
1746,2020-01-27,(04101) Minuto de Dios,2532,1545,1590,5667
1747,2020-03-09,(12007) Zona Industrial,591,67,146,804
1748,2020-03-19,(07201) Guatoque -Veraguas,476,233,303,1012
1749,2020-10-03,(05002) Tintal,2447,1165,1978,5590
1750,2020-02-26,(07113) SANTA ISABEL,2214,1279,1353,4846
1751,2020-03-14,(07113) SANTA ISABEL,1131,589,938,2658
1752,2020-09-12,(07113) SANTA ISABEL,335,175,322,832
1753,2020-05-24,(03007) HUMEDAL CORDOBA,25,27,21,73
1754,2020-07-30,(10006) San Victorino,697,328,305,1330
1755,2020-03-17,(07000) Portal Sur,5261,2987,2868,11116
1756,2020-07-10,(07000) Portal Sur,2035,1251,1258,4544
1757,2020-04-06,(02101) Toberín,567,402,430,1399
1758,2020-06-18,(05100) Banderas P. Central,744,453,498,1695
1759,2020-02-05,(04103) Las Ferias,1633,923,920,3476
1760,2020-07-06,(05100) Banderas P. Central - alimentacion,3074,1804,1868,6746
1761,2020-04-28,(02204) Pepe Sierra,452,339,243,1034
1762,2020-02-11,(04102) Avenida Boyaca,3192,1962,1655,6809
1763,2020-04-21,(02304) Heroes,430,318,255,1003
1764,2020-06-20,(09100) Calle 40 Sur,1433,790,992,3215
1765,2020-06-10,(04107) Escuela Militar,147,79,75,301
1766,2020-07-31,(04107) Escuela Militar,84,53,78,215
1767,2020-06-14,(05000) Portal Américas,551,374,502,1427
1768,2020-07-26,(06111) Universidades,96,48,106,250
1769,2020-07-13,(02303) Calle 85,556,399,254,1209
1770,2020-02-23,(02000) Cabecera Autopista Norte,1761,931,1624,4316
1771,2020-06-27,(09000) Cabecera Usme,1454,791,1105,3350
1772,2020-04-24,(02304) Heroes,439,346,263,1048
1773,2020-08-08,(06111) Universidades,226,137,215,578
1774,2020-07-31,(02104) Calle 146,576,372,377,1325
1775,2020-02-04,(03003) 21 ANGELES,1811,913,898,3622
1776,2020-09-24,(02202) Calle 127,1218,836,763,2817
1777,2020-04-18,(09001) Molinos,907,555,643,2105
1778,2020-05-25,(02000) Cabecera Autopista Norte,346,238,229,813
1779,2020-06-27,(06100) Av. Rojas,145,96,150,391
1780,2020-09-05,(02302) Virrey,444,377,394,1215
1781,2020-01-25,(09122) Calle 72,2887,1958,2593,7438
1782,2020-04-22,(07106) EL CAMPIN,191,134,112,437
1783,2020-06-13,(03010) PUENTE LARGO,224,173,166,563
1784,2020-06-21,(05100) Banderas P. Central,165,80,131,376
1785,2020-02-10,(07003) SEVILLANA,2161,1190,1160,4511
1786,2020-08-27,(07009) SENA,617,356,452,1425
1787,2020-07-13,(06001) Modelia,347,228,176,751
1788,2020-05-09,(02105) Calle 142,398,261,206,865
1789,2020-05-14,(09000) Cabecera Usme,1307,805,843,2955
1790,2020-06-09,(07007) NQS - Calle 38A Sur,376,211,235,822
1791,2020-07-02,(10009) Museo Nacional,505,284,348,1137
1792,2020-03-01,(06102) Salitre El Greco,291,179,291,761
1793,2020-07-16,(10005) Bicentenario,95,45,49,189
1794,2020-03-04,(09106) Nariño,2066,1230,1393,4689
1795,2020-01-25,(04000) Cabecera Calle 80 - intermunicipal,884,599,1151,2634
1796,2020-07-30,(02001) Centro Comercial Santa Fe,455,274,315,1044
1797,2020-08-27,(10008) San Diego,298,155,159,612
1798,2020-01-21,(10004) Policarpa,519,257,377,1153
1799,2020-06-12,(09003) Socorro,552,312,309,1173
1800,2020-05-25,(06000) Portal Eldorado - alimentacion,1213,556,614,2383
1801,2020-04-20,(07110) PALOQUEMAO,472,286,200,958
1802,2020-08-04,(07002) MADELENA,689,377,452,1518
1803,2020-05-28,(02200) Alcalá,1532,1078,711,3321
1804,2020-07-21,(40002) Manitas,296,181,187,664
1805,2020-03-17,(12004) Carrera 22,462,328,322,1112
1806,2020-03-12,(09107) Hortúa,429,424,352,1205
1807,2020-03-08,(04002) Carrera 90,739,294,651,1684
1808,2020-01-13,(14005) Las Aguas,1610,1023,1279,3912
1809,2020-05-30,(09114) Calle 26,159,124,129,412
1810,2020-09-02,(03003) 21 ANGELES,369,203,189,761
1811,2020-02-08,(10003) Ciudad Jardín,605,279,555,1439
1812,2020-04-12,(06000) Portal Eldorado,180,133,97,410
1813,2020-07-15,(06107) Ciudad Universitaria,163,85,94,342
1814,2020-07-31,(04103) Las Ferias,278,146,149,573
1815,2020-08-10,(07110) PALOQUEMAO,603,365,251,1219
1816,2020-09-20,(08000) Portal Tunal,244,161,198,603
1817,2020-05-02,(04104) Avenida 68,257,154,128,539
1818,2020-09-12,(05102) Av. Américas - Av. Boyacá,208,107,140,455
1819,2020-08-13,(07007) NQS - Calle 38A Sur,369,235,222,826
1820,2020-05-11,(07109) CAD,513,307,193,1013
1821,2020-06-04,(08002) Biblioteca,273,157,154,584
1822,2020-04-03,(07109) CAD,415,305,198,918
1823,2020-08-16,(07109) CAD,155,108,105,368
1824,2020-06-13,(07506) DESPENSA,391,203,223,817
1825,2020-09-30,(02102) Calle 161,333,206,258,797
1826,2020-03-17,(09113) Calle 22,1055,590,702,2347
1827,2020-04-24,(07002) MADELENA,364,197,210,771
1828,2020-06-02,(12004) Carrera 22,193,99,117,409
1829,2020-08-06,(12004) Carrera 22,247,122,128,497
1830,2020-07-30,(12003) Ricaurte,338,249,185,772
1831,2020-05-17,(10009) Museo Nacional,72,48,88,208
1832,2020-08-07,(09003) Socorro,308,137,164,609
1833,2020-05-01,(04106) Carrera 47,119,59,65,243
1834,2020-04-21,(10010) San Bernardo,443,270,265,978
1835,2020-03-08,(40001) Juan Pablo II,481,190,364,1035
1836,2020-09-18,(02001) Centro Comercial Santa Fe,573,337,460,1370
1837,2020-04-02,(12002) CDS - Carrera 32,136,114,55,305
1838,2020-04-16,(12002) CDS - Carrera 32,165,122,47,334
1839,2020-07-08,(12002) CDS - Carrera 32,176,113,79,368
1840,2019-12-31,(09103) Olaya,90,29,61,180
1841,2020-05-01,(40001) Juan Pablo II,183,75,101,359
1842,2020-06-04,(40001) Juan Pablo II,521,334,307,1162
1843,2020-09-01,(04000) Cabecera Calle 80 - intermunicipal,382,208,368,958
1844,2020-04-13,(06002) Normandía,188,114,113,415
1845,2020-06-01,(14004) Museo del Oro,0,109,215,324
1846,2020-07-03,(40002) Manitas,427,275,270,972
1847,2020-02-05,(09108) Hospital,239,141,230,610
1848,2020-02-09,(06108) Concejo de Bogotá,100,77,185,362
1849,2020-02-05,(09105) Río Fucha,851,489,539,1879
1850,2020-05-03,(02502) Terminal,49,40,57,146
1851,2020-05-07,(02502) Terminal,259,173,217,649
1852,2020-10-09,(09111) Calle 19,759,512,662,1933
1853,2020-07-16,(03009) Av. Suba- Calle 116,489,319,200,1008
1854,2020-05-29,(09105) Río Fucha,119,66,76,261
1855,2020-08-01,(07005) ALQUERIA,365,183,239,787
1856,2020-09-04,(04106) Carrera 47,370,185,236,791
1857,2020-04-09,(09000) Cabecera Usme,344,194,219,757
1858,2020-01-01,(06001) Modelia,96,75,205,376
1859,2020-07-02,(09113) Calle 22,444,273,355,1072
1860,2020-04-15,(06107) Ciudad Universitaria,99,76,88,263
1861,2020-04-30,(07010) Bosa,401,221,246,868
1862,2020-06-08,(10005) Bicentenario - alimentacion,226,95,193,514
1863,2020-06-07,(07112) COMUNEROS,206,126,131,463
1864,2020-06-01,(10008) San Diego,253,143,135,531
1865,2020-08-01,(07003) SEVILLANA,267,162,181,610
1866,2020-07-24,(07106) EL CAMPIN,347,233,171,751
1867,2020-09-20,(07007) NQS - Calle 38A Sur,208,143,181,532
1868,2020-07-29,(07006) General Santander - alimentacion,382,216,250,848
1869,2020-05-29,(10003) Ciudad Jardín,177,77,113,367
1870,2020-06-14,(03012) SUBA - CALLE 95,78,57,59,194
1871,2020-05-10,(05100) Banderas P. Central,94,44,82,220
1872,2020-08-30,(02502) Terminal,81,76,158,315
1873,2020-05-15,(12002) CDS - Carrera 32,184,135,80,399
1874,2020-07-30,(05101) Mandalay - Cr.73,117,76,65,258
1875,2020-06-25,(04001) Quirigua,466,276,279,1021
1876,2020-03-13,(07108) Av. El Dorado,227,61,132,420
1877,2020-05-01,(06002) Normandía,86,49,60,195
1878,2020-09-20,(06107) Ciudad Universitaria,54,29,80,163
1879,2020-04-05,(07108) Av. El Dorado,17,16,16,49
1880,2020-06-21,(07008) NQS - Calle 30 Sur,110,42,89,241
1881,2020-03-26,(07002) MADELENA,368,200,185,753
1882,2020-01-26,(07200) Tygua-San José,153,103,266,522
1883,2020-06-22,(07003) SEVILLANA,136,77,89,302
1884,2020-04-16,(10005) Bicentenario,49,24,38,111
1885,2020-08-17,(07201) Guatoque -Veraguas,39,27,47,113
1886,2020-03-09,(12000) Puente Aranda,107,30,46,183
1887,2020-03-30,(07004) VENECIA,505,320,271,1096
1888,2020-07-12,(06108) Concejo de Bogotá,42,29,41,112
1889,2020-07-14,(03014) SAN MARTIN,23,9,16,48
1890,2020-04-13,(05101) Mandalay - Cr.73,53,33,24,110
1891,2020-09-20,(50006) Corral Carrera 77,1,1,6,8
1892,2020-07-20,(09105) Río Fucha,35,9,27,71
1893,2020-09-02,(12000) Puente Aranda,90,45,49,184
1894,2020-06-13,(03014) SAN MARTIN,16,12,27,55
1895,2020-04-22,(14004) Museo del Oro,0,50,115,165
1896,2020-05-17,(50006) Corral Carrera 77,2,0,1,3
1897,2020-02-03,(04000) Cabecera Calle 80 - alimentacion,23495,14599,15082,53176
1898,2020-07-07,(04000) Cabecera Calle 80 - alimentacion,4413,2490,2979,9882
1899,2020-07-09,(04000) Cabecera Calle 80 - alimentacion,4361,2500,2824,9685
1900,2020-06-16,(09002) Consuelo,498,264,268,1030
1901,2020-06-24,(09002) Consuelo,474,265,288,1027
1902,2020-02-05,(09118) Marly,8065,5266,4143,17474
1903,2020-07-10,(09118) Marly,1509,999,832,3340
1904,2020-03-19,(05000) Portal Américas - alimentacion,22320,11457,12180,45957
1905,2020-01-30,(07503) SAN MATEO,39973,22722,17559,80254
1906,2020-05-28,(06000) Portal Eldorado - alimentacion,3592,1742,1673,7007
1907,2020-02-27,(09100) Calle 40 Sur,7570,4362,4084,16016
1908,2020-01-18,(09000) Cabecera Usme - alimentacion,16979,8113,11929,37021
1909,2020-04-20,(09001) Molinos,1088,696,963,2747
1910,2020-07-30,(05001) Patio Bonito,1593,854,935,3382
1911,2020-09-25,(08000) Portal Tunal - alimentacion,7100,3807,4563,15470
1912,2020-07-18,(10000) Portal 20 de Julio - alimentacion,2462,1166,1620,5248
1913,2020-02-18,(03009) Av. Suba- Calle 116,2714,1698,1415,5827
1914,2020-09-29,(05100) Banderas P. Central - alimentacion,3773,1938,2344,8055
1915,2020-02-27,(02105) Calle 142,7159,4377,3750,15286
1916,2020-02-11,(07001) PERDOMO,4831,2872,2729,10432
1917,2020-02-04,(07113) SANTA ISABEL,2116,1319,1415,4850
1918,2020-03-03,(07113) SANTA ISABEL,2120,1252,1502,4874
1919,2020-08-31,(40003) Mirador del Paraiso,1653,980,1128,3761
1920,2020-01-04,(07505) LEON XIII,3492,1706,1973,7171
1921,2020-08-25,(07505) LEON XIII,2717,1458,1157,5332
1922,2020-09-02,(03000) Portal Suba - alimentacion,6720,3844,4057,14621
1923,2020-01-20,(05103) Marsella,2655,1529,1279,5463
1924,2020-03-18,(09117) Calle 45,1802,1192,1183,4177
1925,2020-01-23,(06106) Recinto Ferial,1479,803,791,3073
1926,2020-07-06,(07102) NQS - CALLE 75,455,300,278,1033
1927,2020-08-11,(09118) Marly,1423,871,678,2972
1928,2020-10-08,(09118) Marly,1530,1036,1136,3702
1929,2020-01-29,(09103) Olaya,3848,2333,2375,8556
1930,2020-01-30,(09116) Avenida 39,2723,1744,1511,5978
1931,2020-01-03,(09104) Restrepo,2788,1705,2575,7068
1932,2020-06-05,(14001) La Sabana,154,89,97,340
1933,2020-08-12,(02000) Cabecera Autopista Norte - alimentacion,4385,2331,2534,9250
1934,2020-08-15,(09113) Calle 22,407,209,338,954
1935,2020-03-14,(10007) Las Nieves,1009,822,935,2766
1936,2020-06-24,(09001) Molinos,2508,1395,1757,5660
1937,2020-02-28,(05107) Américas - Cr.53,2469,1441,1551,5461
1938,2020-03-12,(05107) Américas - Cr.53,634,267,329,1230
1939,2020-08-28,(07506) DESPENSA,510,268,290,1068
1940,2020-03-13,(12001) Carrera 43,234,227,249,710
1941,2020-05-23,(12001) Carrera 43,225,138,148,511
1942,2020-04-29,(07000) Portal Sur - alimentacion,4636,2607,1922,9165
1943,2020-06-12,(10002) Av. Primero de Mayo,2154,1136,1256,4546
1944,2020-10-03,(10002) Av. Primero de Mayo,1983,885,1688,4556
1945,2020-02-24,(10005) Bicentenario - alimentacion,700,370,511,1581
1946,2020-10-06,(10005) Bicentenario - alimentacion,222,104,270,596
1947,2020-02-01,(06111) Universidades,1751,1150,1809,4710
1948,2020-02-15,(02000) Cabecera Autopista Norte - intermunicipal,1984,1214,1871,5069
1949,2020-02-11,(02302) Virrey,4038,2692,1919,8649
1950,2020-03-24,(02000) Cabecera Autopista Norte - intermunicipal,277,207,237,721
1951,2020-05-02,(03000) Portal Suba - alimentacion,2708,1504,1380,5592
1952,2020-09-19,(03000) Portal Suba - alimentacion,5671,2650,4246,12567
1953,2020-03-08,(02000) Cabecera Autopista Norte - alimentacion,6311,2555,4856,13722
1954,2020-08-09,(02000) Cabecera Autopista Norte - alimentacion,1519,725,1007,3251
1955,2020-01-02,(09114) Calle 26,1315,859,821,2995
1956,2020-04-12,(07112) COMUNEROS,124,87,75,286
1957,2020-09-22,(02303) Calle 85,837,562,537,1936
1958,2020-02-01,(02502) Terminal,1614,943,1707,4264
1959,2020-08-08,(04100) Carrera 77,688,366,554,1608
1960,2020-09-03,(08001) Parque el Tunal,511,293,345,1149
1961,2020-09-28,(09116) Avenida 39,466,280,348,1094
1962,2020-01-07,(07008) NQS - Calle 30 Sur,1243,710,780,2733
1963,2020-04-29,(10000) Portal 20 de Julio - alimentacion,2343,1234,1824,5401
1964,2020-05-26,(10002) Av. Primero de Mayo,1897,1020,1139,4056
1965,2020-03-18,(09003) Socorro,1092,584,637,2313
1966,2020-09-08,(04000) Cabecera Calle 80,1162,700,911,2773
1967,2020-06-13,(03001) LA CAMPIÑA,739,344,488,1571
1968,2020-01-26,(06102) Salitre El Greco,294,195,260,749
1969,2020-07-29,(06102) Salitre El Greco,234,145,133,512
1970,2020-03-26,(09107) Hortúa,458,323,206,987
1971,2020-08-04,(09107) Hortúa,526,312,357,1195
1972,2020-07-14,(09123) Calle 76,803,546,462,1811
1973,2020-09-18,(40003) Mirador del Paraiso,1877,1087,1305,4269
1974,2020-09-27,(05103) Marsella,168,81,194,443
1975,2020-09-30,(02300) Calle 100,1300,900,885,3085
1976,2020-01-06,(10000) Portal 20 de Julio,1662,654,1258,3574
1977,2020-01-17,(06000) Portal Eldorado,5423,3299,2778,11500
1978,2020-09-27,(02000) Cabecera Autopista Norte - alimentacion,2193,896,1855,4944
1979,2020-01-29,(05105) Pradera,2436,1489,1121,5046
1980,2020-07-13,(08000) Portal Tunal,482,182,189,853
1981,2020-10-06,(02302) Virrey,752,517,496,1765
1982,2020-08-25,(03009) Av. Suba- Calle 116,509,332,214,1055
1983,2020-10-08,(03009) Av. Suba- Calle 116,548,326,403,1277
1984,2020-08-12,(02205) Calle 106,299,208,245,752
1985,2020-09-17,(02205) Calle 106,431,288,286,1005
1986,2020-10-02,(02205) Calle 106,451,317,338,1106
1987,2020-03-25,(10002) Av. Primero de Mayo,1193,648,690,2531
1988,2020-06-05,(04108) El Polo,457,292,236,985
1989,2020-09-23,(07106) EL CAMPIN,498,320,340,1158
1990,2020-09-27,(07106) EL CAMPIN,167,110,145,422
1991,2020-09-07,(07113) SANTA ISABEL,411,252,314,977
1992,2020-03-05,(03003) 21 ANGELES,1693,840,897,3430
1993,2020-05-28,(08002) Biblioteca,244,136,145,525
1994,2020-08-04,(08002) Biblioteca,305,162,177,644
1995,2020-03-02,(05101) Mandalay - Cr.73,1201,676,525,2402
1996,2020-03-14,(07000) Portal Sur,4279,2068,3206,9553
1997,2020-02-01,(09115) Calle 34,1430,1050,1559,4039
1998,2020-01-22,(02202) Calle 127,5623,3701,2721,12045
1999,2020-04-06,(07110) PALOQUEMAO,305,253,165,723
2000,2020-09-23,(07104) Simon Bolivar,685,433,361,1479
2001,2020-05-28,(10005) Bicentenario - alimentacion,214,92,165,471
2002,2020-08-21,(10005) Bicentenario - alimentacion,185,83,206,474
2003,2020-08-28,(04104) Avenida 68,620,311,366,1297
2004,2020-03-17,(05103) Marsella,1562,825,786,3173
2005,2020-09-30,(02104) Calle 146,1038,628,872,2538
2006,2020-09-26,(04000) Cabecera Calle 80 - intermunicipal,279,130,323,732
2007,2020-10-09,(02202) Calle 127,1151,844,883,2878
2008,2020-05-21,(04100) Carrera 77,1012,552,613,2177
2009,2020-06-07,(05000) Portal Américas - alimentacion,2937,1351,1481,5769
2010,2020-08-17,(08000) Portal Tunal - alimentacion,2065,987,1268,4320
2011,2020-06-05,(06000) Portal Eldorado,928,641,441,2010
2012,2020-09-20,(12003) Ricaurte,59,55,79,193
2013,2020-06-06,(06000) Portal Eldorado,639,429,403,1471
2014,2020-03-18,(03010) PUENTE LARGO,920,640,513,2073
2015,2020-06-07,(03010) PUENTE LARGO,66,66,62,194
2016,2020-07-11,(05100) Banderas P. Central,676,300,472,1448
2017,2020-07-26,(05100) Banderas P. Central,109,68,92,269
2018,2020-04-16,(03009) Av. Suba- Calle 116,328,243,168,739
2019,2020-01-06,(06103) CAN,268,202,258,728
2020,2020-07-02,(03006) NIZA - CALLE 127,500,272,293,1065
2021,2020-08-15,(03006) NIZA - CALLE 127,356,205,226,787
2022,2020-09-03,(03006) NIZA - CALLE 127,520,289,290,1099
2023,2020-06-22,(03002) SUBA - TV- 91,230,116,184,530
2024,2020-05-22,(05107) Américas - Cr.53,351,204,198,753
2025,2020-05-17,(10002) Av. Primero de Mayo,482,240,336,1058
2026,2020-06-15,(09000) Cabecera Usme - alimentacion,2814,1484,1706,6004
2027,2020-07-24,(07103) AV. CHILE,855,503,343,1701
2028,2020-02-14,(07105) MOVISTAR ARENA,1338,847,760,2945
2029,2020-08-17,(10005) Bicentenario,23,20,29,72
2030,2020-05-02,(40002) Manitas,171,96,123,390
2031,2020-06-23,(09106) Nariño,427,259,293,979
2032,2020-04-06,(02300) Calle 100,768,571,421,1760
2033,2020-06-17,(02102) Calle 161,265,177,168,610
2034,2020-06-24,(09123) Calle 76,1130,786,642,2558
2035,2020-01-08,(07006) General Santander,1935,1120,1124,4179
2036,2020-07-30,(02200) Alcalá,1708,1136,975,3819
2037,2020-06-21,(09120) Calle 63,378,245,285,908
2038,2020-03-20,(05105) Pradera,342,216,161,719
2039,2020-03-26,(05001) Patio Bonito,870,459,509,1838
2040,2020-07-28,(09113) Calle 22,385,220,307,912
2041,2020-09-20,(12007) Zona Industrial,55,53,67,175
2042,2020-06-12,(40001) Juan Pablo II,574,362,338,1274
2043,2020-04-19,(10000) Portal 20 de Julio - alimentacion,1117,466,575,2158
2044,2020-08-17,(09109) Tercer Milenio,116,75,106,297
2045,2020-08-23,(09000) Cabecera Usme - alimentacion,2325,1077,1530,4932
2046,2020-06-21,(07110) PALOQUEMAO,145,113,95,353
2047,2020-06-09,(07201) Guatoque -Veraguas,193,100,122,415
2048,2020-09-30,(07005) ALQUERIA,637,363,488,1488
2049,2020-01-12,(03001) LA CAMPIÑA,977,449,1008,2434
2050,2020-06-05,(06104) Gobernación,239,135,91,465
2051,2020-01-11,(07108) Av. El Dorado,295,230,334,859
2052,2020-07-30,(07105) MOVISTAR ARENA,249,137,123,509
2053,2020-08-15,(02302) Virrey,402,327,292,1021
2054,2020-03-28,(02104) Calle 146,248,195,142,585
2055,2020-06-14,(09119) Calle 57,183,100,141,424
2056,2020-06-05,(07110) PALOQUEMAO,618,370,238,1226
2057,2020-09-02,(06102) Salitre El Greco,250,142,152,544
2058,2020-01-08,(07005) ALQUERIA,1737,970,1094,3801
2059,2020-05-22,(09121) Las Flores,598,384,348,1330
2060,2020-09-03,(02304) Heroes,891,615,574,2080
2061,2020-09-12,(07007) NQS - Calle 38A Sur,392,212,249,853
2062,2020-10-11,(07007) NQS - Calle 38A Sur,200,121,188,509
2063,2020-06-15,(02101) Toberín,311,220,354,885
2064,2020-07-27,(12000) Puente Aranda,82,40,37,159
2065,2020-08-11,(40002) Manitas,381,227,221,829
2066,2020-07-02,(12004) Carrera 22,279,130,143,552
2067,2020-04-22,(07005) ALQUERIA,283,180,165,628
2068,2020-10-01,(05101) Mandalay - Cr.73,155,99,100,354
2069,2020-05-31,(07111) NQS - RICAURTE,134,119,123,376
2070,2020-06-01,(10004) Policarpa,226,111,120,457
2071,2020-04-02,(02200) Alcalá,860,607,470,1937
2072,2020-05-02,(02201) Prado,353,233,206,792
2073,2020-04-10,(09002) Consuelo,83,41,34,158
2074,2020-04-07,(07008) NQS - Calle 30 Sur,148,86,83,317
2075,2020-10-10,(07008) NQS - Calle 30 Sur,324,144,275,743
2076,2020-09-25,(07200) Tygua-San José,275,155,194,624
2077,2020-07-26,(04002) Carrera 90,165,96,121,382
2078,2020-03-31,(09113) Calle 22,140,120,168,428
2079,2020-09-27,(05005) Transversal 86,140,50,181,371
2080,2020-07-03,(04102) Avenida Boyaca,399,233,257,889
2081,2020-06-17,(04000) Cabecera Calle 80 - intermunicipal,304,181,281,766
2082,2020-07-15,(06001) Modelia,330,206,160,696
2083,2020-01-23,(09108) Hospital,213,143,207,563
2084,2020-08-04,(09108) Hospital,68,41,67,176
2085,2020-04-05,(02201) Prado,137,104,71,312
2086,2020-09-06,(09104) Restrepo,530,313,554,1397
2087,2020-03-23,(02105) Calle 142,184,151,142,477
2088,2020-04-04,(07111) NQS - RICAURTE,269,190,146,605
2089,2020-04-27,(04100) Carrera 77,432,87,82,601
2090,2019-12-31,(09104) Restrepo,88,54,95,237
2091,2020-05-15,(07006) General Santander,380,218,228,826
2092,2020-07-29,(07506) DESPENSA,436,232,245,913
2093,2020-03-31,(09105) Río Fucha,54,33,50,137
2094,2020-06-08,(04106) Carrera 47,306,149,165,620
2095,2020-07-06,(05101) Mandalay - Cr.73,153,83,85,321
2096,2020-07-16,(07006) General Santander - alimentacion,283,166,207,656
2097,2020-03-22,(03009) Av. Suba- Calle 116,152,102,80,334
2098,2020-09-27,(02204) Pepe Sierra,185,180,244,609
2099,2020-07-26,(50003) Corral Molinos,375,187,332,894
2100,2020-09-27,(07003) SEVILLANA,128,58,160,346
2101,2020-04-06,(02000) Cabecera Autopista Norte - intermunicipal,140,108,104,352
2102,2020-06-29,(14004) Museo del Oro,16,27,63,106
2103,2020-07-07,(14004) Museo del Oro,319,207,238,764
2104,2020-05-06,(06103) CAN,288,183,126,597
2105,2020-04-26,(12001) Carrera 43,42,45,26,113
2106,2020-09-28,(03005) SUBA - AV. BOYACA,529,308,393,1230
2107,2020-04-26,(09000) Cabecera Usme,317,201,218,736
2108,2020-06-27,(07007) NQS - Calle 38A Sur,390,207,210,807
2109,2020-08-11,(50002) Corral Calle 40 Sur,22,16,22,60
2110,2020-08-09,(40001) Juan Pablo II,137,85,149,371
2111,2020-05-30,(06104) Gobernación,99,72,64,235
2112,2020-09-05,(06104) Gobernación,139,103,147,389
2113,2020-08-01,(05101) Mandalay - Cr.73,72,37,37,146
2114,2020-04-12,(06107) Ciudad Universitaria,29,17,22,68
2115,2020-03-29,(08001) Parque el Tunal,67,51,31,149
2116,2020-04-19,(06002) Normandía,60,43,48,151
2117,2020-09-16,(07201) Guatoque -Veraguas,214,116,163,493
2118,2020-09-27,(04105) Carrera 53,108,51,125,284
2119,2020-06-12,(07101) CASTELLANA,196,123,103,422
2120,2020-03-27,(04102) Avenida Boyaca,128,77,87,292
2121,2020-07-05,(07201) Guatoque -Veraguas,23,20,55,98
2122,2020-10-11,(12004) Carrera 22,63,56,88,207
2123,2020-07-30,(09105) Río Fucha,73,29,71,173
2124,2020-07-14,(06108) Concejo de Bogotá,120,74,53,247
2125,2020-07-19,(06108) Concejo de Bogotá,33,21,33,87
2126,2020-01-17,(50006) Corral Carrera 77,31,18,45,94
2127,2020-03-22,(09109) Tercer Milenio,69,39,30,138
2128,2020-06-21,(12000) Puente Aranda,11,9,14,34
2129,2020-06-14,(14004) Museo del Oro,14,19,41,74
2130,2020-08-31,(03004) GRATAMIRA,0,10,31,41
2131,2020-06-19,(07005) ALQUERIA,595,337,376,1308
2132,2020-07-02,(07005) ALQUERIA,607,365,358,1330
2133,2020-06-19,(09002) Consuelo,510,286,303,1099
2134,2020-06-23,(07504) TERREROS,6184,3554,2943,12681
2135,2020-07-14,(07504) TERREROS,5412,2944,2393,10749
2136,2020-03-05,(10000) Portal 20 de Julio - alimentacion,10066,5667,7897,23630
2137,2020-03-05,(02303) Calle 85,3784,2548,2007,8339
2138,2020-10-10,(03002) SUBA - TV- 91,673,296,586,1555
2139,2020-01-21,(02101) Toberín,10758,5799,4770,21327
2140,2020-02-13,(02101) Toberín,15528,9431,8014,32973
2141,2020-02-26,(50003) Corral Molinos,2973,2231,3802,9006
2142,2020-02-23,(09001) Molinos,1838,817,1663,4318
2143,2020-01-06,(07503) SAN MATEO,7827,3581,4713,16121
2144,2020-02-14,(07010) Bosa,2275,1271,1442,4988
2145,2020-01-29,(02201) Prado,5757,3598,2916,12271
2146,2020-02-12,(14004) Museo del Oro,4356,2653,2090,9099
2147,2020-09-22,(10000) Portal 20 de Julio - alimentacion,4337,1995,2932,9264
2148,2020-02-05,(02102) Calle 161,2007,1235,1207,4449
2149,2020-01-15,(05100) Banderas P. Central - alimentacion,12177,6637,7580,26394
2150,2020-01-23,(02105) Calle 142,6788,3961,3740,14489
2151,2020-03-04,(04000) Cabecera Calle 80,7463,4562,5128,17153
2152,2020-02-11,(06102) Salitre El Greco,1595,905,740,3240
2153,2020-05-13,(10000) Portal 20 de Julio - alimentacion,3267,1534,1894,6695
2154,2020-06-23,(09000) Cabecera Usme - alimentacion,8971,5011,5142,19124
2155,2020-04-15,(07001) PERDOMO,437,258,251,946
2156,2020-08-07,(40003) Mirador del Paraiso,830,492,565,1887
2157,2020-10-08,(09104) Restrepo,1663,951,1608,4222
2158,2020-04-22,(07505) LEON XIII,1203,778,581,2562
2159,2020-09-02,(07505) LEON XIII,2969,1609,1379,5957
2160,2020-01-07,(02204) Pepe Sierra,3363,2200,1703,7266
2161,2020-03-05,(05002) Tintal,10996,6229,5937,23162
2162,2020-02-15,(07102) NQS - CALLE 75,810,614,780,2204
2163,2020-05-07,(07000) Portal Sur - alimentacion,5132,2800,2274,10206
2164,2020-09-03,(07000) Portal Sur - alimentacion,8741,4821,4972,18534
2165,2020-09-14,(05100) Banderas P. Central - alimentacion,3333,1783,2052,7168
2166,2020-07-27,(09103) Olaya,949,561,521,2031
2167,2020-09-05,(09103) Olaya,940,485,586,2011
2168,2020-07-30,(07111) NQS - RICAURTE,1040,641,429,2110
2169,2020-05-22,(02000) Cabecera Autopista Norte,1106,701,597,2404
2170,2020-08-21,(02000) Cabecera Autopista Norte,1225,732,771,2728
2171,2020-01-25,(10007) Las Nieves,1025,820,957,2802
2172,2020-02-22,(04105) Carrera 53,831,438,612,1881
2173,2020-03-02,(04105) Carrera 53,1467,823,797,3087
2174,2020-02-07,(06105) Quinta Paredes,1083,619,535,2237
2175,2020-09-04,(08000) Portal Tunal - alimentacion,6825,3804,4295,14924
2176,2020-01-18,(50003) Corral Molinos,2479,1329,2510,6318
2177,2020-06-25,(04000) Cabecera Calle 80,1122,706,797,2625
2178,2020-09-18,(04000) Cabecera Calle 80,1291,746,1183,3220
2179,2020-01-13,(04003) Avenida Ciudad de Cali,4593,2654,2913,10160
2180,2020-05-14,(40003) Mirador del Paraiso,1310,821,796,2927
2181,2020-02-03,(10000) Portal 20 de Julio,8756,4199,4008,16963
2182,2020-03-07,(12001) Carrera 43,892,498,840,2230
2183,2020-03-09,(09000) Cabecera Usme - alimentacion,967,6312,4683,11962
2184,2020-02-15,(06105) Quinta Paredes,479,260,385,1124
2185,2020-02-06,(07106) EL CAMPIN,2045,1321,1237,4603
2186,2020-10-08,(02000) Cabecera Autopista Norte - intermunicipal,651,407,586,1644
2187,2020-07-27,(09000) Cabecera Usme - alimentacion,7786,4312,4379,16477
2188,2020-03-05,(09101) Quiroga,1640,1010,1234,3884
2189,2020-09-21,(09101) Quiroga,460,212,336,1008
2190,2020-01-12,(03000) Portal Suba - alimentacion,5532,2441,4926,12899
2191,2020-02-25,(06111) Universidades,6001,3772,2456,12229
2192,2020-02-08,(10000) Portal 20 de Julio,5663,2404,3546,11613
2193,2020-01-09,(07000) Portal Sur,5926,3521,3554,13001
2194,2020-01-12,(08002) Biblioteca,220,105,206,531
2195,2020-02-28,(02300) Calle 100,6847,4573,4016,15436
2196,2020-07-08,(07004) VENECIA,1063,658,668,2389
2197,2020-09-07,(10002) Av. Primero de Mayo,2118,1122,1478,4718
2198,2020-09-21,(07010) Bosa,0,281,789,1070
2199,2020-03-11,(02103) Mazurén,3148,1973,1776,6897
2200,2020-08-11,(06102) Salitre El Greco,218,142,109,469
2201,2020-07-19,(09000) Cabecera Usme,337,190,270,797
2202,2020-01-04,(05105) Pradera,793,585,598,1976
2203,2020-09-22,(02103) Mazurén,258,175,262,695
2204,2020-10-02,(05002) Tintal,3010,1764,2179,6953
2205,2020-02-08,(03012) SUBA - CALLE 95,799,514,742,2055
2206,2020-05-30,(03012) SUBA - CALLE 95,191,152,111,454
2207,2020-06-12,(05005) Transversal 86,321,191,232,744
2208,2020-10-08,(05001) Patio Bonito,2316,1173,1510,4999
2209,2020-06-08,(06109) Centro Memoria,239,153,134,526
2210,2020-01-13,(09121) Las Flores,2710,1682,1672,6064
2211,2020-08-19,(02205) Calle 106,304,228,192,724
2212,2020-09-24,(02205) Calle 106,411,304,293,1008
2213,2020-03-15,(12000) Puente Aranda,26,20,38,84
2214,2020-02-11,(09113) Calle 22,1637,938,1084,3659
2215,2020-05-30,(04000) Cabecera Calle 80,653,379,535,1567
2216,2020-10-06,(09101) Quiroga,543,299,511,1353
2217,2020-02-11,(04108) El Polo,2019,1206,1242,4467
2218,2020-06-17,(02300) Calle 100,1326,848,650,2824
2219,2020-02-04,(02202) Calle 127,6115,3963,3042,13120
2220,2020-01-13,(07101) CASTELLANA,844,476,546,1866
2221,2020-08-12,(02201) Prado,696,492,419,1607
2222,2020-08-01,(03007) HUMEDAL CORDOBA,83,51,43,177
2223,2020-03-14,(03011) SUBA - CALLE 100,1054,667,893,2614
2224,2020-03-11,(09121) Las Flores,3118,2109,2119,7346
2225,2020-01-11,(04103) Las Ferias,691,361,549,1601
2226,2020-08-09,(10002) Av. Primero de Mayo,536,260,436,1232
2227,2020-01-26,(10000) Portal 20 de Julio,2098,788,1677,4563
2228,2020-03-13,(07000) Portal Sur,192,1591,1333,3116
2229,2020-05-20,(02202) Calle 127,939,677,449,2065
2230,2020-04-01,(02304) Heroes,418,310,258,986
2231,2020-01-10,(04107) Escuela Militar,445,275,353,1073
2232,2020-05-26,(04107) Escuela Militar,126,104,74,304
2233,2020-04-21,(07000) Portal Sur - alimentacion,4153,2325,1680,8158
2234,2020-03-04,(07109) CAD,2817,1703,1615,6135
2235,2020-07-29,(09121) Las Flores,671,391,394,1456
2236,2020-06-24,(09000) Cabecera Usme,1816,1117,1253,4186
2237,2020-06-02,(09103) Olaya,916,540,472,1928
2238,2020-01-17,(04108) El Polo,1619,1044,1097,3760
2239,2020-10-06,(10009) Museo Nacional,633,389,475,1497
2240,2020-08-19,(04002) Carrera 90,643,361,366,1370
2241,2020-01-08,(07109) CAD,2070,1239,1122,4431
2242,2020-07-08,(04105) Carrera 53,287,147,138,572
2243,2020-08-13,(09117) Calle 45,621,407,372,1400
2244,2020-03-20,(06100) Av. Rojas,126,83,70,279
2245,2020-10-11,(02202) Calle 127,317,254,361,932
2246,2020-08-06,(05000) Portal Américas,2248,1511,1797,5556
2247,2020-04-05,(04100) Carrera 77,203,113,121,437
2248,2020-09-11,(02304) Heroes,850,597,567,2014
2249,2020-09-11,(08000) Portal Tunal,716,338,322,1376
2250,2020-04-05,(02000) Cabecera Autopista Norte,197,130,123,450
2251,2020-05-18,(07009) SENA,506,296,285,1087
2252,2020-10-03,(02302) Virrey,451,347,485,1283
2253,2020-01-11,(09122) Calle 72,2397,1653,2247,6297
2254,2020-02-12,(12003) Ricaurte,1330,800,696,2826
2255,2020-03-17,(12003) Ricaurte,981,667,467,2115
2256,2020-02-11,(04103) Las Ferias,1618,942,817,3377
2257,2020-06-16,(10010) San Bernardo,615,342,389,1346
2258,2020-09-01,(04106) Carrera 47,320,158,191,669
2259,2020-09-02,(04106) Carrera 47,362,183,178,723
2260,2020-07-09,(06103) CAN,373,221,188,782
2261,2020-03-01,(02105) Calle 142,881,477,1147,2505
2262,2020-07-05,(10008) San Diego,85,58,79,222
2263,2020-10-12,(09116) Avenida 39,106,75,158,339
2264,2020-03-13,(03006) NIZA - CALLE 127,638,214,286,1138
2265,2020-06-07,(03006) NIZA - CALLE 127,147,94,88,329
2266,2020-05-12,(05107) Américas - Cr.53,353,217,226,796
2267,2020-08-29,(05107) Américas - Cr.53,281,212,283,776
2268,2020-09-17,(05107) Américas - Cr.53,496,267,322,1085
2269,2020-10-07,(02105) Calle 142,956,577,834,2367
2270,2020-08-28,(09106) Nariño,430,242,331,1003
2271,2020-05-29,(05100) Banderas P. Central - alimentacion,2574,1215,1394,5183
2272,2020-01-18,(10003) Ciudad Jardín,508,231,489,1228
2273,2020-09-22,(10008) San Diego,316,188,227,731
2274,2020-06-07,(05105) Pradera,115,91,82,288
2275,2020-04-21,(09113) Calle 22,225,149,221,595
2276,2020-05-27,(09113) Calle 22,360,209,326,895
2277,2020-08-21,(09115) Calle 34,619,361,388,1368
2278,2020-03-08,(07005) ALQUERIA,602,309,541,1452
2279,2020-03-25,(02204) Pepe Sierra,456,362,294,1112
2280,2020-09-26,(07201) Guatoque -Veraguas,188,107,195,490
2281,2020-03-01,(09104) Restrepo,1109,714,1447,3270
2282,2020-01-26,(05101) Mandalay - Cr.73,125,67,124,316
2283,2020-06-05,(09122) Calle 72,1101,754,601,2456
2284,2020-03-10,(06001) Modelia,662,444,373,1479
2285,2020-01-06,(02202) Calle 127,899,632,742,2273
2286,2020-05-15,(03002) SUBA - TV- 91,607,370,318,1295
2287,2020-08-28,(04105) Carrera 53,290,155,163,608
2288,2020-01-11,(07506) DESPENSA,879,493,580,1952
2289,2020-07-06,(07506) DESPENSA,514,284,264,1062
2290,2020-08-16,(09119) Calle 57,158,107,161,426
2291,2020-09-12,(40001) Juan Pablo II,0,194,632,826
2292,2020-09-02,(09110) Avenida Jimenez,1636,1086,900,3622
2293,2020-05-07,(09115) Calle 34,423,314,228,965
2294,2020-09-23,(03005) SUBA - AV. BOYACA,565,340,372,1277
2295,2020-01-26,(50002) Corral Calle 40 Sur,13,6,23,42
2296,2020-08-25,(10002) Av. Primero de Mayo,1966,991,1220,4177
2297,2020-05-14,(07109) CAD,508,345,228,1081
2298,2020-07-22,(10004) Policarpa,210,90,133,433
2299,2020-02-16,(07108) Av. El Dorado,150,114,212,476
2300,2020-07-09,(06001) Modelia,374,240,243,857
2301,2020-05-08,(02300) Calle 100,971,614,519,2104
2302,2020-06-30,(06106) Recinto Ferial,272,151,129,552
2303,2020-09-24,(05101) Mandalay - Cr.73,173,97,86,356
2304,2020-02-02,(04107) Escuela Militar,120,88,204,412
2305,2020-01-15,(09108) Hospital,204,112,200,516
2306,2020-08-23,(10000) Portal 20 de Julio,684,305,462,1451
2307,2020-08-11,(04101) Minuto de Dios,280,167,220,667
2308,2020-05-08,(07004) VENECIA,640,392,338,1370
2309,2020-04-17,(02103) Mazurén,103,67,74,244
2310,2020-05-11,(02001) Centro Comercial Santa Fe,320,224,198,742
2311,2020-07-07,(07108) Av. El Dorado,155,106,97,358
2312,2020-06-13,(04000) Cabecera Calle 80 - intermunicipal,183,101,154,438
2313,2020-09-08,(07110) PALOQUEMAO,705,426,298,1429
2314,2020-02-19,(03004) GRATAMIRA,322,174,151,647
2315,2020-05-24,(07102) NQS - CALLE 75,46,44,41,131
2316,2020-08-14,(06100) Av. Rojas,227,130,149,506
2317,2020-08-12,(03002) SUBA - TV- 91,637,384,395,1416
2318,2020-09-09,(14005) Las Aguas,234,143,235,612
2319,2020-05-11,(06105) Quinta Paredes,89,67,53,209
2320,2020-01-18,(07201) Guatoque -Veraguas,450,222,486,1158
2321,2020-03-09,(04102) Avenida Boyaca,674,567,396,1637
2322,2020-07-05,(05107) Américas - Cr.53,91,87,104,282
2323,2020-10-04,(07010) Bosa,0,102,347,449
2324,2020-05-01,(12001) Carrera 43,85,63,62,210
2325,2020-05-19,(14004) Museo del Oro,0,77,167,244
2326,2020-03-28,(07002) MADELENA,210,115,107,432
2327,2020-06-14,(05100) Banderas P. Central,139,81,131,351
2328,2020-07-23,(09108) Hospital,62,25,49,136
2329,2020-04-01,(09117) Calle 45,491,303,245,1039
2330,2020-04-16,(06108) Concejo de Bogotá,95,73,55,223
2331,2020-06-23,(06108) Concejo de Bogotá,168,97,69,334
2332,2020-06-29,(10007) Las Nieves,93,78,115,286
2333,2020-05-31,(03002) SUBA - TV- 91,191,111,141,443
2334,2020-04-22,(03005) SUBA - AV. BOYACA,219,159,132,510
2335,2020-08-13,(04102) Avenida Boyaca,285,162,206,653
2336,2020-09-19,(07008) NQS - Calle 30 Sur,343,151,249,743
2337,2020-08-19,(06101) El Tiempo,317,188,154,659
2338,2020-05-24,(03009) Av. Suba- Calle 116,138,98,78,314
2339,2020-08-08,(12004) Carrera 22,164,112,110,386
2340,2020-07-15,(10003) Ciudad Jardín,139,75,90,304
2341,2020-07-28,(10003) Ciudad Jardín,209,102,124,435
2342,2020-07-19,(07506) DESPENSA,110,55,75,240
2343,2020-09-05,(06106) Recinto Ferial,202,123,148,473
2344,2020-06-17,(06100) Av. Rojas,224,125,120,469
2345,2020-04-11,(14004) Museo del Oro,0,21,32,53
2346,2020-09-03,(06100) Av. Rojas,257,147,171,575
2347,2020-06-02,(10005) Bicentenario - alimentacion,241,130,152,523
2348,2020-05-20,(06100) Av. Rojas,192,97,92,381
2349,2020-06-18,(06104) Gobernación,267,154,93,514
2350,2020-07-22,(05101) Mandalay - Cr.73,120,68,70,258
2351,2020-08-27,(03004) GRATAMIRA,0,11,29,40
2352,2020-10-12,(07002) MADELENA,296,119,314,729
2353,2019-12-31,(07002) MADELENA,47,33,50,130
2354,2020-05-17,(07006) General Santander,114,68,78,260
2355,2020-06-28,(06106) Recinto Ferial,61,42,52,155
2356,2020-09-01,(03007) HUMEDAL CORDOBA,142,101,80,323
2357,2020-07-26,(06106) Recinto Ferial,58,40,43,141
2358,2020-10-12,(14001) La Sabana,37,34,59,130
2359,2020-05-13,(09105) Río Fucha,123,44,70,237
2360,2020-07-29,(14005) Las Aguas,167,110,192,469
2361,2020-07-19,(07200) Tygua-San José,49,39,58,146
2362,2020-04-19,(12003) Ricaurte,33,32,22,87
2363,2020-08-18,(06105) Quinta Paredes,130,87,87,304
2364,2020-08-07,(06001) Modelia,109,62,72,243
2365,2020-04-22,(07108) Av. El Dorado,71,47,39,157
2366,2020-08-09,(03007) HUMEDAL CORDOBA,25,25,24,74
2367,2020-06-03,(10005) Bicentenario,95,53,71,219
2368,2020-09-13,(07107) U. NACIONAL,104,74,111,289
2369,2020-03-31,(05101) Mandalay - Cr.73,58,29,20,107
2370,2020-09-24,(03014) SAN MARTIN,0,18,48,66
2371,2020-07-26,(14005) Las Aguas,38,32,65,135
2372,2020-10-13,(05000) Portal Américas - alimentacion,12,0,1,13
2373,2020-08-10,(03014) SAN MARTIN,0,10,15,25
2374,2020-03-02,(04000) Cabecera Calle 80 - alimentacion,23653,14498,14740,52891
2375,2020-08-19,(07005) ALQUERIA,520,307,314,1141
2376,2020-01-17,(07504) TERREROS,16507,9124,9259,34890
2377,2020-09-30,(07504) TERREROS,7124,3518,4008,14650
2378,2020-02-12,(09119) Calle 57,4069,2436,2175,8680
2379,2020-10-06,(03000) Portal Suba - alimentacion,7547,4020,5470,17037
2380,2020-02-21,(05000) Portal Américas - alimentacion,37237,20540,20565,78342
2381,2020-02-11,(03002) SUBA - TV- 91,4781,2886,2486,10153
2382,2020-02-18,(05000) Portal Américas,15617,8981,7950,32548
2383,2020-01-28,(06104) Gobernación,1391,790,634,2815
2384,2020-06-16,(10000) Portal 20 de Julio - alimentacion,4423,2043,2353,8819
2385,2020-01-28,(07111) NQS - RICAURTE,3174,1940,1693,6807
2386,2020-08-20,(07503) SAN MATEO,10363,5956,4909,21228
2387,2020-03-29,(04000) Cabecera Calle 80 - alimentacion,544,345,271,1160
2388,2020-02-11,(09001) Molinos,7877,4840,5893,18610
2389,2020-02-20,(08000) Portal Tunal - alimentacion,23779,13308,11155,48242
2390,2020-02-07,(07010) Bosa,2318,1306,1491,5115
2391,2020-03-14,(07010) Bosa,1317,669,1013,2999
2392,2020-07-13,(09115) Calle 34,568,323,296,1187
2393,2020-02-12,(02105) Calle 142,7549,4582,3896,16027
2394,2020-08-15,(05100) Banderas P. Central,602,277,467,1346
2395,2020-09-16,(07001) PERDOMO,1107,610,792,2509
2396,2020-02-06,(07113) SANTA ISABEL,2054,1341,1442,4837
2397,2020-09-07,(09000) Cabecera Usme - alimentacion,8680,4618,5453,18751
2398,2020-06-06,(09109) Tercer Milenio,251,152,184,587
2399,2020-01-23,(05107) Américas - Cr.53,2440,1271,1338,5049
2400,2020-05-13,(03000) Portal Suba - alimentacion,4649,2667,2365,9681
2401,2020-02-02,(09115) Calle 34,535,330,722,1587
2402,2020-02-26,(04104) Avenida 68,3789,2022,1746,7557
2403,2020-01-23,(06002) Normandía,2233,1380,1256,4869
2404,2020-02-24,(12003) Ricaurte,1314,736,724,2774
2405,2020-01-20,(07111) NQS - RICAURTE,2906,1896,1697,6499
2406,2020-08-17,(10000) Portal 20 de Julio - alimentacion,1507,617,990,3114
2407,2020-02-07,(06106) Recinto Ferial,1548,859,844,3251
2408,2020-01-24,(07102) NQS - CALLE 75,1377,901,899,3177
2409,2020-06-29,(03013) RIO NEGRO,75,61,80,216
2410,2020-02-05,(09103) Olaya,4446,2582,2551,9579
2411,2020-03-16,(09116) Avenida 39,1784,1238,1063,4085
2412,2020-04-20,(09104) Restrepo,722,485,605,1812
2413,2020-09-01,(02103) Mazurén,210,151,170,531
2414,2020-08-12,(07000) Portal Sur - alimentacion,7544,4253,3884,15681
2415,2020-09-17,(07000) Portal Sur - alimentacion,9148,5025,5198,19371
2416,2020-07-14,(09103) Olaya,717,435,406,1558
2417,2020-10-01,(07002) MADELENA,1047,563,714,2324
2418,2020-09-24,(07002) MADELENA,1038,591,627,2256
2419,2020-05-01,(09113) Calle 22,193,113,186,492
2420,2020-04-03,(04105) Carrera 53,157,113,76,346
2421,2020-04-13,(50003) Corral Molinos,771,383,558,1712
2422,2020-07-25,(02000) Cabecera Autopista Norte - alimentacion,3381,1687,1708,6776
2423,2020-02-09,(09110) Avenida Jimenez,1186,834,1079,3099
2424,2020-03-07,(02000) Cabecera Autopista Norte,5061,2533,4304,11898
2425,2020-05-04,(04002) Carrera 90,455,280,223,958
2426,2020-02-12,(06000) Portal Eldorado,7056,4104,2888,14048
2427,2020-01-16,(10008) San Diego,1193,698,730,2621
2428,2020-07-02,(10002) Av. Primero de Mayo,2342,1155,1509,5006
2429,2020-02-02,(04104) Avenida 68,658,374,712,1744
2430,2020-05-28,(09107) Hortúa,530,339,285,1154
2431,2020-03-27,(10006) San Victorino,161,115,137,413
2432,2020-09-30,(09000) Cabecera Usme - alimentacion,9729,4861,6342,20932
2433,2020-01-21,(02302) Virrey,2274,1789,1464,5527
2434,2020-01-19,(09100) Calle 40 Sur,1635,697,1479,3811
2435,2020-09-25,(02000) Cabecera Autopista Norte - alimentacion,5450,2740,3625,11815
2436,2020-02-12,(07004) VENECIA,4914,2831,2414,10159
2437,2020-08-28,(07108) Av. El Dorado,128,88,97,313
2438,2020-02-06,(02300) Calle 100,6873,4722,4083,15678
2439,2020-08-03,(08001) Parque el Tunal,438,222,250,910
2440,2020-02-25,(09116) Avenida 39,3491,2200,1575,7266
2441,2020-06-26,(09116) Avenida 39,365,235,233,833
2442,2020-09-12,(07505) LEON XIII,2309,1064,1336,4709
2443,2020-02-05,(09113) Calle 22,1646,920,1087,3653
2444,2020-05-27,(02201) Prado,798,534,425,1757
2445,2020-01-10,(03001) LA CAMPIÑA,5003,2427,2894,10324
2446,2020-07-09,(06102) Salitre El Greco,272,144,131,547
2447,2020-08-03,(05103) Marsella,362,193,188,743
2448,2020-06-08,(02300) Calle 100,1226,761,632,2619
2449,2020-05-15,(03012) SUBA - CALLE 95,287,172,156,615
2450,2020-06-23,(03012) SUBA - CALLE 95,336,214,190,740
2451,2020-01-30,(10010) San Bernardo,1689,1026,1297,4012
2452,2020-09-15,(05005) Transversal 86,413,230,291,934
2453,2020-09-11,(05105) Pradera,551,334,315,1200
2454,2020-01-29,(09106) Nariño,1966,1188,1323,4477
2455,2020-06-20,(02205) Calle 106,217,173,190,580
2456,2020-09-02,(02205) Calle 106,411,274,262,947
2457,2020-09-09,(04003) Avenida Ciudad de Cali,1115,610,847,2572
2458,2020-07-18,(09101) Quiroga,289,151,247,687
2459,2020-03-09,(07101) CASTELLANA,437,68,145,650
2460,2020-08-24,(07106) EL CAMPIN,339,212,187,738
2461,2020-01-11,(03001) LA CAMPIÑA,2537,1071,1822,5430
2462,2020-03-19,(05100) Banderas P. Central,2843,1360,1658,5861
2463,2020-03-04,(06101) El Tiempo,2862,1710,1501,6073
2464,2020-03-25,(07010) Bosa,286,168,239,693
2465,2020-03-31,(09100) Calle 40 Sur,775,453,477,1705
2466,2020-05-04,(09100) Calle 40 Sur,1169,672,730,2571
2467,2020-06-14,(07004) VENECIA,245,120,196,561
2468,2020-07-19,(05000) Portal Américas - alimentacion,2940,1349,1386,5675
2469,2020-02-29,(05105) Pradera,1536,1055,1037,3628
2470,2020-08-12,(04104) Avenida 68,491,257,309,1057
2471,2020-04-04,(02000) Cabecera Autopista Norte - alimentacion,2053,1001,858,3912
2472,2020-08-15,(02104) Calle 146,546,326,426,1298
2473,2020-01-09,(40001) Juan Pablo II,1324,728,810,2862
2474,2020-04-09,(03001) LA CAMPIÑA,216,108,104,428
2475,2020-03-10,(07004) VENECIA,535,1200,813,2548
2476,2020-10-08,(07109) CAD,744,475,449,1668
2477,2020-05-29,(09002) Consuelo,452,212,246,910
2478,2020-06-15,(07113) SANTA ISABEL,153,83,119,355
2479,2020-04-18,(04108) El Polo,139,102,78,319
2480,2020-07-15,(07008) NQS - Calle 30 Sur,277,144,148,569
2481,2020-07-02,(02302) Virrey,713,477,380,1570
2482,2020-05-17,(12003) Ricaurte,42,31,29,102
2483,2020-05-22,(12003) Ricaurte,304,230,137,671
2484,2020-06-30,(03010) PUENTE LARGO,386,241,206,833
2485,2020-09-04,(09104) Restrepo,1779,985,1346,4110
2486,2020-01-01,(02104) Calle 146,370,210,544,1124
2487,2020-08-14,(09004) Santa Lucía,2381,1207,1218,4806
2488,2020-05-28,(02105) Calle 142,678,421,400,1499
2489,2020-05-04,(07007) NQS - Calle 38A Sur,221,134,153,508
2490,2020-07-02,(02104) Calle 146,811,524,536,1871
2491,2020-09-13,(07103) AV. CHILE,208,145,228,581
2492,2020-03-17,(07105) MOVISTAR ARENA,816,550,422,1788
2493,2020-08-03,(10005) Bicentenario,82,50,66,198
2494,2020-07-06,(02001) Centro Comercial Santa Fe,546,338,362,1246
2495,2020-04-18,(07112) COMUNEROS,306,204,171,681
2496,2020-07-10,(02200) Alcalá,1989,1305,1066,4360
2497,2020-08-06,(14001) La Sabana,174,102,105,381
2498,2020-08-06,(08002) Biblioteca,288,159,180,627
2499,2020-09-28,(04107) Escuela Militar,160,113,113,386
2500,2020-07-23,(09003) Socorro,423,228,248,899
2501,2020-08-03,(12007) Zona Industrial,218,135,126,479
2502,2020-09-07,(06100) Av. Rojas,280,162,176,618
2503,2020-04-21,(09004) Santa Lucía,1178,670,668,2516
2504,2020-04-25,(09004) Santa Lucía,985,548,502,2035
2505,2020-06-09,(03002) SUBA - TV- 91,710,452,467,1629
2506,2020-04-27,(04002) Carrera 90,270,44,33,347
2507,2020-09-01,(03006) NIZA - CALLE 127,447,270,260,977
2508,2020-01-17,(05102) Av. Américas - Av. Boyacá,1474,784,879,3137
2509,2020-09-11,(07110) PALOQUEMAO,657,320,339,1316
2510,2020-09-13,(07110) PALOQUEMAO,170,121,170,461
2511,2020-03-18,(10003) Ciudad Jardín,479,267,352,1098
2512,2020-08-02,(02304) Heroes,190,139,141,470
2513,2020-01-04,(09106) Nariño,678,327,637,1642
2514,2020-10-12,(09123) Calle 76,197,170,321,688
2515,2020-09-09,(02502) Terminal,488,358,448,1294
2516,2020-04-26,(09122) Calle 72,226,167,156,549
2517,2020-02-28,(12002) CDS - Carrera 32,638,405,366,1409
2518,2020-09-12,(07006) General Santander - alimentacion,270,156,297,723
2519,2020-06-30,(09114) Calle 26,331,205,254,790
2520,2020-06-27,(07105) MOVISTAR ARENA,191,129,146,466
2521,2020-02-12,(07104) Simon Bolivar,2513,1588,1323,5424
2522,2020-01-11,(07008) NQS - Calle 30 Sur,844,384,610,1838
2523,2020-06-18,(03003) 21 ANGELES,335,168,162,665
2524,2020-07-16,(03003) 21 ANGELES,300,153,132,585
2525,2020-03-21,(07113) SANTA ISABEL,100,69,72,241
2526,2020-06-26,(02304) Heroes,901,637,487,2025
2527,2020-05-06,(40001) Juan Pablo II,370,207,220,797
2528,2020-09-23,(10004) Policarpa,287,123,179,589
2529,2020-06-16,(04103) Las Ferias,370,194,192,756
2530,2020-06-04,(07110) PALOQUEMAO,599,385,226,1210
2531,2020-07-14,(04103) Las Ferias,309,170,139,618
2532,2020-09-03,(40001) Juan Pablo II,591,347,405,1343
2533,2020-01-05,(10004) Policarpa,191,89,216,496
2534,2020-10-03,(08002) Biblioteca,247,134,238,619
2535,2020-10-02,(07009) SENA,771,435,651,1857
2536,2020-05-21,(07109) CAD,554,347,192,1093
2537,2020-08-01,(05102) Av. Américas - Av. Boyacá,151,98,101,350
2538,2020-07-29,(02102) Calle 161,221,136,152,509
2539,2020-02-23,(07108) Av. El Dorado,130,108,181,419
2540,2020-05-08,(09111) Calle 19,438,253,331,1022
2541,2020-04-04,(03013) RIO NEGRO,101,62,62,225
2542,2020-02-20,(09108) Hospital,250,150,176,576
2543,2020-04-17,(10004) Policarpa,125,71,107,303
2544,2020-03-26,(09002) Consuelo,204,107,100,411
2545,2020-04-03,(09002) Consuelo,237,111,143,491
2546,2020-06-14,(02302) Virrey,166,117,121,404
2547,2020-07-19,(50003) Corral Molinos,375,207,320,902
2548,2020-09-05,(04002) Carrera 90,631,302,408,1341
2549,2020-06-10,(04102) Avenida Boyaca,318,183,167,668
2550,2020-05-19,(02502) Terminal,310,210,248,768
2551,2020-06-03,(03006) NIZA - CALLE 127,374,211,215,800
2552,2020-05-21,(09120) Calle 63,844,602,522,1968
2553,2020-07-04,(09119) Calle 57,477,290,450,1217
2554,2020-07-25,(09119) Calle 57,322,207,245,774
2555,2020-03-04,(09108) Hospital,242,146,222,610
2556,2020-04-09,(04000) Cabecera Calle 80,176,105,119,400
2557,2020-07-26,(07002) MADELENA,142,69,122,333
2558,2020-04-02,(03012) SUBA - CALLE 95,161,121,109,391
2559,2020-04-07,(09105) Río Fucha,62,40,46,148
2560,2020-02-16,(07109) CAD,544,359,546,1449
2561,2020-08-11,(07506) DESPENSA,439,238,255,932
2562,2020-03-27,(10007) Las Nieves,145,131,136,412
2563,2020-05-20,(09113) Calle 22,405,244,328,977
2564,2020-08-20,(09113) Calle 22,392,250,274,916
2565,2020-08-24,(12007) Zona Industrial,269,158,135,562
2566,2020-04-28,(09108) Hospital,52,33,44,129
2567,2020-08-02,(04104) Avenida 68,138,73,102,313
2568,2020-04-08,(02303) Calle 85,302,231,206,739
2569,2020-03-28,(06000) Portal Eldorado,451,338,279,1068
2570,2020-06-09,(09111) Calle 19,718,465,439,1622
2571,2020-05-15,(40002) Manitas,304,166,201,671
2572,2020-06-29,(06108) Concejo de Bogotá,51,36,33,120
2573,2020-01-21,(03004) GRATAMIRA,156,101,107,364
2574,2020-03-18,(03004) GRATAMIRA,112,60,60,232
2575,2020-08-08,(02102) Calle 161,142,91,120,353
2576,2020-10-09,(10003) Ciudad Jardín,265,134,252,651
2577,2020-01-06,(07200) Tygua-San José,107,69,162,338
2578,2020-06-04,(07506) DESPENSA,460,251,230,941
2579,2020-08-16,(14004) Museo del Oro,23,23,46,92
2580,2020-08-30,(09111) Calle 19,216,148,230,594
2581,2020-06-22,(09106) Nariño,164,98,125,387
2582,2020-09-09,(03004) GRATAMIRA,0,23,38,61
2583,2020-05-13,(12002) CDS - Carrera 32,192,131,59,382
2584,2020-05-09,(09106) Nariño,213,111,133,457
2585,2020-10-04,(03005) SUBA - AV. BOYACA,137,100,191,428
2586,2020-06-28,(03004) GRATAMIRA,10,8,9,27
2587,2020-07-11,(04107) Escuela Militar,108,81,101,290
2588,2020-05-07,(07006) General Santander,322,196,201,719
2589,2020-04-02,(07103) AV. CHILE,387,277,227,891
2590,2020-04-20,(03013) RIO NEGRO,168,102,90,360
2591,2020-03-31,(06100) Av. Rojas,105,73,87,265
2592,2020-06-21,(02000) Cabecera Autopista Norte - intermunicipal,112,70,107,289
2593,2020-04-14,(04003) Avenida Ciudad de Cali,558,345,365,1268
2594,2020-04-29,(09105) Río Fucha,84,44,42,170
2595,2020-03-29,(02204) Pepe Sierra,155,143,97,395
2596,2020-04-15,(07101) CASTELLANA,87,66,54,207
2597,2020-07-17,(05101) Mandalay - Cr.73,102,56,47,205
2598,2020-10-11,(06108) Concejo de Bogotá,37,31,64,132
2599,2020-03-08,(50002) Corral Calle 40 Sur,12,13,37,62
2600,2020-06-28,(09108) Hospital,28,17,25,70
2601,2020-08-22,(03014) SAN MARTIN,0,6,30,36
2602,2020-04-19,(05101) Mandalay - Cr.73,15,7,8,30
2603,2020-05-25,(06104) Gobernación,59,38,39,136
2604,2020-04-06,(03014) SAN MARTIN,19,7,25,51
2605,2020-09-01,(03014) SAN MARTIN,0,14,50,64
2606,2020-05-25,(03004) GRATAMIRA,12,7,9,28
2607,2020-05-21,(50006) Corral Carrera 77,6,5,10,21
2608,2020-05-26,(50006) Corral Carrera 77,7,2,4,13
2609,2020-08-07,(03014) SAN MARTIN,0,6,16,22
2610,2020-05-05,(04000) Cabecera Calle 80 - alimentacion,2464,1391,1545,5400
2611,2020-07-13,(04000) Cabecera Calle 80 - alimentacion,3591,2068,2263,7922
2612,2020-07-17,(04000) Cabecera Calle 80 - alimentacion,3684,2026,2350,8060
2613,2020-08-13,(07005) ALQUERIA,491,280,307,1078
2614,2020-07-11,(07504) TERREROS,5237,2684,2755,10676
2615,2020-08-25,(07504) TERREROS,5760,3141,2749,11650
2616,2020-06-04,(09119) Calle 57,510,314,312,1136
2617,2020-02-11,(04106) Carrera 47,1493,888,877,3258
2618,2020-01-29,(09122) Calle 72,7058,4488,3708,15254
2619,2020-02-10,(05000) Portal Américas,15174,8989,7886,32049
2620,2020-01-15,(06104) Gobernación,1211,703,589,2503
2621,2020-02-13,(04101) Minuto de Dios,3697,2233,1843,7773
2622,2020-05-16,(05000) Portal Américas - alimentacion,6623,3266,2913,12802
2623,2020-09-25,(05001) Patio Bonito,2338,1162,1351,4851
2624,2020-02-04,(09118) Marly,7974,5103,4161,17238
2625,2020-03-11,(07010) Bosa,2004,1148,1375,4527
2626,2020-05-13,(05005) Transversal 86,271,153,140,564
2627,2020-01-01,(08000) Portal Tunal - alimentacion,2328,1041,2302,5671
2628,2020-06-05,(09100) Calle 40 Sur,1585,964,1064,3613
2629,2020-02-14,(07009) SENA,3977,2151,2163,8291
2630,2020-03-02,(10003) Ciudad Jardín,1010,577,634,2221
2631,2020-02-13,(09120) Calle 63,7592,4811,3720,16123
2632,2020-01-29,(07113) SANTA ISABEL,2083,1231,1363,4677
2633,2020-08-03,(07505) LEON XIII,2375,1277,1045,4697
2634,2020-03-27,(07504) TERREROS,2465,1398,1404,5267
2635,2020-02-25,(09117) Calle 45,6892,4397,3070,14359
2636,2020-01-03,(03000) Portal Suba - alimentacion,13789,7138,9028,29955
2637,2020-01-07,(03009) Av. Suba- Calle 116,1756,1109,1070,3935
2638,2020-08-24,(09000) Cabecera Usme - alimentacion,7558,3714,4049,15321
2639,2020-01-07,(09103) Olaya,2650,1606,1891,6147
2640,2020-09-02,(06000) Portal Eldorado - alimentacion,4225,2149,2358,8732
2641,2020-01-23,(03001) LA CAMPIÑA,6208,3554,3852,13614
2642,2020-03-06,(09116) Avenida 39,2938,1956,1862,6756
2643,2020-10-09,(02000) Cabecera Autopista Norte - alimentacion,5536,2728,4031,12295
2644,2020-08-24,(07002) MADELENA,692,413,446,1551
2645,2020-01-16,(04102) Avenida Boyaca,2457,1387,1484,5328
2646,2020-02-10,(04102) Avenida Boyaca,3211,1995,1666,6872
2647,2020-02-27,(07107) U. NACIONAL,2120,1353,1211,4684
2648,2020-04-01,(09113) Calle 22,188,117,172,477
2649,2020-02-05,(02001) Centro Comercial Santa Fe,5028,3164,2745,10937
2650,2020-01-26,(05000) Portal Américas,2673,1185,2475,6333
2651,2020-08-07,(05000) Portal Américas,924,588,771,2283
2652,2020-10-09,(07010) Bosa,0,417,1033,1450
2653,2020-02-27,(05002) Tintal,11042,6547,5852,23441
2654,2020-04-16,(09111) Calle 19,245,165,195,605
2655,2020-06-13,(09111) Calle 19,596,428,428,1452
2656,2020-05-01,(09000) Cabecera Usme - alimentacion,2443,1318,1355,5116
2657,2020-09-30,(10006) San Victorino,861,411,438,1710
2658,2020-03-17,(03000) Portal Suba,4924,2960,2655,10539
2659,2020-05-31,(06000) Portal Eldorado,178,131,170,479
2660,2020-08-04,(40003) Mirador del Paraiso,1594,977,1021,3592
2661,2020-02-13,(10000) Portal 20 de Julio,9393,4304,3934,17631
2662,2020-09-25,(12001) Carrera 43,474,288,329,1091
2663,2020-05-24,(50003) Corral Molinos,379,170,330,879
2664,2020-09-15,(10002) Av. Primero de Mayo,2229,1166,1563,4958
2665,2020-02-18,(02105) Calle 142,7512,4621,3859,15992
2666,2020-05-27,(02000) Cabecera Autopista Norte - intermunicipal,440,303,309,1052
2667,2020-04-21,(10000) Portal 20 de Julio - alimentacion,2701,1127,1579,5407
2668,2020-01-17,(06111) Universidades,2798,1847,2204,6849
2669,2020-05-22,(03000) Portal Suba - alimentacion,5049,2904,2607,10560
2670,2020-06-04,(07112) COMUNEROS,742,434,389,1565
2671,2020-03-28,(07000) Portal Sur - alimentacion,2907,1474,1099,5480
2672,2020-02-22,(08002) Biblioteca,611,313,525,1449
2673,2020-09-28,(04002) Carrera 90,812,462,540,1814
2674,2020-05-08,(09118) Marly,1176,833,536,2545
2675,2020-06-16,(08001) Parque el Tunal,489,278,254,1021
2676,2020-07-03,(08001) Parque el Tunal,537,295,291,1123
2677,2020-05-23,(06108) Concejo de Bogotá,88,50,57,195
2678,2020-06-09,(06108) Concejo de Bogotá,135,73,77,285
2679,2020-09-08,(06108) Concejo de Bogotá,163,85,85,333
2680,2020-05-19,(10002) Av. Primero de Mayo,1736,889,942,3567
2681,2020-09-08,(07010) Bosa,660,307,427,1394
2682,2020-06-29,(10001) Country Sur,368,149,294,811
2683,2020-09-01,(09100) Calle 40 Sur,1764,1018,1216,3998
2684,2020-02-11,(10007) Las Nieves,2183,1311,1202,4696
2685,2020-02-02,(04003) Avenida Ciudad de Cali,1052,472,1208,2732
2686,2020-08-05,(09123) Calle 76,917,644,543,2104
2687,2020-01-07,(05101) Mandalay - Cr.73,644,334,371,1349
2688,2020-06-28,(02300) Calle 100,284,209,267,760
2689,2020-06-03,(03012) SUBA - CALLE 95,314,190,185,689
2690,2020-05-28,(09119) Calle 57,489,329,289,1107
2691,2020-05-30,(05005) Transversal 86,227,111,118,456
2692,2020-01-08,(08000) Portal Tunal,1488,896,928,3312
2693,2020-03-04,(03012) SUBA - CALLE 95,1413,940,1033,3386
2694,2020-02-27,(09121) Las Flores,3558,2201,2007,7766
2695,2020-08-15,(06000) Portal Eldorado - alimentacion,3014,1462,1861,6337
2696,2020-06-13,(02300) Calle 100,803,559,521,1883
2697,2020-02-20,(07201) Guatoque -Veraguas,1022,489,575,2086
2698,2020-06-06,(07201) Guatoque -Veraguas,130,73,121,324
2699,2020-07-21,(07103) AV. CHILE,936,560,372,1868
2700,2020-01-29,(03010) PUENTE LARGO,2159,1425,1226,4810
2701,2020-02-10,(06001) Modelia,2745,1662,1321,5728
2702,2020-04-22,(02101) Toberín,658,456,408,1522
2703,2020-05-24,(09103) Olaya,274,121,173,568
2704,2020-01-11,(10010) San Bernardo,786,445,868,2099
2705,2020-02-02,(02304) Heroes,558,434,737,1729
2706,2020-06-03,(04107) Escuela Militar,128,98,78,304
2707,2020-06-07,(05000) Portal Américas,542,364,504,1410
2708,2020-09-19,(07004) VENECIA,871,476,711,2058
2709,2020-08-04,(09121) Las Flores,589,343,390,1322
2710,2020-05-25,(04002) Carrera 90,164,95,119,378
2711,2020-03-08,(07109) CAD,552,340,492,1384
2712,2020-01-25,(09111) Calle 19,1261,847,1161,3269
2713,2020-08-04,(04001) Quirigua,302,188,209,699
2714,2020-08-13,(05001) Patio Bonito,1857,1018,1041,3916
2715,2020-06-04,(09120) Calle 63,973,687,594,2254
2716,2020-10-08,(04108) El Polo,566,323,336,1225
2717,2020-03-13,(02001) Centro Comercial Santa Fe,313,792,691,1796
2718,2020-05-11,(07009) SENA,473,281,302,1056
2719,2020-02-01,(12003) Ricaurte,692,556,580,1828
2720,2020-02-05,(12003) Ricaurte,1303,811,644,2758
2721,2020-06-02,(03012) SUBA - CALLE 95,324,216,158,698
2722,2020-05-08,(10010) San Bernardo,475,271,314,1060
2723,2020-07-25,(05100) Banderas P. Central,328,208,286,822
2724,2020-03-25,(10000) Portal 20 de Julio - alimentacion,2430,907,1192,4529
2725,2020-01-06,(03006) NIZA - CALLE 127,391,236,363,990
2726,2020-01-21,(10005) Bicentenario,467,269,287,1023
2727,2020-08-10,(12007) Zona Industrial,354,229,150,733
2728,2020-03-06,(40002) Manitas,1292,717,762,2771
2729,2020-06-03,(09117) Calle 45,686,385,397,1468
2730,2020-03-05,(12002) CDS - Carrera 32,612,370,343,1325
2731,2020-08-20,(02001) Centro Comercial Santa Fe,411,277,287,975
2732,2020-03-07,(02102) Calle 161,836,411,764,2011
2733,2020-09-13,(09000) Cabecera Usme - alimentacion,2817,1249,2073,6139
2734,2020-06-01,(02104) Calle 146,661,450,439,1550
2735,2020-06-05,(02104) Calle 146,687,466,451,1604
2736,2020-07-02,(07102) NQS - CALLE 75,472,277,250,999
2737,2020-02-29,(40001) Juan Pablo II,1201,622,826,2649
2738,2020-06-13,(10005) Bicentenario - alimentacion,173,72,168,413
2739,2020-03-08,(09113) Calle 22,599,296,512,1407
2740,2020-06-27,(09118) Marly,1113,736,720,2569
2741,2020-09-27,(10008) San Diego,89,65,109,263
2742,2020-05-15,(02202) Calle 127,933,636,475,2044
2743,2020-01-12,(02303) Calle 85,426,375,528,1329
2744,2020-06-07,(03000) Portal Suba - alimentacion,1657,830,1095,3582
2745,2020-04-21,(02204) Pepe Sierra,404,338,225,967
2746,2020-06-23,(09110) Avenida Jimenez,1437,1028,911,3376
2747,2020-06-17,(07200) Tygua-San José,254,123,150,527
2748,2020-07-23,(03012) SUBA - CALLE 95,284,152,153,589
2749,2020-09-10,(12002) CDS - Carrera 32,180,131,87,398
2750,2020-03-31,(09118) Marly,1109,740,468,2317
2751,2020-08-14,(06109) Centro Memoria,248,133,142,523
2752,2020-08-17,(07111) NQS - RICAURTE,236,194,166,596
2753,2020-09-02,(07009) SENA,696,420,500,1616
2754,2020-09-19,(04105) Carrera 53,245,131,226,602
2755,2020-04-13,(09103) Olaya,455,283,248,986
2756,2020-01-27,(50002) Corral Calle 40 Sur,123,78,147,348
2757,2020-05-09,(50003) Corral Molinos,830,374,529,1733
2758,2020-05-01,(03000) Portal Suba,333,180,225,738
2759,2020-05-04,(09121) Las Flores,476,313,281,1070
2760,2020-06-04,(09121) Las Flores,647,450,336,1433
2761,2020-05-25,(07107) U. NACIONAL,114,73,58,245
2762,2020-09-28,(09114) Calle 26,367,235,324,926
2763,2020-05-15,(09113) Calle 22,379,238,285,902
2764,2020-10-08,(03003) 21 ANGELES,383,193,257,833
2765,2020-06-10,(10007) Las Nieves,610,321,368,1299
2766,2020-09-09,(10007) Las Nieves,749,459,444,1652
2767,2020-04-25,(09000) Cabecera Usme,623,394,476,1493
2768,2020-10-06,(10004) Policarpa,282,140,228,650
2769,2020-04-14,(10007) Las Nieves,213,154,166,533
2770,2020-08-12,(08002) Biblioteca,300,169,185,654
2771,2020-07-16,(03010) PUENTE LARGO,324,196,184,704
2772,2020-04-09,(07103) AV. CHILE,144,107,76,327
2773,2020-05-14,(02102) Calle 161,184,108,95,387
2774,2020-08-07,(09113) Calle 22,244,133,175,552
2775,2020-07-27,(12004) Carrera 22,251,110,113,474
2776,2020-04-20,(09111) Calle 19,263,175,207,645
2777,2020-05-06,(02300) Calle 100,941,646,443,2030
2778,2020-08-30,(10004) Policarpa,94,55,99,248
2779,2020-04-12,(02300) Calle 100,290,210,182,682
2780,2020-07-21,(06109) Centro Memoria,223,109,112,444
2781,2020-06-15,(02201) Prado,309,237,184,730
2782,2020-05-19,(07200) Tygua-San José,180,106,105,391
2783,2020-08-27,(40001) Juan Pablo II,551,320,355,1226
2784,2020-05-22,(07112) COMUNEROS,680,392,346,1418
2785,2020-07-14,(07004) VENECIA,837,508,490,1835
2786,2020-09-16,(12002) CDS - Carrera 32,196,142,106,444
2787,2020-05-06,(03006) NIZA - CALLE 127,278,186,128,592
2788,2020-05-09,(40001) Juan Pablo II,277,168,137,582
2789,2020-03-25,(03003) 21 ANGELES,164,89,83,336
2790,2020-04-07,(04000) Cabecera Calle 80 - intermunicipal,103,71,91,265
2791,2020-08-07,(07108) Av. El Dorado,48,24,31,103
2792,2020-09-24,(07108) Av. El Dorado,172,102,118,392
2793,2020-10-09,(07001) PERDOMO,1215,643,1009,2867
2794,2020-05-15,(06001) Modelia,343,214,174,731
2795,2020-06-23,(09108) Hospital,82,43,59,184
2796,2020-09-23,(09108) Hospital,63,48,75,186
2797,2020-07-05,(02105) Calle 142,209,147,208,564
2798,2020-03-25,(03006) NIZA - CALLE 127,244,201,137,582
2799,2020-07-12,(03012) SUBA - CALLE 95,89,53,83,225
2800,2020-01-15,(09105) Río Fucha,627,366,494,1487
2801,2020-04-18,(02502) Terminal,105,73,99,277
2802,2020-01-09,(03004) GRATAMIRA,183,92,116,391
2803,2020-05-29,(02204) Pepe Sierra,677,489,332,1498
2804,2020-07-24,(09115) Calle 34,552,314,283,1149
2805,2020-10-11,(02502) Terminal,90,78,220,388
2806,2020-10-12,(05105) Pradera,203,133,155,491
2807,2020-09-11,(07006) General Santander - alimentacion,370,227,285,882
2808,2020-05-05,(07506) DESPENSA,322,180,180,682
2809,2020-03-26,(07006) General Santander - alimentacion,174,103,117,394
2810,2020-09-01,(06102) Salitre El Greco,211,136,173,520
2811,2020-03-01,(06105) Quinta Paredes,124,67,204,395
2812,2020-04-09,(02303) Calle 85,149,91,79,319
2813,2020-05-05,(06111) Universidades,0,102,279,381
2814,2020-06-21,(10007) Las Nieves,92,78,98,268
2815,2020-07-01,(07101) CASTELLANA,206,139,150,495
2816,2020-06-17,(07003) SEVILLANA,427,262,248,937
2817,2020-07-10,(07108) Av. El Dorado,145,94,85,324
2818,2020-06-07,(12002) CDS - Carrera 32,25,30,19,74
2819,2020-04-11,(04107) Escuela Militar,36,28,25,89
2820,2020-06-27,(03009) Av. Suba- Calle 116,344,255,242,841
2821,2020-05-11,(04000) Cabecera Calle 80 - intermunicipal,192,97,167,456
2822,2020-09-13,(06103) CAN,131,92,112,335
2823,2020-07-12,(10005) Bicentenario,28,24,45,97
2824,2020-04-10,(05102) Av. Américas - Av. Boyacá,69,32,18,119
2825,2020-01-12,(06104) Gobernación,99,98,190,387
2826,2020-09-27,(02102) Calle 161,71,56,102,229
2827,2020-08-09,(07200) Tygua-San José,60,39,59,158
2828,2020-07-05,(06106) Recinto Ferial,72,55,71,198
2829,2020-04-27,(04105) Carrera 53,66,44,31,141
2830,2020-05-26,(50002) Corral Calle 40 Sur,19,5,13,37
2831,2020-04-09,(08002) Biblioteca,79,49,31,159
2832,2020-10-10,(50006) Corral Carrera 77,3,1,6,10
2833,2020-05-10,(14005) Las Aguas,0,11,49,60
2834,2019-12-31,(10005) Bicentenario,2,1,6,9
2835,2020-04-16,(50006) Corral Carrera 77,8,3,7,18
2836,2020-09-12,(50006) Corral Carrera 77,2,1,3,6
2837,2020-04-02,(03004) GRATAMIRA,16,9,12,37
2838,2020-02-18,(04000) Cabecera Calle 80 - alimentacion,24731,15182,15189,55102
2839,2020-09-29,(07005) ALQUERIA,622,366,471,1459
2840,2020-03-03,(09002) Consuelo,1409,768,825,3002
2841,2020-03-13,(09002) Consuelo,64,231,210,505
2842,2020-09-08,(02502) Terminal,440,340,382,1162
2843,2020-08-05,(09118) Marly,1353,855,661,2869
2844,2020-05-27,(07504) TERREROS,4682,2774,2305,9761
2845,2020-07-07,(07504) TERREROS,6425,3638,2978,13041
2846,2020-06-11,(09119) Calle 57,553,374,339,1266
2847,2020-03-11,(05000) Portal Américas - alimentacion,34667,20210,20349,75226
2848,2020-05-18,(05000) Portal Américas - alimentacion,8973,4617,4218,17808
2849,2020-01-30,(09100) Calle 40 Sur,7060,3907,3969,14936
2850,2020-06-23,(06104) Gobernación,271,166,138,575
2851,2020-02-08,(08001) Parque el Tunal,1015,543,815,2373
2852,2020-10-12,(05000) Portal Américas - alimentacion,4092,1739,3007,8838
2853,2020-08-28,(04002) Carrera 90,743,403,444,1590
2854,2020-08-29,(05000) Portal Américas - alimentacion,8764,4337,5335,18436
2855,2020-09-05,(04000) Cabecera Calle 80 - alimentacion,3475,1670,2795,7940
2856,2020-01-23,(02000) Cabecera Autopista Norte - alimentacion,21533,12043,12557,46133
2857,2020-03-17,(07010) Bosa,1502,873,926,3301
2858,2020-08-10,(04103) Las Ferias,296,155,159,610
2859,2020-02-08,(02000) Cabecera Autopista Norte - intermunicipal,2098,1213,1810,5121
2860,2020-02-26,(02201) Prado,6027,3684,2994,12705
2861,2020-01-19,(07002) MADELENA,904,350,857,2111
2862,2020-01-28,(07103) AV. CHILE,3682,2217,1773,7672
2863,2020-01-01,(06000) Portal Eldorado - alimentacion,1819,739,1831,4389
2864,2020-05-16,(06000) Portal Eldorado - alimentacion,2385,1087,1163,4635
2865,2020-01-11,(09115) Calle 34,1044,791,1268,3103
2866,2020-07-09,(09115) Calle 34,696,435,389,1520
2867,2020-09-21,(09113) Calle 22,270,172,273,715
2868,2020-01-09,(06102) Salitre El Greco,1075,620,553,2248
2869,2020-01-08,(07002) MADELENA,3382,1911,1919,7212
2870,2020-03-04,(02204) Pepe Sierra,4930,3222,2563,10715
2871,2020-02-29,(05100) Banderas P. Central,3497,1498,2598,7593
2872,2020-03-29,(08000) Portal Tunal - alimentacion,1331,631,609,2571
2873,2020-08-24,(04101) Minuto de Dios,303,162,208,673
2874,2020-02-06,(07505) LEON XIII,8087,4630,3782,16499
2875,2020-08-12,(07505) LEON XIII,2594,1364,1143,5101
2876,2020-10-01,(02204) Pepe Sierra,898,649,608,2155
2877,2020-01-20,(12003) Ricaurte,1187,716,574,2477
2878,2020-03-04,(04100) Carrera 77,6869,4122,3999,14990
2879,2020-04-22,(07102) NQS - CALLE 75,162,131,104,397
2880,2020-07-16,(07102) NQS - CALLE 75,423,265,202,890
2881,2020-07-17,(05100) Banderas P. Central - alimentacion,2705,1421,1491,5617
2882,2020-08-22,(05100) Banderas P. Central - alimentacion,2160,1009,1285,4454
2883,2020-05-12,(09103) Olaya,757,422,386,1565
2884,2020-04-28,(07111) NQS - RICAURTE,620,434,268,1322
2885,2020-10-08,(02000) Cabecera Autopista Norte,1671,990,1412,4073
2886,2020-09-21,(04102) Avenida Boyaca,296,168,237,701
2887,2020-02-24,(04105) Carrera 53,1555,858,797,3210
2888,2020-05-14,(50003) Corral Molinos,1179,560,762,2501
2889,2020-04-24,(05000) Portal Américas,1333,966,1083,3382
2890,2020-06-24,(05000) Portal Américas,2695,1925,2077,6697
2891,2020-09-09,(02000) Cabecera Autopista Norte - alimentacion,5001,2686,3206,10893
2892,2020-03-24,(04002) Carrera 90,610,317,329,1256
2893,2020-04-03,(06000) Portal Eldorado,763,533,375,1671
2894,2020-01-28,(40003) Mirador del Paraiso,4738,2696,2583,10017
2895,2020-08-24,(10005) Bicentenario - alimentacion,171,84,161,416
2896,2020-02-04,(06105) Quinta Paredes,1104,657,472,2233
2897,2020-02-01,(07106) EL CAMPIN,1243,791,960,2994
2898,2020-02-16,(07106) EL CAMPIN,476,288,463,1227
2899,2020-02-25,(02304) Heroes,4943,3330,2295,10568
2900,2020-09-15,(03000) Portal Suba,1459,925,1080,3464
2901,2020-02-10,(09108) Hospital,260,148,200,608
2902,2020-05-18,(10002) Av. Primero de Mayo,1729,944,1000,3673
2903,2020-01-24,(02502) Terminal,4660,2859,2911,10430
2904,2020-09-22,(02101) Toberín,1858,1143,1362,4363
2905,2020-05-08,(06108) Concejo de Bogotá,113,62,54,229
2906,2020-07-21,(10001) Country Sur,897,430,583,1910
2907,2020-01-29,(09120) Calle 63,5651,3651,3433,12735
2908,2020-03-09,(06002) Normandía,401,536,384,1321
2909,2020-10-08,(06102) Salitre El Greco,259,155,185,599
2910,2020-08-14,(05002) Tintal,2377,1358,1476,5211
2911,2020-03-28,(07112) COMUNEROS,273,192,156,621
2912,2020-09-12,(07005) ALQUERIA,499,255,334,1088
2913,2020-03-13,(03007) HUMEDAL CORDOBA,155,89,103,347
2914,2020-06-06,(02300) Calle 100,792,508,467,1767
2915,2020-02-07,(05107) Américas - Cr.53,2578,1497,1464,5539
2916,2020-08-19,(05005) Transversal 86,332,181,242,755
2917,2020-07-23,(09001) Molinos,1826,1015,1166,4007
2918,2020-06-20,(10008) San Diego,197,130,165,492
2919,2020-03-09,(07106) EL CAMPIN,901,201,248,1350
2920,2020-03-19,(03009) Av. Suba- Calle 116,1188,788,669,2645
2921,2020-07-19,(03000) Portal Suba - alimentacion,1538,808,992,3338
2922,2020-02-04,(04101) Minuto de Dios,2791,1709,1724,6224
2923,2020-06-25,(04101) Minuto de Dios,350,207,267,824
2924,2020-08-04,(04003) Avenida Ciudad de Cali,796,445,683,1924
2925,2020-08-27,(02201) Prado,825,595,536,1956
2926,2020-04-24,(03007) HUMEDAL CORDOBA,80,45,36,161
2927,2020-08-20,(03007) HUMEDAL CORDOBA,152,103,84,339
2928,2020-02-27,(08002) Biblioteca,1057,582,653,2292
2929,2020-09-26,(05101) Mandalay - Cr.73,125,55,91,271
2930,2020-05-16,(10000) Portal 20 de Julio,1470,723,739,2932
2931,2020-05-07,(09100) Calle 40 Sur,1148,683,688,2519
2932,2020-05-12,(10010) San Bernardo,545,301,349,1195
2933,2020-05-27,(03006) NIZA - CALLE 127,355,236,206,797
2934,2020-01-30,(04103) Las Ferias,1528,831,788,3147
2935,2020-02-15,(09117) Calle 45,2655,1770,2367,6792
2936,2020-06-13,(03003) 21 ANGELES,239,102,145,486
2937,2020-04-01,(03011) SUBA - CALLE 100,260,157,128,545
2938,2020-06-21,(05002) Tintal,678,334,451,1463
2939,2020-04-11,(03001) LA CAMPIÑA,284,154,145,583
2940,2020-08-23,(09002) Consuelo,133,56,124,313
2941,2020-08-09,(02000) Cabecera Autopista Norte,361,231,273,865
2942,2020-07-03,(06106) Recinto Ferial,279,162,147,588
2943,2020-02-09,(09122) Calle 72,1143,828,1528,3499
2944,2020-05-17,(03010) PUENTE LARGO,72,56,57,185
2945,2020-07-05,(07009) SENA,222,113,211,546
2946,2020-01-04,(03013) RIO NEGRO,397,245,360,1002
2947,2020-06-13,(03006) NIZA - CALLE 127,356,217,200,773
2948,2020-04-29,(09004) Santa Lucía,1456,768,734,2958
2949,2020-09-15,(05107) Américas - Cr.53,462,275,282,1019
2950,2020-05-13,(09118) Marly,1303,871,614,2788
2951,2020-07-04,(07103) AV. CHILE,657,424,486,1567
2952,2020-04-12,(08000) Portal Tunal - alimentacion,1338,695,647,2680
2953,2020-02-20,(07105) MOVISTAR ARENA,1359,813,692,2864
2954,2020-09-16,(10005) Bicentenario,121,66,90,277
2955,2020-06-26,(40002) Manitas,425,276,282,983
2956,2020-09-12,(02304) Heroes,570,451,519,1540
2957,2020-06-08,(02001) Centro Comercial Santa Fe,430,287,289,1006
2958,2020-04-08,(02300) Calle 100,704,545,425,1674
2959,2020-08-17,(07004) VENECIA,284,156,175,615
2960,2020-06-12,(10008) San Diego,261,143,151,555
2961,2020-07-22,(09120) Calle 63,863,613,596,2072
2962,2020-07-23,(09115) Calle 34,542,328,302,1172
2963,2020-09-29,(09115) Calle 34,749,483,560,1792
2964,2020-09-22,(03006) NIZA - CALLE 127,550,321,328,1199
2965,2020-10-11,(09122) Calle 72,404,268,581,1253
2966,2020-08-20,(07006) General Santander,489,312,277,1078
2967,2020-03-24,(07006) General Santander,449,249,297,995
2968,2020-02-21,(09111) Calle 19,2123,1354,1613,5090
2969,2020-03-08,(02001) Centro Comercial Santa Fe,595,339,900,1834
2970,2020-09-17,(09122) Calle 72,1301,830,919,3050
2971,2020-05-11,(09123) Calle 76,706,516,392,1614
2972,2020-03-07,(06001) Modelia,1064,674,962,2700
2973,2020-09-14,(09118) Marly,1482,926,936,3344
2974,2020-03-09,(02502) Terminal,421,1316,750,2487
2975,2020-09-28,(06104) Gobernación,310,209,179,698
2976,2020-03-29,(06101) El Tiempo,83,61,55,199
2977,2020-08-05,(09114) Calle 26,287,180,171,638
2978,2020-05-24,(03000) Portal Suba,260,144,193,597
2979,2020-03-13,(06001) Modelia,437,271,315,1023
2980,2020-04-12,(09123) Calle 76,157,120,119,396
2981,2020-03-30,(10007) Las Nieves,158,128,132,418
2982,2020-06-09,(10007) Las Nieves,560,323,336,1219
2983,2020-08-28,(10007) Las Nieves,678,427,361,1466
2984,2020-05-27,(07110) PALOQUEMAO,612,348,243,1203
2985,2020-07-12,(40001) Juan Pablo II,243,108,179,530
2986,2020-06-11,(09110) Avenida Jimenez,1007,771,815,2593
2987,2020-02-09,(03002) SUBA - TV- 91,844,418,851,2113
2988,2020-08-29,(08002) Biblioteca,240,127,159,526
2989,2020-05-13,(12000) Puente Aranda,72,40,22,134
2990,2020-08-02,(12000) Puente Aranda,9,12,9,30
2991,2020-06-13,(06001) Modelia,303,191,174,668
2992,2020-06-25,(02102) Calle 161,264,172,163,599
2993,2020-08-08,(03013) RIO NEGRO,147,94,119,360
2994,2020-07-30,(09114) Calle 26,319,199,222,740
2995,2020-09-18,(07101) CASTELLANA,266,150,161,577
2996,2020-10-08,(07008) NQS - Calle 30 Sur,427,218,322,967
2997,2020-08-29,(02000) Cabecera Autopista Norte - intermunicipal,396,217,306,919
2998,2020-04-29,(07009) SENA,356,216,232,804
2999,2020-07-20,(09000) Cabecera Usme,403,249,297,949
3000,2020-06-26,(03010) PUENTE LARGO,383,236,206,825
3001,2020-03-24,(05101) Mandalay - Cr.73,114,61,62,237
3002,2020-07-28,(07008) NQS - Calle 30 Sur,232,131,159,522
3003,2020-03-22,(09110) Avenida Jimenez,109,82,94,285
3004,2020-07-07,(03010) PUENTE LARGO,371,232,239,842
3005,2020-08-18,(09108) Hospital,66,37,55,158
3006,2020-01-05,(04103) Las Ferias,243,112,210,565
3007,2020-05-14,(03009) Av. Suba- Calle 116,391,266,162,819
3008,2020-04-07,(06101) El Tiempo,216,161,104,481
3009,2020-06-18,(07108) Av. El Dorado,151,96,100,347
3010,2020-04-22,(07009) SENA,313,183,183,679
3011,2020-07-19,(04000) Cabecera Calle 80,246,156,220,622
3012,2020-03-08,(06101) El Tiempo,311,253,447,1011
3013,2020-07-09,(07006) General Santander - alimentacion,391,230,265,886
3014,2020-05-02,(02001) Centro Comercial Santa Fe,166,105,109,380
3015,2020-03-20,(06107) Ciudad Universitaria,96,62,57,215
3016,2020-01-05,(05005) Transversal 86,348,113,261,722
3017,2020-08-09,(07111) NQS - RICAURTE,179,134,145,458
3018,2020-04-08,(07010) Bosa,272,167,218,657
3019,2020-04-22,(06001) Modelia,264,194,127,585
3020,2020-08-31,(02304) Heroes,824,559,521,1904
3021,2020-09-12,(03010) PUENTE LARGO,250,146,207,603
3022,2020-08-09,(10007) Las Nieves,92,68,111,271
3023,2020-03-12,(07200) Tygua-San José,142,144,122,408
3024,2020-05-16,(06111) Universidades,0,89,257,346
3025,2020-04-30,(09105) Río Fucha,79,58,43,180
3026,2020-09-06,(09002) Consuelo,168,67,198,433
3027,2020-03-09,(40001) Juan Pablo II,44,427,298,769
3028,2020-08-03,(09106) Nariño,353,193,243,789
3029,2020-01-01,(07106) EL CAMPIN,126,97,213,436
3030,2020-04-02,(06111) Universidades,0,69,242,311
3031,2020-07-30,(07007) NQS - Calle 38A Sur,292,201,238,731
3032,2020-04-02,(05100) Banderas P. Central,319,192,235,746
3033,2020-06-19,(10003) Ciudad Jardín,234,113,166,513
3034,2020-03-20,(07201) Guatoque -Veraguas,50,29,43,122
3035,2020-08-08,(10003) Ciudad Jardín,171,68,116,355
3036,2020-03-23,(08001) Parque el Tunal,78,53,46,177
3037,2020-03-06,(50006) Corral Carrera 77,33,21,47,101
3038,2020-04-10,(02000) Cabecera Autopista Norte - intermunicipal,28,30,30,88
3039,2020-05-21,(04102) Avenida Boyaca,250,145,153,548
3040,2020-03-26,(02303) Calle 85,353,255,220,828
3041,2020-05-24,(07006) General Santander,107,68,66,241
3042,2020-09-27,(06106) Recinto Ferial,79,68,93,240
3043,2020-08-08,(05102) Av. Américas - Av. Boyacá,154,75,107,336
3044,2020-05-11,(07002) MADELENA,531,315,295,1141
3045,2020-03-20,(04107) Escuela Militar,38,35,38,111
3046,2020-04-29,(08002) Biblioteca,178,121,104,403
3047,2020-04-30,(10003) Ciudad Jardín,118,52,84,254
3048,2020-03-22,(07003) SEVILLANA,67,37,35,139
3049,2019-12-31,(07103) AV. CHILE,33,18,36,87
3050,2020-03-08,(07201) Guatoque -Veraguas,73,75,274,422
3051,2020-06-07,(07201) Guatoque -Veraguas,26,22,41,89
3052,2020-04-09,(10005) Bicentenario - alimentacion,58,24,41,123
3053,2020-04-15,(10003) Ciudad Jardín,118,61,83,262
3054,2020-06-07,(07102) NQS - CALLE 75,61,53,65,179
3055,2020-08-17,(07200) Tygua-San José,86,41,61,188
3056,2020-09-20,(05102) Av. Américas - Av. Boyacá,82,45,80,207
3057,2020-03-20,(05101) Mandalay - Cr.73,65,44,40,149
3058,2020-03-13,(50006) Corral Carrera 77,3,8,9,20
3059,2020-04-06,(50002) Corral Calle 40 Sur,10,7,9,26
3060,2019-12-31,(04107) Escuela Militar,2,2,15,19
3061,2020-04-06,(50006) Corral Carrera 77,6,2,7,15
3062,2020-04-15,(50006) Corral Carrera 77,3,2,3,8
3063,2020-04-19,(50006) Corral Carrera 77,4,0,0,4
3064,2020-10-11,(50006) Corral Carrera 77,2,0,3,5
3065,2020-02-15,(04000) Cabecera Calle 80 - alimentacion,13378,6168,10949,30495
3066,2020-07-16,(04000) Cabecera Calle 80 - alimentacion,3658,2007,2195,7860
3067,2020-02-26,(07005) ALQUERIA,2676,1460,1410,5546
3068,2020-07-11,(02502) Terminal,275,189,332,796
3069,2020-08-18,(02502) Terminal,380,286,280,946
3070,2020-07-15,(09118) Marly,1322,861,616,2799
3071,2020-04-23,(07504) TERREROS,2528,1641,1279,5448
3072,2020-06-27,(07504) TERREROS,5042,2584,2648,10274
3073,2020-09-08,(07504) TERREROS,6341,3422,3312,13075
3074,2020-08-29,(10000) Portal 20 de Julio - alimentacion,3534,1512,2486,7532
3075,2020-06-23,(09119) Calle 57,633,391,405,1429
3076,2020-02-25,(04106) Carrera 47,1522,881,883,3286
3077,2020-03-04,(04106) Carrera 47,1511,823,874,3208
3078,2020-01-28,(03000) Portal Suba - alimentacion,27055,15700,15498,58253
3079,2020-06-03,(05000) Portal Américas - alimentacion,9850,5107,4480,19437
3080,2020-03-03,(07505) LEON XIII,8547,4728,3881,17156
3081,2020-03-02,(06000) Portal Eldorado - alimentacion,17917,9959,9619,37495
3082,2020-09-19,(08001) Parque el Tunal,445,198,343,986
3083,2020-01-09,(02000) Cabecera Autopista Norte - alimentacion,16244,8678,9903,34825
3084,2020-09-09,(04002) Carrera 90,761,439,483,1683
3085,2020-08-12,(09001) Molinos,2374,1310,1668,5352
3086,2020-03-21,(05000) Portal Américas - alimentacion,4022,1815,1662,7499
3087,2020-04-27,(05000) Portal Américas - alimentacion,5224,525,608,6357
3088,2020-07-25,(06107) Ciudad Universitaria,94,70,57,221
3089,2020-02-07,(05005) Transversal 86,2854,1470,1368,5692
3090,2020-06-11,(05000) Portal Américas - alimentacion,10236,5216,4794,20246
3091,2020-03-16,(09100) Calle 40 Sur,5388,2895,2928,11211
3092,2020-03-14,(09000) Cabecera Usme,3536,1783,3039,8358
3093,2020-04-12,(06000) Portal Eldorado - alimentacion,752,369,331,1452
3094,2020-02-11,(07002) MADELENA,5330,3050,2673,11053
3095,2020-01-08,(10003) Ciudad Jardín,735,382,525,1642
3096,2020-01-29,(02204) Pepe Sierra,4895,3223,2397,10515
3097,2020-01-29,(02205) Calle 106,2699,1735,1277,5711
3098,2020-04-27,(07001) PERDOMO,348,39,59,446
3099,2020-02-08,(40003) Mirador del Paraiso,4094,2041,2503,8638
3100,2020-08-20,(03000) Portal Suba - alimentacion,5684,3220,3226,12130
3101,2020-02-23,(02204) Pepe Sierra,578,488,657,1723
3102,2020-06-14,(02204) Pepe Sierra,188,153,133,474
3103,2020-02-01,(06002) Normandía,956,560,938,2454
3104,2020-08-31,(10000) Portal 20 de Julio - alimentacion,4096,1817,2530,8443
3105,2020-04-18,(03013) RIO NEGRO,88,68,59,215
3106,2020-03-19,(02302) Virrey,1613,1116,860,3589
3107,2020-01-20,(07110) PALOQUEMAO,2268,1376,1089,4733
3108,2020-03-07,(07110) PALOQUEMAO,1280,969,986,3235
3109,2020-09-11,(50003) Corral Molinos,1527,731,1128,3386
3110,2020-08-18,(09103) Olaya,928,515,529,1972
3111,2020-07-28,(14001) La Sabana,149,92,86,327
3112,2020-02-04,(07002) MADELENA,5148,2976,2578,10702
3113,2020-06-06,(04102) Avenida Boyaca,191,116,135,442
3114,2020-01-28,(07109) CAD,2888,1784,1579,6251
3115,2020-01-30,(07007) NQS - Calle 38A Sur,2118,1233,1230,4581
3116,2020-08-25,(08000) Portal Tunal - alimentacion,5745,3179,3382,12306
3117,2020-03-16,(04000) Cabecera Calle 80,4975,2913,3051,10939
3118,2020-02-23,(02000) Cabecera Autopista Norte - alimentacion,6246,2676,4684,13606
3119,2020-01-14,(04001) Quirigua,1616,929,1115,3660
3120,2020-01-27,(12001) Carrera 43,1601,994,1024,3619
3121,2020-05-20,(12001) Carrera 43,369,206,178,753
3122,2020-03-18,(10002) Av. Primero de Mayo,5044,2400,2722,10166
3123,2020-01-14,(10006) San Victorino,1715,936,1093,3744
3124,2020-06-07,(06105) Quinta Paredes,27,17,27,71
3125,2020-03-18,(02304) Heroes,2209,1715,1260,5184
3126,2020-01-22,(08002) Biblioteca,924,509,631,2064
3127,2020-06-01,(02303) Calle 85,642,448,318,1408
3128,2020-06-28,(02201) Prado,280,180,188,648
3129,2020-05-13,(10002) Av. Primero de Mayo,1662,823,945,3430
3130,2020-01-15,(09004) Santa Lucía,6600,3494,3924,14018
3131,2020-09-28,(10007) Las Nieves,738,473,488,1699
3132,2020-01-13,(07108) Av. El Dorado,703,467,525,1695
3133,2020-02-06,(09109) Tercer Milenio,1412,914,930,3256
3134,2020-03-05,(09116) Avenida 39,3203,2064,1760,7027
3135,2020-10-09,(02201) Prado,1044,684,847,2575
3136,2020-01-30,(10009) Museo Nacional,4233,2277,1922,8432
3137,2020-03-04,(09107) Hortúa,2440,1521,1542,5503
3138,2020-09-16,(09123) Calle 76,1139,755,714,2608
3139,2020-02-09,(07112) COMUNEROS,903,458,873,2234
3140,2020-02-18,(10009) Museo Nacional,4755,2567,1856,9178
3141,2020-01-20,(04002) Carrera 90,3259,2002,1913,7174
3142,2020-06-10,(02300) Calle 100,1242,822,548,2612
3143,2020-01-17,(08000) Portal Tunal,1897,1046,993,3936
3144,2020-04-12,(05005) Transversal 86,72,32,24,128
3145,2020-09-21,(05005) Transversal 86,369,154,214,737
3146,2020-09-08,(02205) Calle 106,414,282,229,925
3147,2020-09-26,(02205) Calle 106,219,172,291,682
3148,2020-04-02,(10002) Av. Primero de Mayo,1124,583,703,2410
3149,2020-01-08,(03006) NIZA - CALLE 127,1517,964,1101,3582
3150,2020-02-10,(03006) NIZA - CALLE 127,2489,1587,1444,5520
3151,2020-02-10,(04003) Avenida Ciudad de Cali,5760,3538,3553,12851
3152,2020-07-06,(04003) Avenida Ciudad de Cali,1120,648,773,2541
3153,2020-03-07,(07101) CASTELLANA,381,274,458,1113
3154,2020-06-13,(09118) Marly,1093,716,680,2489
3155,2020-09-18,(07106) EL CAMPIN,486,300,334,1120
3156,2020-10-04,(07106) EL CAMPIN,128,85,155,368
3157,2020-02-23,(06111) Universidades,475,323,733,1531
3158,2020-06-14,(03007) HUMEDAL CORDOBA,40,28,30,98
3159,2020-01-25,(03001) LA CAMPIÑA,3109,1327,2305,6741
3160,2020-05-05,(02000) Cabecera Autopista Norte - alimentacion,3248,1798,1735,6781
3161,2020-01-30,(03010) PUENTE LARGO,2175,1404,1220,4799
3162,2020-08-11,(09115) Calle 34,595,370,366,1331
3163,2020-03-12,(09100) Calle 40 Sur,413,1673,1123,3209
3164,2020-05-15,(07104) Simon Bolivar,444,303,246,993
3165,2020-09-19,(04003) Avenida Ciudad de Cali,877,438,814,2129
3166,2020-01-11,(10009) Museo Nacional,846,721,1059,2626
3167,2020-04-11,(07109) CAD,222,162,114,498
3168,2020-01-21,(06101) El Tiempo,1740,1037,792,3569
3169,2020-09-16,(06101) El Tiempo,396,241,222,859
3170,2020-09-28,(03002) SUBA - TV- 91,925,548,662,2135
3171,2020-07-05,(09101) Quiroga,209,93,185,487
3172,2020-02-21,(04001) Quirigua,2093,1127,1198,4418
3173,2020-04-22,(03011) SUBA - CALLE 100,292,161,151,604
3174,2020-05-09,(05002) Tintal,968,577,568,2113
3175,2020-04-09,(02205) Calle 106,65,53,44,162
3176,2020-06-21,(07112) COMUNEROS,234,140,157,531
3177,2020-03-30,(05001) Patio Bonito,829,446,514,1789
3178,2020-05-13,(02105) Calle 142,615,417,346,1378
3179,2020-07-11,(06000) Portal Eldorado,646,505,488,1639
3180,2020-07-27,(02302) Virrey,628,395,306,1329
3181,2020-09-04,(12003) Ricaurte,431,290,229,950
3182,2020-02-20,(03013) RIO NEGRO,1203,791,873,2867
3183,2020-04-10,(02302) Virrey,151,124,77,352
3184,2020-03-30,(03009) Av. Suba- Calle 116,371,272,173,816
3185,2020-03-04,(07200) Tygua-San José,840,512,604,1956
3186,2020-03-21,(07106) EL CAMPIN,102,89,54,245
3187,2020-08-27,(09116) Avenida 39,318,179,226,723
3188,2020-04-03,(07005) ALQUERIA,234,148,146,528
3189,2020-10-03,(06108) Concejo de Bogotá,73,64,121,258
3190,2020-09-16,(05107) Américas - Cr.53,519,297,325,1141
3191,2020-07-07,(07103) AV. CHILE,999,589,501,2089
3192,2020-07-06,(12007) Zona Industrial,377,206,218,801
3193,2020-01-31,(06109) Centro Memoria,1039,624,669,2332
3194,2020-02-02,(40002) Manitas,330,158,314,802
3195,2020-01-24,(07006) General Santander - alimentacion,1438,825,936,3199
3196,2020-04-18,(05100) Banderas P. Central - alimentacion,996,507,436,1939
3197,2020-02-18,(07006) General Santander,3031,1734,1585,6350
3198,2020-01-13,(07102) NQS - CALLE 75,1294,824,870,2988
3199,2020-07-27,(07004) VENECIA,879,561,518,1958
3200,2020-08-22,(02200) Alcalá,1277,862,767,2906
3201,2020-05-22,(10008) San Diego,234,147,164,545
3202,2020-08-01,(10008) San Diego,193,113,155,461
3203,2020-04-11,(05107) Américas - Cr.53,165,118,80,363
3204,2020-04-01,(05001) Patio Bonito,775,445,604,1824
3205,2020-10-07,(03002) SUBA - TV- 91,962,545,708,2215
3206,2020-01-11,(06105) Quinta Paredes,313,172,272,757
3207,2020-09-18,(06111) Universidades,465,256,480,1201
3208,2020-05-20,(40001) Juan Pablo II,466,265,264,995
3209,2020-06-15,(05100) Banderas P. Central - alimentacion,765,365,516,1646
3210,2020-07-01,(07110) PALOQUEMAO,661,408,289,1358
3211,2020-09-05,(05005) Transversal 86,364,153,272,789
3212,2020-10-02,(09122) Calle 72,1348,925,1179,3452
3213,2020-07-06,(07004) VENECIA,1045,645,639,2329
3214,2020-03-30,(04100) Carrera 77,544,317,361,1222
3215,2020-08-03,(09114) Calle 26,293,182,161,636
3216,2020-06-19,(07201) Guatoque -Veraguas,196,112,179,487
3217,2020-07-30,(07201) Guatoque -Veraguas,164,83,109,356
3218,2020-09-03,(07003) SEVILLANA,473,255,274,1002
3219,2020-06-07,(10001) Country Sur,264,122,218,604
3220,2020-06-11,(04103) Las Ferias,333,195,150,678
3221,2020-10-02,(04101) Minuto de Dios,422,248,419,1089
3222,2020-07-26,(05000) Portal Américas,497,301,414,1212
3223,2020-06-20,(04104) Avenida 68,496,244,279,1019
3224,2020-08-31,(05102) Av. Américas - Av. Boyacá,207,140,161,508
3225,2020-09-30,(03002) SUBA - TV- 91,916,543,660,2119
3226,2020-05-15,(09110) Avenida Jimenez,795,578,562,1935
3227,2020-10-11,(09120) Calle 63,408,271,547,1226
3228,2020-01-31,(03005) SUBA - AV. BOYACA,2729,1526,1601,5856
3229,2020-05-20,(40002) Manitas,320,190,223,733
3230,2020-07-04,(07001) PERDOMO,773,382,516,1671
3231,2020-10-06,(09122) Calle 72,1336,921,1064,3321
3232,2020-08-24,(07109) CAD,596,347,255,1198
3233,2020-10-08,(07506) DESPENSA,450,276,367,1093
3234,2020-06-26,(02502) Terminal,440,326,357,1123
3235,2020-06-04,(04106) Carrera 47,296,151,141,588
3236,2020-03-20,(07102) NQS - CALLE 75,125,100,85,310
3237,2020-08-04,(04002) Carrera 90,595,343,315,1253
3238,2020-04-27,(12002) CDS - Carrera 32,26,97,29,152
3239,2020-05-29,(03003) 21 ANGELES,295,140,141,576
3240,2020-08-18,(07108) Av. El Dorado,127,82,78,287
3241,2020-08-06,(09117) Calle 45,639,398,416,1453
3242,2020-01-06,(04000) Cabecera Calle 80 - intermunicipal,213,137,279,629
3243,2020-09-02,(03010) PUENTE LARGO,389,231,202,822
3244,2020-07-25,(14004) Museo del Oro,88,63,109,260
3245,2020-05-18,(06001) Modelia,352,214,173,739
3246,2020-06-19,(07006) General Santander - alimentacion,387,218,259,864
3247,2020-07-11,(06103) CAN,227,156,181,564
3248,2020-05-02,(03009) Av. Suba- Calle 116,245,166,126,537
3249,2020-03-23,(06000) Portal Eldorado,368,297,214,879
3250,2020-01-19,(05102) Av. Américas - Av. Boyacá,250,113,270,633
3251,2020-06-13,(06000) Portal Eldorado,642,455,430,1527
3252,2020-05-13,(05101) Mandalay - Cr.73,82,40,44,166
3253,2020-08-26,(06104) Gobernación,244,134,128,506
3254,2020-07-22,(07506) DESPENSA,412,246,215,873
3255,2020-04-16,(05102) Av. Américas - Av. Boyacá,116,71,57,244
3256,2020-08-06,(10004) Policarpa,237,92,183,512
3257,2020-07-06,(06105) Quinta Paredes,140,83,68,291
3258,2020-05-25,(03006) NIZA - CALLE 127,154,82,79,315
3259,2020-04-18,(12007) Zona Industrial,154,110,74,338
3260,2020-03-29,(05107) Américas - Cr.53,69,60,50,179
3261,2020-09-06,(09117) Calle 45,241,154,222,617
3262,2020-05-17,(04104) Avenida 68,161,95,117,373
3263,2020-03-15,(06101) El Tiempo,273,191,307,771
3264,2020-04-04,(06101) El Tiempo,135,96,90,321
3265,2020-08-22,(04103) Las Ferias,270,139,160,569
3266,2020-09-23,(07007) NQS - Calle 38A Sur,490,326,381,1197
3267,2020-05-24,(09109) Tercer Milenio,82,50,59,191
3268,2020-05-25,(03002) SUBA - TV- 91,185,116,133,434
3269,2020-03-30,(10009) Museo Nacional,346,215,205,766
3270,2020-05-21,(06106) Recinto Ferial,214,131,80,425
3271,2020-05-06,(09105) Río Fucha,68,52,59,179
3272,2020-04-29,(06101) El Tiempo,222,153,117,492
3273,2020-07-03,(09003) Socorro,648,318,378,1344
3274,2020-03-30,(09106) Nariño,165,96,123,384
3275,2020-06-29,(05102) Av. Américas - Av. Boyacá,89,38,43,170
3276,2020-05-30,(04105) Carrera 53,184,108,110,402
3277,2020-04-17,(14005) Las Aguas,0,39,102,141
3278,2020-05-09,(04000) Cabecera Calle 80 - intermunicipal,102,55,83,240
3279,2020-04-25,(10008) San Diego,130,87,90,307
3280,2020-04-29,(07113) SANTA ISABEL,238,171,172,581
3281,2020-05-01,(09114) Calle 26,65,52,63,180
3282,2020-03-28,(07201) Guatoque -Veraguas,26,28,34,88
3283,2020-10-04,(05103) Marsella,168,77,195,440
3284,2020-09-27,(40002) Manitas,136,64,121,321
3285,2020-04-01,(07002) MADELENA,378,178,225,781
3286,2020-05-03,(03011) SUBA - CALLE 100,117,67,71,255
3287,2020-03-22,(12002) CDS - Carrera 32,35,26,12,73
3288,2020-05-03,(09110) Avenida Jimenez,152,123,177,452
3289,2020-04-14,(06105) Quinta Paredes,54,51,48,153
3290,2020-05-10,(07200) Tygua-San José,50,25,36,111
3291,2020-01-19,(50002) Corral Calle 40 Sur,21,11,29,61
3292,2020-05-19,(50002) Corral Calle 40 Sur,20,7,18,45
3293,2020-06-09,(50002) Corral Calle 40 Sur,20,9,18,47
3294,2020-09-20,(14001) La Sabana,51,32,70,153
3295,2020-04-08,(10003) Ciudad Jardín,78,56,73,207
3296,2020-06-28,(10008) San Diego,80,49,68,197
3297,2020-07-19,(12002) CDS - Carrera 32,33,24,20,77
3298,2020-03-23,(09108) Hospital,13,11,11,35
3299,2020-04-26,(07010) Bosa,121,71,77,269
3300,2020-05-03,(09108) Hospital,30,14,24,68
3301,2020-04-05,(07003) SEVILLANA,64,37,37,138
3302,2020-04-05,(06106) Recinto Ferial,37,30,19,86
3303,2020-04-05,(10008) San Diego,48,29,32,109
3304,2020-06-17,(50006) Corral Carrera 77,5,4,9,18
3305,2020-06-03,(50006) Corral Carrera 77,6,3,6,15
3306,2020-05-12,(04000) Cabecera Calle 80 - alimentacion,2901,1746,1747,6394
3307,2020-05-19,(04000) Cabecera Calle 80 - alimentacion,3250,1875,1851,6976
3308,2020-02-28,(09002) Consuelo,1458,765,834,3057
3309,2020-07-10,(09002) Consuelo,496,254,314,1064
3310,2020-09-02,(09002) Consuelo,521,297,329,1147
3311,2020-08-22,(09118) Marly,979,632,590,2201
3312,2020-01-05,(04106) Carrera 47,301,133,259,693
3313,2020-02-11,(09122) Calle 72,8973,5653,4359,18985
3314,2020-02-05,(06000) Portal Eldorado - alimentacion,18872,10263,9806,38941
3315,2020-02-11,(14005) Las Aguas,3725,2195,1943,7863
3316,2020-01-29,(07003) SEVILLANA,2078,1138,1074,4290
3317,2020-02-14,(08001) Parque el Tunal,1773,935,994,3702
3318,2020-02-26,(09000) Cabecera Usme - alimentacion,26367,13787,15531,55685
3319,2020-02-25,(04101) Minuto de Dios,3694,2240,1762,7696
3320,2020-01-21,(09001) Molinos,5941,2950,3964,12855
3321,2020-09-30,(09001) Molinos,2981,1541,2313,6835
3322,2020-09-29,(10000) Portal 20 de Julio - alimentacion,4606,1997,2981,9584
3323,2020-07-02,(09100) Calle 40 Sur,1933,1107,1243,4283
3324,2020-09-17,(09100) Calle 40 Sur,1827,1076,1395,4298
3325,2020-01-08,(09000) Cabecera Usme,4297,2493,3290,10080
3326,2020-01-04,(06000) Portal Eldorado - alimentacion,6147,2815,3971,12933
3327,2020-01-14,(09115) Calle 34,3549,2326,2153,8028
3328,2020-02-13,(05100) Banderas P. Central - alimentacion,16618,9415,8559,34592
3329,2020-03-10,(04000) Cabecera Calle 80 - alimentacion,819,6776,4911,12506
3330,2020-02-14,(09120) Calle 63,7190,4668,3856,15714
3331,2020-10-08,(09000) Cabecera Usme - alimentacion,9829,4822,6681,21332
3332,2020-02-29,(10006) San Victorino,1091,844,1052,2987
3333,2020-01-20,(09110) Avenida Jimenez,4172,3011,2767,9950
3334,2020-03-05,(09117) Calle 45,6468,4236,3185,13889
3335,2020-03-31,(02000) Cabecera Autopista Norte - alimentacion,2566,1309,1198,5073
3336,2020-04-26,(02000) Cabecera Autopista Norte - alimentacion,1228,666,527,2421
3337,2020-01-11,(09101) Quiroga,867,449,800,2116
3338,2020-07-02,(03013) RIO NEGRO,296,212,184,692
3339,2020-07-16,(03013) RIO NEGRO,243,147,161,551
3340,2020-01-07,(06001) Modelia,1431,948,1056,3435
3341,2020-01-09,(06001) Modelia,1516,967,1017,3500
3342,2020-01-08,(02103) Mazurén,2046,1303,1309,4658
3343,2020-02-20,(02303) Calle 85,3745,2572,1903,8220
3344,2020-03-03,(09119) Calle 57,3780,2377,2160,8317
3345,2020-10-01,(05100) Banderas P. Central - alimentacion,3666,1927,2583,8176
3346,2020-03-10,(07002) MADELENA,203,1478,963,2644
3347,2020-01-20,(02104) Calle 146,8541,5362,4631,18534
3348,2020-03-02,(03003) 21 ANGELES,1714,891,847,3452
3349,2020-01-08,(02001) Centro Comercial Santa Fe,3110,1927,2037,7074
3350,2020-03-07,(10002) Av. Primero de Mayo,4885,2308,4046,11239
3351,2020-01-14,(02104) Calle 146,7360,4549,4338,16247
3352,2020-02-24,(02104) Calle 146,9471,6096,4672,20239
3353,2020-07-16,(05000) Portal Américas,2508,1594,1660,5762
3354,2020-01-12,(07010) Bosa,412,218,554,1184
3355,2020-03-19,(09114) Calle 26,1270,852,837,2959
3356,2020-07-01,(04002) Carrera 90,810,446,417,1673
3357,2020-03-15,(10006) San Victorino,265,240,352,857
3358,2020-01-29,(03000) Portal Suba,9018,5290,5082,19390
3359,2020-03-12,(40003) Mirador del Paraiso,163,1110,735,2008
3360,2020-03-19,(04001) Quirigua,904,540,615,2059
3361,2020-03-23,(07505) LEON XIII,637,306,269,1212
3362,2020-03-30,(10002) Av. Primero de Mayo,1095,616,695,2406
3363,2020-01-29,(10005) Bicentenario - alimentacion,671,299,507,1477
3364,2020-07-12,(05001) Patio Bonito,640,331,487,1458
3365,2020-01-26,(07106) EL CAMPIN,449,285,435,1169
3366,2020-10-05,(03000) Portal Suba,1714,1047,1407,4168
3367,2020-04-07,(10010) San Bernardo,347,249,282,878
3368,2020-02-27,(06100) Av. Rojas,2767,1532,1354,5653
3369,2020-02-06,(09115) Calle 34,4522,3068,2556,10146
3370,2020-03-11,(09108) Hospital,225,149,220,594
3371,2020-08-23,(07000) Portal Sur - alimentacion,2302,1047,1333,4682
3372,2020-08-06,(08001) Parque el Tunal,451,245,299,995
3373,2020-01-18,(03000) Portal Suba,3811,1791,3141,8743
3374,2020-02-03,(06108) Concejo de Bogotá,893,442,455,1790
3375,2020-04-08,(06108) Concejo de Bogotá,82,80,73,235
3376,2020-09-29,(06108) Concejo de Bogotá,164,81,117,362
3377,2020-06-27,(06102) Salitre El Greco,189,133,120,442
3378,2020-04-10,(09000) Cabecera Usme - alimentacion,1706,897,728,3331
3379,2020-01-02,(10009) Museo Nacional,1967,1047,1094,4108
3380,2020-05-12,(05002) Tintal,1465,853,841,3159
3381,2020-09-21,(05002) Tintal,2472,1024,1218,4714
3382,2020-02-25,(03011) SUBA - CALLE 100,2750,1459,1502,5711
3383,2020-01-01,(10000) Portal 20 de Julio,795,314,863,1972
3384,2020-07-10,(50002) Corral Calle 40 Sur,22,11,32,65
3385,2020-03-04,(08000) Portal Tunal,2256,1222,1130,4608
3386,2020-05-18,(09001) Molinos,1979,1138,1274,4391
3387,2020-07-28,(04003) Avenida Ciudad de Cali,922,517,677,2116
3388,2020-07-17,(09101) Quiroga,393,207,302,902
3389,2020-01-11,(04108) El Polo,772,509,715,1996
3390,2020-06-17,(05001) Patio Bonito,1892,1098,1150,4140
3391,2020-07-04,(07010) Bosa,650,282,416,1348
3392,2020-06-30,(07113) SANTA ISABEL,428,277,307,1012
3393,2020-03-13,(14004) Museo del Oro,1439,84,326,1849
3394,2020-10-03,(04100) Carrera 77,1147,534,1011,2692
3395,2020-01-18,(04102) Avenida Boyaca,1328,715,982,3025
3396,2020-03-07,(04102) Avenida Boyaca,1480,786,1156,3422
3397,2020-10-07,(03006) NIZA - CALLE 127,556,343,375,1274
3398,2020-05-05,(02101) Toberín,871,566,611,2048
3399,2020-05-23,(02101) Toberín,726,437,508,1671
3400,2020-08-16,(02101) Toberín,243,155,274,672
3401,2020-04-13,(09116) Avenida 39,195,143,139,477
3402,2020-06-02,(02000) Cabecera Autopista Norte - alimentacion,4320,2448,2365,9133
3403,2020-03-21,(02202) Calle 127,541,356,266,1163
3404,2020-03-17,(05107) Américas - Cr.53,1521,885,821,3227
3405,2020-03-30,(02304) Heroes,389,337,247,973
3406,2020-01-22,(07104) Simon Bolivar,2194,1381,1242,4817
3407,2020-05-06,(07104) Simon Bolivar,289,191,170,650
3408,2020-09-17,(10005) Bicentenario - alimentacion,199,115,200,514
3409,2020-02-05,(04107) Escuela Militar,689,418,457,1564
3410,2020-02-25,(04107) Escuela Militar,701,447,389,1537
3411,2020-06-12,(04107) Escuela Militar,139,80,70,289
3412,2020-09-29,(02103) Mazurén,269,186,228,683
3413,2020-08-04,(09000) Cabecera Usme,1541,915,1133,3589
3414,2020-07-13,(10000) Portal 20 de Julio - alimentacion,2488,1245,1545,5278
3415,2020-05-20,(05103) Marsella,298,143,155,596
3416,2020-09-24,(09109) Tercer Milenio,402,215,257,874
3417,2020-02-09,(07004) VENECIA,1054,517,943,2514
3418,2020-01-09,(14005) Las Aguas,1190,821,1076,3087
3419,2020-10-06,(06101) El Tiempo,401,264,275,940
3420,2020-09-20,(04104) Avenida 68,218,128,246,592
3421,2020-06-16,(02202) Calle 127,1161,814,622,2597
3422,2020-03-11,(06104) Gobernación,1327,814,612,2753
3423,2020-01-04,(02304) Heroes,1053,897,918,2868
3424,2020-02-27,(07101) CASTELLANA,940,608,597,2145
3425,2020-04-15,(03001) LA CAMPIÑA,410,301,253,964
3426,2020-09-11,(02105) Calle 142,834,490,536,1860
3427,2020-06-03,(06000) Portal Eldorado,983,623,466,2072
3428,2020-07-14,(02302) Virrey,487,337,230,1054
3429,2020-08-04,(02302) Virrey,605,399,308,1312
3430,2020-07-06,(07009) SENA,684,419,447,1550
3431,2020-03-17,(12007) Zona Industrial,975,586,445,2006
3432,2020-08-01,(02105) Calle 142,467,280,304,1051
3433,2020-04-20,(10008) San Diego,141,91,92,324
3434,2020-09-04,(03006) NIZA - CALLE 127,535,308,275,1118
3435,2020-03-08,(02502) Terminal,332,291,852,1475
3436,2020-08-22,(07007) NQS - Calle 38A Sur,281,178,221,680
3437,2020-07-27,(10002) Av. Primero de Mayo,2061,1014,1215,4290
3438,2020-03-01,(04003) Avenida Ciudad de Cali,970,490,1120,2580
3439,2020-05-11,(05100) Banderas P. Central - alimentacion,1968,976,950,3894
3440,2020-01-21,(06109) Centro Memoria,782,449,420,1651
3441,2020-07-23,(03001) LA CAMPIÑA,950,537,522,2009
3442,2020-05-15,(02001) Centro Comercial Santa Fe,328,203,230,761
3443,2020-08-08,(02001) Centro Comercial Santa Fe,264,161,236,661
3444,2020-04-29,(05100) Banderas P. Central - alimentacion,1858,907,864,3629
3445,2020-02-08,(02102) Calle 161,775,403,816,1994
3446,2020-05-05,(04100) Carrera 77,770,469,506,1745
3447,2020-03-19,(07104) Simon Bolivar,1224,811,609,2644
3448,2020-03-04,(40001) Juan Pablo II,1654,942,993,3589
3449,2020-09-11,(10008) San Diego,260,178,208,646
3450,2020-06-30,(08002) Biblioteca,321,191,187,699
3451,2020-08-03,(08002) Biblioteca,290,161,167,618
3452,2020-04-30,(02200) Alcalá,1045,750,538,2333
3453,2020-08-31,(10009) Museo Nacional,504,308,341,1153
3454,2020-01-06,(02303) Calle 85,426,332,442,1200
3455,2020-03-17,(10004) Policarpa,539,253,308,1100
3456,2020-07-04,(09003) Socorro,548,265,336,1149
3457,2020-07-17,(09003) Socorro,430,221,247,898
3458,2020-08-02,(09003) Socorro,198,87,154,439
3459,2020-05-31,(05105) Pradera,115,109,95,319
3460,2020-03-13,(03012) SUBA - CALLE 95,432,112,212,756
3461,2020-05-19,(04000) Cabecera Calle 80 - intermunicipal,221,124,189,534
3462,2020-09-14,(03006) NIZA - CALLE 127,484,286,259,1029
3463,2020-03-07,(14004) Museo del Oro,851,814,1282,2947
3464,2020-03-13,(07110) PALOQUEMAO,931,108,234,1273
3465,2020-04-23,(07110) PALOQUEMAO,484,289,178,951
3466,2020-07-10,(07110) PALOQUEMAO,635,395,298,1328
3467,2020-06-18,(09110) Avenida Jimenez,1257,969,833,3059
3468,2020-04-27,(02105) Calle 142,198,153,70,421
3469,2020-09-24,(02105) Calle 142,938,574,646,2158
3470,2020-03-31,(08000) Portal Tunal - alimentacion,3369,1561,1761,6691
3471,2020-02-03,(12004) Carrera 22,746,441,492,1679
3472,2020-03-07,(12004) Carrera 22,486,360,433,1279
3473,2020-07-06,(08001) Parque el Tunal,526,284,293,1103
3474,2020-05-24,(02001) Centro Comercial Santa Fe,74,56,75,205
3475,2020-04-15,(09122) Calle 72,628,442,376,1446
3476,2020-04-23,(09122) Calle 72,634,464,399,1497
3477,2020-01-15,(10007) Las Nieves,1787,1118,1102,4007
3478,2020-08-02,(07111) NQS - RICAURTE,180,133,119,432
3479,2020-04-03,(02303) Calle 85,325,238,196,759
3480,2020-10-10,(09002) Consuelo,397,203,366,966
3481,2020-03-30,(03000) Portal Suba,555,377,401,1333
3482,2020-05-07,(03000) Portal Suba,730,495,485,1710
3483,2020-07-03,(07105) MOVISTAR ARENA,276,164,163,603
3484,2020-01-23,(07008) NQS - Calle 30 Sur,1774,955,1024,3753
3485,2020-07-02,(03003) 21 ANGELES,351,182,195,728
3486,2020-07-28,(03003) 21 ANGELES,330,180,159,669
3487,2020-09-16,(03003) 21 ANGELES,376,194,214,784
3488,2020-06-08,(07001) PERDOMO,805,486,497,1788
3489,2020-05-07,(10006) San Victorino,264,163,213,640
3490,2020-05-08,(04104) Avenida 68,430,248,202,880
3491,2020-06-30,(05102) Av. Américas - Av. Boyacá,235,130,148,513
3492,2020-07-10,(03009) Av. Suba- Calle 116,549,352,264,1165
3493,2020-06-29,(06111) Universidades,100,60,130,290
3494,2020-06-28,(05100) Banderas P. Central - alimentacion,934,390,547,1871
3495,2020-03-07,(12000) Puente Aranda,159,105,159,423
3496,2020-07-16,(12004) Carrera 22,124,83,92,299
3497,2020-09-01,(12004) Carrera 22,207,116,124,447
3498,2020-06-29,(07107) U. NACIONAL,120,88,87,295
3499,2020-10-01,(07107) U. NACIONAL,395,264,312,971
3500,2020-07-29,(12003) Ricaurte,331,208,168,707
3501,2020-07-23,(10009) Museo Nacional,398,214,238,850
3502,2020-07-24,(04000) Cabecera Calle 80,934,575,655,2164
3503,2020-05-25,(04106) Carrera 47,120,64,52,236
3504,2020-01-11,(07005) ALQUERIA,1318,658,854,2830
3505,2020-03-26,(07003) SEVILLANA,239,137,109,485
3506,2020-06-14,(14001) La Sabana,40,27,45,112
3507,2020-07-16,(07001) PERDOMO,727,424,451,1602
3508,2020-01-17,(12002) CDS - Carrera 32,493,329,332,1154
3509,2020-10-04,(12002) CDS - Carrera 32,39,50,47,136
3510,2020-09-09,(04000) Cabecera Calle 80 - intermunicipal,394,206,366,966
3511,2020-07-24,(07108) Av. El Dorado,131,88,54,273
3512,2020-08-03,(06002) Normandía,220,145,160,525
3513,2020-08-19,(06108) Concejo de Bogotá,120,72,67,259
3514,2020-09-20,(14004) Museo del Oro,53,41,121,215
3515,2020-04-09,(50003) Corral Molinos,388,170,246,804
3516,2020-08-26,(09108) Hospital,67,45,58,170
3517,2020-09-29,(09108) Hospital,60,41,70,171
3518,2020-08-29,(07102) NQS - CALLE 75,326,229,260,815
3519,2020-04-13,(03003) 21 ANGELES,156,85,61,302
3520,2020-04-22,(02103) Mazurén,98,70,75,243
3521,2020-04-12,(09104) Restrepo,252,175,202,629
3522,2020-09-30,(09003) Socorro,608,315,403,1326
3523,2020-03-24,(07104) Simon Bolivar,310,218,251,779
3524,2020-07-19,(07000) Portal Sur,356,189,274,819
3525,2020-03-26,(07001) PERDOMO,400,250,252,902
3526,2020-05-13,(07107) U. NACIONAL,276,174,127,577
3527,2020-09-25,(07008) NQS - Calle 30 Sur,401,200,333,934
3528,2020-06-02,(05102) Av. Américas - Av. Boyacá,178,96,138,412
3529,2020-04-21,(07006) General Santander - alimentacion,185,122,119,426
3530,2020-10-07,(07107) U. NACIONAL,409,264,300,973
3531,2020-09-07,(04101) Minuto de Dios,354,207,262,823
3532,2020-06-24,(10004) Policarpa,262,122,175,559
3533,2020-09-25,(05105) Pradera,676,437,374,1487
3534,2020-08-03,(03003) 21 ANGELES,266,142,145,553
3535,2020-08-22,(14004) Museo del Oro,84,79,149,312
3536,2020-09-30,(03005) SUBA - AV. BOYACA,529,322,379,1230
3537,2020-05-14,(03004) GRATAMIRA,26,16,16,58
3538,2020-06-06,(12004) Carrera 22,137,76,109,322
3539,2020-06-29,(09121) Las Flores,212,165,175,552
3540,2020-03-22,(09113) Calle 22,107,61,86,254
3541,2020-03-16,(50002) Corral Calle 40 Sur,68,66,96,230
3542,2020-01-24,(03014) SAN MARTIN,255,162,173,590
3543,2020-08-07,(02102) Calle 161,69,44,56,169
3544,2020-04-27,(03006) NIZA - CALLE 127,43,113,44,200
3545,2020-05-04,(06104) Gobernación,180,116,67,363
3546,2020-08-09,(07010) Bosa,173,79,129,381
3547,2020-07-26,(12002) CDS - Carrera 32,32,27,9,68
3548,2020-07-31,(06106) Recinto Ferial,237,123,130,490
3549,2020-07-10,(04105) Carrera 53,311,152,165,628
3550,2020-04-02,(06100) Av. Rojas,108,89,75,272
3551,2020-04-20,(12007) Zona Industrial,213,157,118,488
3552,2020-06-07,(07008) NQS - Calle 30 Sur,85,29,54,168
3553,2020-04-27,(09113) Calle 22,81,81,62,224
3554,2020-05-03,(07201) Guatoque -Veraguas,13,13,18,44
3555,2020-04-20,(09113) Calle 22,216,125,193,534
3556,2020-03-20,(06109) Centro Memoria,126,79,64,269
3557,2020-07-18,(50002) Corral Calle 40 Sur,6,6,11,23
3558,2020-05-03,(06104) Gobernación,48,30,23,101
3559,2020-05-19,(05101) Mandalay - Cr.73,91,44,40,175
3560,2020-09-28,(50006) Corral Carrera 77,4,4,7,15
3561,2020-03-22,(09105) Río Fucha,20,8,18,46
3562,2020-05-02,(06105) Quinta Paredes,54,39,42,135
3563,2020-05-18,(50002) Corral Calle 40 Sur,12,12,15,39
3564,2020-05-27,(50002) Corral Calle 40 Sur,20,5,20,45
3565,2020-05-12,(50006) Corral Carrera 77,6,0,3,9
3566,2020-01-05,(50006) Corral Carrera 77,10,5,10,25
3567,2020-09-29,(09118) Marly,1542,1010,1071,3623
3568,2020-05-22,(07504) TERREROS,4589,2610,2215,9414
3569,2020-06-05,(07504) TERREROS,5351,3126,2624,11101
3570,2020-08-21,(05000) Portal Américas - alimentacion,10314,5371,5465,21150
3571,2020-02-13,(03000) Portal Suba - alimentacion,29950,17362,17077,64389
3572,2020-01-16,(09122) Calle 72,5579,3671,3422,12672
3573,2020-02-03,(02200) Alcalá,14815,9519,6691,31025
3574,2020-01-04,(09003) Socorro,775,368,538,1681
3575,2020-06-21,(04000) Cabecera Calle 80 - alimentacion,1189,571,875,2635
3576,2020-03-03,(10000) Portal 20 de Julio - alimentacion,11062,5617,7750,24429
3577,2020-09-12,(04002) Carrera 90,619,283,428,1330
3578,2020-07-01,(04000) Cabecera Calle 80 - alimentacion,4419,2503,2954,9876
3579,2020-03-12,(02000) Cabecera Autopista Norte - intermunicipal,382,1137,832,2351
3580,2020-02-04,(05005) Transversal 86,2802,1625,1363,5790
3581,2020-02-10,(50006) Corral Carrera 77,31,21,47,99
3582,2020-02-05,(08000) Portal Tunal - alimentacion,24957,13773,12266,50996
3583,2020-04-13,(10000) Portal 20 de Julio - alimentacion,2628,1062,1457,5147
3584,2020-02-06,(05100) Banderas P. Central,7486,4727,4009,16222
3585,2020-06-26,(05100) Banderas P. Central,809,435,546,1790
3586,2020-08-06,(05100) Banderas P. Central,680,371,474,1525
3587,2020-09-17,(05100) Banderas P. Central,1062,634,714,2410
3588,2020-01-10,(02102) Calle 161,1271,745,864,2880
3589,2020-01-27,(09000) Cabecera Usme,5502,3404,3816,12722
3590,2020-01-31,(09000) Cabecera Usme,5725,3269,3992,12986
3591,2020-02-16,(09000) Cabecera Usme,1278,602,1314,3194
3592,2020-01-27,(02205) Calle 106,2610,1720,1343,5673
3593,2020-05-09,(07001) PERDOMO,419,234,261,914
3594,2020-06-18,(07001) PERDOMO,975,543,544,2062
3595,2020-09-15,(07001) PERDOMO,1032,596,717,2345
3596,2020-01-10,(06000) Portal Eldorado - alimentacion,12842,6487,7459,26788
3597,2020-07-07,(09104) Restrepo,1684,990,1302,3976
3598,2020-06-05,(07505) LEON XIII,2585,1360,1123,5068
3599,2020-08-02,(07505) LEON XIII,725,348,372,1445
3600,2020-01-10,(10006) San Victorino,1339,871,972,3182
3601,2020-01-08,(09123) Calle 76,3349,2302,2197,7848
3602,2020-01-19,(03005) SUBA - AV. BOYACA,412,263,509,1184
3603,2020-09-06,(07102) NQS - CALLE 75,100,73,139,312
3604,2020-05-17,(09118) Marly,476,281,248,1005
3605,2020-02-09,(09103) Olaya,1046,452,874,2372
3606,2020-06-19,(07000) Portal Sur - alimentacion,8448,4735,4130,17313
3607,2020-06-26,(03001) LA CAMPIÑA,1224,657,707,2588
3608,2020-03-07,(04100) Carrera 77,3907,1865,3009,8781
3609,2020-04-09,(09104) Restrepo,293,202,232,727
3610,2020-01-09,(02103) Mazurén,2089,1352,1350,4791
3611,2020-03-24,(02103) Mazurén,185,116,196,497
3612,2020-05-13,(02103) Mazurén,147,89,117,353
3613,2020-08-22,(07106) EL CAMPIN,247,157,198,602
3614,2020-09-25,(02000) Cabecera Autopista Norte,1787,1052,1237,4076
3615,2020-10-03,(02000) Cabecera Autopista Norte,1280,719,1150,3149
3616,2020-06-18,(04102) Avenida Boyaca,353,222,218,793
3617,2020-06-28,(07504) TERREROS,1589,806,972,3367
3618,2020-06-02,(50003) Corral Molinos,1426,684,930,3040
3619,2020-07-03,(04000) Cabecera Calle 80,1244,706,947,2897
3620,2020-08-24,(04000) Cabecera Calle 80,950,572,676,2198
3621,2020-01-05,(02000) Cabecera Autopista Norte - alimentacion,4993,1913,3525,10431
3622,2020-06-19,(02000) Cabecera Autopista Norte - alimentacion,4980,2810,2736,10526
3623,2020-09-05,(08000) Portal Tunal - alimentacion,5693,2809,3807,12309
3624,2020-02-20,(05107) Américas - Cr.53,2587,1444,1316,5347
3625,2020-05-30,(04002) Carrera 90,448,243,259,950
3626,2020-06-23,(04100) Carrera 77,1346,776,840,2962
3627,2020-01-11,(03000) Portal Suba,3233,1583,2719,7535
3628,2020-02-27,(12001) Carrera 43,1679,1038,1113,3830
3629,2020-03-06,(12001) Carrera 43,1645,947,1159,3751
3630,2020-10-09,(12001) Carrera 43,513,307,339,1159
3631,2020-03-16,(10002) Av. Primero de Mayo,6102,3094,3276,12472
3632,2020-02-07,(10005) Bicentenario - alimentacion,740,340,502,1582
3633,2020-03-14,(10005) Bicentenario - alimentacion,389,163,390,942
3634,2020-02-18,(09101) Quiroga,1684,1076,1329,4089
3635,2020-06-14,(02000) Cabecera Autopista Norte - alimentacion,1679,802,985,3466
3636,2020-01-28,(06100) Av. Rojas,2629,1503,1214,5346
3637,2020-02-23,(09108) Hospital,72,44,103,219
3638,2020-02-10,(03007) HUMEDAL CORDOBA,1060,683,499,2242
3639,2020-01-20,(08002) Biblioteca,903,480,650,2033
3640,2020-08-14,(07004) VENECIA,993,568,558,2119
3641,2020-03-05,(07108) Av. El Dorado,909,606,630,2145
3642,2020-04-04,(07503) SAN MATEO,4267,2277,1958,8502
3643,2020-04-28,(08001) Parque el Tunal,264,151,159,574
3644,2020-09-27,(02101) Toberín,379,216,564,1159
3645,2020-03-08,(06108) Concejo de Bogotá,117,72,160,349
3646,2020-05-23,(07503) SAN MATEO,5733,3570,2781,12084
3647,2020-01-16,(02304) Heroes,3657,2660,2148,8465
3648,2020-07-24,(09107) Hortúa,475,310,276,1061
3649,2020-09-02,(09107) Hortúa,614,358,400,1372
3650,2020-06-03,(05002) Tintal,1648,996,931,3575
3651,2020-07-27,(03012) SUBA - CALLE 95,282,171,166,619
3652,2020-08-17,(10000) Portal 20 de Julio,742,348,516,1606
3653,2020-01-26,(09001) Molinos,1877,799,1868,4544
3654,2020-06-30,(50002) Corral Calle 40 Sur,26,10,34,70
3655,2020-08-03,(50002) Corral Calle 40 Sur,22,11,21,54
3656,2020-06-17,(08000) Portal Tunal,790,315,245,1350
3657,2020-10-02,(04000) Cabecera Calle 80,1421,816,1359,3596
3658,2020-02-02,(09104) Restrepo,1138,733,1558,3429
3659,2020-04-11,(05005) Transversal 86,102,62,55,219
3660,2020-07-16,(05005) Transversal 86,148,168,297,613
3661,2020-09-25,(05005) Transversal 86,509,264,375,1148
3662,2020-05-17,(02202) Calle 127,356,255,179,790
3663,2020-05-18,(05105) Pradera,459,272,193,924
3664,2020-09-07,(04104) Avenida 68,676,322,393,1391
3665,2020-08-06,(08000) Portal Tunal,746,285,266,1297
3666,2020-02-15,(02205) Calle 106,974,665,889,2528
3667,2020-06-22,(04101) Minuto de Dios,84,63,80,227
3668,2020-07-19,(04101) Minuto de Dios,68,35,74,177
3669,2020-05-24,(06000) Portal Eldorado - alimentacion,1066,473,572,2111
3670,2020-07-15,(07106) EL CAMPIN,402,243,171,816
3671,2020-07-31,(07106) EL CAMPIN,366,231,143,740
3672,2020-09-28,(07113) SANTA ISABEL,419,292,370,1081
3673,2020-09-28,(03007) HUMEDAL CORDOBA,174,132,113,419
3674,2020-08-06,(04104) Avenida 68,475,251,290,1016
3675,2020-03-05,(06101) El Tiempo,2887,1683,1319,5889
3676,2020-07-15,(07010) Bosa,650,329,340,1319
3677,2020-07-13,(09103) Olaya,698,426,369,1493
3678,2020-06-01,(07104) Simon Bolivar,575,361,260,1196
3679,2020-07-18,(07104) Simon Bolivar,423,280,253,956
3680,2020-05-14,(10005) Bicentenario - alimentacion,199,88,150,437
3681,2020-06-24,(10005) Bicentenario - alimentacion,221,117,210,548
3682,2020-03-02,(04107) Escuela Militar,675,408,427,1510
3683,2020-02-23,(09119) Calle 57,622,392,707,1721
3684,2020-09-18,(07004) VENECIA,1175,674,782,2631
3685,2020-07-24,(09000) Cabecera Usme,1222,784,902,2908
3686,2020-09-30,(10009) Museo Nacional,611,388,466,1465
3687,2020-08-28,(09109) Tercer Milenio,354,209,228,791
3688,2020-08-19,(03002) SUBA - TV- 91,678,415,431,1524
3689,2020-06-15,(02202) Calle 127,396,346,250,992
3690,2020-04-29,(10001) Country Sur,688,303,418,1409
3691,2020-03-08,(02000) Cabecera Autopista Norte,1759,893,1819,4471
3692,2020-07-20,(09001) Molinos,634,344,422,1400
3693,2020-02-11,(07101) CASTELLANA,992,616,596,2204
3694,2020-08-28,(07109) CAD,639,373,333,1345
3695,2020-03-30,(04108) El Polo,204,145,113,462
3696,2020-09-16,(06106) Recinto Ferial,281,172,163,616
3697,2020-08-18,(02302) Virrey,596,399,347,1342
3698,2020-08-29,(02302) Virrey,397,317,319,1033
3699,2020-06-22,(03010) PUENTE LARGO,97,81,70,248
3700,2020-07-19,(08000) Portal Tunal - alimentacion,1500,784,896,3180
3701,2020-10-07,(03009) Av. Suba- Calle 116,551,320,420,1291
3702,2020-08-20,(10010) San Bernardo,534,283,358,1175
3703,2020-05-01,(03000) Portal Suba - alimentacion,1789,1033,989,3811
3704,2020-08-08,(03002) SUBA - TV- 91,416,238,346,1000
3705,2020-08-26,(05107) Américas - Cr.53,402,224,241,867
3706,2020-01-08,(07201) Guatoque -Veraguas,667,321,473,1461
3707,2020-05-21,(06102) Salitre El Greco,168,91,97,356
3708,2020-03-25,(08000) Portal Tunal - alimentacion,3608,1785,1721,7114
3709,2020-08-04,(04103) Las Ferias,252,162,145,559
3710,2020-09-12,(10005) Bicentenario,84,49,76,209
3711,2020-03-16,(40002) Manitas,996,538,616,2150
3712,2020-06-17,(02304) Heroes,871,592,449,1912
3713,2020-07-10,(02001) Centro Comercial Santa Fe,555,331,412,1298
3714,2020-09-29,(02001) Centro Comercial Santa Fe,595,385,471,1451
3715,2020-10-09,(02001) Centro Comercial Santa Fe,644,380,567,1591
3716,2020-06-20,(02102) Calle 161,185,108,154,447
3717,2020-07-04,(02200) Alcalá,1592,1019,955,3566
3718,2020-06-25,(08002) Biblioteca,318,184,196,698
3719,2020-05-08,(09002) Consuelo,364,186,211,761
3720,2020-03-29,(03000) Portal Suba - alimentacion,1253,679,582,2514
3721,2020-03-19,(06111) Universidades,0,598,1254,1852
3722,2020-04-23,(09004) Santa Lucía,1197,676,643,2516
3723,2020-10-02,(04000) Cabecera Calle 80 - intermunicipal,457,269,437,1163
3724,2020-08-20,(03006) NIZA - CALLE 127,487,264,223,974
3725,2020-08-08,(14004) Museo del Oro,100,92,145,337
3726,2020-06-06,(05000) Portal Américas,1558,1019,1311,3888
3727,2020-03-25,(02201) Prado,444,338,278,1060
3728,2020-08-15,(09106) Nariño,323,190,299,812
3729,2020-07-24,(14004) Museo del Oro,216,132,156,504
3730,2020-06-03,(09122) Calle 72,1070,733,621,2424
3731,2020-06-20,(09122) Calle 72,871,603,652,2126
3732,2020-09-18,(09122) Calle 72,1385,930,1077,3392
3733,2020-01-18,(04003) Avenida Ciudad de Cali,2939,1371,2277,6587
3734,2020-10-05,(07001) PERDOMO,1132,664,893,2689
3735,2020-01-21,(07006) General Santander - alimentacion,1094,568,611,2273
3736,2020-09-07,(50003) Corral Molinos,1524,793,1228,3545
3737,2020-10-05,(50003) Corral Molinos,1577,783,1424,3784
3738,2020-05-04,(03000) Portal Suba,692,462,461,1615
3739,2020-05-15,(03000) Portal Suba,917,546,586,2049
3740,2020-01-02,(10005) Bicentenario - alimentacion,299,139,342,780
3741,2020-08-29,(07107) U. NACIONAL,251,150,186,587
3742,2020-07-10,(03003) 21 ANGELES,373,177,232,782
3743,2020-07-27,(03001) LA CAMPIÑA,1103,639,598,2340
3744,2020-06-04,(10006) San Victorino,491,253,287,1031
3745,2020-06-14,(02104) Calle 146,229,149,164,542
3746,2020-05-25,(04104) Avenida 68,171,91,95,357
3747,2020-10-07,(40002) Manitas,436,250,347,1033
3748,2020-03-22,(03002) SUBA - TV- 91,146,84,82,312
3749,2020-05-08,(09114) Calle 26,201,147,138,486
3750,2020-10-01,(14005) Las Aguas,263,173,297,733
3751,2020-04-20,(12000) Puente Aranda,42,29,28,99
3752,2020-05-03,(07103) AV. CHILE,159,103,119,381
3753,2020-03-16,(02102) Calle 161,1167,757,677,2601
3754,2020-04-21,(02102) Calle 161,98,66,59,223
3755,2020-05-18,(02102) Calle 161,184,135,113,432
3756,2020-08-03,(12004) Carrera 22,251,134,116,501
3757,2020-09-25,(06001) Modelia,427,299,308,1034
3758,2020-05-11,(03013) RIO NEGRO,223,151,138,512
3759,2020-10-05,(03013) RIO NEGRO,308,204,254,766
3760,2020-07-01,(04106) Carrera 47,329,166,222,717
3761,2020-07-19,(09003) Socorro,162,81,121,364
3762,2020-05-11,(09002) Consuelo,368,195,191,754
3763,2020-09-23,(07008) NQS - Calle 30 Sur,414,207,263,884
3764,2020-01-01,(07103) AV. CHILE,208,143,361,712
3765,2020-05-25,(07003) SEVILLANA,102,65,66,233
3766,2020-09-19,(02001) Centro Comercial Santa Fe,377,215,412,1004
3767,2020-08-04,(07108) Av. El Dorado,128,77,62,267
3768,2020-08-26,(04101) Minuto de Dios,306,189,240,735
3769,2020-06-11,(07006) General Santander,517,345,267,1129
3770,2020-06-01,(04000) Cabecera Calle 80 - intermunicipal,238,148,223,609
3771,2020-05-27,(09108) Hospital,64,45,43,152
3772,2020-06-04,(09108) Hospital,64,45,73,182
3773,2020-09-17,(09108) Hospital,61,47,51,159
3774,2020-09-29,(07006) General Santander - alimentacion,395,237,338,970
3775,2020-01-01,(06102) Salitre El Greco,94,67,115,276
3776,2020-06-09,(06101) El Tiempo,332,204,198,734
3777,2020-04-13,(04000) Cabecera Calle 80 - intermunicipal,122,81,91,294
3778,2020-06-18,(07006) General Santander - alimentacion,379,222,245,846
3779,2020-05-14,(06105) Quinta Paredes,93,60,50,203
3780,2020-07-08,(07109) CAD,677,418,317,1412
3781,2020-05-22,(07008) NQS - Calle 30 Sur,215,116,109,440
3782,2020-03-20,(06001) Modelia,344,234,176,754
3783,2020-08-01,(06001) Modelia,189,147,150,486
3784,2020-03-31,(02303) Calle 85,309,243,196,748
3785,2020-03-26,(07004) VENECIA,491,322,248,1061
3786,2020-04-12,(05100) Banderas P. Central,82,56,47,185
3787,2020-06-01,(06108) Concejo de Bogotá,138,72,61,271
3788,2020-08-23,(07007) NQS - Calle 38A Sur,131,91,106,328
3789,2020-07-14,(09113) Calle 22,255,163,259,677
3790,2020-09-28,(10003) Ciudad Jardín,253,139,217,609
3791,2020-06-04,(40002) Manitas,358,210,227,795
3792,2020-01-05,(09106) Nariño,317,152,363,832
3793,2020-08-01,(12004) Carrera 22,163,95,113,371
3794,2020-07-21,(10003) Ciudad Jardín,157,79,114,350
3795,2020-01-06,(07107) U. NACIONAL,174,153,286,613
3796,2020-06-13,(04107) Escuela Militar,86,69,84,239
3797,2020-08-24,(06100) Av. Rojas,206,129,111,446
3798,2020-07-23,(07006) General Santander - alimentacion,293,167,197,657
3799,2020-04-30,(04105) Carrera 53,178,102,86,366
3800,2020-09-23,(09105) Río Fucha,0,81,172,253
3801,2020-04-06,(06103) CAN,311,236,148,695
3802,2020-09-13,(05101) Mandalay - Cr.73,38,16,45,99
3803,2020-03-28,(06001) Modelia,159,104,110,373
3804,2020-05-29,(07003) SEVILLANA,422,223,209,854
3805,2020-04-25,(07006) General Santander,197,130,115,442
3806,2020-06-01,(04001) Quirigua,349,220,184,753
3807,2020-05-31,(09115) Calle 34,166,128,129,423
3808,2020-09-05,(50002) Corral Calle 40 Sur,17,8,23,48
3809,2020-05-31,(03005) SUBA - AV. BOYACA,90,75,67,232
3810,2020-06-29,(05101) Mandalay - Cr.73,37,23,21,81
3811,2020-03-22,(03003) 21 ANGELES,65,28,31,124
3812,2020-10-11,(04107) Escuela Militar,38,32,68,138
3813,2020-04-11,(12000) Puente Aranda,25,14,11,50
3814,2020-07-06,(50006) Corral Carrera 77,4,3,5,12
3815,2020-08-07,(06108) Concejo de Bogotá,49,23,28,100
3816,2020-10-13,(07503) SAN MATEO,0,1,0,1
3817,2020-02-22,(50004) Corral Avenida Ciudad de Cali,0,0,1,1
3818,2020-02-03,(07005) ALQUERIA,2600,1476,1475,5551
3819,2020-07-19,(09002) Consuelo,123,42,91,256
3820,2020-09-26,(02502) Terminal,333,244,433,1010
3821,2020-01-14,(09118) Marly,4738,3321,3116,11175
3822,2020-05-29,(09118) Marly,1355,936,668,2959
3823,2020-01-20,(07504) TERREROS,16261,9742,9157,35160
3824,2020-09-07,(07504) TERREROS,6432,3452,3254,13138
3825,2020-02-21,(03000) Portal Suba - alimentacion,28234,15530,16770,60534
3826,2020-01-08,(09122) Calle 72,4489,3019,2947,10455
3827,2020-02-12,(09122) Calle 72,9019,5761,4466,19246
3828,2020-02-25,(05000) Portal Américas,15384,8663,8040,32087
3829,2020-01-30,(08001) Parque el Tunal,1648,929,909,3486
3830,2020-01-24,(09001) Molinos,7501,4040,5332,16873
3831,2020-09-03,(05000) Portal Américas - alimentacion,11625,6253,6668,24546
3832,2020-03-11,(14004) Museo del Oro,3929,2476,1954,8359
3833,2020-01-31,(05005) Transversal 86,2690,1397,1382,5469
3834,2020-02-04,(07103) AV. CHILE,3859,2251,1939,8049
3835,2020-07-28,(09100) Calle 40 Sur,1611,939,957,3507
3836,2020-03-18,(09000) Cabecera Usme,3862,2190,2420,8472
3837,2020-01-25,(06000) Portal Eldorado - alimentacion,10163,4686,6532,21381
3838,2020-06-30,(09115) Calle 34,694,435,439,1568
3839,2020-07-16,(09115) Calle 34,549,351,282,1182
3840,2020-06-07,(07000) Portal Sur - alimentacion,2208,1060,1127,4395
3841,2020-03-06,(10003) Ciudad Jardín,973,529,676,2178
3842,2020-02-25,(07113) SANTA ISABEL,2179,1328,1351,4858
3843,2020-03-07,(09109) Tercer Milenio,846,497,702,2045
3844,2020-05-08,(09109) Tercer Milenio,223,145,169,537
3845,2020-01-22,(05107) Américas - Cr.53,2342,1268,1274,4884
3846,2020-01-28,(07505) LEON XIII,8268,4675,3703,16646
3847,2020-05-15,(07505) LEON XIII,1924,1128,911,3963
3848,2020-05-09,(03000) Portal Suba - alimentacion,3032,1716,1623,6371
3849,2020-06-22,(03000) Portal Suba - alimentacion,2115,1159,1285,4559
3850,2020-07-01,(03000) Portal Suba - alimentacion,6575,3866,3936,14377
3851,2020-07-19,(07504) TERREROS,1341,709,750,2800
3852,2020-01-20,(06002) Normandía,2292,1400,1248,4940
3853,2020-02-03,(04100) Carrera 77,6734,4106,4161,15001
3854,2020-03-25,(07102) NQS - CALLE 75,159,123,120,402
3855,2020-07-23,(03013) RIO NEGRO,238,162,153,553
3856,2020-03-05,(02103) Mazurén,3308,2072,1891,7271
3857,2020-03-06,(09119) Calle 57,3638,2209,2199,8046
3858,2020-09-18,(05100) Banderas P. Central - alimentacion,3805,2009,2438,8252
3859,2020-03-24,(09103) Olaya,782,455,498,1735
3860,2020-10-05,(09103) Olaya,1149,637,847,2633
3861,2020-07-29,(07002) MADELENA,769,420,468,1657
3862,2020-05-04,(07002) MADELENA,423,260,224,907
3863,2020-07-14,(07010) Bosa,679,307,344,1330
3864,2020-09-16,(09110) Avenida Jimenez,1671,1141,986,3798
3865,2020-09-14,(09111) Calle 19,712,437,521,1670
3866,2020-01-11,(05002) Tintal,5309,2546,3500,11355
3867,2020-08-15,(08000) Portal Tunal - alimentacion,5100,2512,3148,10760
3868,2020-03-16,(07113) SANTA ISABEL,1444,864,932,3240
3869,2020-02-05,(07106) EL CAMPIN,2214,1393,1271,4878
3870,2020-02-07,(06101) El Tiempo,2892,1617,1467,5976
3871,2020-06-27,(03000) Portal Suba,979,510,742,2231
3872,2020-07-31,(03000) Portal Suba,869,598,609,2076
3873,2020-08-29,(03000) Portal Suba,928,527,826,2281
3874,2020-04-21,(02000) Cabecera Autopista Norte - intermunicipal,184,122,152,458
3875,2020-06-12,(09000) Cabecera Usme - alimentacion,7643,4789,5229,17661
3876,2020-02-25,(08001) Parque el Tunal,1763,1030,965,3758
3877,2020-03-18,(10000) Portal 20 de Julio,5482,2476,2365,10323
3878,2020-08-22,(07112) COMUNEROS,639,344,367,1350
3879,2020-08-18,(02303) Calle 85,663,433,376,1472
3880,2020-07-18,(09116) Avenida 39,164,112,141,417
3881,2020-06-06,(07503) SAN MATEO,7485,4297,3809,15591
3882,2020-10-05,(08001) Parque el Tunal,504,287,353,1144
3883,2020-03-07,(06108) Concejo de Bogotá,298,217,368,883
3884,2020-09-22,(06108) Concejo de Bogotá,163,89,104,356
3885,2020-06-17,(10001) Country Sur,1224,574,722,2520
3886,2020-09-19,(07001) PERDOMO,856,423,773,2052
3887,2020-02-11,(02304) Heroes,4923,3411,2289,10623
3888,2020-07-05,(05103) Marsella,130,63,87,280
3889,2020-02-22,(04002) Carrera 90,2014,958,1479,4451
3890,2020-02-18,(02300) Calle 100,7439,4727,3915,16081
3891,2020-05-14,(03012) SUBA - CALLE 95,276,166,146,588
3892,2020-09-01,(03012) SUBA - CALLE 95,336,206,205,747
3893,2020-06-28,(10000) Portal 20 de Julio,768,337,520,1625
3894,2020-06-14,(09001) Molinos,725,335,514,1574
3895,2020-03-15,(04106) Carrera 47,277,138,237,652
3896,2020-03-21,(07007) NQS - Calle 38A Sur,106,71,57,234
3897,2020-03-12,(05105) Pradera,910,261,239,1410
3898,2020-09-22,(05005) Transversal 86,483,258,368,1109
3899,2020-09-23,(05005) Transversal 86,463,270,360,1093
3900,2020-02-12,(06109) Centro Memoria,1235,700,659,2594
3901,2020-09-26,(04104) Avenida 68,500,280,437,1217
3902,2020-06-19,(08000) Portal Tunal,800,334,298,1432
3903,2020-05-07,(03009) Av. Suba- Calle 116,362,248,169,779
3904,2020-06-13,(02205) Calle 106,223,145,176,544
3905,2020-03-20,(10002) Av. Primero de Mayo,1127,581,536,2244
3906,2020-01-17,(03006) NIZA - CALLE 127,1948,1238,1380,4566
3907,2020-08-09,(06000) Portal Eldorado - alimentacion,1109,553,772,2434
3908,2020-03-13,(03000) Portal Suba,368,1692,1510,3570
3909,2020-01-06,(06106) Recinto Ferial,199,124,178,501
3910,2020-01-26,(07010) Bosa,473,235,561,1269
3911,2020-05-21,(03007) HUMEDAL CORDOBA,123,81,49,253
3912,2020-08-10,(03007) HUMEDAL CORDOBA,108,81,88,277
3913,2020-06-18,(10006) San Victorino,653,295,318,1266
3914,2020-04-10,(09004) Santa Lucía,365,218,165,748
3915,2020-09-28,(08002) Biblioteca,334,187,224,745
3916,2020-06-13,(02101) Toberín,975,556,706,2237
3917,2020-10-11,(03000) Portal Suba,491,197,620,1308
3918,2020-01-06,(07000) Portal Sur,1148,568,1040,2756
3919,2020-05-12,(10005) Bicentenario - alimentacion,179,81,121,381
3920,2020-09-25,(04003) Avenida Ciudad de Cali,1190,612,1017,2819
3921,2020-01-12,(40003) Mirador del Paraiso,1706,805,1177,3688
3922,2020-05-22,(05103) Marsella,310,150,180,640
3923,2020-02-22,(07001) PERDOMO,2576,1277,1902,5755
3924,2020-07-07,(05001) Patio Bonito,704,1036,1916,3656
3925,2020-02-29,(09120) Calle 63,3758,2549,2941,9248
3926,2020-05-16,(09001) Molinos,1547,820,999,3366
3927,2020-09-22,(02205) Calle 106,464,293,321,1078
3928,2020-10-05,(08000) Portal Tunal,827,392,436,1655
3929,2020-02-16,(09116) Avenida 39,242,229,433,904
3930,2020-02-15,(07004) VENECIA,2973,1482,2005,6460
3931,2020-08-21,(07109) CAD,601,380,292,1273
3932,2020-09-24,(40001) Juan Pablo II,602,340,439,1381
3933,2020-01-04,(02104) Calle 146,1590,721,1432,3743
3934,2020-05-04,(07009) SENA,371,229,222,822
3935,2020-02-25,(07008) NQS - Calle 30 Sur,1987,1122,1089,4198
3936,2020-09-26,(06100) Av. Rojas,154,104,192,450
3937,2020-05-29,(12003) Ricaurte,355,240,169,764
3938,2020-01-23,(03013) RIO NEGRO,1198,713,839,2750
3939,2020-03-27,(02302) Virrey,324,253,191,768
3940,2020-01-04,(07200) Tygua-San José,265,139,249,653
3941,2020-10-07,(06001) Modelia,403,269,312,984
3942,2020-02-04,(09109) Tercer Milenio,1435,861,926,3222
3943,2020-04-06,(09109) Tercer Milenio,155,96,109,360
3944,2020-05-17,(05102) Av. Américas - Av. Boyacá,55,25,26,106
3945,2020-09-01,(07009) SENA,645,346,444,1435
3946,2020-09-22,(10010) San Bernardo,642,331,496,1469
3947,2020-07-20,(10005) Bicentenario,21,20,27,68
3948,2020-06-06,(02000) Cabecera Autopista Norte,865,549,570,1984
3949,2020-02-11,(07006) General Santander,3049,1766,1583,6398
3950,2020-02-26,(02102) Calle 161,1960,1168,1109,4237
3951,2020-04-29,(07003) SEVILLANA,291,159,140,590
3952,2020-06-24,(07003) SEVILLANA,483,271,229,983
3953,2020-04-07,(07104) Simon Bolivar,198,132,123,453
3954,2020-08-26,(07112) COMUNEROS,798,443,431,1672
3955,2020-06-14,(07102) NQS - CALLE 75,77,70,69,216
3956,2020-08-28,(10008) San Diego,295,174,180,649
3957,2020-08-19,(09120) Calle 63,955,603,641,2199
3958,2020-05-13,(02200) Alcalá,1374,964,703,3041
3959,2020-07-14,(03011) SUBA - CALLE 100,539,247,191,977
3960,2020-02-29,(04107) Escuela Militar,369,246,369,984
3961,2020-07-23,(04101) Minuto de Dios,287,175,184,646
3962,2020-09-29,(06111) Universidades,505,273,431,1209
3963,2020-02-22,(07105) MOVISTAR ARENA,732,471,561,1764
3964,2020-01-30,(03004) GRATAMIRA,318,177,160,655
3965,2020-09-05,(03004) GRATAMIRA,0,15,29,44
3966,2020-04-30,(05100) Banderas P. Central - alimentacion,1803,879,832,3514
3967,2020-09-07,(02204) Pepe Sierra,863,589,513,1965
3968,2020-01-02,(05102) Av. Américas - Av. Boyacá,550,336,376,1262
3969,2020-05-05,(07110) PALOQUEMAO,532,318,219,1069
3970,2020-10-05,(07200) Tygua-San José,287,148,211,646
3971,2020-07-08,(09106) Nariño,410,260,317,987
3972,2020-01-07,(07005) ALQUERIA,1602,908,1096,3606
3973,2020-01-09,(07005) ALQUERIA,1838,968,1108,3914
3974,2020-04-22,(09122) Calle 72,658,475,378,1511
3975,2020-03-31,(06109) Centro Memoria,157,110,103,370
3976,2020-06-24,(06109) Centro Memoria,282,164,134,580
3977,2020-09-25,(09111) Calle 19,811,511,598,1920
3978,2020-03-30,(04000) Cabecera Calle 80,474,324,330,1128
3979,2020-07-08,(08000) Portal Tunal,829,363,346,1538
3980,2020-06-24,(07105) MOVISTAR ARENA,270,168,157,595
3981,2020-02-10,(09105) Río Fucha,832,508,518,1858
3982,2020-10-07,(09115) Calle 34,723,454,625,1802
3983,2020-03-24,(02200) Alcalá,1458,1042,929,3429
3984,2020-06-08,(07107) U. NACIONAL,291,188,163,642
3985,2020-09-04,(10007) Las Nieves,716,467,461,1644
3986,2020-06-13,(09110) Avenida Jimenez,836,679,710,2225
3987,2020-04-18,(09119) Calle 57,173,143,137,453
3988,2020-09-12,(09119) Calle 57,509,303,409,1221
3989,2020-04-16,(02502) Terminal,166,114,135,415
3990,2020-05-21,(12000) Puente Aranda,61,40,26,127
3991,2020-04-09,(07001) PERDOMO,147,90,77,314
3992,2020-04-08,(03005) SUBA - AV. BOYACA,196,148,163,507
3993,2020-09-17,(02102) Calle 161,289,156,199,644
3994,2020-09-16,(12004) Carrera 22,310,181,190,681
3995,2020-09-30,(04106) Carrera 47,357,186,257,800
3996,2020-01-26,(03013) RIO NEGRO,249,131,309,689
3997,2020-04-10,(09107) Hortúa,186,112,76,374
3998,2020-06-21,(08000) Portal Tunal,203,113,124,440
3999,2020-08-02,(06106) Recinto Ferial,53,41,55,149
4000,2020-04-01,(12002) CDS - Carrera 32,137,120,57,314
4001,2020-05-31,(12002) CDS - Carrera 32,33,31,23,87
4002,2020-09-28,(12002) CDS - Carrera 32,214,145,91,450
4003,2020-04-14,(10009) Museo Nacional,300,226,193,719
4004,2020-06-20,(09000) Cabecera Usme,1370,772,1092,3234
4005,2020-08-18,(09122) Calle 72,1146,752,734,2632
4006,2020-05-17,(09109) Tercer Milenio,88,60,65,213
4007,2020-07-16,(04000) Cabecera Calle 80 - intermunicipal,295,154,238,687
4008,2020-07-05,(07108) Av. El Dorado,32,27,35,94
4009,2020-06-24,(06002) Normandía,320,179,204,703
4010,2020-09-18,(06100) Av. Rojas,294,178,221,693
4011,2020-03-31,(06001) Modelia,238,170,149,557
4012,2020-04-06,(09108) Hospital,37,28,38,103
4013,2020-05-02,(09108) Hospital,55,22,28,105
4014,2020-05-15,(09003) Socorro,472,243,245,960
4015,2020-05-13,(02502) Terminal,291,203,215,709
4016,2020-08-17,(03009) Av. Suba- Calle 116,168,130,90,388
4017,2020-03-18,(07003) SEVILLANA,1192,609,634,2435
4018,2020-07-22,(07109) CAD,567,379,282,1228
4019,2020-05-25,(09122) Calle 72,299,229,237,765
4020,2020-05-11,(05100) Banderas P. Central,472,277,295,1044
4021,2020-08-20,(05102) Av. Américas - Av. Boyacá,208,108,150,466
4022,2020-09-25,(07107) U. NACIONAL,406,273,332,1011
4023,2020-08-09,(02204) Pepe Sierra,162,161,150,473
4024,2020-05-30,(07109) CAD,361,248,202,811
4025,2020-09-12,(10004) Policarpa,225,86,154,465
4026,2020-04-04,(06108) Concejo de Bogotá,68,51,42,161
4027,2020-06-25,(09116) Avenida 39,356,234,236,826
4028,2020-10-05,(06106) Recinto Ferial,290,183,231,704
4029,2020-05-26,(07008) NQS - Calle 30 Sur,241,135,136,512
4030,2020-04-30,(03005) SUBA - AV. BOYACA,233,147,151,531
4031,2020-07-23,(07506) DESPENSA,371,222,204,797
4032,2020-03-24,(09105) Río Fucha,86,70,102,258
4033,2020-09-26,(03004) GRATAMIRA,0,18,39,57
4034,2020-04-13,(07201) Guatoque -Veraguas,68,52,53,173
4035,2020-09-10,(07003) SEVILLANA,455,209,260,924
4036,2020-09-13,(12004) Carrera 22,73,51,75,199
4037,2020-04-28,(04105) Carrera 53,192,115,105,412
4038,2020-04-29,(04105) Carrera 53,191,105,93,389
4039,2020-04-09,(04106) Carrera 47,86,53,42,181
4040,2020-03-28,(09114) Calle 26,73,59,71,203
4041,2020-05-16,(09121) Las Flores,378,264,268,910
4042,2020-08-08,(06100) Av. Rojas,105,66,113,284
4043,2020-05-09,(07101) CASTELLANA,67,42,68,177
4044,2020-08-07,(07200) Tygua-San José,90,53,76,219
4045,2020-09-13,(06104) Gobernación,52,37,68,157
4046,2020-04-16,(05103) Marsella,200,105,97,402
4047,2020-08-02,(08002) Biblioteca,79,46,39,164
4048,2020-08-29,(12000) Puente Aranda,53,34,45,132
4049,2020-10-03,(12000) Puente Aranda,57,37,71,165
4050,2020-03-31,(50002) Corral Calle 40 Sur,8,6,9,23
4051,2020-04-08,(50006) Corral Carrera 77,6,0,4,10
4052,2020-04-27,(03014) SAN MARTIN,4,9,3,16
4053,2020-02-06,(04000) Cabecera Calle 80 - alimentacion,24747,14467,14461,53675
4054,2020-02-27,(07005) ALQUERIA,2723,1477,1390,5590
4055,2020-02-11,(09002) Consuelo,1477,834,839,3150
4056,2020-02-21,(09002) Consuelo,1374,715,792,2881
4057,2020-02-10,(07504) TERREROS,17826,11095,9322,38243
4058,2020-02-14,(05000) Portal Américas - alimentacion,38427,21697,20998,81122
4059,2020-02-17,(10000) Portal 20 de Julio - alimentacion,11121,5690,7463,24274
4060,2020-02-24,(10000) Portal 20 de Julio - alimentacion,10990,5724,7462,24176
4061,2020-01-14,(05000) Portal Américas - alimentacion,32288,17664,17992,67944
4062,2020-01-11,(03002) SUBA - TV- 91,1794,865,1287,3946
4063,2020-01-08,(02101) Toberín,9661,5833,5582,21076
4064,2020-01-21,(05000) Portal Américas,10705,3414,4614,18733
4065,2020-01-24,(05000) Portal Américas,14182,7622,7432,29236
4066,2020-02-05,(05000) Portal Américas,15468,8607,7993,32068
4067,2020-08-04,(05000) Portal Américas,2169,1462,1728,5359
4068,2020-01-22,(06104) Gobernación,1327,753,647,2727
4069,2020-09-25,(04000) Cabecera Calle 80 - alimentacion,5165,2665,3949,11779
4070,2020-01-10,(50003) Corral Molinos,2702,1787,3028,7517
4071,2020-02-22,(07111) NQS - RICAURTE,2065,1452,1412,4929
4072,2020-04-24,(06107) Ciudad Universitaria,106,75,73,254
4073,2020-03-11,(09001) Molinos,7033,4431,5757,17221
4074,2020-02-27,(07010) Bosa,2238,1292,1396,4926
4075,2020-01-16,(05000) Portal Américas,13174,7060,7472,27706
4076,2020-02-13,(02201) Prado,6162,3783,3034,12979
4077,2020-03-19,(14004) Museo del Oro,0,755,1547,2302
4078,2020-09-11,(07112) COMUNEROS,851,420,591,1862
4079,2020-02-01,(04100) Carrera 77,3749,1788,3004,8541
4080,2020-09-24,(08000) Portal Tunal - alimentacion,6903,3730,4389,15022
4081,2020-08-19,(05100) Banderas P. Central,734,388,463,1585
4082,2020-02-17,(09000) Cabecera Usme,6105,3734,3956,13795
4083,2020-06-01,(09115) Calle 34,642,439,327,1408
4084,2020-06-19,(09115) Calle 34,666,455,440,1561
4085,2020-02-25,(02000) Cabecera Autopista Norte,11762,7252,6066,25080
4086,2020-01-03,(02205) Calle 106,992,694,715,2401
4087,2020-03-02,(02000) Cabecera Autopista Norte,11322,6974,6037,24333
4088,2020-08-12,(09000) Cabecera Usme - alimentacion,8088,4255,4570,16913
4089,2020-02-23,(09109) Tercer Milenio,339,172,334,845
4090,2020-05-20,(09109) Tercer Milenio,307,195,163,665
4091,2020-07-31,(03000) Portal Suba - alimentacion,4712,2684,2683,10079
4092,2020-01-08,(02204) Pepe Sierra,3497,2289,1879,7665
4093,2020-07-03,(09000) Cabecera Usme,1841,1130,1350,4321
4094,2020-01-10,(04104) Avenida 68,2429,1278,1515,5222
4095,2020-03-02,(06002) Normandía,2591,1582,1297,5470
4096,2020-06-06,(09101) Quiroga,371,215,307,893
4097,2020-09-09,(09000) Cabecera Usme - alimentacion,9244,4809,5675,19728
4098,2020-07-06,(09103) Olaya,1120,622,616,2358
4099,2020-05-05,(02302) Virrey,393,272,218,883
4100,2020-01-27,(09110) Avenida Jimenez,4386,3166,2663,10215
4101,2020-02-19,(03001) LA CAMPIÑA,6872,4197,4151,15220
4102,2020-02-26,(03001) LA CAMPIÑA,6791,3917,4340,15048
4103,2020-01-15,(06001) Modelia,2047,1253,1129,4429
4104,2020-03-07,(03007) HUMEDAL CORDOBA,480,283,375,1138
4105,2020-02-28,(09116) Avenida 39,3037,2094,1783,6914
4106,2020-08-08,(02103) Mazurén,101,53,106,260
4107,2020-07-20,(09103) Olaya,266,152,165,583
4108,2020-08-28,(14001) La Sabana,177,102,82,361
4109,2020-03-30,(07504) TERREROS,2321,1345,1303,4969
4110,2020-05-24,(09113) Calle 22,192,104,184,480
4111,2020-10-10,(09113) Calle 22,409,214,436,1059
4112,2020-08-29,(09004) Santa Lucía,2206,1004,1357,4567
4113,2020-02-09,(09104) Restrepo,1155,680,1433,3268
4114,2020-05-17,(08000) Portal Tunal - alimentacion,1592,785,929,3306
4115,2020-09-09,(08000) Portal Tunal - alimentacion,6807,3805,4149,14761
4116,2020-07-03,(07112) COMUNEROS,838,463,557,1858
4117,2020-01-22,(10001) Country Sur,4808,2108,2568,9484
4118,2020-09-22,(06000) Portal Eldorado,922,629,633,2184
4119,2020-02-28,(10008) San Diego,1414,853,772,3039
4120,2020-01-15,(04001) Quirigua,1669,976,1115,3760
4121,2020-03-12,(04001) Quirigua,115,522,351,988
4122,2020-07-03,(08000) Portal Tunal - alimentacion,6797,3772,3987,14556
4123,2020-02-25,(12001) Carrera 43,1786,1041,1104,3931
4124,2020-06-13,(12001) Carrera 43,271,161,213,645
4125,2020-07-25,(10002) Av. Primero de Mayo,1185,599,790,2574
4126,2020-01-20,(40001) Juan Pablo II,1522,887,979,3388
4127,2020-02-10,(02302) Virrey,4019,2717,1891,8627
4128,2020-02-10,(02304) Heroes,4924,3308,2309,10541
4129,2020-07-28,(09101) Quiroga,381,246,321,948
4130,2020-02-24,(10010) San Bernardo,1806,1093,1339,4238
4131,2020-01-01,(07000) Portal Sur - alimentacion,2621,1195,2564,6380
4132,2020-10-03,(07112) COMUNEROS,716,385,693,1794
4133,2020-02-02,(09116) Avenida 39,222,192,434,848
4134,2020-01-20,(09113) Calle 22,1151,763,1032,2946
4135,2020-07-22,(10001) Country Sur,910,409,594,1913
4136,2020-02-18,(09120) Calle 63,7605,4848,3750,16203
4137,2020-05-06,(02101) Toberín,915,599,575,2089
4138,2020-07-28,(02201) Prado,812,543,495,1850
4139,2020-07-13,(09107) Hortúa,505,315,257,1077
4140,2020-08-04,(05103) Marsella,338,198,208,744
4141,2020-03-01,(02201) Prado,1091,554,1120,2765
4142,2020-08-03,(02300) Calle 100,1056,687,550,2293
4143,2020-09-12,(10000) Portal 20 de Julio,1871,843,1242,3956
4144,2020-07-28,(05005) Transversal 86,272,163,212,647
4145,2020-03-05,(10008) San Diego,1531,849,742,3122
4146,2020-03-09,(08000) Portal Tunal,682,301,283,1266
4147,2020-01-30,(06109) Centro Memoria,1084,630,610,2324
4148,2020-03-06,(06109) Centro Memoria,1065,609,703,2377
4149,2020-04-07,(05107) Américas - Cr.53,262,203,169,634
4150,2020-04-24,(08000) Portal Tunal,466,249,186,901
4151,2020-08-23,(05000) Portal Américas - alimentacion,3025,1316,1671,6012
4152,2020-06-16,(02205) Calle 106,369,236,213,818
4153,2020-01-10,(04000) Cabecera Calle 80,5405,3031,3865,12301
4154,2020-01-16,(07113) SANTA ISABEL,1766,1045,1244,4055
4155,2020-05-13,(04101) Minuto de Dios,263,151,165,579
4156,2020-02-26,(07201) Guatoque -Veraguas,1053,495,628,2176
4157,2020-08-18,(07201) Guatoque -Veraguas,185,97,124,406
4158,2020-02-09,(07106) EL CAMPIN,476,280,475,1231
4159,2020-06-29,(07106) EL CAMPIN,139,102,89,330
4160,2020-09-22,(07113) SANTA ISABEL,439,252,361,1052
4161,2020-05-01,(06111) Universidades,0,29,121,150
4162,2020-07-12,(03007) HUMEDAL CORDOBA,53,28,16,97
4163,2020-03-04,(06105) Quinta Paredes,1085,644,521,2250
4164,2020-04-22,(07104) Simon Bolivar,240,150,113,503
4165,2020-06-18,(07104) Simon Bolivar,617,394,303,1314
4166,2020-05-30,(10005) Bicentenario - alimentacion,144,67,123,334
4167,2020-01-07,(07004) VENECIA,3163,1950,1873,6986
4168,2020-05-28,(09109) Tercer Milenio,244,204,226,674
4169,2020-07-11,(09109) Tercer Milenio,310,184,229,723
4170,2020-08-24,(03001) LA CAMPIÑA,1052,586,526,2164
4171,2020-09-23,(06104) Gobernación,291,177,132,600
4172,2020-05-29,(03001) LA CAMPIÑA,969,536,472,1977
4173,2020-03-18,(07103) AV. CHILE,2067,1419,1112,4598
4174,2020-08-22,(07003) SEVILLANA,325,151,198,674
4175,2020-03-27,(04108) El Polo,164,131,126,421
4176,2020-04-06,(04108) El Polo,206,140,117,463
4177,2020-10-08,(06106) Recinto Ferial,307,183,202,692
4178,2020-09-04,(02001) Centro Comercial Santa Fe,543,309,411,1263
4179,2020-09-13,(05001) Patio Bonito,697,293,534,1524
4180,2020-09-10,(09120) Calle 63,1154,722,814,2690
4181,2020-02-09,(06100) Av. Rojas,223,165,328,716
4182,2020-06-16,(06000) Portal Eldorado,994,695,455,2144
4183,2020-05-03,(07009) SENA,103,59,85,247
4184,2020-06-09,(07009) SENA,613,380,348,1341
4185,2020-01-28,(03013) RIO NEGRO,1285,824,842,2951
4186,2020-06-06,(07106) EL CAMPIN,237,159,153,549
4187,2020-03-17,(10010) San Bernardo,1067,673,956,2696
4188,2020-04-20,(03009) Av. Suba- Calle 116,343,242,176,761
4189,2020-02-09,(06103) CAN,247,219,333,799
4190,2020-03-30,(02105) Calle 142,364,292,244,900
4191,2020-05-17,(09116) Avenida 39,77,58,53,188
4192,2020-03-19,(05107) Américas - Cr.53,1268,750,691,2709
4193,2020-09-18,(05107) Américas - Cr.53,461,289,342,1092
4194,2020-07-10,(02104) Calle 146,849,528,570,1947
4195,2020-07-13,(12007) Zona Industrial,342,202,138,682
4196,2020-05-24,(08000) Portal Tunal - alimentacion,1657,816,915,3388
4197,2020-02-25,(40002) Manitas,1357,803,745,2905
4198,2020-03-13,(09106) Nariño,159,300,320,779
4199,2020-02-07,(08002) Biblioteca,1058,595,656,2309
4200,2020-03-10,(07001) PERDOMO,159,1480,1009,2648
4201,2020-08-20,(07112) COMUNEROS,764,438,438,1640
4202,2020-04-16,(09101) Quiroga,260,136,176,572
4203,2020-07-11,(09003) Socorro,548,275,353,1176
4204,2020-05-12,(09004) Santa Lucía,1856,992,1003,3851
4205,2020-07-10,(07111) NQS - RICAURTE,1192,747,520,2459
4206,2020-09-20,(09115) Calle 34,166,108,265,539
4207,2020-06-21,(09111) Calle 19,195,153,222,570
4208,2020-08-05,(02105) Calle 142,658,401,398,1457
4209,2020-03-08,(05102) Av. Américas - Av. Boyacá,222,110,251,583
4210,2020-09-14,(05102) Av. Américas - Av. Boyacá,242,150,180,572
4211,2020-01-26,(10009) Museo Nacional,306,296,543,1145
4212,2020-04-18,(10000) Portal 20 de Julio,906,498,446,1850
4213,2020-06-01,(06104) Gobernación,240,141,106,487
4214,2020-05-02,(09103) Olaya,451,244,228,923
4215,2020-02-23,(50003) Corral Molinos,927,513,1167,2607
4216,2020-01-13,(50002) Corral Calle 40 Sur,117,68,103,288
4217,2020-05-07,(07201) Guatoque -Veraguas,124,78,83,285
4218,2020-04-25,(07105) MOVISTAR ARENA,127,78,67,272
4219,2020-08-03,(07003) SEVILLANA,376,200,182,758
4220,2020-08-08,(07003) SEVILLANA,276,143,187,606
4221,2020-04-16,(14005) Las Aguas,0,29,96,125
4222,2020-06-23,(07107) U. NACIONAL,345,208,224,777
4223,2020-03-04,(07104) Simon Bolivar,2487,1505,1269,5261
4224,2020-07-26,(04003) Avenida Ciudad de Cali,226,127,200,553
4225,2020-05-18,(03003) 21 ANGELES,270,139,124,533
4226,2020-07-27,(03003) 21 ANGELES,303,154,164,621
4227,2020-08-15,(03003) 21 ANGELES,245,110,137,492
4228,2020-02-22,(10003) Ciudad Jardín,582,271,522,1375
4229,2020-04-10,(02104) Calle 146,155,111,63,329
4230,2020-08-01,(09119) Calle 57,429,251,289,969
4231,2020-09-10,(09110) Avenida Jimenez,1400,989,881,3270
4232,2020-05-30,(10007) Las Nieves,364,258,247,869
4233,2020-07-25,(02000) Cabecera Autopista Norte,836,474,484,1794
4234,2020-06-18,(08002) Biblioteca,325,179,154,658
4235,2020-02-19,(50002) Corral Calle 40 Sur,130,94,144,368
4236,2020-03-11,(07006) General Santander - alimentacion,1382,811,906,3099
4237,2020-04-17,(03005) SUBA - AV. BOYACA,207,158,158,523
4238,2020-08-25,(12004) Carrera 22,238,158,139,535
4239,2020-02-01,(06001) Modelia,966,588,902,2456
4240,2020-07-07,(03013) RIO NEGRO,304,205,210,719
4241,2020-07-15,(07005) ALQUERIA,468,252,256,976
4242,2020-05-23,(07112) COMUNEROS,477,290,295,1062
4243,2020-04-13,(09003) Socorro,275,124,182,581
4244,2020-02-01,(09108) Hospital,165,83,169,417
4245,2020-05-10,(03013) RIO NEGRO,58,36,45,139
4246,2020-10-10,(40001) Juan Pablo II,503,261,472,1236
4247,2020-03-17,(40001) Juan Pablo II,1223,698,667,2588
4248,2020-08-10,(04101) Minuto de Dios,257,170,222,649
4249,2020-04-17,(03009) Av. Suba- Calle 116,343,228,158,729
4250,2020-09-07,(09123) Calle 76,1116,718,694,2528
4251,2020-06-01,(06001) Modelia,398,234,197,829
4252,2020-05-05,(09108) Hospital,64,45,50,159
4253,2020-09-23,(07006) General Santander - alimentacion,438,229,353,1020
4254,2020-05-08,(02502) Terminal,238,150,179,567
4255,2020-06-01,(06103) CAN,359,223,156,738
4256,2020-06-05,(02304) Heroes,738,560,386,1684
4257,2020-04-17,(03006) NIZA - CALLE 127,243,177,142,562
4258,2020-09-10,(07006) General Santander - alimentacion,302,189,297,788
4259,2020-05-01,(03006) NIZA - CALLE 127,143,105,55,303
4260,2020-09-16,(40002) Manitas,440,273,335,1048
4261,2020-10-05,(05101) Mandalay - Cr.73,165,107,106,378
4262,2020-04-02,(09113) Calle 22,189,119,169,477
4263,2020-09-12,(07201) Guatoque -Veraguas,139,70,159,368
4264,2020-04-26,(07005) ALQUERIA,105,55,61,221
4265,2020-08-09,(07006) General Santander - alimentacion,55,41,89,185
4266,2020-07-24,(10007) Las Nieves,363,232,278,873
4267,2020-01-05,(07006) General Santander,436,192,383,1011
4268,2020-09-15,(04101) Minuto de Dios,337,226,290,853
4269,2020-04-28,(10004) Policarpa,133,78,77,288
4270,2020-08-01,(14001) La Sabana,124,78,82,284
4271,2020-06-18,(03011) SUBA - CALLE 100,519,225,255,999
4272,2020-07-23,(03004) GRATAMIRA,23,12,21,56
4273,2020-07-05,(06101) El Tiempo,97,74,94,265
4274,2020-06-20,(07003) SEVILLANA,361,189,238,788
4275,2020-06-29,(07007) NQS - Calle 38A Sur,191,116,134,441
4276,2020-08-27,(06107) Ciudad Universitaria,168,100,122,390
4277,2020-03-21,(12004) Carrera 22,14,15,31,60
4278,2020-05-10,(08002) Biblioteca,77,34,40,151
4279,2020-07-05,(07010) Bosa,200,81,171,452
4280,2020-04-13,(04107) Escuela Militar,52,32,43,127
4281,2020-05-26,(07108) Av. El Dorado,122,75,76,273
4282,2020-09-27,(08002) Biblioteca,115,54,118,287
4283,2020-03-27,(02000) Cabecera Autopista Norte - intermunicipal,139,109,90,338
4284,2020-07-19,(06107) Ciudad Universitaria,30,19,39,88
4285,2020-07-12,(10003) Ciudad Jardín,97,32,110,239
4286,2020-03-29,(07105) MOVISTAR ARENA,37,35,39,111
4287,2020-03-29,(07200) Tygua-San José,22,21,17,60
4288,2020-04-10,(07009) SENA,85,43,42,170
4289,2020-07-15,(14005) Las Aguas,155,93,148,396
4290,2020-05-10,(12002) CDS - Carrera 32,22,37,16,75
4291,2020-07-12,(09105) Río Fucha,47,18,51,116
4292,2020-08-24,(10005) Bicentenario,66,43,55,164
4293,2020-03-31,(06106) Recinto Ferial,136,84,86,306
4294,2020-04-12,(08002) Biblioteca,59,42,24,125
4295,2020-07-05,(10005) Bicentenario,24,13,27,64
4296,2019-12-31,(02304) Heroes,36,7,27,70
4297,2020-03-29,(10003) Ciudad Jardín,19,17,18,54
4298,2020-03-29,(02102) Calle 161,29,23,23,75
4299,2020-04-28,(50006) Corral Carrera 77,5,0,2,7
4300,2020-01-17,(50004) Corral Avenida Ciudad de Cali,1,1,0,2
4301,2020-02-20,(02502) Terminal,5175,3344,2801,11320
4302,2020-08-16,(09118) Marly,414,263,328,1005
4303,2020-08-22,(07504) TERREROS,4576,2225,2458,9259
4304,2020-02-25,(05000) Portal Américas - alimentacion,36993,22583,21647,81223
4305,2020-03-02,(05000) Portal Américas - alimentacion,36002,21295,21125,78422
4306,2020-08-26,(05000) Portal Américas - alimentacion,10358,5476,5345,21179
4307,2020-02-08,(07111) NQS - RICAURTE,2104,1516,1374,4994
4308,2020-01-04,(03002) SUBA - TV- 91,1261,583,925,2769
4309,2020-09-28,(50003) Corral Molinos,1582,817,1426,3825
4310,2020-07-08,(06107) Ciudad Universitaria,179,111,123,413
4311,2020-02-03,(14004) Museo del Oro,3909,2463,2106,8478
4312,2020-01-21,(04100) Carrera 77,4574,2310,2276,9160
4313,2020-01-07,(09000) Cabecera Usme - alimentacion,18761,9704,13284,41749
4314,2020-01-02,(05100) Banderas P. Central,2595,1553,1676,5824
4315,2020-08-25,(05100) Banderas P. Central,769,424,481,1674
4316,2020-04-25,(10001) Country Sur,424,201,300,925
4317,2020-09-09,(09100) Calle 40 Sur,1887,1111,1330,4328
4318,2020-05-26,(09115) Calle 34,610,385,360,1355
4319,2020-03-03,(06102) Salitre El Greco,1583,895,710,3188
4320,2020-01-30,(10002) Av. Primero de Mayo,8058,4019,4521,16598
4321,2020-02-13,(02204) Pepe Sierra,5103,3270,2496,10869
4322,2020-06-05,(09000) Cabecera Usme - alimentacion,8122,4639,4518,17279
4323,2020-04-25,(40003) Mirador del Paraiso,679,443,467,1589
4324,2020-05-05,(40003) Mirador del Paraiso,1080,646,691,2417
4325,2020-01-22,(09104) Restrepo,4908,2986,3845,11739
4326,2020-02-13,(09104) Restrepo,5629,3288,4073,12990
4327,2020-08-13,(09104) Restrepo,1546,840,1020,3406
4328,2020-02-05,(04100) Carrera 77,7013,4226,4138,15377
4329,2020-01-16,(06002) Normandía,2066,1153,1181,4400
4330,2020-01-26,(07112) COMUNEROS,881,426,854,2161
4331,2020-08-04,(08000) Portal Tunal - alimentacion,5814,3238,3310,12362
4332,2020-03-10,(03001) LA CAMPIÑA,191,2080,1508,3779
4333,2020-01-22,(03007) HUMEDAL CORDOBA,967,564,520,2051
4334,2020-02-17,(02103) Mazurén,3492,2280,1768,7540
4335,2020-01-20,(02001) Centro Comercial Santa Fe,4366,2793,2562,9721
4336,2020-09-09,(14001) La Sabana,185,111,123,419
4337,2020-03-20,(07111) NQS - RICAURTE,287,206,141,634
4338,2020-02-01,(02104) Calle 146,3357,1510,2970,7837
4339,2020-09-05,(04102) Avenida Boyaca,358,200,297,855
4340,2020-08-14,(09113) Calle 22,391,219,325,935
4341,2020-01-04,(09118) Marly,1811,1249,1513,4573
4342,2020-01-03,(02001) Centro Comercial Santa Fe,1864,1062,1366,4292
4343,2020-02-03,(04105) Carrera 53,1447,800,811,3058
4344,2020-07-05,(09001) Molinos,826,386,691,1903
4345,2020-07-13,(08000) Portal Tunal - alimentacion,3708,2220,2257,8185
4346,2020-06-26,(04000) Cabecera Calle 80,1180,687,895,2762
4347,2020-07-30,(07010) Bosa,622,318,389,1329
4348,2020-02-03,(09120) Calle 63,6953,4306,3828,15087
4349,2020-04-01,(04002) Carrera 90,313,173,140,626
4350,2020-03-08,(10001) Country Sur,853,352,1018,2223
4351,2020-05-11,(06000) Portal Eldorado,903,580,383,1866
4352,2020-08-08,(06000) Portal Eldorado - alimentacion,2471,1227,1455,5153
4353,2020-02-03,(12001) Carrera 43,1725,1029,1067,3821
4354,2020-02-21,(09107) Hortúa,2246,1337,1475,5058
4355,2020-04-02,(10005) Bicentenario - alimentacion,156,79,112,347
4356,2020-02-21,(02001) Centro Comercial Santa Fe,4803,2745,2589,10137
4357,2020-01-15,(06111) Universidades,2619,1671,1947,6237
4358,2020-05-11,(10006) San Victorino,320,193,224,737
4359,2020-02-29,(02201) Prado,3034,1593,2280,6907
4360,2020-06-13,(06105) Quinta Paredes,95,65,65,225
4361,2020-01-15,(09119) Calle 57,2587,1815,1787,6189
4362,2020-10-08,(03000) Portal Suba,1681,1017,1440,4138
4363,2020-07-14,(02000) Cabecera Autopista Norte - intermunicipal,466,301,310,1077
4364,2020-03-11,(10010) San Bernardo,1594,945,1246,3785
4365,2020-02-03,(06100) Av. Rojas,2746,1589,1293,5628
4366,2020-02-14,(09119) Calle 57,3755,2303,2167,8225
4367,2020-03-19,(09115) Calle 34,1864,1199,1116,4179
4368,2020-01-12,(02300) Calle 100,736,681,1164,2581
4369,2020-09-15,(09004) Santa Lucía,1934,1331,2209,5474
4370,2020-02-23,(04003) Avenida Ciudad de Cali,953,452,1043,2448
4371,2020-08-16,(07503) SAN MATEO,2787,1435,1583,5805
4372,2020-02-13,(05102) Av. Américas - Av. Boyacá,2017,1182,943,4142
4373,2020-08-09,(02101) Toberín,212,168,251,631
4374,2020-01-27,(06108) Concejo de Bogotá,867,435,433,1735
4375,2020-02-16,(02201) Prado,1086,569,1094,2749
4376,2020-07-03,(09107) Hortúa,673,378,418,1469
4377,2020-03-17,(05101) Mandalay - Cr.73,576,298,283,1157
4378,2020-04-20,(02300) Calle 100,807,581,399,1787
4379,2020-10-01,(03012) SUBA - CALLE 95,394,224,258,876
4380,2020-09-04,(10000) Portal 20 de Julio,2440,1196,1405,5041
4381,2020-07-25,(50002) Corral Calle 40 Sur,11,7,12,30
4382,2020-05-01,(02000) Cabecera Autopista Norte - alimentacion,1587,868,703,3158
4383,2020-09-20,(09123) Calle 76,241,188,335,764
4384,2020-08-01,(07002) MADELENA,469,257,387,1113
4385,2020-03-15,(05100) Banderas P. Central,648,286,656,1590
4386,2020-09-24,(07104) Simon Bolivar,639,397,374,1410
4387,2020-05-13,(08000) Portal Tunal,606,241,224,1071
4388,2020-09-19,(08000) Portal Tunal,613,311,414,1338
4389,2020-08-01,(06109) Centro Memoria,160,113,113,386
4390,2020-03-16,(07007) NQS - Calle 38A Sur,1468,837,808,3113
4391,2020-04-21,(08000) Portal Tunal,442,236,183,861
4392,2020-09-13,(07113) SANTA ISABEL,122,72,175,369
4393,2020-10-07,(09118) Marly,1576,1051,1180,3807
4394,2020-02-12,(04108) El Polo,2003,1221,1224,4448
4395,2020-09-26,(06000) Portal Eldorado - alimentacion,3383,1503,2458,7344
4396,2020-09-14,(06000) Portal Eldorado - alimentacion,3921,2011,2376,8308
4397,2020-02-13,(06101) El Tiempo,3089,1767,1365,6221
4398,2020-06-11,(10006) San Victorino,562,274,300,1136
4399,2020-01-03,(03005) SUBA - AV. BOYACA,1169,674,838,2681
4400,2020-05-04,(07000) Portal Sur,1103,733,671,2507
4401,2020-01-25,(07104) Simon Bolivar,1388,866,936,3190
4402,2020-08-03,(07104) Simon Bolivar,289,221,219,729
4403,2020-08-26,(07104) Simon Bolivar,598,339,250,1187
4404,2020-02-25,(07109) CAD,2895,1786,1442,6123
4405,2020-01-02,(02000) Cabecera Autopista Norte - intermunicipal,1769,1170,1317,4256
4406,2020-06-28,(02000) Cabecera Autopista Norte - intermunicipal,110,71,118,299
4407,2020-06-09,(09000) Cabecera Usme,1619,1011,1061,3691
4408,2020-04-22,(05103) Marsella,199,109,107,415
4409,2020-07-03,(05103) Marsella,472,235,268,975
4410,2020-01-16,(09109) Tercer Milenio,1199,723,814,2736
4411,2020-06-25,(09109) Tercer Milenio,357,223,251,831
4412,2020-02-24,(07104) Simon Bolivar,2286,1443,1191,4920
4413,2020-06-25,(05001) Patio Bonito,1966,1061,1143,4170
4414,2020-09-21,(03001) LA CAMPIÑA,1173,572,709,2454
4415,2020-04-13,(03002) SUBA - TV- 91,440,258,232,930
4416,2020-09-16,(03002) SUBA - TV- 91,917,556,623,2096
4417,2020-10-07,(09110) Avenida Jimenez,1670,1181,1168,4019
4418,2020-08-06,(06101) El Tiempo,283,172,198,653
4419,2020-07-22,(09121) Las Flores,584,350,382,1316
4420,2020-01-23,(40001) Juan Pablo II,1589,863,1011,3463
4421,2020-03-31,(05001) Patio Bonito,844,473,516,1833
4422,2020-04-19,(07113) SANTA ISABEL,56,42,36,134
4423,2020-05-29,(07113) SANTA ISABEL,368,250,227,845
4424,2020-05-22,(02105) Calle 142,652,424,380,1456
4425,2020-09-06,(06106) Recinto Ferial,82,43,81,206
4426,2020-05-13,(07009) SENA,480,304,291,1075
4427,2020-01-17,(07008) NQS - Calle 30 Sur,1662,803,972,3437
4428,2020-06-26,(12003) Ricaurte,421,298,214,933
4429,2020-02-23,(03010) PUENTE LARGO,265,199,322,786
4430,2020-08-27,(10010) San Bernardo,591,294,393,1278
4431,2020-05-04,(03009) Av. Suba- Calle 116,362,239,211,812
4432,2020-03-07,(04106) Carrera 47,915,449,687,2051
4433,2020-05-11,(06001) Modelia,316,218,168,702
4434,2020-03-22,(10000) Portal 20 de Julio - alimentacion,1028,407,515,1950
4435,2020-06-24,(05100) Banderas P. Central - alimentacion,2962,1655,1780,6397
4436,2020-08-30,(02104) Calle 146,276,178,257,711
4437,2020-07-02,(12007) Zona Industrial,362,214,176,752
4438,2020-01-13,(07201) Guatoque -Veraguas,813,432,587,1832
4439,2020-07-25,(10005) Bicentenario,78,45,42,165
4440,2020-01-15,(04102) Avenida Boyaca,2396,1374,1362,5132
4441,2020-03-18,(06103) CAN,1060,709,531,2300
4442,2020-03-29,(06002) Normandía,57,33,41,131
4443,2020-06-08,(06002) Normandía,288,191,158,637
4444,2020-06-16,(07003) SEVILLANA,467,259,216,942
4445,2020-06-30,(07003) SEVILLANA,440,262,227,929
4446,2020-02-01,(14001) La Sabana,248,237,301,786
4447,2020-08-28,(08002) Biblioteca,299,172,198,669
4448,2020-08-31,(08002) Biblioteca,323,179,190,692
4449,2020-03-04,(10005) Bicentenario,798,397,369,1564
4450,2020-08-29,(04107) Escuela Militar,88,68,101,257
4451,2020-04-30,(03012) SUBA - CALLE 95,216,124,136,476
4452,2020-08-24,(09115) Calle 34,473,358,359,1190
4453,2020-04-21,(07110) PALOQUEMAO,469,297,198,964
4454,2020-01-11,(14005) Las Aguas,604,422,787,1813
4455,2020-05-26,(02101) Toberín,1276,828,827,2931
4456,2020-08-29,(02101) Toberín,954,533,922,2409
4457,2020-01-05,(12004) Carrera 22,82,59,134,275
4458,2020-10-05,(07101) CASTELLANA,282,152,193,627
4459,2020-03-04,(09111) Calle 19,2331,1385,1612,5328
4460,2020-08-27,(04105) Carrera 53,292,150,144,586
4461,2020-04-01,(04000) Cabecera Calle 80,489,321,346,1156
4462,2020-05-22,(09114) Calle 26,232,180,183,595
4463,2020-05-06,(07201) Guatoque -Veraguas,119,72,80,271
4464,2020-02-04,(07506) DESPENSA,1640,946,913,3499
4465,2020-07-10,(09121) Las Flores,733,455,476,1664
4466,2020-08-31,(09121) Las Flores,701,445,438,1584
4467,2020-06-25,(10004) Policarpa,257,142,150,549
4468,2020-08-02,(06107) Ciudad Universitaria,40,27,47,114
4469,2020-10-06,(10010) San Bernardo,662,323,608,1593
4470,2020-09-28,(05102) Av. Américas - Av. Boyacá,286,152,267,705
4471,2020-05-11,(10007) Las Nieves,388,226,281,895
4472,2020-03-21,(05100) Banderas P. Central,207,101,131,439
4473,2020-09-28,(09122) Calle 72,1338,933,1075,3346
4474,2020-06-28,(02200) Alcalá,560,393,404,1357
4475,2020-06-23,(07506) DESPENSA,542,280,253,1075
4476,2020-04-08,(02001) Centro Comercial Santa Fe,173,121,124,418
4477,2020-06-14,(07111) NQS - RICAURTE,166,106,114,386
4478,2020-03-20,(10007) Las Nieves,193,117,130,440
4479,2020-04-24,(09115) Calle 34,373,294,217,884
4480,2020-06-01,(09111) Calle 19,699,425,450,1574
4481,2020-05-14,(04107) Escuela Militar,101,76,59,236
4482,2020-08-26,(03013) RIO NEGRO,289,153,194,636
4483,2020-09-26,(10009) Museo Nacional,283,259,472,1014
4484,2020-08-26,(09122) Calle 72,1121,735,708,2564
4485,2020-07-17,(07102) NQS - CALLE 75,455,285,212,952
4486,2020-08-26,(04103) Las Ferias,352,179,160,691
4487,2020-09-10,(07109) CAD,572,273,380,1225
4488,2020-09-19,(04001) Quirigua,379,184,333,896
4489,2020-02-26,(09105) Río Fucha,812,425,521,1758
4490,2020-01-05,(03012) SUBA - CALLE 95,226,137,253,616
4491,2019-12-31,(50003) Corral Molinos,30,31,100,161
4492,2020-05-02,(07001) PERDOMO,318,190,195,703
4493,2020-07-26,(04000) Cabecera Calle 80,248,159,237,644
4494,2020-09-30,(07108) Av. El Dorado,181,118,131,430
4495,2020-04-18,(06002) Normandía,95,64,56,215
4496,2020-06-24,(09108) Hospital,75,44,56,175
4497,2020-08-19,(09108) Hospital,69,39,62,170
4498,2020-01-19,(04000) Cabecera Calle 80,1231,615,1473,3319
4499,2020-01-19,(09003) Socorro,501,199,418,1118
4500,2020-07-31,(07006) General Santander - alimentacion,335,188,229,752
4501,2020-09-23,(02102) Calle 161,307,188,213,708
4502,2020-05-08,(04103) Las Ferias,239,152,132,523
4503,2020-05-09,(02204) Pepe Sierra,405,284,182,871
4504,2020-01-10,(09105) Río Fucha,554,295,441,1290
4505,2020-03-24,(07105) MOVISTAR ARENA,235,204,175,614
4506,2020-04-01,(07006) General Santander - alimentacion,177,117,145,439
4507,2020-04-25,(10005) Bicentenario - alimentacion,120,58,98,276
4508,2020-04-16,(09117) Calle 45,449,287,271,1007
4509,2020-05-04,(06105) Quinta Paredes,81,67,46,194
4510,2020-01-17,(03004) GRATAMIRA,273,136,143,552
4511,2020-05-23,(06111) Universidades,0,105,289,394
4512,2020-05-10,(09115) Calle 34,131,94,81,306
4513,2020-07-15,(03005) SUBA - AV. BOYACA,401,227,214,842
4514,2020-03-25,(02303) Calle 85,333,271,221,825
4515,2020-04-11,(04000) Cabecera Calle 80,252,166,182,600
4516,2020-05-27,(06106) Recinto Ferial,211,141,89,441
4517,2020-05-17,(04103) Las Ferias,109,47,55,211
4518,2020-02-26,(50002) Corral Calle 40 Sur,131,86,124,341
4519,2020-07-30,(07006) General Santander - alimentacion,375,205,262,842
4520,2020-03-28,(09101) Quiroga,116,89,104,309
4521,2020-04-28,(07008) NQS - Calle 30 Sur,168,99,88,355
4522,2020-04-12,(40001) Juan Pablo II,86,51,45,182
4523,2020-04-30,(04107) Escuela Militar,68,49,55,172
4524,2020-10-11,(03012) SUBA - CALLE 95,89,57,120,266
4525,2020-04-08,(03004) GRATAMIRA,21,11,14,46
4526,2020-07-28,(14005) Las Aguas,168,119,161,448
4527,2020-04-01,(09003) Socorro,243,118,154,515
4528,2020-08-07,(04102) Avenida Boyaca,112,70,90,272
4529,2020-07-15,(09105) Río Fucha,95,36,62,193
4530,2020-05-25,(04003) Avenida Ciudad de Cali,238,142,210,590
4531,2020-04-07,(07101) CASTELLANA,65,57,62,184
4532,2020-08-24,(06105) Quinta Paredes,121,73,72,266
4533,2020-07-26,(07200) Tygua-San José,43,30,51,124
4534,2020-04-25,(07200) Tygua-San José,102,67,71,240
4535,2020-01-05,(07201) Guatoque -Veraguas,83,54,166,303
4536,2020-04-27,(09108) Hospital,18,18,11,47
4537,2020-07-19,(06100) Av. Rojas,35,29,57,121
4538,2020-06-28,(14005) Las Aguas,51,43,83,177
4539,2020-10-05,(03014) SAN MARTIN,0,22,61,83
4540,2020-02-11,(04000) Cabecera Calle 80 - alimentacion,25417,15391,15142,55950
4541,2020-09-22,(09002) Consuelo,528,299,383,1210
4542,2020-03-04,(02502) Terminal,5343,3373,3055,11771
4543,2020-08-02,(09118) Marly,434,291,266,991
4544,2020-01-03,(07504) TERREROS,10007,5508,6037,21552
4545,2020-04-15,(07504) TERREROS,2377,1577,1214,5168
4546,2020-08-06,(07504) TERREROS,5702,2999,2887,11588
4547,2020-07-28,(09119) Calle 57,531,340,347,1218
4548,2020-02-15,(07503) SAN MATEO,28090,13791,14606,56487
4549,2020-01-25,(02200) Alcalá,5911,3033,3882,12826
4550,2020-01-15,(06000) Portal Eldorado - alimentacion,14842,7745,8462,31049
4551,2020-03-01,(05000) Portal Américas - alimentacion,9365,3936,6964,20265
4552,2020-01-02,(06107) Ciudad Universitaria,305,216,410,931
4553,2020-09-01,(06107) Ciudad Universitaria,191,106,135,432
4554,2020-10-06,(06107) Ciudad Universitaria,213,136,184,533
4555,2020-03-14,(09001) Molinos,4971,2398,3864,11233
4556,2020-09-11,(04103) Las Ferias,336,193,188,717
4557,2020-01-16,(07000) Portal Sur - alimentacion,25479,13189,13287,51955
4558,2020-10-01,(07112) COMUNEROS,937,521,783,2241
4559,2020-09-24,(10001) Country Sur,1468,625,958,3051
4560,2020-08-13,(40001) Juan Pablo II,320,304,511,1135
4561,2020-01-12,(10003) Ciudad Jardín,203,93,222,518
4562,2020-07-31,(10000) Portal 20 de Julio - alimentacion,3842,1705,2341,7888
4563,2020-01-22,(07505) LEON XIII,7920,4494,3841,16255
4564,2020-07-10,(07102) NQS - CALLE 75,461,303,300,1064
4565,2020-07-15,(09000) Cabecera Usme - alimentacion,5507,3208,3286,12001
4566,2020-02-06,(02001) Centro Comercial Santa Fe,4772,3052,2648,10472
4567,2020-05-26,(07000) Portal Sur - alimentacion,6917,3971,3234,14122
4568,2020-07-09,(07000) Portal Sur - alimentacion,8308,4751,4160,17219
4569,2020-04-22,(09103) Olaya,539,318,277,1134
4570,2020-08-06,(09103) Olaya,954,530,538,2022
4571,2020-09-24,(09103) Olaya,1119,623,739,2481
4572,2020-09-24,(14001) La Sabana,176,102,152,430
4573,2020-07-17,(07111) NQS - RICAURTE,857,560,396,1813
4574,2020-07-18,(02000) Cabecera Autopista Norte - alimentacion,3488,1784,1948,7220
4575,2020-03-30,(07112) COMUNEROS,366,244,217,827
4576,2020-07-07,(02000) Cabecera Autopista Norte,1412,891,904,3207
4577,2020-09-16,(02000) Cabecera Autopista Norte,1641,990,1108,3739
4578,2020-05-18,(04102) Avenida Boyaca,235,148,189,572
4579,2020-01-31,(07007) NQS - Calle 38A Sur,2102,1168,1302,4572
4580,2020-04-22,(50003) Corral Molinos,791,391,537,1719
4581,2020-02-08,(04002) Carrera 90,2106,960,1619,4685
4582,2020-07-02,(10000) Portal 20 de Julio - alimentacion,4480,2069,2654,9203
4583,2020-01-23,(10000) Portal 20 de Julio,8392,3783,3733,15908
4584,2020-01-28,(04001) Quirigua,1962,1157,1132,4251
4585,2020-07-18,(07000) Portal Sur - alimentacion,5687,3047,2885,11619
4586,2020-03-14,(10002) Av. Primero de Mayo,4229,2169,3529,9927
4587,2020-02-14,(09107) Hortúa,2428,1437,1579,5444
4588,2020-03-01,(10000) Portal 20 de Julio,2140,787,1573,4500
4589,2020-08-03,(10000) Portal 20 de Julio - alimentacion,3805,1701,2310,7816
4590,2020-02-26,(08002) Biblioteca,1038,549,650,2237
4591,2020-06-19,(02303) Calle 85,767,517,405,1689
4592,2020-01-31,(02001) Centro Comercial Santa Fe,4713,2724,2719,10156
4593,2020-02-02,(09004) Santa Lucía,2226,882,1890,4998
4594,2020-06-18,(09004) Santa Lucía,2642,1398,1474,5514
4595,2020-07-10,(09004) Santa Lucía,2703,1463,1439,5605
4596,2020-08-02,(09004) Santa Lucía,773,329,513,1615
4597,2020-09-02,(07108) Av. El Dorado,174,107,120,401
4598,2020-06-09,(08001) Parque el Tunal,483,270,237,990
4599,2020-06-23,(08001) Parque el Tunal,491,286,277,1054
4600,2020-03-17,(02103) Mazurén,1288,837,765,2890
4601,2020-06-28,(10001) Country Sur,348,142,321,811
4602,2020-09-13,(10001) Country Sur,384,162,372,918
4603,2020-02-22,(03003) 21 ANGELES,977,402,635,2014
4604,2020-05-25,(04000) Cabecera Calle 80 - alimentacion,946,545,649,2140
4605,2020-01-25,(06108) Concejo de Bogotá,307,216,348,871
4606,2020-02-08,(05100) Banderas P. Central,3414,1499,2609,7522
4607,2020-08-21,(06102) Salitre El Greco,179,113,137,429
4608,2020-08-23,(09004) Santa Lucía,776,315,505,1596
4609,2020-08-22,(40003) Mirador del Paraiso,1377,772,945,3094
4610,2020-04-05,(09107) Hortúa,157,117,75,349
4611,2020-04-15,(09123) Calle 76,521,418,265,1204
4612,2020-07-28,(02204) Pepe Sierra,739,532,367,1638
4613,2020-03-29,(05002) Tintal,322,205,212,739
4614,2020-02-05,(03011) SUBA - CALLE 100,2712,1380,1533,5625
4615,2020-04-28,(02300) Calle 100,869,609,434,1912
4616,2020-02-05,(03012) SUBA - CALLE 95,1519,895,1071,3485
4617,2020-02-21,(03012) SUBA - CALLE 95,1395,900,1029,3324
4618,2020-08-08,(03012) SUBA - CALLE 95,151,97,120,368
4619,2020-01-18,(50002) Corral Calle 40 Sur,52,32,69,153
4620,2020-05-03,(02000) Cabecera Autopista Norte - alimentacion,1225,650,610,2485
4621,2020-07-24,(05005) Transversal 86,224,157,166,547
4622,2020-07-31,(02202) Calle 127,976,678,516,2170
4623,2020-03-12,(04105) Carrera 53,273,214,189,676
4624,2020-09-10,(02205) Calle 106,327,222,257,806
4625,2020-04-27,(09101) Quiroga,199,18,37,254
4626,2020-01-18,(07101) CASTELLANA,361,259,423,1043
4627,2020-10-02,(06000) Portal Eldorado - alimentacion,4544,2182,3042,9768
4628,2020-06-12,(07106) EL CAMPIN,359,256,225,840
4629,2020-02-17,(07113) SANTA ISABEL,2119,1329,1406,4854
4630,2020-10-03,(06111) Universidades,370,212,476,1058
4631,2020-05-28,(03007) HUMEDAL CORDOBA,129,96,57,282
4632,2020-09-04,(04104) Avenida 68,683,340,408,1431
4633,2020-03-01,(05101) Mandalay - Cr.73,116,51,131,298
4634,2020-07-08,(09100) Calle 40 Sur,1869,1127,1230,4226
4635,2020-05-08,(07104) Simon Bolivar,314,192,181,687
4636,2020-02-16,(09119) Calle 57,675,402,857,1934
4637,2020-03-17,(08001) Parque el Tunal,1193,636,638,2467
4638,2020-04-19,(03006) NIZA - CALLE 127,110,89,45,244
4639,2020-08-06,(09121) Las Flores,622,385,365,1372
4640,2020-02-22,(05103) Marsella,1547,731,1045,3323
4641,2020-09-25,(09109) Tercer Milenio,375,232,287,894
4642,2020-09-01,(04002) Carrera 90,695,395,428,1518
4643,2020-08-31,(07002) MADELENA,805,466,577,1848
4644,2020-03-18,(06105) Quinta Paredes,434,259,221,914
4645,2020-08-29,(04104) Avenida 68,435,256,316,1007
4646,2020-06-29,(09000) Cabecera Usme - alimentacion,2963,1500,1876,6339
4647,2020-05-09,(02202) Calle 127,661,426,300,1387
4648,2020-05-15,(03011) SUBA - CALLE 100,341,193,196,730
4649,2020-03-29,(02205) Calle 106,50,39,51,140
4650,2020-04-30,(03001) LA CAMPIÑA,618,368,316,1302
4651,2020-02-24,(04101) Minuto de Dios,3597,2188,1687,7472
4652,2020-04-08,(02302) Virrey,310,235,184,729
4653,2020-04-03,(04100) Carrera 77,598,333,383,1314
4654,2020-09-21,(03006) NIZA - CALLE 127,395,239,246,880
4655,2020-08-12,(05107) Américas - Cr.53,403,240,231,874
4656,2020-07-10,(10002) Av. Primero de Mayo,2336,1182,1452,4970
4657,2020-06-10,(12007) Zona Industrial,322,229,146,697
4658,2020-07-02,(10005) Bicentenario,129,56,87,272
4659,2020-01-18,(06001) Modelia,862,545,865,2272
4660,2020-01-20,(12002) CDS - Carrera 32,523,314,280,1117
4661,2020-03-27,(05100) Banderas P. Central - alimentacion,1494,666,710,2870
4662,2020-05-02,(02000) Cabecera Autopista Norte,452,313,273,1038
4663,2020-06-30,(10008) San Diego,302,152,178,632
4664,2020-07-10,(10008) San Diego,297,186,219,702
4665,2020-08-31,(10008) San Diego,255,156,179,590
4666,2020-05-30,(03011) SUBA - CALLE 100,298,172,169,639
4667,2020-09-13,(10009) Museo Nacional,79,88,182,349
4668,2020-07-12,(12007) Zona Industrial,63,65,58,186
4669,2020-06-11,(06111) Universidades,0,155,366,521
4670,2020-07-21,(06111) Universidades,255,156,243,654
4671,2020-09-17,(09115) Calle 34,710,423,555,1688
4672,2020-05-30,(09115) Calle 34,360,255,261,876
4673,2020-05-15,(02204) Pepe Sierra,620,448,296,1364
4674,2020-04-23,(02104) Calle 146,405,264,226,895
4675,2020-03-01,(04101) Minuto de Dios,432,244,576,1252
4676,2020-01-02,(14005) Las Aguas,703,457,677,1837
4677,2020-09-26,(09103) Olaya,977,459,697,2133
4678,2020-05-14,(09122) Calle 72,876,590,522,1988
4679,2020-10-02,(06104) Gobernación,311,189,189,689
4680,2020-08-29,(07105) MOVISTAR ARENA,168,120,158,446
4681,2020-03-31,(12007) Zona Industrial,143,131,80,354
4682,2020-06-27,(07107) U. NACIONAL,242,177,158,577
4683,2020-06-30,(07107) U. NACIONAL,340,194,199,733
4684,2020-10-08,(09114) Calle 26,381,251,364,996
4685,2020-05-23,(03003) 21 ANGELES,211,89,115,415
4686,2020-08-06,(03003) 21 ANGELES,266,129,141,536
4687,2020-07-09,(10007) Las Nieves,710,401,400,1511
4688,2020-01-05,(07105) MOVISTAR ARENA,153,110,251,514
4689,2020-06-28,(40001) Juan Pablo II,182,97,122,401
4690,2020-02-08,(40002) Manitas,960,538,706,2204
4691,2020-10-11,(40002) Manitas,150,68,170,388
4692,2020-07-28,(03011) SUBA - CALLE 100,503,226,230,959
4693,2020-01-07,(10004) Policarpa,539,300,475,1314
4694,2020-01-08,(40002) Manitas,941,553,671,2165
4695,2020-03-04,(50002) Corral Calle 40 Sur,116,110,157,383
4696,2020-06-07,(12001) Carrera 43,54,39,66,159
4697,2020-07-28,(09121) Las Flores,615,365,380,1360
4698,2020-01-15,(02102) Calle 161,1618,921,1003,3542
4699,2020-05-28,(06002) Normandía,279,159,162,600
4700,2020-07-01,(12004) Carrera 22,269,126,171,566
4701,2020-07-06,(03013) RIO NEGRO,293,181,199,673
4702,2020-03-12,(04106) Carrera 47,296,195,201,692
4703,2020-05-02,(09110) Avenida Jimenez,335,272,293,900
4704,2020-07-09,(03006) NIZA - CALLE 127,520,281,264,1065
4705,2020-06-19,(09113) Calle 22,453,255,368,1076
4706,2020-05-12,(10004) Policarpa,179,92,108,379
4707,2020-03-21,(10000) Portal 20 de Julio,706,329,327,1362
4708,2020-09-06,(07008) NQS - Calle 30 Sur,120,63,116,299
4709,2020-09-26,(07008) NQS - Calle 30 Sur,315,167,238,720
4710,2020-05-27,(03012) SUBA - CALLE 95,311,195,164,670
4711,2020-01-19,(07008) NQS - Calle 30 Sur,435,182,422,1039
4712,2020-08-07,(07006) General Santander,229,126,148,503
4713,2020-07-09,(07506) DESPENSA,498,263,281,1042
4714,2020-04-07,(02300) Calle 100,704,541,405,1650
4715,2020-02-04,(09105) Río Fucha,792,507,517,1816
4716,2020-08-18,(07106) EL CAMPIN,327,224,207,758
4717,2020-05-02,(03011) SUBA - CALLE 100,209,127,107,443
4718,2020-03-08,(07506) DESPENSA,272,160,339,771
4719,2020-06-27,(12002) CDS - Carrera 32,117,80,74,271
4720,2020-08-02,(12001) Carrera 43,57,46,63,166
4721,2020-08-03,(07107) U. NACIONAL,324,166,178,668
4722,2020-08-16,(09117) Calle 45,201,129,192,522
4723,2020-03-23,(04003) Avenida Ciudad de Cali,218,148,155,521
4724,2020-03-28,(03010) PUENTE LARGO,167,131,81,379
4725,2020-07-10,(10004) Policarpa,287,140,162,589
4726,2020-05-25,(10004) Policarpa,85,47,74,206
4727,2020-05-03,(10005) Bicentenario,17,10,20,47
4728,2020-06-22,(07007) NQS - Calle 38A Sur,173,94,120,387
4729,2020-03-25,(07004) VENECIA,524,354,274,1152
4730,2020-08-30,(07010) Bosa,188,67,155,410
4731,2020-08-02,(14004) Museo del Oro,18,19,46,83
4732,2020-08-21,(14004) Museo del Oro,110,148,235,493
4733,2020-05-21,(09105) Río Fucha,112,57,68,237
4734,2020-06-22,(06101) El Tiempo,118,58,76,252
4735,2020-03-28,(04108) El Polo,81,67,64,212
4736,2020-05-03,(07002) MADELENA,105,55,75,235
4737,2020-09-24,(06100) Av. Rojas,296,167,199,662
4738,2020-04-14,(10008) San Diego,146,104,69,319
4739,2020-08-09,(09106) Nariño,115,68,117,300
4740,2020-07-17,(06106) Recinto Ferial,238,132,111,481
4741,2020-03-28,(04003) Avenida Ciudad de Cali,319,209,241,769
4742,2020-04-07,(10005) Bicentenario - alimentacion,158,73,94,325
4743,2020-07-15,(07003) SEVILLANA,352,206,183,741
4744,2020-04-09,(07113) SANTA ISABEL,80,45,60,185
4745,2020-08-09,(10003) Ciudad Jardín,73,31,69,173
4746,2020-04-25,(07109) CAD,303,216,130,649
4747,2020-05-18,(07101) CASTELLANA,144,98,92,334
4748,2020-05-03,(07108) Av. El Dorado,18,18,17,53
4749,2020-08-25,(09105) Río Fucha,0,66,124,190
4750,2020-09-19,(12004) Carrera 22,224,147,153,524
4751,2020-04-19,(09002) Consuelo,82,46,49,177
4752,2020-08-16,(07201) Guatoque -Veraguas,34,24,42,100
4753,2020-04-20,(09108) Hospital,42,26,39,107
4754,2020-07-18,(14004) Museo del Oro,110,91,124,325
4755,2020-04-10,(03007) HUMEDAL CORDOBA,35,28,22,85
4756,2020-05-09,(05101) Mandalay - Cr.73,54,31,15,100
4757,2020-06-21,(05101) Mandalay - Cr.73,23,13,13,49
4758,2020-02-17,(50006) Corral Carrera 77,36,17,51,104
4759,2020-07-19,(07113) SANTA ISABEL,96,46,85,227
4760,2020-05-07,(10005) Bicentenario,79,31,66,176
4761,2020-05-03,(07101) CASTELLANA,15,16,28,59
4762,2020-08-09,(50002) Corral Calle 40 Sur,7,3,4,14
4763,2020-05-03,(02102) Calle 161,30,28,25,83
4764,2020-05-22,(04000) Cabecera Calle 80 - alimentacion,3355,1876,1985,7216
4765,2020-07-15,(02502) Terminal,361,270,288,919
4766,2020-07-27,(02502) Terminal,388,280,333,1001
4767,2020-02-29,(09118) Marly,3832,2617,3128,9577
4768,2020-04-22,(07504) TERREROS,2553,1690,1229,5472
4769,2020-01-15,(05000) Portal Américas - alimentacion,32679,17980,18320,68979
4770,2020-03-03,(03010) PUENTE LARGO,2076,1434,1248,4758
4771,2020-02-20,(09003) Socorro,1478,968,1051,3497
4772,2020-06-13,(04101) Minuto de Dios,235,135,170,540
4773,2020-01-14,(07503) SAN MATEO,35986,19980,16669,72635
4774,2020-03-16,(06107) Ciudad Universitaria,761,492,531,1784
4775,2020-08-26,(09001) Molinos,2464,1289,1573,5326
4776,2020-02-01,(02000) Cabecera Autopista Norte - alimentacion,14256,6587,9938,30781
4777,2020-02-25,(02000) Cabecera Autopista Norte - intermunicipal,5090,3476,3033,11599
4778,2020-01-29,(05005) Transversal 86,2684,1524,1283,5491
4779,2020-02-05,(05005) Transversal 86,2882,1611,1359,5852
4780,2020-09-22,(07112) COMUNEROS,900,518,643,2061
4781,2020-02-08,(03000) Portal Suba,4454,2072,3718,10244
4782,2020-01-29,(09004) Santa Lucía,7255,4068,4045,15368
4783,2020-03-04,(09000) Cabecera Usme,5865,3482,3985,13332
4784,2020-02-04,(05100) Banderas P. Central - alimentacion,15927,9268,8693,33888
4785,2020-02-21,(07009) SENA,3764,2124,1961,7849
4786,2020-02-08,(02204) Pepe Sierra,2061,1456,1647,5164
4787,2020-02-18,(07113) SANTA ISABEL,2216,1351,1460,5027
4788,2020-08-28,(40003) Mirador del Paraiso,1736,1072,1096,3904
4789,2020-09-03,(09104) Restrepo,1722,988,1341,4051
4790,2020-07-23,(07505) LEON XIII,2387,1262,993,4642
4791,2020-03-07,(07504) TERREROS,11689,5800,7552,25041
4792,2020-08-06,(09000) Cabecera Usme,1580,897,1123,3600
4793,2020-03-03,(09117) Calle 45,6604,4243,3066,13913
4794,2020-03-11,(09123) Calle 76,5484,3659,3072,12215
4795,2020-03-16,(07111) NQS - RICAURTE,2690,1666,1197,5553
4796,2020-07-03,(10000) Portal 20 de Julio - alimentacion,4443,2101,2799,9343
4797,2020-06-16,(09101) Quiroga,524,293,397,1214
4798,2020-01-28,(04100) Carrera 77,6406,3766,3694,13866
4799,2020-04-27,(09118) Marly,202,476,192,870
4800,2020-03-09,(09103) Olaya,355,1109,769,2233
4801,2020-06-25,(09103) Olaya,1096,595,635,2326
4802,2020-05-30,(09110) Avenida Jimenez,790,590,546,1926
4803,2020-01-24,(07110) PALOQUEMAO,2302,1404,1064,4770
4804,2020-08-15,(50003) Corral Molinos,1266,605,983,2854
4805,2020-01-25,(02101) Toberín,5609,2550,4537,12696
4806,2020-09-26,(09113) Calle 22,380,237,382,999
4807,2020-02-15,(09000) Cabecera Usme - alimentacion,18605,9260,13164,41029
4808,2020-09-20,(09004) Santa Lucía,990,386,805,2181
4809,2020-05-11,(50003) Corral Molinos,1056,512,737,2305
4810,2020-05-05,(04000) Cabecera Calle 80,740,475,519,1734
4811,2020-01-04,(10001) Country Sur,1743,687,1343,3773
4812,2020-02-19,(10001) Country Sur,5174,2372,2757,10303
4813,2020-04-14,(09111) Calle 19,257,169,213,639
4814,2020-03-03,(12001) Carrera 43,1609,1008,1080,3697
4815,2020-03-05,(12001) Carrera 43,1634,936,1103,3673
4816,2020-09-08,(10002) Av. Primero de Mayo,2212,1173,1423,4808
4817,2020-01-24,(09107) Hortúa,2184,1294,1415,4893
4818,2020-01-27,(09107) Hortúa,2302,1356,1532,5190
4819,2020-06-17,(06105) Quinta Paredes,134,86,71,291
4820,2020-07-14,(10000) Portal 20 de Julio - alimentacion,2614,1276,1631,5521
4821,2020-01-13,(09116) Avenida 39,2028,1368,1299,4695
4822,2020-01-29,(08002) Biblioteca,1012,551,623,2186
4823,2020-06-21,(10000) Portal 20 de Julio,725,335,462,1522
4824,2020-09-08,(10000) Portal 20 de Julio,2274,1118,1282,4674
4825,2020-09-03,(07112) COMUNEROS,900,501,564,1965
4826,2020-05-24,(07000) Portal Sur - alimentacion,1965,972,943,3880
4827,2020-09-01,(10002) Av. Primero de Mayo,2208,1169,1430,4807
4828,2020-09-30,(08001) Parque el Tunal,521,295,329,1145
4829,2020-06-17,(02101) Toberín,1510,995,959,3464
4830,2020-07-30,(02101) Toberín,1405,859,897,3161
4831,2020-01-31,(09123) Calle 76,4890,3397,3151,11438
4832,2020-02-25,(06108) Concejo de Bogotá,929,431,444,1804
4833,2020-06-25,(10002) Av. Primero de Mayo,2240,1143,1368,4751
4834,2020-02-06,(07001) PERDOMO,4567,2749,2547,9863
4835,2020-08-02,(40003) Mirador del Paraiso,577,274,443,1294
4836,2020-04-23,(09107) Hortúa,449,280,193,922
4837,2020-07-31,(09123) Calle 76,886,622,536,2044
4838,2020-07-11,(05002) Tintal,1872,1026,1302,4200
4839,2020-01-03,(05105) Pradera,1157,785,789,2731
4840,2020-03-01,(05103) Marsella,459,215,432,1106
4841,2020-02-27,(03007) HUMEDAL CORDOBA,1034,660,522,2216
4842,2020-01-17,(03011) SUBA - CALLE 100,2156,1140,1293,4589
4843,2020-08-19,(03012) SUBA - CALLE 95,306,178,162,646
4844,2020-02-22,(07006) General Santander,1601,754,1198,3553
4845,2020-05-01,(09104) Restrepo,450,300,334,1084
4846,2020-06-22,(09104) Restrepo,530,365,437,1332
4847,2020-04-03,(05005) Transversal 86,177,108,88,373
4848,2020-06-21,(05005) Transversal 86,112,49,73,234
4849,2020-06-24,(05005) Transversal 86,435,222,252,909
4850,2020-08-05,(05005) Transversal 86,272,173,200,645
4851,2020-06-28,(02202) Calle 127,355,274,223,852
4852,2020-07-20,(05000) Portal Américas - alimentacion,3391,1560,1610,6561
4853,2020-03-04,(04108) El Polo,1918,1226,1249,4393
4854,2020-03-16,(04108) El Polo,1386,899,802,3087
4855,2020-08-24,(04108) El Polo,438,277,212,927
4856,2020-06-17,(06000) Portal Eldorado - alimentacion,3968,2105,1927,8000
4857,2020-06-19,(02200) Alcalá,1966,1346,1112,4424
4858,2020-09-19,(06111) Universidades,357,168,464,989
4859,2020-06-12,(03007) HUMEDAL CORDOBA,156,107,67,330
4860,2020-06-17,(09100) Calle 40 Sur,1811,1079,1075,3965
4861,2020-07-23,(07002) MADELENA,574,319,384,1277
4862,2020-03-30,(08000) Portal Tunal,345,189,192,726
4863,2020-08-28,(02000) Cabecera Autopista Norte - alimentacion,4765,2508,2903,10176
4864,2020-03-10,(05103) Marsella,186,818,438,1442
4865,2020-09-27,(09109) Tercer Milenio,119,75,158,352
4866,2020-02-03,(06000) Portal Eldorado,6672,3860,2837,13369
4867,2020-06-23,(07004) VENECIA,1065,634,598,2297
4868,2020-06-08,(04105) Carrera 53,273,157,162,592
4869,2020-07-28,(04104) Avenida 68,582,312,371,1265
4870,2020-06-17,(02104) Calle 146,753,501,466,1720
4871,2020-07-06,(09110) Avenida Jimenez,1508,966,973,3447
4872,2020-04-14,(03011) SUBA - CALLE 100,270,152,136,558
4873,2020-04-29,(05001) Patio Bonito,1148,603,578,2329
4874,2020-03-31,(04108) El Polo,189,151,122,462
4875,2020-03-24,(02001) Centro Comercial Santa Fe,393,242,339,974
4876,2020-06-06,(07009) SENA,478,232,300,1010
4877,2020-06-23,(07009) SENA,673,411,370,1454
4878,2020-01-24,(03013) RIO NEGRO,1176,715,875,2766
4879,2020-04-03,(03010) PUENTE LARGO,185,150,129,464
4880,2020-07-05,(03010) PUENTE LARGO,85,59,74,218
4881,2020-05-19,(05100) Banderas P. Central,511,326,349,1186
4882,2020-01-12,(07200) Tygua-San José,149,94,237,480
4883,2020-09-02,(09109) Tercer Milenio,386,231,245,862
4884,2020-04-25,(09116) Avenida 39,132,86,77,295
4885,2020-08-12,(03006) NIZA - CALLE 127,359,218,209,786
4886,2020-03-11,(10005) Bicentenario,755,419,366,1540
4887,2020-09-16,(02103) Mazurén,222,152,218,592
4888,2020-03-08,(10005) Bicentenario,62,52,132,246
4889,2020-06-25,(40002) Manitas,418,255,281,954
4890,2020-06-01,(02001) Centro Comercial Santa Fe,429,253,268,950
4891,2020-05-23,(03001) LA CAMPIÑA,562,291,346,1199
4892,2020-05-12,(10005) Bicentenario,88,52,48,188
4893,2020-04-24,(09120) Calle 63,607,442,361,1410
4894,2020-09-29,(08000) Portal Tunal,834,363,372,1569
4895,2020-07-12,(09103) Olaya,412,227,315,954
4896,2020-06-02,(10009) Museo Nacional,457,267,253,977
4897,2020-08-11,(05105) Pradera,587,302,269,1158
4898,2020-08-21,(05105) Pradera,534,310,269,1113
4899,2020-05-19,(02104) Calle 146,607,387,339,1333
4900,2020-08-02,(07006) General Santander,141,73,116,330
4901,2020-03-17,(14005) Las Aguas,1029,689,802,2520
4902,2020-03-07,(04105) Carrera 53,790,447,641,1878
4903,2020-09-09,(07101) CASTELLANA,278,132,138,548
4904,2020-09-07,(07200) Tygua-San José,217,120,164,501
4905,2020-10-08,(07000) Portal Sur,2312,1350,1721,5383
4906,2020-08-02,(02202) Calle 127,312,237,210,759
4907,2020-07-05,(03012) SUBA - CALLE 95,86,58,82,226
4908,2020-04-20,(09122) Calle 72,652,466,354,1472
4909,2020-01-05,(02202) Calle 127,775,557,756,2088
4910,2020-10-06,(04105) Carrera 53,337,165,266,768
4911,2020-10-02,(50002) Corral Calle 40 Sur,33,15,42,90
4912,2020-05-19,(02302) Virrey,496,348,265,1109
4913,2020-04-28,(09121) Las Flores,429,282,269,980
4914,2020-10-11,(02200) Alcalá,605,402,602,1609
4915,2020-03-03,(04102) Avenida Boyaca,3021,1843,1637,6501
4916,2020-05-17,(09123) Calle 76,176,128,138,442
4917,2020-08-21,(06000) Portal Eldorado,916,594,518,2028
4918,2020-08-08,(02304) Heroes,464,346,382,1192
4919,2020-06-09,(08002) Biblioteca,288,162,168,618
4920,2020-04-12,(07006) General Santander - alimentacion,55,43,55,153
4921,2020-04-27,(07103) AV. CHILE,117,267,121,505
4922,2020-07-25,(07109) CAD,320,214,199,733
4923,2020-07-24,(09111) Calle 19,455,264,342,1061
4924,2020-03-29,(09000) Cabecera Usme,284,131,162,577
4925,2020-04-23,(07005) ALQUERIA,304,169,143,616
4926,2020-05-17,(10004) Policarpa,70,38,71,179
4927,2020-06-28,(09118) Marly,511,329,323,1163
4928,2020-03-29,(08000) Portal Tunal,132,84,57,273
4929,2020-04-01,(09000) Cabecera Usme,829,410,617,1856
4930,2020-04-24,(12002) CDS - Carrera 32,200,127,67,394
4931,2020-03-20,(40001) Juan Pablo II,221,117,100,438
4932,2020-06-28,(04105) Carrera 53,101,56,70,227
4933,2020-07-23,(04102) Avenida Boyaca,319,166,154,639
4934,2020-05-06,(07108) Av. El Dorado,84,55,49,188
4935,2020-10-02,(04001) Quirigua,507,301,405,1213
4936,2020-10-03,(04001) Quirigua,393,190,336,919
4937,2020-04-20,(04102) Avenida Boyaca,151,104,100,355
4938,2020-10-02,(07110) PALOQUEMAO,706,438,467,1611
4939,2020-09-20,(04108) El Polo,115,72,153,340
4940,2020-06-07,(07004) VENECIA,257,116,177,550
4941,2020-03-26,(04103) Las Ferias,164,111,96,371
4942,2020-09-13,(02304) Heroes,215,179,170,564
4943,2020-05-15,(07108) Av. El Dorado,108,67,66,241
4944,2020-05-25,(10005) Bicentenario - alimentacion,61,32,65,158
4945,2020-06-26,(07506) DESPENSA,511,268,248,1027
4946,2020-05-26,(14005) Las Aguas,0,62,194,256
4947,2020-08-19,(10008) San Diego,247,139,158,544
4948,2020-04-24,(12001) Carrera 43,300,174,140,614
4949,2020-08-22,(02000) Cabecera Autopista Norte - intermunicipal,333,179,279,791
4950,2020-08-19,(12007) Zona Industrial,313,190,149,652
4951,2020-04-23,(05100) Banderas P. Central,357,218,207,782
4952,2020-07-15,(09108) Hospital,53,38,51,142
4953,2020-04-13,(06102) Salitre El Greco,147,101,88,336
4954,2020-09-11,(06102) Salitre El Greco,229,138,127,494
4955,2020-07-20,(06102) Salitre El Greco,89,48,45,182
4956,2020-06-22,(04003) Avenida Ciudad de Cali,309,189,236,734
4957,2020-04-18,(03002) SUBA - TV- 91,291,177,154,622
4958,2020-09-27,(06000) Portal Eldorado,135,181,330,646
4959,2020-04-13,(05100) Banderas P. Central,337,194,257,788
4960,2020-07-14,(03004) GRATAMIRA,26,12,19,57
4961,2020-04-05,(08001) Parque el Tunal,81,37,45,163
4962,2020-08-23,(03003) 21 ANGELES,75,33,50,158
4963,2020-07-23,(02102) Calle 161,235,127,141,503
4964,2020-07-21,(06001) Modelia,306,206,181,693
4965,2020-05-11,(06103) CAN,341,216,145,702
4966,2020-06-28,(04000) Cabecera Calle 80,307,168,265,740
4967,2020-07-12,(14004) Museo del Oro,24,34,82,140
4968,2020-04-03,(07010) Bosa,268,171,244,683
4969,2020-03-22,(12004) Carrera 22,11,12,21,44
4970,2020-05-01,(02101) Toberín,218,173,221,612
4971,2020-06-02,(04105) Carrera 53,249,137,150,536
4972,2020-05-19,(10005) Bicentenario,101,45,54,200
4973,2020-09-27,(14001) La Sabana,47,26,58,131
4974,2020-04-10,(07010) Bosa,112,63,81,256
4975,2020-03-23,(04104) Avenida 68,141,76,85,302
4976,2020-01-07,(07504) TERREROS,13093,7424,7693,28210
4977,2020-02-26,(03002) SUBA - TV- 91,4796,2611,2392,9799
4978,2020-02-28,(02101) Toberín,14812,8697,7896,31405
4979,2020-01-29,(09100) Calle 40 Sur,6986,3973,4149,15108
4980,2020-02-25,(06104) Gobernación,1503,868,628,2999
4981,2020-02-27,(03010) PUENTE LARGO,2140,1446,1189,4775
4982,2020-02-18,(09003) Socorro,1746,1027,1036,3809
4983,2020-10-03,(09000) Cabecera Usme - alimentacion,8041,3599,6191,17831
4984,2020-01-27,(09001) Molinos,7251,4343,5596,17190
4985,2020-05-10,(04000) Cabecera Calle 80 - alimentacion,654,385,461,1500
4986,2020-01-27,(05001) Patio Bonito,6705,3842,3719,14266
4987,2020-09-09,(05001) Patio Bonito,2189,1172,1281,4642
4988,2020-02-29,(07112) COMUNEROS,2323,1318,1854,5495
4989,2020-09-30,(07503) SAN MATEO,13937,6989,7403,28329
4990,2020-07-20,(10001) Country Sur,281,118,201,600
4991,2020-06-27,(07503) SAN MATEO,9078,4979,4913,18970
4992,2020-10-06,(05100) Banderas P. Central - alimentacion,3712,1929,2588,8229
4993,2020-09-06,(09113) Calle 22,255,122,218,595
4994,2020-03-18,(07000) Portal Sur - alimentacion,17803,9523,8370,35696
4995,2020-01-31,(10002) Av. Primero de Mayo,8058,3953,4664,16675
4996,2020-02-01,(02204) Pepe Sierra,2036,1360,1640,5036
4997,2020-01-08,(02205) Calle 106,1809,1183,1072,4064
4998,2020-10-05,(10005) Bicentenario - alimentacion,215,119,229,563
4999,2020-05-04,(07001) PERDOMO,558,321,315,1194
5000,2020-02-16,(40003) Mirador del Paraiso,1903,866,1383,4152
5001,2020-08-19,(05107) Américas - Cr.53,369,228,233,830
5002,2020-07-31,(04101) Minuto de Dios,250,143,222,615
5003,2020-10-01,(07505) LEON XIII,3153,1655,1711,6519
5004,2020-07-30,(03000) Portal Suba - alimentacion,6268,3522,3724,13514
5005,2020-06-28,(02204) Pepe Sierra,225,180,179,584
5006,2020-01-29,(04104) Avenida 68,3648,1930,1722,7300
5007,2020-02-24,(04104) Avenida 68,3820,2055,1765,7640
5008,2020-05-23,(05002) Tintal,1398,722,756,2876
5009,2020-03-12,(09104) Restrepo,924,935,959,2818
5010,2020-01-04,(03000) Portal Suba - alimentacion,9432,4438,6468,20338
5011,2020-03-11,(02000) Cabecera Autopista Norte - alimentacion,21094,12734,12692,46520
5012,2020-03-02,(07110) PALOQUEMAO,2705,1621,1238,5564
5013,2020-06-08,(09101) Quiroga,460,280,354,1094
5014,2020-02-09,(07102) NQS - CALLE 75,215,189,325,729
5015,2020-03-16,(02302) Virrey,2730,1856,1314,5900
5016,2020-01-27,(07110) PALOQUEMAO,2474,1411,1147,5032
5017,2020-02-05,(06001) Modelia,2666,1630,1306,5602
5018,2020-05-07,(07503) SAN MATEO,6621,4176,3147,13944
5019,2020-07-01,(05100) Banderas P. Central - alimentacion,2987,1731,1889,6607
5020,2020-04-27,(09103) Olaya,376,74,60,510
5021,2020-05-15,(09103) Olaya,740,466,396,1602
5022,2020-06-26,(07002) MADELENA,885,512,558,1955
5023,2020-09-09,(07002) MADELENA,893,565,654,2112
5024,2020-02-13,(07112) COMUNEROS,3602,2259,2299,8160
5025,2020-06-08,(02000) Cabecera Autopista Norte,1265,818,783,2866
5026,2020-02-03,(07007) NQS - Calle 38A Sur,2143,1258,1175,4576
5027,2020-09-02,(08000) Portal Tunal - alimentacion,6677,3769,3969,14415
5028,2020-03-14,(04000) Cabecera Calle 80,3338,1656,2999,7993
5029,2020-08-27,(07010) Bosa,652,326,390,1368
5030,2020-06-15,(07112) COMUNEROS,218,141,150,509
5031,2020-07-05,(07112) COMUNEROS,246,146,186,578
5032,2020-04-15,(10001) Country Sur,546,248,341,1135
5033,2020-06-10,(10001) Country Sur,1148,509,641,2298
5034,2020-07-09,(04002) Carrera 90,780,436,441,1657
5035,2020-03-09,(10001) Country Sur,177,1015,778,1970
5036,2020-05-29,(40003) Mirador del Paraiso,1617,1065,947,3629
5037,2020-10-02,(12001) Carrera 43,522,330,380,1232
5038,2020-02-20,(10002) Av. Primero de Mayo,8286,4218,4290,16794
5039,2020-08-05,(09107) Hortúa,535,314,329,1178
5040,2020-02-02,(07106) EL CAMPIN,471,291,484,1246
5041,2020-04-25,(03000) Portal Suba - alimentacion,2382,1466,1318,5166
5042,2020-02-25,(04001) Quirigua,2206,1362,1196,4764
5043,2020-05-24,(07010) Bosa,179,85,108,372
5044,2020-03-17,(02001) Centro Comercial Santa Fe,2245,1389,1270,4904
5045,2020-01-16,(07004) VENECIA,4047,2117,2226,8390
5046,2020-02-29,(09116) Avenida 39,811,651,1108,2570
5047,2020-05-19,(09116) Avenida 39,268,186,156,610
5048,2020-03-11,(05102) Av. Américas - Av. Boyacá,1847,1125,903,3875
5049,2020-08-17,(02101) Toberín,254,180,290,724
5050,2020-03-16,(06108) Concejo de Bogotá,595,338,296,1229
5051,2020-02-16,(10002) Av. Primero de Mayo,1625,772,1823,4220
5052,2020-03-19,(03003) 21 ANGELES,808,325,440,1573
5053,2020-06-30,(02201) Prado,987,631,601,2219
5054,2020-05-27,(02000) Cabecera Autopista Norte,1139,722,661,2522
5055,2020-06-12,(02000) Cabecera Autopista Norte,1283,805,767,2855
5056,2020-09-12,(07001) PERDOMO,821,362,690,1873
5057,2020-08-29,(06102) Salitre El Greco,179,106,148,433
5058,2020-02-06,(09107) Hortúa,2482,1546,1538,5566
5059,2020-07-11,(02300) Calle 100,819,603,600,2022
5060,2020-01-24,(03012) SUBA - CALLE 95,1360,822,1045,3227
5061,2020-05-25,(03012) SUBA - CALLE 95,85,59,74,218
5062,2020-01-06,(07104) Simon Bolivar,262,180,323,765
5063,2020-07-24,(06109) Centro Memoria,192,103,111,406
5064,2020-02-22,(03009) Av. Suba- Calle 116,1133,783,1011,2927
5065,2020-02-06,(04003) Avenida Ciudad de Cali,5305,3258,3471,12034
5066,2020-08-15,(04003) Avenida Ciudad de Cali,723,387,637,1747
5067,2020-10-04,(07113) SANTA ISABEL,130,78,196,404
5068,2020-06-24,(03007) HUMEDAL CORDOBA,166,105,79,350
5069,2020-09-20,(03007) HUMEDAL CORDOBA,43,41,33,117
5070,2020-03-17,(03011) SUBA - CALLE 100,1576,782,760,3118
5071,2020-02-17,(05103) Marsella,3237,1924,1466,6627
5072,2020-07-02,(04107) Escuela Militar,146,95,104,345
5073,2020-01-11,(07004) VENECIA,2370,1264,1504,5138
5074,2020-01-08,(06001) Modelia,1502,962,1017,3481
5075,2020-01-05,(09004) Santa Lucía,1650,636,1374,3660
5076,2020-08-25,(04104) Avenida 68,617,301,324,1242
5077,2020-08-20,(09109) Tercer Milenio,323,184,222,729
5078,2020-04-06,(12001) Carrera 43,213,164,126,503
5079,2020-01-04,(10009) Museo Nacional,618,455,800,1873
5080,2020-08-31,(03001) LA CAMPIÑA,1147,651,735,2533
5081,2020-09-01,(03001) LA CAMPIÑA,1174,718,702,2594
5082,2020-07-21,(06101) El Tiempo,334,195,169,698
5083,2020-07-28,(09117) Calle 45,654,414,354,1422
5084,2020-09-19,(09117) Calle 45,563,336,556,1455
5085,2020-09-23,(09117) Calle 45,750,496,596,1842
5086,2020-08-08,(02104) Calle 146,446,285,333,1064
5087,2020-08-17,(02104) Calle 146,218,140,178,536
5088,2020-04-21,(09000) Cabecera Usme - alimentacion,4693,2479,2647,9819
5089,2020-09-27,(09001) Molinos,904,379,914,2197
5090,2020-05-14,(03011) SUBA - CALLE 100,326,164,180,670
5091,2020-09-22,(06104) Gobernación,315,188,153,656
5092,2020-06-01,(02204) Pepe Sierra,719,506,405,1630
5093,2020-07-15,(02204) Pepe Sierra,742,535,347,1624
5094,2020-10-04,(02205) Calle 106,65,65,134,264
5095,2020-07-23,(05001) Patio Bonito,1210,750,737,2697
5096,2020-05-01,(03001) LA CAMPIÑA,263,129,153,545
5097,2020-05-14,(03001) LA CAMPIÑA,792,433,405,1630
5098,2020-08-11,(04108) El Polo,380,240,208,828
5099,2020-07-07,(02001) Centro Comercial Santa Fe,564,353,362,1279
5100,2020-05-22,(07009) SENA,580,331,292,1203
5101,2020-07-21,(09120) Calle 63,886,606,588,2080
5102,2020-08-15,(09120) Calle 63,864,590,706,2160
5103,2020-06-06,(06000) Portal Eldorado - alimentacion,2805,1316,1478,5599
5104,2020-07-04,(07009) SENA,547,313,419,1279
5105,2020-02-15,(12003) Ricaurte,743,613,611,1967
5106,2020-09-25,(12003) Ricaurte,430,314,269,1013
5107,2020-07-10,(10010) San Bernardo,680,322,488,1490
5108,2020-06-11,(06103) CAN,344,203,173,720
5109,2020-07-09,(07009) SENA,717,424,420,1561
5110,2020-09-28,(02105) Calle 142,904,558,742,2204
5111,2020-02-20,(10005) Bicentenario,835,436,346,1617
5112,2020-09-25,(07007) NQS - Calle 38A Sur,500,307,406,1213
5113,2020-04-24,(09118) Marly,1053,746,476,2275
5114,2020-06-04,(04003) Avenida Ciudad de Cali,921,580,634,2135
5115,2020-09-13,(02104) Calle 146,280,168,289,737
5116,2020-05-08,(07103) AV. CHILE,670,405,259,1334
5117,2020-08-29,(07103) AV. CHILE,634,417,456,1507
5118,2020-06-20,(10005) Bicentenario,97,46,85,228
5119,2020-08-21,(10005) Bicentenario,81,44,77,202
5120,2020-01-26,(02302) Virrey,381,358,572,1311
5121,2020-03-03,(40001) Juan Pablo II,1643,974,954,3571
5122,2020-06-13,(10008) San Diego,197,128,149,474
5123,2020-07-25,(10008) San Diego,133,84,109,326
5124,2020-10-02,(08002) Biblioteca,358,194,254,806
5125,2020-10-10,(08002) Biblioteca,274,127,221,622
5126,2020-05-10,(10000) Portal 20 de Julio - alimentacion,1245,485,669,2399
5127,2020-08-13,(10009) Museo Nacional,479,261,275,1015
5128,2020-08-26,(10009) Museo Nacional,461,249,287,997
5129,2020-02-22,(10008) San Diego,669,500,629,1798
5130,2020-09-04,(06111) Universidades,431,247,405,1083
5131,2020-09-07,(06111) Universidades,379,236,362,977
5132,2020-07-19,(12007) Zona Industrial,65,44,57,166
5133,2020-05-13,(03002) SUBA - TV- 91,553,345,336,1234
5134,2020-10-06,(02202) Calle 127,1143,855,868,2866
5135,2020-08-14,(07002) MADELENA,737,438,461,1636
5136,2020-01-13,(03004) GRATAMIRA,222,115,134,471
5137,2020-08-21,(07002) MADELENA,762,438,466,1666
5138,2020-08-26,(02101) Toberín,1257,811,849,2917
5139,2020-08-17,(05000) Portal Américas,743,414,575,1732
5140,2020-05-28,(07105) MOVISTAR ARENA,240,140,126,506
5141,2020-05-30,(07201) Guatoque -Veraguas,146,82,109,337
5142,2020-08-27,(07003) SEVILLANA,435,224,247,906
5143,2020-08-10,(14005) Las Aguas,180,104,184,468
5144,2020-08-17,(04100) Carrera 77,357,206,286,849
5145,2020-07-18,(07113) SANTA ISABEL,249,142,213,604
5146,2020-10-10,(03003) 21 ANGELES,278,105,229,612
5147,2020-06-04,(09110) Avenida Jimenez,966,674,652,2292
5148,2020-03-01,(10003) Ciudad Jardín,189,97,241,527
5149,2020-06-14,(06107) Ciudad Universitaria,46,38,41,125
5150,2020-04-17,(09121) Las Flores,405,278,262,945
5151,2020-09-18,(40002) Manitas,459,290,347,1096
5152,2020-05-14,(07112) COMUNEROS,588,330,292,1210
5153,2020-09-13,(10004) Policarpa,119,46,86,251
5154,2020-05-06,(04105) Carrera 53,185,99,109,393
5155,2020-08-11,(03005) SUBA - AV. BOYACA,337,220,257,814
5156,2020-09-26,(09107) Hortúa,455,264,434,1153
5157,2020-08-05,(02304) Heroes,762,525,398,1685
5158,2020-04-13,(08002) Biblioteca,158,100,80,338
5159,2020-07-26,(03000) Portal Suba,285,147,221,653
5160,2020-01-24,(50002) Corral Calle 40 Sur,128,60,140,328
5161,2020-06-24,(14005) Las Aguas,186,130,179,495
5162,2020-09-21,(06105) Quinta Paredes,118,94,91,303
5163,2020-03-12,(07109) CAD,956,175,341,1472
5164,2020-10-01,(07506) DESPENSA,422,271,316,1009
5165,2020-05-22,(06002) Normandía,268,138,153,559
5166,2020-06-18,(06002) Normandía,312,175,195,682
5167,2020-09-24,(12004) Carrera 22,285,180,173,638
5168,2020-08-08,(10004) Policarpa,178,81,145,404
5169,2020-03-09,(07200) Tygua-San José,173,167,157,497
5170,2020-05-10,(05005) Transversal 86,73,17,46,136
5171,2020-08-20,(07008) NQS - Calle 30 Sur,294,144,177,615
5172,2020-10-06,(03010) PUENTE LARGO,406,262,320,988
5173,2020-06-24,(12002) CDS - Carrera 32,213,139,100,452
5174,2020-07-25,(07006) General Santander,303,174,152,629
5175,2020-04-08,(40001) Juan Pablo II,269,144,156,569
5176,2020-05-05,(04000) Cabecera Calle 80 - intermunicipal,176,97,156,429
5177,2020-07-19,(04000) Cabecera Calle 80 - intermunicipal,56,25,41,122
5178,2020-08-19,(04001) Quirigua,343,212,251,806
5179,2020-09-17,(03010) PUENTE LARGO,416,233,265,914
5180,2020-09-24,(03010) PUENTE LARGO,427,230,295,952
5181,2020-03-20,(09119) Calle 57,233,177,135,545
5182,2020-09-18,(03010) PUENTE LARGO,442,256,254,952
5183,2020-02-15,(09108) Hospital,195,97,181,473
5184,2020-04-28,(03003) 21 ANGELES,180,83,92,355
5185,2020-08-27,(09117) Calle 45,607,398,420,1425
5186,2020-04-12,(03012) SUBA - CALLE 95,63,32,37,132
5187,2020-03-31,(07010) Bosa,254,153,209,616
5188,2020-01-11,(03004) GRATAMIRA,106,52,89,247
5189,2020-05-07,(10000) Portal 20 de Julio,1531,758,759,3048
5190,2020-10-07,(09003) Socorro,654,320,479,1453
5191,2020-06-18,(14005) Las Aguas,147,99,189,435
5192,2020-10-11,(07102) NQS - CALLE 75,66,75,127,268
5193,2020-07-28,(07005) ALQUERIA,474,280,280,1034
5194,2020-06-22,(09123) Calle 76,233,170,219,622
5195,2020-03-22,(07006) General Santander - alimentacion,78,58,68,204
5196,2020-08-15,(07008) NQS - Calle 30 Sur,238,117,165,520
5197,2020-01-01,(02102) Calle 161,87,51,181,319
5198,2020-03-24,(03010) PUENTE LARGO,301,253,225,779
5199,2020-06-21,(09121) Las Flores,193,130,171,494
5200,2020-03-30,(04102) Avenida Boyaca,124,82,92,298
5201,2020-05-18,(09105) Río Fucha,120,54,77,251
5202,2020-07-11,(03004) GRATAMIRA,31,15,22,68
5203,2020-07-02,(07506) DESPENSA,436,260,289,985
5204,2020-03-26,(07201) Guatoque -Veraguas,42,43,49,134
5205,2020-06-22,(07101) CASTELLANA,45,29,44,118
5206,2020-03-28,(07200) Tygua-San José,29,34,51,114
5207,2020-05-12,(09114) Calle 26,226,178,165,569
5208,2020-06-26,(10003) Ciudad Jardín,234,101,174,509
5209,2020-07-20,(02201) Prado,252,173,166,591
5210,2020-06-29,(06105) Quinta Paredes,40,31,41,112
5211,2020-08-29,(05103) Marsella,333,161,226,720
5212,2020-07-05,(03009) Av. Suba- Calle 116,144,96,132,372
5213,2020-03-20,(05103) Marsella,183,116,92,391
5214,2020-05-30,(07108) Av. El Dorado,84,57,56,197
5215,2020-08-16,(07008) NQS - Calle 30 Sur,90,42,66,198
5216,2020-04-15,(06111) Universidades,0,75,225,300
5217,2020-05-30,(02103) Mazurén,102,55,105,262
5218,2020-04-19,(10004) Policarpa,59,44,37,140
5219,2020-04-12,(12001) Carrera 43,39,38,42,119
5220,2020-05-17,(10005) Bicentenario,22,12,20,54
5221,2020-10-01,(06100) Av. Rojas,277,168,208,653
5222,2020-04-14,(07108) Av. El Dorado,63,49,52,164
5223,2020-08-18,(10005) Bicentenario,71,49,80,200
5224,2020-05-26,(07101) CASTELLANA,175,108,82,365
5225,2020-08-16,(09108) Hospital,24,11,41,76
5226,2020-08-09,(12000) Puente Aranda,10,10,12,32
5227,2020-04-06,(07106) EL CAMPIN,140,123,99,362
5228,2020-07-19,(05102) Av. Américas - Av. Boyacá,63,32,39,134
5229,2020-04-04,(09110) Avenida Jimenez,194,146,188,528
5230,2020-04-12,(07111) NQS - RICAURTE,65,69,69,203
5231,2020-08-31,(50006) Corral Carrera 77,3,3,4,10
5232,2020-04-12,(03014) SAN MARTIN,3,2,4,9
5233,2020-05-21,(05101) Mandalay - Cr.73,91,45,33,169
5234,2020-04-09,(10008) San Diego,62,38,31,131
5235,2020-09-27,(12000) Puente Aranda,14,10,19,43
5236,2020-05-15,(03004) GRATAMIRA,24,11,15,50
5237,2020-05-02,(03014) SAN MARTIN,8,5,7,20
5238,2020-09-05,(09002) Consuelo,444,198,340,982
5239,2020-01-24,(09118) Marly,5908,3962,3615,13485
5240,2020-02-01,(03013) RIO NEGRO,666,433,731,1830
5241,2020-01-31,(07504) TERREROS,17546,10023,9567,37136
5242,2020-03-06,(07504) TERREROS,17523,9897,9767,37187
5243,2020-02-10,(05000) Portal Américas - alimentacion,38347,22547,20724,81618
5244,2020-01-17,(04106) Carrera 47,1275,635,817,2727
5245,2020-04-23,(05000) Portal Américas - alimentacion,6305,3344,2802,12451
5246,2020-03-14,(03002) SUBA - TV- 91,2076,984,1445,4505
5247,2020-08-08,(07503) SAN MATEO,7059,3722,3820,14601
5248,2020-03-15,(06000) Portal Eldorado - alimentacion,3554,1356,2535,7445
5249,2020-03-09,(09100) Calle 40 Sur,451,1940,1271,3662
5250,2020-07-13,(09003) Socorro,389,204,235,828
5251,2020-02-08,(10000) Portal 20 de Julio - alimentacion,8831,3904,6091,18826
5252,2020-01-28,(09001) Molinos,7556,4339,5533,17428
5253,2020-06-04,(07503) SAN MATEO,9889,6049,4619,20557
5254,2020-09-10,(06107) Ciudad Universitaria,178,104,139,421
5255,2020-09-03,(09001) Molinos,2827,1470,1987,6284
5256,2020-09-05,(09001) Molinos,2328,1079,1848,5255
5257,2020-01-03,(07000) Portal Sur - alimentacion,15724,8237,8994,32955
5258,2020-02-14,(05005) Transversal 86,2877,1517,1382,5776
5259,2020-09-12,(07503) SAN MATEO,9443,4720,5568,19731
5260,2020-09-03,(05100) Banderas P. Central,934,500,672,2106
5261,2020-01-08,(02102) Calle 161,1222,735,830,2787
5262,2020-01-31,(02102) Calle 161,1853,1069,1139,4061
5263,2020-05-20,(09115) Calle 34,547,405,333,1285
5264,2020-01-29,(05100) Banderas P. Central - alimentacion,14893,8453,8019,31365
5265,2020-02-03,(05100) Banderas P. Central - alimentacion,14341,9043,9708,33092
5266,2020-03-05,(07009) SENA,3666,2123,2020,7809
5267,2020-07-04,(10000) Portal 20 de Julio - alimentacion,3769,1678,2493,7940
5268,2020-01-09,(02000) Cabecera Autopista Norte,6741,4128,4315,15184
5269,2020-02-22,(09120) Calle 63,3571,2443,2770,8784
5270,2020-01-22,(04100) Carrera 77,6041,3490,3801,13332
5271,2020-03-07,(07505) LEON XIII,5780,2757,3172,11709
5272,2020-05-11,(07505) LEON XIII,1779,1055,946,3780
5273,2020-01-18,(09123) Calle 76,1892,1497,1855,5244
5274,2020-02-29,(09123) Calle 76,2180,1802,2354,6336
5275,2020-04-08,(07102) NQS - CALLE 75,152,112,104,368
5276,2020-05-14,(07102) NQS - CALLE 75,300,208,157,665
5277,2020-08-03,(07102) NQS - CALLE 75,303,210,180,693
5278,2020-10-01,(07102) NQS - CALLE 75,487,347,315,1149
5279,2020-10-06,(07102) NQS - CALLE 75,481,322,311,1114
5280,2020-01-16,(02302) Virrey,3431,2237,1660,7328
5281,2020-09-07,(03001) LA CAMPIÑA,1216,730,758,2704
5282,2020-04-23,(09103) Olaya,571,327,316,1214
5283,2020-08-14,(09103) Olaya,974,518,532,2024
5284,2020-09-04,(07002) MADELENA,989,555,683,2227
5285,2020-03-11,(07107) U. NACIONAL,2442,1585,1399,5426
5286,2020-09-30,(04105) Carrera 53,315,168,219,702
5287,2020-01-14,(04106) Carrera 47,1198,683,760,2641
5288,2020-01-03,(09120) Calle 63,2068,1579,1943,5590
5289,2020-08-29,(10001) Country Sur,967,438,749,2154
5290,2020-07-30,(04002) Carrera 90,717,402,427,1546
5291,2020-01-22,(06109) Centro Memoria,1035,579,585,2199
5292,2020-08-24,(10006) San Victorino,409,202,282,893
5293,2020-10-07,(10006) San Victorino,861,413,491,1765
5294,2020-02-24,(40003) Mirador del Paraiso,4845,2732,2561,10138
5295,2020-08-15,(12001) Carrera 43,296,154,217,667
5296,2020-04-18,(50003) Corral Molinos,582,283,375,1240
5297,2020-01-09,(10002) Av. Primero de Mayo,6195,3004,3796,12995
5298,2020-02-11,(02001) Centro Comercial Santa Fe,5052,3235,2802,11089
5299,2020-01-15,(10006) San Victorino,1747,1042,1128,3917
5300,2020-06-25,(09000) Cabecera Usme - alimentacion,8675,5012,5095,18782
5301,2020-04-29,(03000) Portal Suba,706,466,445,1617
5302,2020-04-03,(02000) Cabecera Autopista Norte - intermunicipal,134,104,99,337
5303,2020-08-14,(02000) Cabecera Autopista Norte - intermunicipal,527,338,356,1221
5304,2020-03-02,(09101) Quiroga,1604,996,1220,3820
5305,2020-04-24,(08001) Parque el Tunal,268,142,128,538
5306,2020-05-13,(07010) Bosa,535,315,306,1156
5307,2020-01-04,(09004) Santa Lucía,3275,1489,2281,7045
5308,2020-06-30,(09004) Santa Lucía,2802,1482,1374,5658
5309,2020-09-13,(09004) Santa Lucía,578,418,1057,2053
5310,2020-08-21,(08001) Parque el Tunal,422,232,258,912
5311,2020-01-27,(02302) Virrey,3761,2446,1752,7959
5312,2020-03-05,(06103) CAN,2610,1542,1210,5362
5313,2020-05-04,(02000) Cabecera Autopista Norte,675,505,414,1594
5314,2020-01-11,(05100) Banderas P. Central,2361,1051,1815,5227
5315,2020-03-24,(09123) Calle 76,724,587,514,1825
5316,2020-10-09,(09123) Calle 76,1160,828,934,2922
5317,2020-08-21,(05002) Tintal,2301,1323,1435,5059
5318,2020-02-23,(05105) Pradera,540,351,478,1369
5319,2020-10-10,(05103) Marsella,354,169,344,867
5320,2020-05-22,(50003) Corral Molinos,1228,633,888,2749
5321,2020-05-31,(02300) Calle 100,329,219,218,766
5322,2020-01-08,(03012) SUBA - CALLE 95,993,683,735,2411
5323,2020-02-04,(03012) SUBA - CALLE 95,1494,929,950,3373
5324,2020-08-31,(03012) SUBA - CALLE 95,339,212,180,731
5325,2020-01-29,(07007) NQS - Calle 38A Sur,2075,1224,1217,4516
5326,2020-01-10,(10010) San Bernardo,1313,778,1169,3260
5327,2020-01-13,(10010) San Bernardo,1398,835,1190,3423
5328,2020-06-10,(08000) Portal Tunal,745,323,267,1335
5329,2020-06-23,(05005) Transversal 86,439,218,253,910
5330,2020-03-19,(02202) Calle 127,2450,1722,1364,5536
5331,2020-08-29,(05105) Pradera,473,306,312,1091
5332,2020-03-14,(03009) Av. Suba- Calle 116,974,701,853,2528
5333,2020-08-21,(09113) Calle 22,394,225,299,918
5334,2020-07-30,(06000) Portal Eldorado - alimentacion,3446,1814,1880,7140
5335,2020-07-15,(04108) El Polo,410,259,200,869
5336,2020-07-18,(07201) Guatoque -Veraguas,87,53,88,228
5337,2020-02-18,(05103) Marsella,3314,1888,1530,6732
5338,2020-03-26,(09116) Avenida 39,159,129,126,414
5339,2020-03-17,(08002) Biblioteca,632,405,455,1492
5340,2020-03-11,(07108) Av. El Dorado,908,559,560,2027
5341,2020-09-07,(07000) Portal Sur,2037,1280,1376,4693
5342,2020-03-29,(03011) SUBA - CALLE 100,115,79,52,246
5343,2020-05-16,(02000) Cabecera Autopista Norte - alimentacion,3101,1578,1493,6172
5344,2020-02-13,(06105) Quinta Paredes,1131,642,472,2245
5345,2020-06-01,(10010) San Bernardo,576,304,356,1236
5346,2020-03-24,(02202) Calle 127,960,751,661,2372
5347,2020-01-09,(05107) Américas - Cr.53,1853,1055,1121,4029
5348,2020-04-04,(07110) PALOQUEMAO,242,184,121,547
5349,2020-07-15,(09100) Calle 40 Sur,1175,769,789,2733
5350,2020-08-19,(04101) Minuto de Dios,303,188,220,711
5351,2020-06-16,(09109) Tercer Milenio,362,217,252,831
5352,2020-09-10,(12001) Carrera 43,399,248,239,886
5353,2020-09-08,(06000) Portal Eldorado,968,618,599,2185
5354,2020-09-30,(09117) Calle 45,711,485,586,1782
5355,2020-09-19,(09119) Calle 57,498,324,472,1294
5356,2020-04-02,(03011) SUBA - CALLE 100,275,186,129,590
5357,2020-07-24,(02204) Pepe Sierra,690,467,363,1520
5358,2020-05-09,(10001) Country Sur,520,256,351,1127
5359,2020-08-23,(02304) Heroes,157,125,140,422
5360,2020-08-03,(08000) Portal Tunal,704,286,263,1253
5361,2020-03-15,(06000) Portal Eldorado,641,478,769,1888
5362,2020-05-11,(03001) LA CAMPIÑA,723,414,407,1544
5363,2020-05-16,(06100) Av. Rojas,119,59,96,274
5364,2020-07-12,(02302) Virrey,196,133,143,472
5365,2020-09-05,(09104) Restrepo,1380,774,1198,3352
5366,2020-08-31,(06103) CAN,386,224,196,806
5367,2020-07-03,(02105) Calle 142,840,508,559,1907
5368,2020-06-28,(07009) SENA,218,115,185,518
5369,2020-04-06,(09116) Avenida 39,170,140,138,448
5370,2020-04-23,(09000) Cabecera Usme,776,504,581,1861
5371,2020-01-17,(04103) Las Ferias,1308,717,779,2804
5372,2020-03-26,(07007) NQS - Calle 38A Sur,176,103,105,384
5373,2020-08-24,(07007) NQS - Calle 38A Sur,318,203,222,743
5374,2020-03-28,(10002) Av. Primero de Mayo,761,404,421,1586
5375,2020-09-24,(12007) Zona Industrial,390,268,203,861
5376,2020-09-23,(09122) Calle 72,1438,940,1079,3457
5377,2020-09-02,(40002) Manitas,423,248,320,991
5378,2020-05-28,(09117) Calle 45,594,400,359,1353
5379,2020-06-20,(02001) Centro Comercial Santa Fe,359,202,278,839
5380,2020-04-24,(04105) Carrera 53,170,107,83,360
5381,2020-01-04,(02102) Calle 161,372,217,397,986
5382,2020-07-16,(02200) Alcalá,1631,1062,767,3460
5383,2020-04-01,(07003) SEVILLANA,223,112,97,432
5384,2020-10-09,(10008) San Diego,323,205,259,787
5385,2020-04-11,(03000) Portal Suba - alimentacion,1932,1135,998,4065
5386,2020-02-13,(10004) Policarpa,929,476,534,1939
5387,2020-08-10,(09117) Calle 45,666,385,371,1422
5388,2020-08-28,(06111) Universidades,403,230,345,978
5389,2020-09-25,(06111) Universidades,460,294,486,1240
5390,2020-01-06,(07004) VENECIA,729,429,665,1823
5391,2020-08-31,(02204) Pepe Sierra,809,587,455,1851
5392,2020-04-16,(02200) Alcalá,917,677,453,2047
5393,2020-02-11,(12004) Carrera 22,765,437,453,1655
5394,2020-04-06,(09106) Nariño,191,122,142,455
5395,2020-04-11,(07200) Tygua-San José,58,32,47,137
5396,2020-03-28,(09106) Nariño,102,70,73,245
5397,2020-06-24,(07000) Portal Sur,1973,1232,1077,4282
5398,2020-08-28,(12002) CDS - Carrera 32,188,116,72,376
5399,2020-04-29,(09123) Calle 76,584,410,315,1309
5400,2020-04-01,(06102) Salitre El Greco,157,112,81,350
5401,2020-09-20,(09103) Olaya,438,179,381,998
5402,2020-03-19,(07003) SEVILLANA,1098,529,635,2262
5403,2020-02-21,(07506) DESPENSA,1462,923,946,3331
5404,2020-06-03,(02200) Alcalá,1632,1125,830,3587
5405,2020-08-07,(02200) Alcalá,634,463,392,1489
5406,2020-02-02,(05105) Pradera,523,359,483,1365
5407,2020-05-17,(09000) Cabecera Usme - alimentacion,1938,983,1178,4099
5408,2020-08-23,(06109) Centro Memoria,72,45,62,179
5409,2020-06-19,(10007) Las Nieves,678,403,401,1482
5410,2020-05-30,(07004) VENECIA,667,357,354,1378
5411,2020-04-28,(10001) Country Sur,652,285,423,1360
5412,2020-03-29,(02104) Calle 146,139,105,59,303
5413,2020-04-12,(07000) Portal Sur,259,173,162,594
5414,2020-08-31,(04103) Las Ferias,370,200,176,746
5415,2020-10-07,(04101) Minuto de Dios,401,223,394,1018
5416,2020-03-08,(10007) Las Nieves,186,217,400,803
5417,2020-05-23,(09114) Calle 26,119,109,149,377
5418,2020-06-01,(09114) Calle 26,268,192,199,659
5419,2020-09-20,(12001) Carrera 43,80,60,136,276
5420,2020-07-31,(07109) CAD,486,332,233,1051
5421,2020-03-08,(09104) Restrepo,1107,658,1487,3252
5422,2020-07-04,(14005) Las Aguas,140,91,177,408
5423,2020-02-14,(05101) Mandalay - Cr.73,1229,623,602,2454
5424,2020-05-21,(02102) Calle 161,187,111,114,412
5425,2020-04-25,(07002) MADELENA,256,121,141,518
5426,2020-09-29,(12004) Carrera 22,306,180,158,644
5427,2020-03-27,(07505) LEON XIII,1136,641,619,2396
5428,2020-07-28,(12003) Ricaurte,318,213,168,699
5429,2020-08-27,(12003) Ricaurte,398,254,155,807
5430,2020-08-23,(10009) Museo Nacional,69,62,99,230
5431,2020-07-30,(07110) PALOQUEMAO,593,394,268,1255
5432,2020-04-21,(09003) Socorro,285,161,177,623
5433,2020-04-21,(07008) NQS - Calle 30 Sur,156,96,107,359
5434,2020-07-19,(04002) Carrera 90,192,109,116,417
5435,2020-05-09,(05100) Banderas P. Central,309,150,200,659
5436,2020-02-29,(06103) CAN,625,548,842,2015
5437,2020-05-06,(02502) Terminal,251,175,192,618
5438,2020-01-01,(10009) Museo Nacional,138,123,302,563
5439,2020-06-03,(04000) Cabecera Calle 80 - intermunicipal,272,126,216,614
5440,2020-05-18,(06108) Concejo de Bogotá,123,64,53,240
5441,2020-05-15,(14005) Las Aguas,0,52,158,210
5442,2020-05-13,(06100) Av. Rojas,177,111,100,388
5443,2020-01-26,(07109) CAD,566,411,545,1522
5444,2020-05-13,(07109) CAD,534,369,215,1118
5445,2020-09-08,(03010) PUENTE LARGO,381,235,247,863
5446,2020-03-21,(05107) Américas - Cr.53,214,149,120,483
5447,2020-04-08,(03001) LA CAMPIÑA,471,261,260,992
5448,2020-08-08,(07006) General Santander - alimentacion,233,125,179,537
5449,2020-04-28,(07010) Bosa,362,209,222,793
5450,2020-09-10,(09003) Socorro,566,298,313,1177
5451,2020-04-02,(02502) Terminal,133,96,125,354
5452,2020-06-22,(09000) Cabecera Usme,539,289,430,1258
5453,2020-08-09,(12001) Carrera 43,63,45,69,177
5454,2020-04-25,(03009) Av. Suba- Calle 116,240,168,125,533
5455,2020-01-06,(07002) MADELENA,644,298,529,1471
5456,2020-04-25,(07108) Av. El Dorado,42,33,26,101
5457,2020-03-15,(06106) Recinto Ferial,237,126,226,589
5458,2020-01-12,(07102) NQS - CALLE 75,184,151,273,608
5459,2020-03-12,(07006) General Santander - alimentacion,74,286,259,619
5460,2020-03-23,(09115) Calle 34,171,118,85,374
5461,2020-08-01,(12002) CDS - Carrera 32,109,71,61,241
5462,2020-06-28,(12001) Carrera 43,63,44,70,177
5463,2020-03-30,(07006) General Santander - alimentacion,167,106,123,396
5464,2020-08-02,(09108) Hospital,26,15,22,63
5465,2020-06-18,(06102) Salitre El Greco,240,135,97,472
5466,2020-05-15,(12007) Zona Industrial,232,173,108,513
5467,2020-07-28,(10004) Policarpa,217,104,137,458
5468,2020-04-22,(40002) Manitas,177,108,132,417
5469,2020-03-20,(04001) Quirigua,189,117,85,391
5470,2020-02-09,(14001) La Sabana,89,91,151,331
5471,2020-05-03,(04108) El Polo,50,38,46,134
5472,2020-01-23,(10003) Ciudad Jardín,999,511,689,2199
5473,2020-06-09,(40002) Manitas,378,225,243,846
5474,2020-08-12,(06101) El Tiempo,356,215,183,754
5475,2020-06-21,(07113) SANTA ISABEL,133,72,126,331
5476,2020-04-01,(12003) Ricaurte,86,76,76,238
5477,2020-09-05,(14005) Las Aguas,182,107,236,525
5478,2020-06-07,(09121) Las Flores,163,107,162,432
5479,2020-05-01,(06103) CAN,193,115,71,379
5480,2020-07-05,(07200) Tygua-San José,75,51,88,214
5481,2020-08-07,(07006) General Santander - alimentacion,118,83,105,306
5482,2020-04-18,(03009) Av. Suba- Calle 116,240,174,125,539
5483,2020-04-06,(09003) Socorro,286,131,184,601
5484,2020-03-20,(09105) Río Fucha,58,40,50,148
5485,2020-08-30,(06002) Normandía,77,60,77,214
5486,2020-06-29,(04000) Cabecera Calle 80 - intermunicipal,81,42,78,201
5487,2020-04-02,(07003) SEVILLANA,225,112,123,460
5488,2020-05-17,(02104) Calle 146,201,145,96,442
5489,2020-07-24,(14005) Las Aguas,132,80,141,353
5490,2020-03-01,(12000) Puente Aranda,35,36,77,148
5491,2020-09-03,(50006) Corral Carrera 77,5,2,4,11
5492,2020-07-05,(06104) Gobernación,49,27,36,112
5493,2020-05-17,(04107) Escuela Militar,22,16,15,53
5494,2020-01-18,(50006) Corral Carrera 77,14,13,33,60
5495,2020-04-26,(14004) Museo del Oro,0,9,26,35
5496,2020-04-11,(04101) Minuto de Dios,85,48,56,189
5497,2020-04-24,(03014) SAN MARTIN,17,7,16,40
5498,2020-06-07,(10005) Bicentenario,24,14,19,57
5499,2020-10-10,(03004) GRATAMIRA,0,18,49,67
5500,2020-06-28,(50002) Corral Calle 40 Sur,3,1,3,7
5501,2020-08-25,(50006) Corral Carrera 77,4,0,7,11
5502,2020-05-01,(50002) Corral Calle 40 Sur,3,3,4,10
5503,2020-06-08,(07005) ALQUERIA,554,325,283,1162
5504,2020-10-04,(09118) Marly,490,342,564,1396
5505,2020-02-24,(07504) TERREROS,17656,11010,9008,37674
5506,2020-02-05,(04106) Carrera 47,1510,818,905,3233
5507,2020-02-20,(03002) SUBA - TV- 91,4567,2617,2348,9532
5508,2020-01-27,(05000) Portal Américas,14020,8368,7529,29917
5509,2020-01-25,(09001) Molinos,5274,2469,4135,11878
5510,2020-01-25,(07111) NQS - RICAURTE,2025,1398,1341,4764
5511,2020-03-31,(04000) Cabecera Calle 80 - alimentacion,1759,994,1018,3771
5512,2020-02-04,(06107) Ciudad Universitaria,1680,1021,916,3617
5513,2020-08-03,(09001) Molinos,2251,1256,1520,5027
5514,2020-09-29,(05001) Patio Bonito,2263,1184,1345,4792
5515,2020-01-30,(09118) Marly,6406,4264,3714,14384
5516,2020-02-27,(07000) Portal Sur - alimentacion,29429,16800,14341,60570
5517,2020-01-09,(03009) Av. Suba- Calle 116,1910,1168,1007,4085
5518,2020-02-11,(09104) Restrepo,5555,3331,3997,12883
5519,2020-01-14,(05100) Banderas P. Central,6121,3494,3333,12948
5520,2020-07-27,(10001) Country Sur,1167,569,723,2459
5521,2020-09-30,(10001) Country Sur,1551,660,1050,3261
5522,2020-02-28,(02000) Cabecera Autopista Norte,11411,6478,6274,24163
5523,2020-02-13,(02105) Calle 142,7479,4393,4004,15876
5524,2020-03-05,(02101) Toberín,14868,9044,7764,31676
5525,2020-09-15,(02101) Toberín,1652,1047,1202,3901
5526,2020-08-21,(10000) Portal 20 de Julio - alimentacion,3897,1720,2475,8092
5527,2020-06-20,(08000) Portal Tunal - alimentacion,5319,2818,3046,11183
5528,2020-02-14,(07001) PERDOMO,4674,2658,2745,10077
5529,2020-02-25,(05107) Américas - Cr.53,2688,1513,1424,5625
5530,2020-01-09,(09104) Restrepo,3861,2319,3196,9376
5531,2020-06-19,(09104) Restrepo,1594,953,1166,3713
5532,2020-01-29,(07505) LEON XIII,8317,4677,3793,16787
5533,2020-10-09,(03000) Portal Suba - alimentacion,7824,3997,5826,17647
5534,2020-09-16,(02204) Pepe Sierra,848,607,501,1956
5535,2020-07-11,(09000) Cabecera Usme,1516,829,1238,3583
5536,2020-01-02,(06002) Normandía,822,514,622,1958
5537,2020-03-11,(06002) Normandía,2473,1494,1204,5171
5538,2020-02-24,(09117) Calle 45,6600,4236,2957,13793
5539,2020-03-16,(09117) Calle 45,2475,1666,1669,5810
5540,2020-02-13,(02000) Cabecera Autopista Norte - alimentacion,24743,13906,13766,52415
5541,2020-04-18,(07102) NQS - CALLE 75,124,99,65,288
5542,2020-06-29,(07000) Portal Sur - alimentacion,2866,1461,1448,5775
5543,2020-03-19,(09110) Avenida Jimenez,2564,1886,1505,5955
5544,2020-08-13,(50003) Corral Molinos,1472,699,1039,3210
5545,2020-01-04,(04100) Carrera 77,2083,999,1736,4818
5546,2020-07-08,(05100) Banderas P. Central - alimentacion,3220,1754,1824,6798
5547,2020-09-29,(09103) Olaya,1130,627,723,2480
5548,2020-02-10,(14001) La Sabana,634,384,360,1378
5549,2020-06-30,(14001) La Sabana,156,93,132,381
5550,2020-01-24,(10006) San Victorino,1973,1176,1297,4446
5551,2020-02-20,(50003) Corral Molinos,1240,2462,4596,8298
5552,2020-09-09,(05000) Portal Américas,3512,2109,2275,7896
5553,2020-08-06,(04000) Cabecera Calle 80,885,531,728,2144
5554,2020-01-09,(04106) Carrera 47,1018,552,640,2210
5555,2020-03-13,(09114) Calle 26,1163,133,406,1702
5556,2020-02-09,(09001) Molinos,1991,872,1930,4793
5557,2020-02-28,(09120) Calle 63,6916,4572,4011,15499
5558,2020-07-03,(10001) Country Sur,1341,645,832,2818
5559,2020-07-10,(04100) Carrera 77,1399,767,883,3049
5560,2020-04-27,(09000) Cabecera Usme - alimentacion,3590,442,519,4551
5561,2020-02-28,(12001) Carrera 43,1705,981,1119,3805
5562,2020-06-08,(12001) Carrera 43,447,237,209,893
5563,2020-09-26,(12001) Carrera 43,307,191,305,803
5564,2020-01-17,(07113) SANTA ISABEL,1815,1095,1353,4263
5565,2020-03-01,(06000) Portal Eldorado - alimentacion,4272,1748,3529,9549
5566,2020-08-18,(03000) Portal Suba,1157,709,788,2654
5567,2020-02-19,(09101) Quiroga,1661,1054,1187,3902
5568,2020-06-30,(07112) COMUNEROS,831,497,490,1818
5569,2020-03-31,(07000) Portal Sur - alimentacion,3800,1959,1593,7352
5570,2020-04-13,(07000) Portal Sur - alimentacion,3912,2137,1529,7578
5571,2020-02-17,(07000) Portal Sur,7925,4890,4084,16899
5572,2020-02-17,(07004) VENECIA,4783,2765,2421,9969
5573,2020-01-06,(04002) Carrera 90,567,253,542,1362
5574,2020-01-20,(02502) Terminal,4649,3014,2726,10389
5575,2020-07-10,(09003) Socorro,643,341,394,1378
5576,2020-06-21,(07503) SAN MATEO,2928,1706,1709,6343
5577,2020-02-23,(10001) Country Sur,858,385,974,2217
5578,2020-06-12,(02201) Prado,932,579,499,2010
5579,2020-05-19,(09114) Calle 26,226,166,143,535
5580,2020-03-15,(03007) HUMEDAL CORDOBA,125,83,124,332
5581,2020-01-22,(03012) SUBA - CALLE 95,1323,830,956,3109
5582,2020-05-05,(09104) Restrepo,934,580,751,2265
5583,2020-06-18,(05005) Transversal 86,386,207,226,819
5584,2020-08-07,(05005) Transversal 86,140,67,96,303
5585,2020-02-26,(02202) Calle 127,5917,3838,2923,12678
5586,2020-07-25,(05105) Pradera,337,211,191,739
5587,2020-03-11,(08000) Portal Tunal,2085,1156,995,4236
5588,2020-05-16,(05100) Banderas P. Central - alimentacion,1512,711,759,2982
5589,2020-02-13,(06109) Centro Memoria,1234,695,612,2541
5590,2020-02-14,(06109) Centro Memoria,1176,634,688,2498
5591,2020-05-16,(06109) Centro Memoria,180,114,90,384
5592,2020-07-08,(06109) Centro Memoria,282,161,133,576
5593,2020-01-07,(03006) NIZA - CALLE 127,1438,930,1127,3495
5594,2020-01-07,(04000) Cabecera Calle 80,4918,2944,3517,11379
5595,2020-02-27,(10008) San Diego,1653,823,790,3266
5596,2020-07-25,(06000) Portal Eldorado - alimentacion,2248,1157,1274,4679
5597,2020-05-12,(02300) Calle 100,1009,648,508,2165
5598,2020-01-23,(07201) Guatoque -Veraguas,931,491,600,2022
5599,2020-06-04,(02201) Prado,858,560,421,1839
5600,2020-06-26,(07106) EL CAMPIN,414,265,249,928
5601,2020-03-31,(06000) Portal Eldorado,759,561,385,1705
5602,2020-08-13,(06111) Universidades,335,185,291,811
5603,2020-05-20,(04104) Avenida 68,504,281,258,1043
5604,2020-03-07,(06101) El Tiempo,962,714,1032,2708
5605,2020-08-14,(10003) Ciudad Jardín,218,97,152,467
5606,2020-02-15,(07110) PALOQUEMAO,1323,948,993,3264
5607,2020-06-18,(09100) Calle 40 Sur,1809,1108,1104,4021
5608,2020-06-15,(05000) Portal Américas,634,457,628,1719
5609,2020-09-07,(04002) Carrera 90,759,409,466,1634
5610,2020-05-29,(05001) Patio Bonito,1561,846,960,3367
5611,2020-04-16,(07002) MADELENA,365,169,197,731
5612,2020-09-27,(07004) VENECIA,324,184,336,844
5613,2020-03-29,(04105) Carrera 53,51,40,23,114
5614,2020-06-07,(03002) SUBA - TV- 91,193,99,170,462
5615,2020-08-11,(02202) Calle 127,851,708,712,2271
5616,2020-06-07,(07505) LEON XIII,627,351,354,1332
5617,2020-02-16,(03011) SUBA - CALLE 100,425,258,501,1184
5618,2020-04-20,(03011) SUBA - CALLE 100,273,167,143,583
5619,2020-01-13,(06100) Av. Rojas,1820,1020,1022,3862
5620,2020-10-02,(08000) Portal Tunal,835,373,430,1638
5621,2020-05-28,(40001) Juan Pablo II,478,291,281,1050
5622,2020-06-09,(03001) LA CAMPIÑA,1063,600,614,2277
5623,2020-03-02,(07004) VENECIA,4536,2616,2415,9567
5624,2020-06-24,(02105) Calle 142,825,527,480,1832
5625,2020-01-09,(04101) Minuto de Dios,1588,983,1162,3733
5626,2020-03-25,(09120) Calle 63,560,391,340,1291
5627,2020-08-07,(06100) Av. Rojas,44,40,52,136
5628,2020-05-29,(02302) Virrey,575,378,308,1261
5629,2020-07-26,(02302) Virrey,161,98,109,368
5630,2020-09-13,(02302) Virrey,166,110,181,457
5631,2020-08-22,(03010) PUENTE LARGO,214,133,157,504
5632,2020-06-27,(02302) Virrey,417,335,333,1085
5633,2020-09-21,(07200) Tygua-San José,161,103,139,403
5634,2020-01-07,(07107) U. NACIONAL,844,657,823,2324
5635,2020-04-10,(09109) Tercer Milenio,51,39,34,124
5636,2020-06-14,(09116) Avenida 39,89,62,82,233
5637,2020-08-06,(07103) AV. CHILE,694,458,421,1573
5638,2020-10-02,(06109) Centro Memoria,301,210,260,771
5639,2020-03-01,(10005) Bicentenario,68,56,128,252
5640,2020-09-13,(10005) Bicentenario,23,25,42,90
5641,2020-03-31,(40002) Manitas,164,75,115,354
5642,2020-01-25,(02102) Calle 161,744,362,740,1846
5643,2020-06-02,(04100) Carrera 77,1153,632,734,2519
5644,2020-09-01,(10008) San Diego,271,155,177,603
5645,2020-02-06,(08002) Biblioteca,1055,574,693,2322
5646,2020-01-06,(02200) Alcalá,1495,935,1416,3846
5647,2020-04-09,(03000) Portal Suba - alimentacion,1353,748,619,2720
5648,2020-07-06,(05107) Américas - Cr.53,476,234,265,975
5649,2020-03-31,(05105) Pradera,357,255,156,768
5650,2020-09-03,(06111) Universidades,423,220,369,1012
5651,2020-10-05,(06100) Av. Rojas,303,204,275,782
5652,2020-09-12,(03013) RIO NEGRO,207,125,197,529
5653,2020-05-08,(07000) Portal Sur,1158,760,695,2613
5654,2020-09-27,(07110) PALOQUEMAO,165,142,191,498
5655,2020-01-17,(07006) General Santander,2484,1418,1478,5380
5656,2020-02-16,(06105) Quinta Paredes,143,85,216,444
5657,2020-09-11,(02101) Toberín,1456,914,1069,3439
5658,2020-08-02,(09122) Calle 72,280,198,287,765
5659,2020-06-16,(07200) Tygua-San José,240,131,143,514
5660,2020-09-17,(07005) ALQUERIA,601,332,381,1314
5661,2020-10-07,(09107) Hortúa,609,401,546,1556
5662,2020-08-08,(09122) Calle 72,727,461,595,1783
5663,2020-03-25,(10000) Portal 20 de Julio,1204,595,545,2344
5664,2020-06-28,(07001) PERDOMO,280,136,233,649
5665,2020-05-06,(09123) Calle 76,620,434,365,1419
5666,2020-05-17,(07000) Portal Sur,338,191,263,792
5667,2020-05-30,(02302) Virrey,411,271,235,917
5668,2020-04-22,(07105) MOVISTAR ARENA,164,110,93,367
5669,2020-05-30,(07105) MOVISTAR ARENA,161,106,118,385
5670,2020-08-11,(07003) SEVILLANA,408,234,232,874
5671,2020-07-17,(07107) U. NACIONAL,335,206,186,727
5672,2020-03-07,(07506) DESPENSA,867,535,709,2111
5673,2020-04-13,(07110) PALOQUEMAO,418,281,184,883
5674,2020-09-23,(03011) SUBA - CALLE 100,678,270,326,1274
5675,2020-09-27,(09121) Las Flores,182,130,261,573
5676,2020-04-15,(04104) Avenida 68,346,181,169,696
5677,2020-07-22,(09110) Avenida Jimenez,553,516,630,1699
5678,2020-05-02,(10007) Las Nieves,182,105,119,406
5679,2020-03-18,(07006) General Santander - alimentacion,903,458,599,1960
5680,2020-02-15,(12000) Puente Aranda,185,112,163,460
5681,2020-02-18,(12000) Puente Aranda,285,165,189,639
5682,2020-06-30,(07109) CAD,636,409,326,1371
5683,2020-04-06,(02102) Calle 161,82,60,60,202
5684,2020-03-27,(07107) U. NACIONAL,181,177,111,469
5685,2019-12-31,(10000) Portal 20 de Julio,85,57,111,253
5686,2020-01-28,(09111) Calle 19,2160,1300,1520,4980
5687,2020-05-10,(05001) Patio Bonito,361,191,232,784
5688,2020-06-07,(02201) Prado,222,159,164,545
5689,2020-07-15,(07109) CAD,560,365,269,1194
5690,2020-02-07,(07200) Tygua-San José,827,480,618,1925
5691,2020-07-27,(04002) Carrera 90,702,369,393,1464
5692,2020-09-02,(06106) Recinto Ferial,247,155,136,538
5693,2020-07-26,(07008) NQS - Calle 30 Sur,72,37,54,163
5694,2020-03-26,(02103) Mazurén,82,54,72,208
5695,2020-09-09,(12002) CDS - Carrera 32,207,124,102,433
5696,2020-04-14,(40001) Juan Pablo II,245,145,148,538
5697,2020-08-20,(04000) Cabecera Calle 80 - intermunicipal,324,155,263,742
5698,2020-04-07,(06002) Normandía,164,96,101,361
5699,2020-05-26,(06002) Normandía,286,165,153,604
5700,2020-04-29,(07506) DESPENSA,281,163,150,594
5701,2020-09-30,(04001) Quirigua,457,290,357,1104
5702,2020-05-28,(06001) Modelia,364,214,177,755
5703,2020-09-22,(09111) Calle 19,832,485,574,1891
5704,2020-09-08,(07006) General Santander - alimentacion,406,227,293,926
5705,2020-05-14,(09117) Calle 45,585,360,306,1251
5706,2020-09-07,(06105) Quinta Paredes,148,100,101,349
5707,2020-07-08,(07006) General Santander - alimentacion,383,211,251,845
5708,2020-03-28,(09122) Calle 72,419,309,281,1009
5709,2020-10-04,(09107) Hortúa,221,136,256,613
5710,2020-06-19,(06102) Salitre El Greco,251,125,137,513
5711,2020-08-24,(03010) PUENTE LARGO,354,197,173,724
5712,2020-09-27,(03011) SUBA - CALLE 100,154,124,172,450
5713,2020-07-11,(08002) Biblioteca,263,138,160,561
5714,2020-09-19,(07006) General Santander,489,271,389,1149
5715,2020-04-13,(06100) Av. Rojas,123,74,77,274
5716,2020-05-01,(09121) Las Flores,179,136,144,459
5717,2020-07-18,(06001) Modelia,218,147,136,501
5718,2020-09-15,(07201) Guatoque -Veraguas,198,107,142,447
5719,2020-06-15,(07010) Bosa,218,108,148,474
5720,2020-06-22,(10006) San Victorino,137,88,109,334
5721,2020-09-21,(03005) SUBA - AV. BOYACA,438,256,296,990
5722,2020-09-11,(14005) Las Aguas,210,111,242,563
5723,2020-08-16,(10003) Ciudad Jardín,81,25,59,165
5724,2020-05-04,(04105) Carrera 53,179,105,105,389
5725,2020-08-23,(06103) CAN,114,73,72,259
5726,2020-07-05,(12007) Zona Industrial,47,47,83,177
5727,2020-08-19,(04102) Avenida Boyaca,342,184,221,747
5728,2020-10-01,(07101) CASTELLANA,256,151,186,593
5729,2020-04-12,(02001) Centro Comercial Santa Fe,49,37,47,133
5730,2020-04-17,(07201) Guatoque -Veraguas,82,52,71,205
5731,2020-07-20,(10006) San Victorino,64,56,90,210
5732,2020-04-19,(12004) Carrera 22,16,9,15,40
5733,2020-07-04,(10003) Ciudad Jardín,187,87,138,412
5734,2020-05-21,(06103) CAN,316,193,139,648
5735,2020-07-18,(06103) CAN,198,138,96,432
5736,2020-08-05,(06103) CAN,345,188,147,680
5737,2020-08-17,(09123) Calle 76,199,161,174,534
5738,2020-10-03,(07101) CASTELLANA,151,96,180,427
5739,2020-09-08,(09105) Río Fucha,0,76,149,225
5740,2020-04-26,(03003) 21 ANGELES,46,27,38,111
5741,2020-06-12,(10005) Bicentenario,101,53,67,221
5742,2020-04-19,(14004) Museo del Oro,0,12,21,33
5743,2020-04-04,(12002) CDS - Carrera 32,90,57,33,180
5744,2020-03-21,(08002) Biblioteca,99,62,51,212
5745,2020-05-31,(07200) Tygua-San José,48,32,54,134
5746,2020-07-19,(10004) Policarpa,70,26,51,147
5747,2020-04-12,(09002) Consuelo,90,40,52,182
5748,2020-04-10,(06105) Quinta Paredes,29,21,19,69
5749,2020-08-27,(50002) Corral Calle 40 Sur,28,12,28,68
5750,2020-09-16,(50002) Corral Calle 40 Sur,25,15,34,74
5751,2020-04-19,(04105) Carrera 53,58,37,32,127
5752,2019-12-31,(06101) El Tiempo,14,7,25,46
5753,2020-08-09,(03014) SAN MARTIN,0,2,16,18
5754,2020-05-01,(07102) NQS - CALLE 75,81,57,55,193
5755,2020-07-20,(07101) CASTELLANA,33,25,32,90
5756,2020-03-09,(50006) Corral Carrera 77,2,8,7,17
5757,2020-04-12,(10004) Policarpa,42,28,38,108
5758,2020-03-22,(07200) Tygua-San José,23,16,31,70
5759,2020-03-14,(04000) Cabecera Calle 80 - alimentacion,11270,5229,9157,25656
5760,2020-03-14,(09002) Consuelo,946,430,718,2094
5761,2020-08-28,(09002) Consuelo,455,277,291,1023
5762,2020-09-09,(09002) Consuelo,514,278,332,1124
5763,2020-03-14,(07504) TERREROS,10329,5375,6704,22408
5764,2020-01-09,(09119) Calle 57,2097,1441,1602,5140
5765,2020-09-22,(09119) Calle 57,693,423,500,1616
5766,2020-03-03,(03000) Portal Suba - alimentacion,29041,17327,17290,63658
5767,2020-09-27,(05000) Portal Américas - alimentacion,3847,1600,2948,8395
5768,2020-01-31,(07503) SAN MATEO,40155,21784,18400,80339
5769,2020-02-13,(06104) Gobernación,1449,859,639,2947
5770,2020-02-27,(09003) Socorro,1715,976,946,3637
5771,2020-01-31,(09001) Molinos,7461,4158,5916,17535
5772,2020-02-13,(14004) Museo del Oro,4289,2588,2065,8942
5773,2020-01-13,(04100) Carrera 77,5121,2985,3487,11593
5774,2020-09-28,(08000) Portal Tunal - alimentacion,6675,3624,4497,14796
5775,2020-07-30,(05100) Banderas P. Central,618,376,460,1454
5776,2020-09-03,(09000) Cabecera Usme,1820,1161,1379,4360
5777,2020-01-16,(05100) Banderas P. Central - alimentacion,12552,6515,7398,26465
5778,2020-01-23,(07009) SENA,3223,1862,1953,7038
5779,2020-10-10,(05100) Banderas P. Central,753,352,708,1813
5780,2020-09-27,(07001) PERDOMO,304,148,338,790
5781,2020-10-07,(07001) PERDOMO,1189,706,933,2828
5782,2020-01-22,(09120) Calle 63,4365,3094,3170,10629
5783,2020-06-29,(09104) Restrepo,594,375,430,1399
5784,2020-08-11,(03000) Portal Suba - alimentacion,5209,2973,3182,11364
5785,2020-02-29,(02204) Pepe Sierra,2114,1450,1771,5335
5786,2020-01-08,(06002) Normandía,1490,864,924,3278
5787,2020-08-31,(07110) PALOQUEMAO,648,401,322,1371
5788,2020-01-25,(07102) NQS - CALLE 75,747,566,687,2000
5789,2020-05-07,(07102) NQS - CALLE 75,272,190,159,621
5790,2020-05-03,(02103) Mazurén,20,19,26,65
5791,2020-03-30,(07111) NQS - RICAURTE,355,270,192,817
5792,2020-10-06,(02000) Cabecera Autopista Norte - alimentacion,5324,2776,3880,11980
5793,2020-01-12,(07002) MADELENA,834,333,762,1929
5794,2020-04-17,(02000) Cabecera Autopista Norte,558,388,360,1306
5795,2020-09-18,(02000) Cabecera Autopista Norte,1703,968,1167,3838
5796,2020-09-07,(09113) Calle 22,417,203,336,956
5797,2020-05-13,(50003) Corral Molinos,1182,559,769,2510
5798,2020-09-20,(04000) Cabecera Calle 80,371,219,471,1061
5799,2020-01-16,(06109) Centro Memoria,961,524,580,2065
5800,2020-02-18,(03000) Portal Suba,10082,5930,5039,21051
5801,2020-07-28,(12001) Carrera 43,377,192,169,738
5802,2020-09-30,(12001) Carrera 43,489,303,368,1160
5803,2020-02-18,(07106) EL CAMPIN,2258,1401,1155,4814
5804,2020-04-06,(03000) Portal Suba,592,358,375,1325
5805,2020-09-27,(10002) Av. Primero de Mayo,540,332,822,1694
5806,2020-03-04,(08002) Biblioteca,1047,631,652,2330
5807,2020-02-15,(02300) Calle 100,2808,2092,2918,7818
5808,2020-07-03,(09004) Santa Lucía,2772,1465,1561,5798
5809,2020-03-10,(10007) Las Nieves,1334,85,266,1685
5810,2019-12-31,(04100) Carrera 77,59,44,96,199
5811,2020-09-23,(03003) 21 ANGELES,408,203,243,854
5812,2020-05-11,(10002) Av. Primero de Mayo,1508,804,923,3235
5813,2020-05-04,(14004) Museo del Oro,0,54,132,186
5814,2020-02-20,(07001) PERDOMO,4759,2774,2459,9992
5815,2020-02-22,(02105) Calle 142,2977,1371,2365,6713
5816,2020-10-03,(07001) PERDOMO,904,388,861,2153
5817,2020-02-21,(02304) Heroes,4276,3222,2351,9849
5818,2020-01-03,(10009) Museo Nacional,1972,1151,1214,4337
5819,2020-05-29,(09123) Calle 76,855,626,491,1972
5820,2020-07-27,(05002) Tintal,1950,1165,1194,4309
5821,2020-04-04,(05000) Portal Américas,878,569,646,2093
5822,2020-02-03,(03011) SUBA - CALLE 100,2670,1350,1448,5468
5823,2020-02-21,(03011) SUBA - CALLE 100,2555,1274,1502,5331
5824,2020-09-15,(02300) Calle 100,1251,847,791,2889
5825,2020-05-19,(10000) Portal 20 de Julio,1898,941,868,3707
5826,2020-09-27,(09123) Calle 76,217,180,315,712
5827,2020-02-08,(05101) Mandalay - Cr.73,524,251,365,1140
5828,2020-05-10,(09104) Restrepo,320,203,245,768
5829,2020-07-10,(05005) Transversal 86,0,231,540,771
5830,2020-07-13,(05005) Transversal 86,0,165,378,543
5831,2020-07-05,(05105) Pradera,151,113,152,416
5832,2020-02-01,(02205) Calle 106,902,679,922,2503
5833,2020-03-27,(02205) Calle 106,176,149,110,435
5834,2020-06-28,(04108) El Polo,95,58,72,225
5835,2020-03-04,(12007) Zona Industrial,1225,724,632,2581
5836,2020-05-02,(06000) Portal Eldorado - alimentacion,1842,813,822,3477
5837,2020-10-12,(06000) Portal Eldorado - alimentacion,1543,713,1229,3485
5838,2020-09-17,(07106) EL CAMPIN,450,295,316,1061
5839,2020-02-24,(07103) AV. CHILE,3736,2289,1901,7926
5840,2020-10-05,(07103) AV. CHILE,1000,620,692,2312
5841,2020-03-11,(07113) SANTA ISABEL,2004,1193,1356,4553
5842,2020-03-31,(03007) HUMEDAL CORDOBA,68,53,30,151
5843,2020-01-16,(08002) Biblioteca,894,476,648,2018
5844,2020-04-21,(02101) Toberín,658,454,439,1551
5845,2020-08-19,(02101) Toberín,1288,817,881,2986
5846,2020-06-24,(10010) San Bernardo,651,331,421,1403
5847,2020-06-13,(02303) Calle 85,423,318,258,999
5848,2020-07-06,(05103) Marsella,431,268,265,964
5849,2020-09-01,(06000) Portal Eldorado,939,608,505,2052
5850,2020-08-12,(02104) Calle 146,639,419,454,1512
5851,2020-09-21,(03002) SUBA - TV- 91,742,415,486,1643
5852,2020-01-01,(09110) Avenida Jimenez,146,158,497,801
5853,2020-09-15,(02202) Calle 127,1173,819,723,2715
5854,2020-07-08,(07101) CASTELLANA,230,132,124,486
5855,2020-04-29,(03001) LA CAMPIÑA,586,310,309,1205
5856,2020-06-18,(09120) Calle 63,1176,739,754,2669
5857,2020-01-24,(40001) Juan Pablo II,1583,867,963,3413
5858,2020-06-03,(04108) El Polo,455,284,232,971
5859,2020-09-15,(02001) Centro Comercial Santa Fe,543,335,438,1316
5860,2020-08-01,(02302) Virrey,389,281,237,907
5861,2020-06-27,(12003) Ricaurte,300,237,165,702
5862,2020-07-09,(12003) Ricaurte,406,277,204,887
5863,2020-05-14,(07106) EL CAMPIN,260,180,148,588
5864,2020-04-24,(03010) PUENTE LARGO,221,152,118,491
5865,2020-05-24,(02302) Virrey,152,98,99,349
5866,2020-03-12,(06104) Gobernación,475,81,136,692
5867,2020-08-11,(03002) SUBA - TV- 91,604,357,420,1381
5868,2020-02-08,(04101) Minuto de Dios,1490,838,1359,3687
5869,2020-07-08,(02103) Mazurén,222,145,210,577
5870,2020-08-03,(02103) Mazurén,138,96,108,342
5871,2020-09-15,(07103) AV. CHILE,961,606,539,2106
5872,2020-09-27,(07103) AV. CHILE,192,138,251,581
5873,2020-02-28,(07105) MOVISTAR ARENA,1325,833,753,2911
5874,2020-05-26,(02001) Centro Comercial Santa Fe,398,263,277,938
5875,2020-07-02,(02001) Centro Comercial Santa Fe,545,346,371,1262
5876,2020-10-04,(09123) Calle 76,211,185,334,730
5877,2020-08-25,(10008) San Diego,258,136,172,566
5878,2020-09-29,(03011) SUBA - CALLE 100,644,281,354,1279
5879,2020-01-15,(10004) Policarpa,710,358,602,1670
5880,2020-06-23,(06111) Universidades,293,196,336,825
5881,2020-01-06,(06100) Av. Rojas,164,106,251,521
5882,2020-03-28,(09004) Santa Lucía,698,372,375,1445
5883,2020-09-20,(05002) Tintal,784,394,799,1977
5884,2020-08-18,(03006) NIZA - CALLE 127,475,249,213,937
5885,2020-04-06,(02204) Pepe Sierra,426,340,242,1008
5886,2020-07-04,(07110) PALOQUEMAO,478,336,291,1105
5887,2020-07-17,(07110) PALOQUEMAO,551,331,233,1115
5888,2020-04-11,(09111) Calle 19,156,103,135,394
5889,2020-09-14,(07101) CASTELLANA,265,136,135,536
5890,2020-05-30,(09106) Nariño,282,162,211,655
5891,2020-01-05,(07106) EL CAMPIN,302,195,322,819
5892,2020-04-01,(10001) Country Sur,548,239,355,1142
5893,2020-08-11,(02200) Alcalá,1564,1083,896,3543
5894,2020-08-31,(07107) U. NACIONAL,356,229,189,774
5895,2020-05-18,(06109) Centro Memoria,231,143,109,483
5896,2020-07-27,(14004) Museo del Oro,268,166,204,638
5897,2020-06-29,(07004) VENECIA,341,200,221,762
5898,2020-08-22,(10006) San Victorino,245,180,296,721
5899,2020-06-13,(04001) Quirigua,310,180,222,712
5900,2020-01-07,(40002) Manitas,877,539,648,2064
5901,2020-05-07,(07112) COMUNEROS,531,315,326,1172
5902,2020-05-27,(09114) Calle 26,255,197,199,651
5903,2020-07-14,(09122) Calle 72,891,636,563,2090
5904,2020-05-03,(12000) Puente Aranda,8,9,6,23
5905,2020-05-18,(12000) Puente Aranda,63,42,32,137
5906,2020-07-13,(12000) Puente Aranda,95,44,34,173
5907,2020-07-29,(12000) Puente Aranda,82,44,36,162
5908,2020-06-01,(06105) Quinta Paredes,125,81,74,280
5909,2020-10-03,(02102) Calle 161,216,122,223,561
5910,2020-05-26,(03011) SUBA - CALLE 100,407,216,184,807
5911,2020-06-22,(10002) Av. Primero de Mayo,627,324,506,1457
5912,2020-08-26,(07107) U. NACIONAL,350,186,162,698
5913,2020-06-17,(02502) Terminal,428,313,359,1100
5914,2020-08-07,(02502) Terminal,130,89,143,362
5915,2020-08-21,(06001) Modelia,304,202,157,663
5916,2020-01-04,(07005) ALQUERIA,881,454,631,1966
5917,2020-08-15,(10009) Museo Nacional,235,190,271,696
5918,2020-07-07,(04106) Carrera 47,348,188,221,757
5919,2020-04-08,(03013) RIO NEGRO,132,90,110,332
5920,2020-09-26,(07101) CASTELLANA,145,87,147,379
5921,2020-07-11,(10004) Policarpa,228,81,163,472
5922,2020-01-07,(07200) Tygua-San José,468,304,477,1249
5923,2020-09-08,(02000) Cabecera Autopista Norte - intermunicipal,588,365,436,1389
5924,2020-10-11,(09100) Calle 40 Sur,666,315,718,1699
5925,2020-10-10,(02000) Cabecera Autopista Norte - intermunicipal,449,264,483,1196
5926,2020-07-11,(07008) NQS - Calle 30 Sur,255,127,181,563
5927,2020-06-27,(04105) Carrera 53,220,122,163,505
5928,2020-08-05,(06002) Normandía,229,149,163,541
5929,2020-09-11,(06002) Normandía,336,193,231,760
5930,2020-08-14,(09108) Hospital,66,43,55,164
5931,2020-03-01,(07006) General Santander,654,277,576,1507
5932,2020-05-20,(03005) SUBA - AV. BOYACA,347,207,224,778
5933,2020-08-05,(09003) Socorro,542,295,314,1151
5934,2020-05-13,(04002) Carrera 90,563,316,288,1167
5935,2020-02-23,(07107) U. NACIONAL,260,225,420,905
5936,2020-04-16,(07009) SENA,322,190,157,669
5937,2020-06-18,(04106) Carrera 47,338,164,151,653
5938,2020-09-11,(04106) Carrera 47,345,159,209,713
5939,2020-10-10,(07107) U. NACIONAL,287,186,239,712
5940,2020-05-10,(02303) Calle 85,163,103,86,352
5941,2020-07-27,(10004) Policarpa,207,101,138,446
5942,2020-05-25,(05100) Banderas P. Central,146,69,105,320
5943,2020-03-14,(03004) GRATAMIRA,115,45,81,241
5944,2020-05-26,(03004) GRATAMIRA,23,21,17,61
5945,2020-04-16,(06102) Salitre El Greco,124,87,82,293
5946,2020-05-09,(06111) Universidades,0,76,220,296
5947,2020-03-31,(12003) Ricaurte,92,73,75,240
5948,2020-08-02,(07007) NQS - Calle 38A Sur,103,74,86,263
5949,2020-04-29,(07200) Tygua-San José,125,88,108,321
5950,2020-07-26,(09116) Avenida 39,88,58,82,228
5951,2020-05-07,(06103) CAN,289,204,110,603
5952,2020-08-30,(02000) Cabecera Autopista Norte - intermunicipal,135,88,146,369
5953,2020-05-09,(04107) Escuela Militar,58,45,33,136
5954,2020-10-05,(04107) Escuela Militar,173,116,149,438
5955,2020-08-03,(04105) Carrera 53,217,132,137,486
5956,2020-04-03,(09003) Socorro,274,134,178,586
5957,2020-04-22,(06104) Gobernación,167,108,54,329
5958,2020-04-04,(06107) Ciudad Universitaria,72,50,48,170
5959,2020-06-11,(07003) SEVILLANA,413,215,221,849
5960,2020-06-08,(10003) Ciudad Jardín,181,101,128,410
5961,2020-07-11,(12004) Carrera 22,207,125,117,449
5962,2020-04-30,(07101) CASTELLANA,100,79,86,265
5963,2020-05-24,(10003) Ciudad Jardín,48,19,41,108
5964,2020-06-28,(10004) Policarpa,95,43,71,209
5965,2020-08-02,(14001) La Sabana,43,29,36,108
5966,2020-09-20,(06105) Quinta Paredes,32,31,51,114
5967,2020-07-12,(05101) Mandalay - Cr.73,34,19,23,76
5968,2020-07-02,(14005) Las Aguas,190,121,219,530
5969,2020-09-14,(03014) SAN MARTIN,0,11,33,44
5970,2020-06-15,(03014) SAN MARTIN,15,8,14,37
5971,2020-08-19,(09105) Río Fucha,0,54,96,150
5972,2020-05-30,(50002) Corral Calle 40 Sur,11,3,9,23
5973,2020-10-04,(50002) Corral Calle 40 Sur,4,2,6,12
5974,2020-02-19,(09118) Marly,8579,5499,4088,18166
5975,2020-02-08,(05000) Portal Américas - alimentacion,25491,13097,16092,54680
5976,2020-09-14,(10000) Portal 20 de Julio - alimentacion,4244,1858,2677,8779
5977,2020-09-17,(09119) Calle 57,629,409,465,1503
5978,2020-03-18,(03000) Portal Suba - alimentacion,15613,8504,7980,32097
5979,2020-05-02,(05000) Portal Américas,1085,751,857,2693
5980,2020-07-08,(05000) Portal Américas,2719,1867,1979,6565
5981,2020-01-22,(03010) PUENTE LARGO,2048,1296,1209,4553
5982,2020-01-22,(10000) Portal 20 de Julio - alimentacion,10419,5290,6914,22623
5983,2020-10-06,(07111) NQS - RICAURTE,1242,781,686,2709
5984,2020-03-28,(05000) Portal Américas - alimentacion,4464,2092,1909,8465
5985,2020-08-21,(06107) Ciudad Universitaria,157,91,102,350
5986,2020-06-10,(09001) Molinos,2342,1319,1497,5158
5987,2020-02-13,(05001) Patio Bonito,7241,4176,3712,15129
5988,2020-01-03,(05000) Portal Américas,7619,4081,4989,16689
5989,2020-01-25,(07112) COMUNEROS,2286,1213,1650,5149
5990,2020-09-04,(07112) COMUNEROS,949,522,609,2080
5991,2020-02-21,(05100) Banderas P. Central,7928,4015,3808,15751
5992,2020-09-04,(09000) Cabecera Usme,1885,1133,1451,4469
5993,2020-03-16,(05100) Banderas P. Central - alimentacion,10050,5643,5713,21406
5994,2020-01-17,(07009) SENA,2974,1718,1892,6584
5995,2020-02-18,(04000) Cabecera Calle 80,7617,4827,5017,17461
5996,2020-04-20,(06000) Portal Eldorado - alimentacion,2355,1167,1023,4545
5997,2020-02-29,(10002) Av. Primero de Mayo,4761,2303,4053,11117
5998,2020-03-09,(02101) Toberín,1273,4298,2182,7753
5999,2020-01-18,(07005) ALQUERIA,1527,774,1047,3348
6000,2020-03-11,(02105) Calle 142,6721,4006,3642,14369
6001,2020-03-02,(07001) PERDOMO,4535,2795,2455,9785
6002,2020-02-27,(10006) San Victorino,2418,1350,1307,5075
6003,2020-03-31,(06002) Normandía,153,102,100,355
6004,2020-06-01,(02000) Cabecera Autopista Norte - alimentacion,4405,2527,2444,9376
6005,2020-07-18,(05000) Portal Américas,1887,1083,1315,4285
6006,2020-08-07,(07102) NQS - CALLE 75,94,63,88,245
6007,2020-08-24,(03000) Portal Suba - alimentacion,5593,3038,3105,11736
6008,2020-02-27,(09103) Olaya,4310,2530,2319,9159
6009,2020-09-09,(07000) Portal Sur - alimentacion,8719,5061,5277,19057
6010,2020-08-04,(05100) Banderas P. Central - alimentacion,2612,1429,1542,5583
6011,2020-04-03,(07111) NQS - RICAURTE,376,277,212,865
6012,2020-04-19,(07111) NQS - RICAURTE,96,97,73,266
6013,2020-07-04,(07111) NQS - RICAURTE,949,591,447,1987
6014,2020-01-08,(02201) Prado,3686,2300,2241,8227
6015,2020-03-17,(10007) Las Nieves,1487,954,776,3217
6016,2020-04-03,(50003) Corral Molinos,768,346,543,1657
6017,2020-08-24,(07010) Bosa,594,279,341,1214
6018,2020-03-10,(07112) COMUNEROS,746,733,629,2108
6019,2020-01-29,(02000) Cabecera Autopista Norte - intermunicipal,4860,3279,3001,11140
6020,2020-01-10,(10001) Country Sur,3848,1539,2169,7556
6021,2020-01-18,(06109) Centro Memoria,447,326,471,1244
6022,2020-04-12,(10000) Portal 20 de Julio - alimentacion,1176,429,538,2143
6023,2020-06-03,(40003) Mirador del Paraiso,1599,1026,969,3594
6024,2020-07-10,(40003) Mirador del Paraiso,1906,1219,1114,4239
6025,2020-01-07,(12001) Carrera 43,1046,674,841,2561
6026,2020-04-25,(12001) Carrera 43,188,120,110,418
6027,2020-06-29,(12001) Carrera 43,65,77,82,224
6028,2020-07-04,(12001) Carrera 43,304,166,214,684
6029,2020-02-26,(06111) Universidades,5622,3659,2518,11799
6030,2020-02-04,(02105) Calle 142,7433,4641,3818,15892
6031,2020-04-01,(02000) Cabecera Autopista Norte - intermunicipal,132,95,94,321
6032,2020-10-07,(02000) Cabecera Autopista Norte - intermunicipal,686,451,617,1754
6033,2020-02-24,(06100) Av. Rojas,2779,1541,1235,5555
6034,2020-05-18,(07010) Bosa,576,277,350,1203
6035,2020-03-13,(02303) Calle 85,1344,107,341,1792
6036,2020-08-10,(07000) Portal Sur,1840,1147,1116,4103
6037,2020-08-21,(10002) Av. Primero de Mayo,1990,1000,1296,4286
6038,2020-08-27,(09004) Santa Lucía,2483,1258,1348,5089
6039,2020-07-22,(02101) Toberín,1311,838,875,3024
6040,2020-03-18,(02300) Calle 100,3325,2304,1872,7501
6041,2020-05-10,(07503) SAN MATEO,2194,1346,1054,4594
6042,2020-03-04,(02202) Calle 127,5871,3763,3032,12666
6043,2020-09-10,(02000) Cabecera Autopista Norte - alimentacion,4329,2228,2956,9513
6044,2020-04-06,(09107) Hortúa,398,274,244,916
6045,2020-06-28,(09107) Hortúa,224,127,158,509
6046,2020-01-07,(09118) Marly,3676,2497,2706,8879
6047,2020-01-18,(03011) SUBA - CALLE 100,1042,662,966,2670
6048,2020-01-28,(03012) SUBA - CALLE 95,1496,870,939,3305
6049,2020-07-05,(10000) Portal 20 de Julio,811,376,559,1746
6050,2020-09-10,(10000) Portal 20 de Julio,2237,1032,1127,4396
6051,2020-02-17,(50002) Corral Calle 40 Sur,150,95,136,381
6052,2020-05-12,(05005) Transversal 86,278,139,134,551
6053,2020-05-27,(05005) Transversal 86,307,170,169,646
6054,2020-07-28,(05105) Pradera,443,279,250,972
6055,2020-03-03,(03009) Av. Suba- Calle 116,2737,1596,1347,5680
6056,2020-07-09,(02205) Calle 106,391,244,244,879
6057,2020-10-01,(04101) Minuto de Dios,384,236,383,1003
6058,2020-07-16,(04108) El Polo,422,271,180,873
6059,2020-01-18,(02205) Calle 106,847,629,831,2307
6060,2020-03-16,(03011) SUBA - CALLE 100,1962,915,950,3827
6061,2020-05-03,(02101) Toberín,139,111,154,404
6062,2020-06-14,(02101) Toberín,266,181,284,731
6063,2020-03-03,(04101) Minuto de Dios,3568,2102,1833,7503
6064,2020-09-26,(07102) NQS - CALLE 75,317,234,315,866
6065,2020-05-28,(09100) Calle 40 Sur,1483,861,836,3180
6066,2020-07-23,(07104) Simon Bolivar,546,326,254,1126
6067,2020-06-10,(10005) Bicentenario - alimentacion,205,96,186,487
6068,2020-06-03,(09000) Cabecera Usme,1506,977,1005,3488
6069,2020-09-26,(04003) Avenida Ciudad de Cali,912,453,885,2250
6070,2020-09-03,(07007) NQS - Calle 38A Sur,425,276,352,1053
6071,2020-06-20,(02202) Calle 127,910,620,556,2086
6072,2020-07-21,(06000) Portal Eldorado,832,533,435,1800
6073,2020-02-15,(03001) LA CAMPIÑA,3608,1499,2551,7658
6074,2020-10-11,(09101) Quiroga,212,93,244,549
6075,2020-01-18,(06101) El Tiempo,826,531,875,2232
6076,2020-03-12,(06002) Normandía,345,479,360,1184
6077,2020-04-05,(05002) Tintal,319,238,195,752
6078,2020-03-23,(10001) Country Sur,267,118,170,555
6079,2020-02-20,(07004) VENECIA,4639,2633,2222,9494
6080,2020-03-29,(02000) Cabecera Autopista Norte,189,133,93,415
6081,2020-06-11,(07113) SANTA ISABEL,370,228,237,835
6082,2020-03-14,(06000) Portal Eldorado,2302,1680,2137,6119
6083,2020-01-29,(12003) Ricaurte,1236,804,612,2652
6084,2020-08-14,(12003) Ricaurte,395,270,163,828
6085,2020-04-26,(04101) Minuto de Dios,45,29,48,122
6086,2020-06-04,(09104) Restrepo,1330,841,918,3089
6087,2020-06-26,(02105) Calle 142,837,528,536,1901
6088,2020-05-15,(09116) Avenida 39,259,187,179,625
6089,2020-08-01,(03002) SUBA - TV- 91,413,226,283,922
6090,2020-08-28,(03002) SUBA - TV- 91,812,459,507,1778
6091,2020-08-28,(10010) San Bernardo,608,308,498,1414
6092,2020-01-25,(06109) Centro Memoria,484,320,430,1234
6093,2020-08-27,(10005) Bicentenario,84,60,68,212
6094,2020-05-22,(02304) Heroes,696,460,351,1507
6095,2020-04-04,(02000) Cabecera Autopista Norte,337,242,215,794
6096,2020-03-16,(03010) PUENTE LARGO,1314,895,713,2922
6097,2020-06-18,(09123) Calle 76,1109,720,576,2405
6098,2020-01-09,(10006) San Victorino,1271,814,906,2991
6099,2020-09-02,(07003) SEVILLANA,460,283,304,1047
6100,2020-01-03,(07006) General Santander,1287,739,872,2898
6101,2020-10-06,(07006) General Santander,639,373,470,1482
6102,2020-10-08,(10008) San Diego,346,190,255,791
6103,2020-09-20,(03011) SUBA - CALLE 100,171,123,146,440
6104,2020-05-09,(09120) Calle 63,622,413,353,1388
6105,2020-07-01,(09120) Calle 63,1224,752,756,2732
6106,2020-06-28,(09103) Olaya,364,162,245,771
6107,2020-07-08,(10010) San Bernardo,643,325,438,1406
6108,2020-06-25,(09003) Socorro,609,311,313,1233
6109,2020-07-21,(03006) NIZA - CALLE 127,456,262,205,923
6110,2020-04-22,(05001) Patio Bonito,929,539,558,2026
6111,2020-09-29,(09004) Santa Lucía,2787,1428,1744,5959
6112,2020-09-07,(07101) CASTELLANA,263,130,130,523
6113,2020-05-11,(09111) Calle 19,515,319,358,1192
6114,2020-05-21,(07201) Guatoque -Veraguas,154,104,89,347
6115,2020-01-22,(07105) MOVISTAR ARENA,1254,727,710,2691
6116,2020-03-25,(09121) Las Flores,444,291,265,1000
6117,2020-07-25,(02200) Alcalá,1199,802,590,2591
6118,2020-07-13,(07113) SANTA ISABEL,313,185,207,705
6119,2020-06-08,(09110) Avenida Jimenez,961,744,779,2484
6120,2020-01-01,(05103) Marsella,104,57,176,337
6121,2020-07-19,(09119) Calle 57,160,83,122,365
6122,2020-08-04,(06102) Salitre El Greco,202,118,99,419
6123,2020-07-17,(09110) Avenida Jimenez,522,520,656,1698
6124,2020-08-16,(02000) Cabecera Autopista Norte,336,228,268,832
6125,2020-07-14,(10002) Av. Primero de Mayo,1556,785,867,3208
6126,2020-03-25,(07109) CAD,414,301,221,936
6127,2020-06-23,(03005) SUBA - AV. BOYACA,462,280,276,1018
6128,2020-03-30,(12004) Carrera 22,42,40,48,130
6129,2020-08-27,(09111) Calle 19,736,442,427,1605
6130,2020-06-23,(06001) Modelia,426,275,221,922
6131,2020-09-24,(09122) Calle 72,1342,911,1006,3259
6132,2020-10-12,(06106) Recinto Ferial,73,55,93,221
6133,2020-10-11,(04106) Carrera 47,142,75,108,325
6134,2020-08-01,(02000) Cabecera Autopista Norte,809,508,535,1852
6135,2020-09-28,(10004) Policarpa,286,137,207,630
6136,2020-06-07,(02200) Alcalá,460,324,307,1091
6137,2020-06-22,(08001) Parque el Tunal,146,79,87,312
6138,2020-07-02,(07109) CAD,671,401,345,1417
6139,2020-05-31,(40003) Mirador del Paraiso,573,309,344,1226
6140,2020-03-15,(09122) Calle 72,919,595,1144,2658
6141,2020-09-15,(09117) Calle 45,682,456,519,1657
6142,2020-07-19,(04108) El Polo,71,39,77,187
6143,2020-04-18,(04003) Avenida Ciudad de Cali,376,243,255,874
6144,2020-07-20,(02001) Centro Comercial Santa Fe,141,88,91,320
6145,2020-08-23,(02001) Centro Comercial Santa Fe,122,74,117,313
6146,2020-07-10,(04000) Cabecera Calle 80 - intermunicipal,320,213,310,843
6147,2020-07-29,(04000) Cabecera Calle 80 - intermunicipal,328,180,285,793
6148,2020-06-12,(04102) Avenida Boyaca,341,195,192,728
6149,2020-02-22,(07108) Av. El Dorado,394,274,488,1156
6150,2020-06-23,(07108) Av. El Dorado,157,110,104,371
6151,2020-07-28,(06002) Normandía,256,173,181,610
6152,2020-09-15,(06002) Normandía,342,186,236,764
6153,2020-05-19,(04101) Minuto de Dios,268,171,174,613
6154,2020-05-23,(04000) Cabecera Calle 80 - intermunicipal,131,64,115,310
6155,2020-05-29,(04001) Quirigua,346,199,225,770
6156,2020-08-17,(04001) Quirigua,115,58,86,259
6157,2020-09-02,(09108) Hospital,27,38,76,141
6158,2020-01-17,(07006) General Santander - alimentacion,1232,766,993,2991
6159,2020-03-21,(07006) General Santander,163,94,83,340
6160,2020-04-16,(06101) El Tiempo,208,130,103,441
6161,2020-06-20,(06101) El Tiempo,213,153,198,564
6162,2020-03-22,(09104) Restrepo,261,172,190,623
6163,2020-06-24,(14004) Museo del Oro,275,184,236,695
6164,2020-09-17,(09003) Socorro,603,319,409,1331
6165,2020-10-12,(09114) Calle 26,73,57,127,257
6166,2020-06-21,(07107) U. NACIONAL,96,82,60,238
6167,2020-08-26,(03010) PUENTE LARGO,349,188,189,726
6168,2020-05-07,(09117) Calle 45,529,359,282,1170
6169,2020-07-18,(40002) Manitas,236,142,167,545
6170,2020-03-29,(06102) Salitre El Greco,63,42,37,142
6171,2020-07-08,(09113) Calle 22,431,253,338,1022
6172,2020-09-13,(07506) DESPENSA,123,78,129,330
6173,2020-05-21,(12007) Zona Industrial,243,168,119,530
6174,2020-04-15,(06001) Modelia,259,176,156,591
6175,2020-07-27,(06001) Modelia,322,203,161,686
6176,2020-09-16,(05102) Av. Américas - Av. Boyacá,301,160,218,679
6177,2020-08-23,(09119) Calle 57,161,104,178,443
6178,2020-06-07,(09122) Calle 72,306,230,263,799
6179,2020-05-03,(06111) Universidades,0,21,66,87
6180,2020-04-20,(06111) Universidades,0,82,223,305
6181,2020-03-28,(14005) Las Aguas,0,26,62,88
6182,2020-06-03,(07003) SEVILLANA,383,235,192,810
6183,2020-06-21,(03004) GRATAMIRA,13,10,16,39
6184,2020-02-09,(50006) Corral Carrera 77,13,9,19,41
6185,2020-04-25,(10003) Ciudad Jardín,83,44,47,174
6186,2020-03-28,(12007) Zona Industrial,103,98,63,264
6187,2020-05-27,(07108) Av. El Dorado,116,72,62,250
6188,2020-04-09,(05103) Marsella,80,41,42,163
6189,2020-10-11,(07006) General Santander - alimentacion,75,43,124,242
6190,2020-05-24,(14005) Las Aguas,0,16,53,69
6191,2020-05-31,(04003) Avenida Ciudad de Cali,239,143,214,596
6192,2020-03-30,(07002) MADELENA,352,193,175,720
6193,2020-08-09,(09114) Calle 26,57,38,66,161
6194,2020-05-28,(10003) Ciudad Jardín,168,91,110,369
6195,2020-06-07,(02204) Pepe Sierra,202,148,151,501
6196,2020-04-10,(07008) NQS - Calle 30 Sur,54,30,21,105
6197,2020-07-02,(50002) Corral Calle 40 Sur,28,12,37,77
6198,2019-12-31,(04108) El Polo,23,10,19,52
6199,2020-07-14,(07108) Av. El Dorado,142,94,70,306
6200,2020-03-21,(02104) Calle 146,252,178,125,555
6201,2020-06-06,(10005) Bicentenario,70,38,66,174
6202,2020-04-04,(03014) SAN MARTIN,14,7,15,36
6203,2020-05-01,(07106) EL CAMPIN,100,75,58,233
6204,2020-04-10,(04101) Minuto de Dios,41,27,26,94
6205,2020-05-16,(50006) Corral Carrera 77,3,0,8,11
6206,2020-08-15,(50006) Corral Carrera 77,3,1,3,7
6207,2020-03-26,(03004) GRATAMIRA,17,10,10,37
6208,2020-04-12,(03004) GRATAMIRA,12,9,3,24
6209,2020-06-22,(50002) Corral Calle 40 Sur,7,2,6,15
6210,2020-09-13,(04000) Cabecera Calle 80 - alimentacion,1378,609,1396,3383
6211,2020-10-11,(09002) Consuelo,162,63,181,406
6212,2020-01-11,(07504) TERREROS,10053,5028,6457,21538
6213,2020-05-01,(07504) TERREROS,1297,782,747,2826
6214,2020-09-11,(07504) TERREROS,5346,3070,3343,11759
6215,2020-02-10,(03000) Portal Suba - alimentacion,29491,17794,16409,63694
6216,2020-01-29,(05000) Portal Américas - alimentacion,35921,20488,19627,76036
6217,2020-04-28,(05000) Portal Américas - alimentacion,7245,3544,3057,13846
6218,2020-01-13,(07503) SAN MATEO,35455,19605,16516,71576
6219,2020-02-14,(02200) Alcalá,14884,8846,6800,30530
6220,2020-08-21,(09003) Socorro,583,315,354,1252
6221,2020-01-03,(50003) Corral Molinos,2138,1216,2215,5569
6222,2020-06-03,(04002) Carrera 90,667,367,316,1350
6223,2020-09-25,(09001) Molinos,2965,1515,2185,6665
6224,2020-03-05,(05001) Patio Bonito,7201,3951,3683,14835
6225,2020-03-16,(09004) Santa Lucía,5934,3185,3105,12224
6226,2020-01-26,(09000) Cabecera Usme,1219,574,1297,3090
6227,2020-02-11,(09000) Cabecera Usme,6117,3790,4113,14020
6228,2020-03-12,(04000) Cabecera Calle 80,810,1717,1354,3881
6229,2020-01-31,(06102) Salitre El Greco,1493,827,732,3052
6230,2020-02-14,(10003) Ciudad Jardín,1107,547,694,2348
6231,2020-03-11,(10005) Bicentenario - alimentacion,682,364,518,1564
6232,2020-01-07,(09120) Calle 63,2792,2124,2510,7426
6233,2020-02-13,(09000) Cabecera Usme - alimentacion,27001,14931,15860,57792
6234,2020-01-16,(06000) Portal Eldorado - alimentacion,15174,7735,8375,31284
6235,2020-08-27,(03000) Portal Suba - alimentacion,6000,3433,3478,12911
6236,2020-02-10,(09110) Avenida Jimenez,5317,3458,2925,11700
6237,2020-01-23,(07110) PALOQUEMAO,2297,1347,1061,4705
6238,2020-05-04,(07102) NQS - CALLE 75,244,170,160,574
6239,2020-06-17,(03013) RIO NEGRO,280,175,169,624
6240,2020-04-14,(09110) Avenida Jimenez,280,250,268,798
6241,2020-01-28,(09116) Avenida 39,2564,1698,1379,5641
6242,2020-04-27,(09100) Calle 40 Sur,677,103,142,922
6243,2020-01-08,(02303) Calle 85,2664,1813,1471,5948
6244,2020-06-26,(07000) Portal Sur - alimentacion,8491,4870,4185,17546
6245,2020-06-08,(09103) Olaya,1000,582,533,2115
6246,2020-03-03,(14001) La Sabana,626,415,395,1436
6247,2020-06-22,(07002) MADELENA,219,120,165,504
6248,2020-03-03,(07107) U. NACIONAL,2418,1768,1881,6067
6249,2020-01-14,(02201) Prado,4769,2990,2646,10405
6250,2020-02-25,(10007) Las Nieves,2158,1264,1238,4660
6251,2020-02-05,(09000) Cabecera Usme - alimentacion,26168,14975,16437,57580
6252,2020-01-27,(10002) Av. Primero de Mayo,7951,3980,4538,16469
6253,2020-05-04,(50003) Corral Molinos,956,481,688,2125
6254,2020-02-03,(04000) Cabecera Calle 80,7195,4543,5235,16973
6255,2020-04-23,(04000) Cabecera Calle 80,553,380,404,1337
6256,2020-02-09,(07010) Bosa,473,248,577,1298
6257,2020-08-07,(09104) Restrepo,652,380,466,1498
6258,2020-09-15,(02201) Prado,951,655,645,2251
6259,2020-01-27,(07506) DESPENSA,1598,919,882,3399
6260,2020-09-01,(09111) Calle 19,716,443,486,1645
6261,2020-08-26,(03000) Portal Suba,1177,737,824,2738
6262,2020-06-26,(06000) Portal Eldorado,982,677,535,2194
6263,2020-07-31,(06000) Portal Eldorado,829,519,428,1776
6264,2020-04-18,(08000) Portal Tunal - alimentacion,2557,1386,1345,5288
6265,2020-03-02,(09123) Calle 76,5559,3645,3187,12391
6266,2020-02-01,(04001) Quirigua,1128,516,946,2590
6267,2020-09-25,(06000) Portal Eldorado - alimentacion,4399,2217,2854,9470
6268,2020-06-24,(12001) Carrera 43,446,274,255,975
6269,2020-08-11,(12001) Carrera 43,424,224,238,886
6270,2020-08-24,(12001) Carrera 43,390,205,190,785
6271,2020-04-11,(50003) Corral Molinos,528,243,336,1107
6272,2020-02-12,(10005) Bicentenario - alimentacion,752,343,510,1605
6273,2020-04-08,(03000) Portal Suba,567,322,381,1270
6274,2020-08-06,(02000) Cabecera Autopista Norte - intermunicipal,500,332,349,1181
6275,2020-09-05,(03000) Portal Suba - alimentacion,5390,2558,3767,11715
6276,2020-06-19,(07112) COMUNEROS,838,492,491,1821
6277,2020-02-24,(02001) Centro Comercial Santa Fe,4808,3079,2500,10387
6278,2020-08-11,(07004) VENECIA,921,547,514,1982
6279,2020-02-05,(09004) Santa Lucía,7902,4303,4259,16464
6280,2020-03-03,(09004) Santa Lucía,7635,4223,4309,16167
6281,2020-05-28,(09003) Socorro,516,239,284,1039
6282,2020-05-14,(08001) Parque el Tunal,360,205,172,737
6283,2020-05-10,(07505) LEON XIII,542,298,261,1101
6284,2020-02-11,(06108) Concejo de Bogotá,950,493,421,1864
6285,2020-04-29,(06108) Concejo de Bogotá,112,65,61,238
6286,2020-05-28,(07010) Bosa,609,336,335,1280
6287,2020-01-18,(09003) Socorro,1141,528,760,2429
6288,2020-08-20,(09000) Cabecera Usme - alimentacion,8008,4215,4550,16773
6289,2020-02-09,(02101) Toberín,1816,897,2319,5032
6290,2020-05-14,(02201) Prado,639,425,368,1432
6291,2020-07-21,(09107) Hortúa,529,318,309,1156
6292,2020-07-25,(09107) Hortúa,336,209,229,774
6293,2020-09-10,(09107) Hortúa,571,332,349,1252
6294,2020-01-02,(05103) Marsella,1006,557,604,2167
6295,2020-02-03,(02103) Mazurén,3476,2248,1877,7601
6296,2020-03-08,(03000) Portal Suba,1382,638,1611,3631
6297,2020-06-15,(02300) Calle 100,332,252,230,814
6298,2020-07-23,(50002) Corral Calle 40 Sur,12,11,18,41
6299,2020-01-24,(07007) NQS - Calle 38A Sur,2009,1127,1210,4346
6300,2020-02-05,(05107) Américas - Cr.53,2739,1556,1467,5762
6301,2020-08-15,(05101) Mandalay - Cr.73,97,47,59,203
6302,2020-01-19,(10002) Av. Primero de Mayo,1472,724,1730,3926
6303,2020-09-13,(09104) Restrepo,524,280,536,1340
6304,2020-07-30,(05005) Transversal 86,279,183,208,670
6305,2020-09-29,(05005) Transversal 86,500,257,347,1104
6306,2020-09-12,(05105) Pradera,484,277,313,1074
6307,2020-01-12,(04105) Carrera 53,258,138,269,665
6308,2020-04-15,(05107) Américas - Cr.53,281,245,206,732
6309,2020-02-01,(03009) Av. Suba- Calle 116,1039,789,1003,2831
6310,2020-07-30,(02205) Calle 106,335,227,225,787
6311,2020-09-01,(04108) El Polo,514,305,230,1049
6312,2020-07-01,(02300) Calle 100,1379,849,737,2965
6313,2020-01-02,(12007) Zona Industrial,517,374,321,1212
6314,2020-05-02,(07201) Guatoque -Veraguas,69,55,54,178
6315,2020-08-28,(07113) SANTA ISABEL,395,230,268,893
6316,2020-08-24,(03007) HUMEDAL CORDOBA,136,97,87,320
6317,2020-09-27,(03007) HUMEDAL CORDOBA,40,54,49,143
6318,2020-08-08,(04000) Cabecera Calle 80 - alimentacion,2184,1180,1640,5004
6319,2020-09-22,(05101) Mandalay - Cr.73,172,109,78,359
6320,2020-03-02,(06101) El Tiempo,2841,1672,1384,5897
6321,2020-02-25,(07004) VENECIA,4793,2823,2417,10033
6322,2020-03-09,(10009) Museo Nacional,2228,209,419,2856
6323,2020-01-02,(07002) MADELENA,1983,1093,1304,4380
6324,2020-08-18,(07002) MADELENA,739,443,480,1662
6325,2020-04-22,(09110) Avenida Jimenez,354,273,288,915
6326,2020-03-02,(12003) Ricaurte,1267,792,679,2738
6327,2020-01-19,(02202) Calle 127,966,698,936,2600
6328,2020-01-10,(40001) Juan Pablo II,1343,744,838,2925
6329,2020-09-23,(07101) CASTELLANA,283,155,186,624
6330,2020-09-29,(40001) Juan Pablo II,592,344,445,1381
6331,2020-06-09,(09104) Restrepo,1404,869,1002,3275
6332,2020-08-12,(06001) Modelia,347,224,169,740
6333,2020-05-06,(02105) Calle 142,523,329,242,1094
6334,2020-10-10,(02105) Calle 142,652,377,638,1667
6335,2020-04-17,(09000) Cabecera Usme,816,493,626,1935
6336,2020-01-10,(06108) Concejo de Bogotá,596,353,380,1329
6337,2020-02-25,(04000) Cabecera Calle 80 - intermunicipal,2475,1733,2135,6343
6338,2020-06-03,(02103) Mazurén,179,119,125,423
6339,2020-05-27,(05100) Banderas P. Central - alimentacion,2498,1191,1244,4933
6340,2020-07-03,(12007) Zona Industrial,372,219,193,784
6341,2020-03-02,(07105) MOVISTAR ARENA,1270,830,729,2829
6342,2020-02-14,(40002) Manitas,1347,755,806,2908
6343,2020-08-25,(40002) Manitas,375,225,284,884
6344,2020-07-14,(02001) Centro Comercial Santa Fe,436,265,271,972
6345,2020-04-10,(02300) Calle 100,295,230,159,684
6346,2020-02-16,(07102) NQS - CALLE 75,239,171,320,730
6347,2020-07-27,(08002) Biblioteca,302,174,180,656
6348,2020-06-17,(12007) Zona Industrial,379,253,182,814
6349,2020-10-10,(04002) Carrera 90,629,260,500,1389
6350,2020-09-22,(07110) PALOQUEMAO,709,452,381,1542
6351,2020-04-06,(02304) Heroes,407,324,274,1005
6352,2020-07-27,(09000) Cabecera Usme,1602,987,1157,3746
6353,2020-02-25,(05101) Mandalay - Cr.73,1228,699,563,2490
6354,2020-04-04,(06109) Centro Memoria,104,79,75,258
6355,2020-03-30,(07001) PERDOMO,453,241,289,983
6356,2020-04-15,(03002) SUBA - TV- 91,341,247,205,793
6357,2020-09-12,(06104) Gobernación,160,94,122,376
6358,2020-09-26,(06104) Gobernación,141,109,162,412
6359,2020-03-03,(07006) General Santander - alimentacion,1523,890,1013,3426
6360,2020-04-25,(09114) Calle 26,95,83,81,259
6361,2020-05-08,(07201) Guatoque -Veraguas,111,65,68,244
6362,2020-01-02,(07105) MOVISTAR ARENA,604,411,390,1405
6363,2020-09-22,(07105) MOVISTAR ARENA,267,156,156,579
6364,2020-05-09,(06109) Centro Memoria,161,103,95,359
6365,2020-09-05,(03003) 21 ANGELES,266,116,222,604
6366,2020-07-09,(10004) Policarpa,266,116,162,544
6367,2020-07-14,(06107) Ciudad Universitaria,146,95,85,326
6368,2020-04-23,(04103) Las Ferias,206,122,90,418
6369,2020-02-15,(40002) Manitas,978,491,704,2173
6370,2020-08-14,(09110) Avenida Jimenez,1383,1050,891,3324
6371,2020-05-11,(40002) Manitas,271,159,181,611
6372,2020-08-12,(03005) SUBA - AV. BOYACA,349,214,202,765
6373,2020-10-01,(03005) SUBA - AV. BOYACA,532,324,400,1256
6374,2020-02-18,(50002) Corral Calle 40 Sur,159,108,116,383
6375,2020-05-10,(07109) CAD,168,93,77,338
6376,2020-05-23,(14001) La Sabana,121,75,55,251
6377,2020-05-21,(07111) NQS - RICAURTE,906,591,344,1841
6378,2020-05-09,(10007) Las Nieves,202,145,148,495
6379,2020-08-05,(04106) Carrera 47,253,125,154,532
6380,2020-08-04,(07110) PALOQUEMAO,574,356,226,1156
6381,2020-04-21,(06101) El Tiempo,218,148,117,483
6382,2020-05-24,(10004) Policarpa,78,36,45,159
6383,2020-10-08,(10004) Policarpa,271,138,229,638
6384,2020-08-05,(07200) Tygua-San José,228,116,128,472
6385,2020-08-26,(07009) SENA,581,358,376,1315
6386,2020-03-01,(04108) El Polo,318,195,427,940
6387,2020-10-05,(10007) Las Nieves,738,459,505,1702
6388,2020-08-19,(12002) CDS - Carrera 32,192,116,72,380
6389,2020-04-15,(03006) NIZA - CALLE 127,228,137,112,477
6390,2020-04-01,(40001) Juan Pablo II,286,148,188,622
6391,2020-08-25,(06103) CAN,326,197,157,680
6392,2020-07-12,(03003) 21 ANGELES,97,47,85,229
6393,2020-04-09,(07109) CAD,178,123,80,381
6394,2020-07-18,(04000) Cabecera Calle 80 - intermunicipal,185,86,170,441
6395,2020-05-10,(07111) NQS - RICAURTE,91,84,73,248
6396,2020-04-10,(04103) Las Ferias,73,50,39,162
6397,2020-04-05,(03009) Av. Suba- Calle 116,134,88,64,286
6398,2020-05-13,(07108) Av. El Dorado,100,60,71,231
6399,2020-07-10,(06105) Quinta Paredes,153,72,94,319
6400,2020-07-14,(06105) Quinta Paredes,135,73,61,269
6401,2020-07-13,(09116) Avenida 39,315,195,156,666
6402,2020-04-15,(12001) Carrera 43,253,165,127,545
6403,2020-07-20,(07005) ALQUERIA,128,95,92,315
6404,2020-09-06,(04103) Las Ferias,125,75,113,313
6405,2020-01-14,(12004) Carrera 22,619,373,407,1399
6406,2020-10-11,(04001) Quirigua,159,80,165,404
6407,2020-05-08,(07105) MOVISTAR ARENA,165,110,99,374
6408,2020-07-27,(06101) El Tiempo,277,180,207,664
6409,2020-03-30,(09105) Río Fucha,53,40,58,151
6410,2020-05-23,(07009) SENA,422,237,228,887
6411,2020-04-11,(07002) MADELENA,169,108,113,390
6412,2020-05-22,(03011) SUBA - CALLE 100,391,213,177,781
6413,2020-07-18,(12003) Ricaurte,159,151,120,430
6414,2020-04-14,(02000) Cabecera Autopista Norte - intermunicipal,146,114,100,360
6415,2020-06-26,(09106) Nariño,460,254,289,1003
6416,2020-06-06,(09114) Calle 26,141,103,171,415
6417,2020-02-09,(08002) Biblioteca,213,127,232,572
6418,2020-01-26,(12002) CDS - Carrera 32,53,71,88,212
6419,2020-05-06,(12004) Carrera 22,117,82,81,280
6420,2020-04-04,(02303) Calle 85,214,168,157,539
6421,2020-06-24,(06106) Recinto Ferial,262,140,137,539
6422,2020-08-10,(06106) Recinto Ferial,231,141,154,526
6423,2020-05-29,(06103) CAN,323,233,155,711
6424,2020-06-28,(03000) Portal Suba,335,181,328,844
6425,2020-05-07,(06100) Av. Rojas,155,87,92,334
6426,2020-04-27,(07002) MADELENA,262,20,47,329
6427,2020-06-06,(02102) Calle 161,160,90,135,385
6428,2020-08-26,(06102) Salitre El Greco,182,108,122,412
6429,2020-08-14,(14005) Las Aguas,191,116,182,489
6430,2020-07-18,(06107) Ciudad Universitaria,98,56,88,242
6431,2020-07-10,(09105) Río Fucha,133,61,78,272
6432,2020-05-16,(07108) Av. El Dorado,69,39,48,156
6433,2020-05-05,(10003) Ciudad Jardín,119,67,103,289
6434,2020-09-12,(06107) Ciudad Universitaria,131,86,171,388
6435,2020-06-21,(04107) Escuela Militar,37,21,46,104
6436,2020-10-11,(09108) Hospital,35,22,43,100
6437,2020-04-25,(07106) EL CAMPIN,126,88,85,299
6438,2020-07-11,(50002) Corral Calle 40 Sur,23,13,16,52
6439,2020-09-19,(50002) Corral Calle 40 Sur,20,7,24,51
6440,2020-09-26,(50002) Corral Calle 40 Sur,26,11,32,69
6441,2020-05-07,(50002) Corral Calle 40 Sur,9,2,18,29
6442,2020-05-10,(06001) Modelia,58,48,54,160
6443,2020-07-19,(03014) SAN MARTIN,0,6,13,19
6444,2020-08-17,(09108) Hospital,33,14,33,80
6445,2020-03-26,(50002) Corral Calle 40 Sur,10,9,10,29
6446,2020-03-27,(03007) HUMEDAL CORDOBA,64,61,42,167
6447,2020-09-08,(03004) GRATAMIRA,0,17,27,44
6448,2020-07-26,(04000) Cabecera Calle 80 - alimentacion,961,484,711,2156
6449,2020-07-06,(07005) ALQUERIA,578,350,352,1280
6450,2020-09-21,(10000) Portal 20 de Julio - alimentacion,3616,1336,2209,7161
6451,2020-01-08,(09119) Calle 57,2047,1409,1489,4945
6452,2020-03-09,(05000) Portal Américas - alimentacion,1088,9447,6168,16703
6453,2020-10-11,(05000) Portal Américas - alimentacion,3945,1573,2993,8511
6454,2020-03-16,(06000) Portal Eldorado - alimentacion,12540,6514,6470,25524
6455,2020-01-30,(09114) Calle 26,2907,1959,1765,6631
6456,2020-01-25,(09003) Socorro,1105,523,875,2503
6457,2020-05-27,(04101) Minuto de Dios,290,190,191,671
6458,2020-06-12,(07503) SAN MATEO,10507,6537,5498,22542
6459,2020-08-31,(05000) Portal Américas - alimentacion,10760,5771,5805,22336
6460,2020-02-04,(07010) Bosa,2246,1320,1449,5015
6461,2020-03-04,(04103) Las Ferias,1604,944,885,3433
6462,2020-01-31,(14004) Museo del Oro,3556,2382,2069,8007
6463,2020-02-11,(14004) Museo del Oro,4459,2688,2080,9227
6464,2020-09-09,(07112) COMUNEROS,910,534,631,2075
6465,2020-01-07,(03000) Portal Suba,5692,3462,3729,12883
6466,2020-09-21,(08000) Portal Tunal - alimentacion,5653,2588,3364,11605
6467,2020-09-26,(08000) Portal Tunal - alimentacion,5670,2736,3979,12385
6468,2020-10-06,(05100) Banderas P. Central,1202,656,908,2766
6469,2020-08-25,(10001) Country Sur,1147,502,675,2324
6470,2020-04-08,(06000) Portal Eldorado - alimentacion,2237,1033,958,4228
6471,2020-01-19,(09115) Calle 34,477,360,722,1559
6472,2020-01-27,(02000) Cabecera Autopista Norte,10817,6638,5756,23211
6473,2020-07-30,(10000) Portal 20 de Julio - alimentacion,4007,1802,2300,8109
6474,2020-09-05,(09000) Cabecera Usme - alimentacion,7632,3673,5272,16577
6475,2020-03-19,(40003) Mirador del Paraiso,3180,1795,1873,6848
6476,2020-03-24,(40003) Mirador del Paraiso,1070,597,904,2571
6477,2020-08-18,(09104) Restrepo,1392,821,1102,3315
6478,2020-06-06,(03000) Portal Suba - alimentacion,4265,2329,2399,8993
6479,2020-02-06,(09110) Avenida Jimenez,5049,3647,2921,11617
6480,2020-01-17,(09101) Quiroga,1412,823,1137,3372
6481,2020-02-22,(09104) Restrepo,3390,2011,3141,8542
6482,2020-07-13,(07102) NQS - CALLE 75,419,259,209,887
6483,2020-08-22,(07102) NQS - CALLE 75,314,212,222,748
6484,2020-03-15,(03013) RIO NEGRO,229,131,238,598
6485,2020-05-18,(03013) RIO NEGRO,214,152,160,526
6486,2020-06-30,(09000) Cabecera Usme - alimentacion,9006,5030,5324,19360
6487,2020-07-04,(06000) Portal Eldorado - alimentacion,3232,1586,1913,6731
6488,2020-02-26,(02302) Virrey,3899,2724,1951,8574
6489,2020-01-30,(07110) PALOQUEMAO,2460,1428,1180,5068
6490,2020-05-13,(07106) EL CAMPIN,238,162,147,547
6491,2020-01-14,(02103) Mazurén,2755,1754,1656,6165
6492,2020-05-27,(02103) Mazurén,151,99,124,374
6493,2020-08-04,(07000) Portal Sur - alimentacion,6814,3753,3484,14051
6494,2020-08-19,(07000) Portal Sur - alimentacion,7447,4158,3851,15456
6495,2020-07-18,(05100) Banderas P. Central - alimentacion,1942,867,1073,3882
6496,2020-02-04,(14001) La Sabana,603,403,395,1401
6497,2020-02-13,(14001) La Sabana,641,403,398,1442
6498,2020-05-12,(14001) La Sabana,127,101,71,299
6499,2020-07-23,(08000) Portal Tunal - alimentacion,4467,2489,2538,9494
6500,2020-07-02,(02000) Cabecera Autopista Norte,1393,935,849,3177
6501,2020-03-21,(04105) Carrera 53,93,61,60,214
6502,2020-01-31,(06105) Quinta Paredes,1007,591,575,2173
6503,2020-05-09,(04002) Carrera 90,363,211,160,734
6504,2020-01-04,(06109) Centro Memoria,273,198,303,774
6505,2020-01-22,(04001) Quirigua,1802,1098,1142,4042
6506,2020-02-07,(07113) SANTA ISABEL,2261,1310,1547,5118
6507,2020-02-11,(10005) Bicentenario - alimentacion,741,343,546,1630
6508,2020-02-16,(03000) Portal Suba - alimentacion,6088,2899,5718,14705
6509,2020-03-10,(03000) Portal Suba,492,2854,2041,5387
6510,2020-07-04,(03000) Portal Suba,1006,553,757,2316
6511,2020-08-21,(02000) Cabecera Autopista Norte - intermunicipal,483,312,364,1159
6512,2020-02-28,(08001) Parque el Tunal,1735,952,978,3665
6513,2020-03-18,(08001) Parque el Tunal,1096,552,618,2266
6514,2020-03-07,(09108) Hospital,179,94,158,431
6515,2020-05-11,(07503) SAN MATEO,7422,4622,3621,15665
6516,2020-08-30,(07503) SAN MATEO,3378,1767,2166,7311
6517,2020-06-01,(08001) Parque el Tunal,460,261,241,962
6518,2020-06-30,(09116) Avenida 39,372,221,231,824
6519,2020-09-27,(07505) LEON XIII,910,391,626,1927
6520,2020-08-21,(09000) Cabecera Usme - alimentacion,8119,4263,4625,17007
6521,2020-09-27,(06002) Normandía,108,71,144,323
6522,2020-03-05,(06001) Modelia,2569,1578,1320,5467
6523,2020-03-25,(03000) Portal Suba - alimentacion,3517,1931,1775,7223
6524,2020-09-12,(03000) Portal Suba - alimentacion,5112,2559,3845,11516
6525,2020-08-12,(09107) Hortúa,573,356,315,1244
6526,2020-06-12,(09123) Calle 76,1021,698,599,2318
6527,2020-06-19,(05101) Mandalay - Cr.73,145,77,75,297
6528,2020-03-07,(07005) ALQUERIA,1611,862,1154,3627
6529,2020-01-15,(02103) Mazurén,2769,1670,1609,6048
6530,2020-01-20,(02102) Calle 161,1758,1036,1084,3878
6531,2020-02-29,(02300) Calle 100,2797,2096,2914,7807
6532,2020-10-03,(02300) Calle 100,780,604,865,2249
6533,2020-07-21,(09119) Calle 57,444,333,287,1064
6534,2020-02-16,(04106) Carrera 47,380,170,315,865
6535,2020-09-14,(10010) San Bernardo,605,317,443,1365
6536,2020-09-11,(07104) Simon Bolivar,582,325,312,1219
6537,2020-07-18,(05005) Transversal 86,175,117,193,485
6538,2020-03-03,(10008) San Diego,1556,874,790,3220
6539,2020-08-28,(05107) Américas - Cr.53,398,258,249,905
6540,2020-05-13,(02205) Calle 106,259,187,130,576
6541,2020-03-07,(04108) El Polo,978,610,927,2515
6542,2020-02-17,(07201) Guatoque -Veraguas,1063,542,616,2221
6543,2020-09-06,(07201) Guatoque -Veraguas,39,27,83,149
6544,2020-06-16,(06102) Salitre El Greco,230,137,117,484
6545,2020-06-02,(02201) Prado,827,536,443,1806
6546,2020-06-27,(07113) SANTA ISABEL,319,171,240,730
6547,2020-08-08,(06000) Portal Eldorado,534,366,396,1296
6548,2020-08-02,(03007) HUMEDAL CORDOBA,22,20,16,58
6549,2020-01-07,(07108) Av. El Dorado,525,348,437,1310
6550,2020-03-31,(02202) Calle 127,669,490,358,1517
6551,2020-05-30,(07104) Simon Bolivar,430,285,206,921
6552,2020-01-13,(07109) CAD,2447,1493,1347,5287
6553,2020-09-13,(04003) Avenida Ciudad de Cali,302,165,354,821
6554,2020-05-06,(05103) Marsella,231,118,110,459
6555,2020-09-19,(04002) Carrera 90,649,318,466,1433
6556,2020-08-29,(05001) Patio Bonito,1678,809,1042,3529
6557,2020-01-14,(14005) Las Aguas,1739,1090,1386,4215
6558,2020-06-27,(09114) Calle 26,173,125,197,495
6559,2020-05-20,(04100) Carrera 77,1034,552,631,2217
6560,2020-08-30,(05002) Tintal,643,337,595,1575
6561,2020-03-23,(09001) Molinos,507,280,330,1117
6562,2020-09-06,(03001) LA CAMPIÑA,347,161,356,864
6563,2020-04-11,(08000) Portal Tunal - alimentacion,2118,1192,1079,4389
6564,2020-06-12,(07009) SENA,637,384,372,1393
6565,2020-02-08,(07107) U. NACIONAL,976,710,970,2656
6566,2020-09-15,(02302) Virrey,732,498,428,1658
6567,2020-06-30,(12003) Ricaurte,386,210,223,819
6568,2020-10-07,(12003) Ricaurte,442,303,249,994
6569,2020-08-15,(09104) Restrepo,1226,737,1036,2999
6570,2020-04-20,(05100) Banderas P. Central,318,208,215,741
6571,2020-05-09,(07106) EL CAMPIN,150,105,88,343
6572,2020-01-14,(05102) Av. Américas - Av. Boyacá,1323,795,809,2927
6573,2020-08-21,(07103) AV. CHILE,887,556,466,1909
6574,2020-08-04,(03002) SUBA - TV- 91,570,338,355,1263
6575,2020-05-26,(02103) Mazurén,152,118,119,389
6576,2020-07-07,(12007) Zona Industrial,385,221,167,773
6577,2020-06-16,(40002) Manitas,398,238,249,885
6578,2020-09-20,(08001) Parque el Tunal,134,72,163,369
6579,2020-04-19,(10000) Portal 20 de Julio,473,236,217,926
6580,2020-07-23,(04105) Carrera 53,272,142,150,564
6581,2020-06-26,(08002) Biblioteca,331,171,214,716
6582,2020-08-14,(02304) Heroes,812,567,461,1840
6583,2020-02-27,(10004) Policarpa,968,449,588,2005
6584,2020-05-26,(06111) Universidades,0,136,366,502
6585,2020-09-22,(06111) Universidades,455,252,433,1140
6586,2020-07-24,(06100) Av. Rojas,158,105,113,376
6587,2020-09-10,(03002) SUBA - TV- 91,831,456,520,1807
6588,2020-04-03,(02204) Pepe Sierra,384,326,219,929
6589,2020-03-25,(07006) General Santander,250,149,136,535
6590,2020-03-31,(07006) General Santander,235,144,121,500
6591,2020-01-05,(02205) Calle 106,151,164,253,568
6592,2020-04-01,(02201) Prado,409,262,237,908
6593,2020-01-20,(12004) Carrera 22,643,394,476,1513
6594,2020-09-25,(09107) Hortúa,643,370,557,1570
6595,2020-06-21,(03012) SUBA - CALLE 95,84,51,77,212
6596,2020-04-07,(09118) Marly,974,704,458,2136
6597,2020-04-17,(09103) Olaya,515,307,311,1133
6598,2020-07-27,(07105) MOVISTAR ARENA,229,110,106,445
6599,2020-06-01,(09121) Las Flores,686,465,381,1532
6600,2020-01-13,(07506) DESPENSA,1388,818,828,3034
6601,2020-06-18,(07506) DESPENSA,530,290,290,1110
6602,2020-07-26,(06109) Centro Memoria,60,42,52,154
6603,2020-03-26,(03003) 21 ANGELES,170,84,58,312
6604,2020-05-14,(03003) 21 ANGELES,238,139,111,488
6605,2020-07-11,(06107) Ciudad Universitaria,128,98,96,322
6606,2020-01-19,(04108) El Polo,273,206,411,890
6607,2020-10-11,(09107) Hortúa,226,122,233,581
6608,2020-06-15,(09003) Socorro,236,101,156,493
6609,2020-08-05,(04000) Cabecera Calle 80 - intermunicipal,318,156,266,740
6610,2020-06-18,(02102) Calle 161,248,165,154,567
6611,2020-07-17,(09111) Calle 19,439,281,354,1074
6612,2020-03-15,(12003) Ricaurte,127,117,157,401
6613,2020-06-15,(09119) Calle 57,188,123,180,491
6614,2020-07-01,(07200) Tygua-San José,238,119,168,525
6615,2020-08-08,(02000) Cabecera Autopista Norte - intermunicipal,265,161,229,655
6616,2020-09-26,(07009) SENA,538,337,562,1437
6617,2020-02-29,(09105) Río Fucha,459,230,382,1071
6618,2020-03-08,(14001) La Sabana,98,82,111,291
6619,2020-05-21,(07004) VENECIA,793,491,415,1699
6620,2020-04-01,(04102) Avenida Boyaca,142,97,100,339
6621,2020-07-28,(04102) Avenida Boyaca,340,196,212,748
6622,2020-05-13,(03005) SUBA - AV. BOYACA,303,212,202,717
6623,2020-03-14,(09105) Río Fucha,390,209,331,930
6624,2020-06-28,(09000) Cabecera Usme,478,273,417,1168
6625,2020-06-22,(04102) Avenida Boyaca,135,84,93,312
6626,2020-07-01,(04102) Avenida Boyaca,387,231,264,882
6627,2020-07-17,(07108) Av. El Dorado,144,96,76,316
6628,2020-06-18,(09106) Nariño,419,246,290,955
6629,2020-07-02,(06002) Normandía,320,180,181,681
6630,2020-05-09,(07506) DESPENSA,229,145,154,528
6631,2020-07-26,(07506) DESPENSA,94,78,76,248
6632,2020-10-10,(04000) Cabecera Calle 80 - intermunicipal,264,125,312,701
6633,2020-07-03,(06100) Av. Rojas,246,145,150,541
6634,2020-03-28,(07109) CAD,253,181,144,578
6635,2020-03-29,(03001) LA CAMPIÑA,160,95,82,337
6636,2020-05-05,(09003) Socorro,386,208,222,816
6637,2020-09-15,(07006) General Santander - alimentacion,390,198,306,894
6638,2020-05-12,(09121) Las Flores,578,373,327,1278
6639,2020-06-05,(10008) San Diego,266,157,171,594
6640,2020-02-13,(09105) Río Fucha,831,489,502,1822
6641,2020-01-03,(05101) Mandalay - Cr.73,414,196,273,883
6642,2020-04-25,(02303) Calle 85,255,183,165,603
6643,2020-06-04,(04102) Avenida Boyaca,268,169,170,607
6644,2020-02-16,(07200) Tygua-San José,173,120,292,585
6645,2020-06-20,(09111) Calle 19,628,434,479,1541
6646,2020-04-06,(12007) Zona Industrial,146,109,66,321
6647,2020-08-03,(09116) Avenida 39,327,182,191,700
6648,2020-06-21,(04103) Las Ferias,108,56,83,247
6649,2020-08-30,(12004) Carrera 22,66,53,70,189
6650,2020-09-21,(07006) General Santander,499,266,288,1053
6651,2020-06-25,(03004) GRATAMIRA,36,21,21,78
6652,2020-06-12,(06103) CAN,391,224,173,788
6653,2020-05-23,(07007) NQS - Calle 38A Sur,223,122,118,463
6654,2020-06-15,(09116) Avenida 39,108,76,78,262
6655,2020-09-20,(07009) SENA,232,137,250,619
6656,2020-03-06,(03014) SAN MARTIN,222,153,186,561
6657,2020-04-16,(07007) NQS - Calle 38A Sur,157,101,113,371
6658,2020-05-04,(06102) Salitre El Greco,160,79,106,345
6659,2020-01-01,(06108) Concejo de Bogotá,80,52,98,230
6660,2020-04-10,(09110) Avenida Jimenez,108,74,91,273
6661,2020-03-08,(09105) Río Fucha,131,80,185,396
6662,2020-04-01,(03006) NIZA - CALLE 127,221,170,135,526
6663,2020-03-23,(02000) Cabecera Autopista Norte - intermunicipal,58,40,50,148
6664,2020-05-05,(04107) Escuela Militar,78,55,64,197
6665,2020-06-07,(06103) CAN,139,91,64,294
6666,2020-04-21,(06107) Ciudad Universitaria,102,61,80,243
6667,2020-05-05,(06107) Ciudad Universitaria,133,79,73,285
6668,2020-05-04,(10003) Ciudad Jardín,119,76,90,285
6669,2020-07-27,(14005) Las Aguas,171,105,167,443
6670,2020-04-12,(03002) SUBA - TV- 91,155,83,99,337
6671,2020-03-30,(07101) CASTELLANA,60,50,87,197
6672,2020-01-14,(03014) SAN MARTIN,234,150,157,541
6673,2020-03-24,(06108) Concejo de Bogotá,147,109,145,401
6674,2020-09-11,(09105) Río Fucha,0,73,161,234
6675,2020-03-31,(09101) Quiroga,157,107,157,421
6676,2020-04-18,(09108) Hospital,25,11,26,62
6677,2020-07-12,(12004) Carrera 22,88,69,83,240
6678,2020-04-10,(05103) Marsella,47,28,27,102
6679,2020-09-17,(50006) Corral Carrera 77,4,3,10,17
6680,2020-06-21,(07200) Tygua-San José,66,35,61,162
6681,2020-03-31,(03014) SAN MARTIN,17,12,22,51
6682,2020-06-14,(04107) Escuela Militar,38,31,41,110
6683,2020-09-20,(04000) Cabecera Calle 80 - alimentacion,1423,649,1624,3696
6684,2020-05-14,(07504) TERREROS,4025,2410,1884,8319
6685,2020-07-27,(09119) Calle 57,495,333,337,1165
6686,2020-01-29,(02303) Calle 85,3723,2428,1837,7988
6687,2020-02-18,(05000) Portal Américas - alimentacion,38119,22664,21375,82158
6688,2020-05-08,(05000) Portal Américas - alimentacion,8034,4179,3481,15694
6689,2020-02-04,(09122) Calle 72,7356,4658,4020,16034
6690,2020-02-27,(09122) Calle 72,8618,5527,4184,18329
6691,2020-02-11,(07503) SAN MATEO,42568,24186,18082,84836
6692,2020-02-05,(02200) Alcalá,15353,9566,6882,31801
6693,2020-08-28,(07503) SAN MATEO,11697,6528,5763,23988
6694,2020-02-17,(06107) Ciudad Universitaria,1549,963,829,3341
6695,2020-08-24,(09001) Molinos,2273,1162,1411,4846
6696,2020-01-18,(03009) Av. Suba- Calle 116,1015,676,935,2626
6697,2020-01-21,(09104) Restrepo,3719,2079,2505,8303
6698,2020-09-26,(05100) Banderas P. Central,798,354,675,1827
6699,2020-10-05,(10001) Country Sur,1455,695,1150,3300
6700,2020-02-26,(09000) Cabecera Usme,6028,3391,4043,13462
6701,2020-04-11,(06000) Portal Eldorado - alimentacion,1273,626,527,2426
6702,2020-01-27,(05100) Banderas P. Central - alimentacion,14594,8200,7906,30700
6703,2020-03-11,(07009) SENA,3423,1993,1947,7363
6704,2020-03-19,(06000) Portal Eldorado - alimentacion,9184,4252,4572,18008
6705,2020-05-17,(07000) Portal Sur - alimentacion,1922,977,853,3752
6706,2020-08-29,(10005) Bicentenario - alimentacion,149,83,193,425
6707,2020-01-04,(09109) Tercer Milenio,432,304,442,1178
6708,2020-04-24,(09109) Tercer Milenio,151,102,104,357
6709,2020-07-26,(07504) TERREROS,1408,682,829,2919
6710,2020-02-07,(10006) San Victorino,2388,1390,1359,5137
6711,2020-03-04,(10006) San Victorino,2487,1332,1291,5110
6712,2020-09-10,(05002) Tintal,2728,1438,1624,5790
6713,2020-09-22,(03000) Portal Suba - alimentacion,7292,4042,4836,16170
6714,2020-02-28,(09123) Calle 76,5362,3690,3316,12368
6715,2020-08-03,(09101) Quiroga,437,252,310,999
6716,2020-06-24,(07102) NQS - CALLE 75,458,294,218,970
6717,2020-01-29,(03013) RIO NEGRO,1257,790,857,2904
6718,2020-04-07,(09103) Olaya,464,270,266,1000
6719,2020-02-21,(07111) NQS - RICAURTE,3150,2038,1726,6914
6720,2020-04-20,(07111) NQS - RICAURTE,527,367,246,1140
6721,2020-03-18,(07112) COMUNEROS,2024,1189,1088,4301
6722,2020-07-11,(02000) Cabecera Autopista Norte,1099,648,767,2514
6723,2020-03-04,(07107) U. NACIONAL,2839,1770,1571,6180
6724,2020-02-08,(09118) Marly,3779,2546,3126,9451
6725,2020-01-11,(04105) Carrera 53,648,330,472,1450
6726,2020-07-15,(08000) Portal Tunal - alimentacion,4031,2373,2418,8822
6727,2020-09-08,(09120) Calle 63,1115,729,819,2663
6728,2020-09-24,(07506) DESPENSA,389,274,341,1004
6729,2020-03-17,(04100) Carrera 77,3689,2155,2269,8113
6730,2020-02-20,(10000) Portal 20 de Julio,8916,4207,3792,16915
6731,2020-01-07,(10002) Av. Primero de Mayo,5826,2853,3876,12555
6732,2020-09-22,(03000) Portal Suba,1645,1032,1259,3936
6733,2020-09-29,(03000) Portal Suba,1644,1044,1375,4063
6734,2020-07-22,(02000) Cabecera Autopista Norte - intermunicipal,456,309,321,1086
6735,2020-07-23,(02000) Cabecera Autopista Norte - intermunicipal,449,281,322,1052
6736,2020-04-14,(03000) Portal Suba - alimentacion,3362,1922,1725,7009
6737,2020-02-04,(10000) Portal 20 de Julio,9100,4283,4032,17415
6738,2020-08-03,(09004) Santa Lucía,2254,1158,1254,4666
6739,2020-09-25,(09004) Santa Lucía,2907,1420,1699,6026
6740,2020-06-21,(04100) Carrera 77,372,162,287,821
6741,2020-09-18,(09116) Avenida 39,456,280,335,1071
6742,2020-01-05,(03000) Portal Suba,1063,507,1194,2764
6743,2020-03-10,(05102) Av. Américas - Av. Boyacá,192,448,288,928
6744,2020-01-29,(07008) NQS - Calle 30 Sur,1904,1043,1061,4008
6745,2020-03-30,(10000) Portal 20 de Julio - alimentacion,2556,924,1333,4813
6746,2020-02-17,(06108) Concejo de Bogotá,931,441,440,1812
6747,2020-09-05,(06108) Concejo de Bogotá,79,52,103,234
6748,2020-06-05,(09004) Santa Lucía,2447,1291,1211,4949
6749,2020-06-29,(02300) Calle 100,321,275,246,842
6750,2020-01-19,(03003) 21 ANGELES,358,122,339,819
6751,2020-01-29,(03003) 21 ANGELES,1739,836,896,3471
6752,2020-04-20,(10002) Av. Primero de Mayo,1208,706,741,2655
6753,2020-05-30,(02201) Prado,666,426,361,1453
6754,2020-04-12,(09000) Cabecera Usme - alimentacion,1734,914,875,3523
6755,2020-03-30,(40003) Mirador del Paraiso,705,377,456,1538
6756,2020-03-13,(02204) Pepe Sierra,1344,274,404,2022
6757,2020-06-29,(05002) Tintal,800,406,477,1683
6758,2020-07-28,(05002) Tintal,1983,1137,1117,4237
6759,2020-05-10,(05103) Marsella,50,25,30,105
6760,2020-08-05,(03012) SUBA - CALLE 95,244,153,126,523
6761,2020-10-09,(10000) Portal 20 de Julio,2719,1219,1886,5824
6762,2020-01-15,(50002) Corral Calle 40 Sur,106,70,124,300
6763,2020-01-31,(10010) San Bernardo,1642,952,1373,3967
6764,2020-06-17,(05101) Mandalay - Cr.73,132,71,82,285
6765,2020-07-04,(08000) Portal Tunal,686,288,315,1289
6766,2020-03-17,(07104) Simon Bolivar,1437,947,708,3092
6767,2020-05-18,(08000) Portal Tunal,618,257,212,1087
6768,2020-03-16,(07106) EL CAMPIN,1462,961,800,3223
6769,2020-01-04,(03009) Av. Suba- Calle 116,621,456,553,1630
6770,2020-05-29,(02205) Calle 106,292,175,159,626
6771,2020-08-13,(04003) Avenida Ciudad de Cali,880,478,655,2013
6772,2020-08-13,(09101) Quiroga,444,251,352,1047
6773,2020-07-26,(06000) Portal Eldorado - alimentacion,998,496,627,2121
6774,2020-07-10,(04108) El Polo,496,318,286,1100
6775,2020-02-08,(07101) CASTELLANA,397,298,417,1112
6776,2020-07-22,(02201) Prado,768,533,424,1725
6777,2020-06-21,(07106) EL CAMPIN,133,75,99,307
6778,2020-08-10,(07106) EL CAMPIN,363,230,198,791
6779,2020-01-06,(09000) Cabecera Usme,1018,507,1081,2606
6780,2020-03-17,(06106) Recinto Ferial,865,481,420,1766
6781,2020-09-22,(10006) San Victorino,751,388,419,1558
6782,2020-04-04,(09004) Santa Lucía,792,408,385,1585
6783,2020-02-19,(03010) PUENTE LARGO,2171,1469,1260,4900
6784,2020-09-25,(07000) Portal Sur,2322,1384,1658,5364
6785,2020-03-28,(02101) Toberín,345,257,270,872
6786,2020-05-09,(07110) PALOQUEMAO,368,247,179,794
6787,2020-08-20,(10005) Bicentenario - alimentacion,181,82,180,443
6788,2020-03-09,(04107) Escuela Militar,272,60,86,418
6789,2020-08-04,(04100) Carrera 77,1024,549,676,2249
6790,2020-05-30,(12000) Puente Aranda,59,49,24,132
6791,2020-05-05,(04108) El Polo,304,180,189,673
6792,2020-07-14,(07002) MADELENA,535,362,322,1219
6793,2020-09-20,(05001) Patio Bonito,735,355,558,1648
6794,2020-06-27,(02105) Calle 142,606,328,442,1376
6795,2020-03-14,(02001) Centro Comercial Santa Fe,1842,834,1649,4325
6796,2020-06-20,(06100) Av. Rojas,153,74,118,345
6797,2020-03-22,(05100) Banderas P. Central - alimentacion,554,259,254,1067
6798,2020-07-01,(12003) Ricaurte,377,229,218,824
6799,2020-08-06,(03013) RIO NEGRO,219,148,167,534
6800,2020-06-08,(03009) Av. Suba- Calle 116,473,320,239,1032
6801,2020-08-19,(04106) Carrera 47,317,163,179,659
6802,2020-08-27,(04106) Carrera 47,308,148,155,611
6803,2020-01-03,(06103) CAN,999,623,626,2248
6804,2020-07-06,(06103) CAN,370,231,177,778
6805,2020-01-08,(02105) Calle 142,4404,2678,2624,9706
6806,2020-04-28,(09004) Santa Lucía,1471,759,728,2958
6807,2020-07-29,(07007) NQS - Calle 38A Sur,262,192,228,682
6808,2020-09-16,(07007) NQS - Calle 38A Sur,468,278,329,1075
6809,2020-03-26,(10010) San Bernardo,342,239,266,847
6810,2020-03-03,(04000) Cabecera Calle 80 - intermunicipal,2321,1670,2142,6133
6811,2020-05-13,(07103) AV. CHILE,752,509,292,1553
6812,2020-08-15,(07103) AV. CHILE,566,375,419,1360
6813,2020-03-18,(09122) Calle 72,3247,2214,1951,7412
6814,2020-02-14,(10005) Bicentenario,763,431,398,1592
6815,2020-01-11,(04000) Cabecera Calle 80 - intermunicipal,717,493,877,2087
6816,2020-07-29,(02001) Centro Comercial Santa Fe,435,290,271,996
6817,2020-07-26,(07003) SEVILLANA,82,42,68,192
6818,2020-05-14,(05100) Banderas P. Central,485,280,302,1067
6819,2020-01-02,(02103) Mazurén,943,596,653,2192
6820,2020-08-13,(04107) Escuela Militar,110,51,63,224
6821,2020-08-24,(10009) Museo Nacional,411,240,232,883
6822,2020-02-07,(10004) Policarpa,917,448,619,1984
6823,2020-08-13,(05105) Pradera,595,323,246,1164
6824,2020-07-04,(06111) Universidades,261,147,321,729
6825,2020-04-17,(09004) Santa Lucía,1157,634,670,2461
6826,2020-07-23,(07111) NQS - RICAURTE,758,471,343,1572
6827,2020-06-01,(03006) NIZA - CALLE 127,381,252,220,853
6828,2020-08-25,(02204) Pepe Sierra,698,501,379,1578
6829,2020-08-23,(06000) Portal Eldorado,150,140,203,493
6830,2020-01-19,(06105) Quinta Paredes,119,82,163,364
6831,2020-10-01,(02105) Calle 142,943,610,701,2254
6832,2020-08-01,(09122) Calle 72,685,494,595,1774
6833,2020-04-15,(06109) Centro Memoria,172,118,116,406
6834,2020-08-13,(06109) Centro Memoria,256,142,126,524
6835,2020-07-03,(06102) Salitre El Greco,204,144,163,511
6836,2020-03-24,(10001) Country Sur,894,432,683,2009
6837,2020-08-19,(09114) Calle 26,275,161,204,640
6838,2020-02-05,(07506) DESPENSA,1742,957,962,3661
6839,2020-09-18,(03003) 21 ANGELES,395,186,249,830
6840,2020-04-11,(09119) Calle 57,154,115,95,364
6841,2020-04-23,(06107) Ciudad Universitaria,106,62,75,243
6842,2020-04-28,(04100) Carrera 77,740,408,441,1589
6843,2020-08-03,(05102) Av. Américas - Av. Boyacá,194,120,142,456
6844,2020-10-01,(07008) NQS - Calle 30 Sur,399,212,303,914
6845,2020-03-24,(09113) Calle 22,328,205,342,875
6846,2020-07-05,(14005) Las Aguas,64,40,85,189
6847,2020-06-08,(10002) Av. Primero de Mayo,1989,1034,1267,4290
6848,2020-06-11,(07004) VENECIA,953,575,528,2056
6849,2020-04-06,(03005) SUBA - AV. BOYACA,182,135,141,458
6850,2020-04-24,(09003) Socorro,320,139,180,639
6851,2020-05-14,(07506) DESPENSA,364,179,165,708
6852,2020-08-19,(02102) Calle 161,193,121,166,480
6853,2020-04-15,(07002) MADELENA,336,170,198,704
6854,2020-01-22,(09111) Calle 19,1904,1245,1455,4604
6855,2020-05-20,(09111) Calle 19,599,386,401,1386
6856,2020-05-06,(04107) Escuela Militar,76,54,66,196
6857,2020-05-30,(06001) Modelia,261,168,136,565
6858,2020-09-17,(06001) Modelia,399,245,276,920
6859,2020-06-03,(07200) Tygua-San José,223,102,134,459
6860,2020-05-09,(09114) Calle 26,124,87,101,312
6861,2020-05-03,(09122) Calle 72,256,186,163,605
6862,2020-04-01,(14001) La Sabana,58,53,62,173
6863,2020-04-29,(02001) Centro Comercial Santa Fe,242,143,178,563
6864,2020-05-20,(12002) CDS - Carrera 32,185,137,61,383
6865,2020-09-25,(12002) CDS - Carrera 32,194,129,93,416
6866,2020-01-02,(09105) Río Fucha,301,166,230,697
6867,2020-01-05,(04105) Carrera 53,248,117,212,577
6868,2020-06-05,(14004) Museo del Oro,0,121,245,366
6869,2020-05-23,(04102) Avenida Boyaca,189,109,122,420
6870,2020-07-22,(04102) Avenida Boyaca,325,182,192,699
6871,2020-01-26,(06002) Normandía,298,174,365,837
6872,2020-03-27,(03000) Portal Suba,601,368,390,1359
6873,2020-02-14,(09108) Hospital,260,144,217,621
6874,2020-04-09,(09117) Calle 45,225,150,110,485
6875,2020-06-25,(03014) SAN MARTIN,35,12,29,76
6876,2020-06-08,(40002) Manitas,382,243,248,873
6877,2020-04-19,(02502) Terminal,50,37,45,132
6878,2020-04-18,(04103) Las Ferias,156,105,84,345
6879,2020-06-18,(07101) CASTELLANA,218,135,102,455
6880,2020-03-31,(07009) SENA,251,138,161,550
6881,2020-04-20,(03006) NIZA - CALLE 127,229,169,125,523
6882,2020-05-03,(03006) NIZA - CALLE 127,104,91,63,258
6883,2020-06-21,(04000) Cabecera Calle 80,290,167,268,725
6884,2020-06-27,(14004) Museo del Oro,113,106,159,378
6885,2020-09-23,(07201) Guatoque -Veraguas,236,139,171,546
6886,2020-06-22,(07010) Bosa,206,89,159,454
6887,2020-08-17,(07506) DESPENSA,145,76,115,336
6888,2020-06-07,(04101) Minuto de Dios,93,43,81,217
6889,2020-09-27,(07111) NQS - RICAURTE,215,173,230,618
6890,2020-04-15,(12007) Zona Industrial,190,147,101,438
6891,2020-05-15,(04002) Carrera 90,551,322,288,1161
6892,2020-02-02,(06108) Concejo de Bogotá,114,67,195,376
6893,2020-04-17,(06105) Quinta Paredes,77,53,47,177
6894,2020-05-31,(04101) Minuto de Dios,82,41,69,192
6895,2020-07-31,(10004) Policarpa,201,80,173,454
6896,2020-04-07,(09111) Calle 19,226,163,199,588
6897,2020-03-10,(03004) GRATAMIRA,58,44,40,142
6898,2020-08-07,(06111) Universidades,116,60,149,325
6899,2020-05-23,(06103) CAN,209,151,136,496
6900,2020-07-07,(06103) CAN,383,226,185,794
6901,2020-06-07,(09116) Avenida 39,68,66,64,198
6902,2020-01-11,(06108) Concejo de Bogotá,243,152,274,669
6903,2020-05-18,(07113) SANTA ISABEL,314,209,201,724
6904,2020-05-12,(02000) Cabecera Autopista Norte - intermunicipal,327,247,231,805
6905,2020-09-17,(14005) Las Aguas,260,155,274,689
6906,2020-05-17,(07005) ALQUERIA,113,62,84,259
6907,2020-04-15,(12004) Carrera 22,67,50,58,175
6908,2020-04-09,(02103) Mazurén,24,23,31,78
6909,2020-05-17,(10008) San Diego,61,43,52,156
6910,2020-10-11,(03004) GRATAMIRA,0,6,21,27
6911,2020-04-05,(02000) Cabecera Autopista Norte - intermunicipal,27,32,24,83
6912,2020-01-06,(03014) SAN MARTIN,25,13,58,96
6913,2020-03-20,(06106) Recinto Ferial,153,91,59,303
6914,2020-01-01,(07006) General Santander - alimentacion,85,69,203,357
6915,2020-03-31,(05102) Av. Américas - Av. Boyacá,118,60,75,253
6916,2020-08-16,(02204) Pepe Sierra,168,141,146,455
6917,2020-05-08,(07113) SANTA ISABEL,263,178,149,590
6918,2020-04-20,(07108) Av. El Dorado,73,54,47,174
6919,2020-05-03,(06109) Centro Memoria,62,40,43,145
6920,2020-10-04,(10004) Policarpa,117,52,110,279
6921,2020-06-02,(07003) SEVILLANA,382,211,196,789
6922,2020-01-10,(12000) Puente Aranda,194,110,156,460
6923,2020-01-01,(10007) Las Nieves,57,79,234,370
6924,2020-08-07,(08002) Biblioteca,138,78,56,272
6925,2020-05-17,(07106) EL CAMPIN,81,60,59,200
6926,2020-03-21,(06106) Recinto Ferial,107,76,41,224
6927,2020-05-11,(03007) HUMEDAL CORDOBA,83,69,45,197
6928,2020-01-18,(03014) SAN MARTIN,111,58,131,300
6929,2020-08-30,(06106) Recinto Ferial,67,53,62,182
6930,2020-07-26,(06104) Gobernación,53,38,30,121
6931,2020-03-21,(06104) Gobernación,56,49,37,142
6932,2020-04-15,(50002) Corral Calle 40 Sur,8,3,4,15
6933,2020-04-12,(04101) Minuto de Dios,49,30,29,108
6934,2020-04-14,(50006) Corral Carrera 77,5,3,5,13
6935,2020-04-21,(03004) GRATAMIRA,16,13,13,42
6936,2020-06-06,(03014) SAN MARTIN,15,12,24,51
6937,2020-03-29,(50002) Corral Calle 40 Sur,2,3,5,10
6938,2020-03-09,(04000) Cabecera Calle 80 - alimentacion,822,6582,4489,11893
6939,2020-06-04,(07005) ALQUERIA,539,304,280,1123
6940,2020-06-27,(09002) Consuelo,403,176,241,820
6941,2020-09-30,(09002) Consuelo,538,300,382,1220
6942,2020-09-01,(02502) Terminal,426,310,384,1120
6943,2020-01-28,(07504) TERREROS,17350,10501,9048,36899
6944,2020-05-26,(05000) Portal Américas - alimentacion,9832,5053,4822,19707
6945,2020-01-16,(09119) Calle 57,2648,1813,1838,6299
6946,2020-03-07,(08000) Portal Tunal - alimentacion,15019,7584,9384,31987
6947,2020-10-07,(07505) LEON XIII,3119,1596,1736,6451
6948,2020-01-20,(02200) Alcalá,13118,8304,6504,27926
6949,2020-01-14,(06104) Gobernación,1188,694,528,2410
6950,2020-02-26,(03010) PUENTE LARGO,2149,1379,1263,4791
6951,2020-01-22,(07111) NQS - RICAURTE,2987,1875,1740,6602
6952,2020-03-12,(05000) Portal Américas - alimentacion,939,7888,5406,14233
6953,2020-07-25,(05000) Portal Américas - alimentacion,6738,3325,3222,13285
6954,2020-08-08,(05000) Portal Américas - alimentacion,7378,3582,4273,15233
6955,2020-07-30,(06107) Ciudad Universitaria,163,110,119,392
6956,2020-06-24,(05001) Patio Bonito,1963,1054,1102,4119
6957,2020-08-05,(07000) Portal Sur - alimentacion,6832,3805,3504,14141
6958,2020-01-16,(14004) Museo del Oro,2586,1655,1598,5839
6959,2020-02-21,(05005) Transversal 86,2738,1366,1303,5407
6960,2020-09-22,(50006) Corral Carrera 77,4,4,8,16
6961,2020-02-27,(05100) Banderas P. Central,8392,4747,3851,16990
6962,2020-01-07,(02102) Calle 161,1152,695,822,2669
6963,2020-01-24,(09000) Cabecera Usme,5490,3176,3870,12536
6964,2020-01-22,(07009) SENA,3240,1924,1999,7163
6965,2020-02-19,(10003) Ciudad Jardín,1127,597,689,2413
6966,2020-03-12,(10000) Portal 20 de Julio - alimentacion,375,1676,1646,3697
6967,2020-08-14,(07001) PERDOMO,874,520,589,1983
6968,2020-02-28,(09109) Tercer Milenio,1393,856,891,3140
6969,2020-08-24,(09104) Restrepo,1408,767,927,3102
6970,2020-09-30,(09104) Restrepo,1694,1018,1614,4326
6971,2020-08-10,(04100) Carrera 77,1005,591,691,2287
6972,2020-01-03,(02101) Toberín,5720,3152,3642,12514
6973,2020-09-15,(02204) Pepe Sierra,825,562,519,1906
6974,2020-10-08,(02204) Pepe Sierra,885,629,633,2147
6975,2020-03-02,(09115) Calle 34,4416,2758,2476,9650
6976,2020-03-09,(10006) San Victorino,1403,154,287,1844
6977,2020-02-19,(03009) Av. Suba- Calle 116,2594,1641,1447,5682
6978,2020-01-24,(03005) SUBA - AV. BOYACA,2648,1498,1505,5651
6979,2020-07-26,(03013) RIO NEGRO,76,54,46,176
6980,2020-08-25,(09000) Cabecera Usme - alimentacion,8191,4306,4586,17083
6981,2020-02-22,(09103) Olaya,2644,1282,1853,5779
6982,2020-04-16,(09104) Restrepo,759,461,652,1872
6983,2020-02-12,(05100) Banderas P. Central - alimentacion,16831,9896,8518,35245
6984,2020-05-26,(09103) Olaya,861,496,506,1863
6985,2020-09-01,(14001) La Sabana,152,91,84,327
6986,2020-06-06,(07111) NQS - RICAURTE,800,540,364,1704
6987,2020-03-14,(02000) Cabecera Autopista Norte - alimentacion,12862,5983,8546,27391
6988,2020-05-23,(07002) MADELENA,425,244,276,945
6989,2020-08-09,(07002) MADELENA,179,109,147,435
6990,2020-03-06,(04102) Avenida Boyaca,3013,1719,1658,6390
6991,2020-06-10,(09113) Calle 22,385,246,321,952
6992,2020-02-01,(10007) Las Nieves,997,839,991,2827
6993,2020-03-26,(04105) Carrera 53,163,128,92,383
6994,2020-01-23,(07109) CAD,2744,1697,1402,5843
6995,2020-04-22,(05000) Portal Américas,1295,952,1058,3305
6996,2020-01-26,(02201) Prado,1042,559,1025,2626
6997,2020-01-06,(07504) TERREROS,3692,1572,2602,7866
6998,2020-09-19,(03000) Portal Suba,1219,633,1083,2935
6999,2020-05-20,(06000) Portal Eldorado,983,640,398,2021
7000,2020-07-02,(06000) Portal Eldorado,982,672,538,2192
7001,2020-01-28,(10008) San Diego,1397,754,722,2873
7002,2020-02-10,(40003) Mirador del Paraiso,4857,2804,2563,10224
7003,2020-06-01,(40003) Mirador del Paraiso,1642,1010,938,3590
7004,2020-07-03,(40003) Mirador del Paraiso,1969,1194,1199,4362
7005,2020-09-26,(10002) Av. Primero de Mayo,1849,857,1641,4347
7006,2020-08-28,(06105) Quinta Paredes,146,95,89,330
7007,2020-02-15,(07106) EL CAMPIN,1291,867,1008,3166
7008,2020-08-31,(02000) Cabecera Autopista Norte - intermunicipal,554,391,424,1369
7009,2020-03-07,(09101) Quiroga,992,527,994,2513
7010,2020-07-04,(03000) Portal Suba - alimentacion,5152,2719,3360,11231
7011,2020-04-22,(08000) Portal Tunal - alimentacion,3043,1828,1804,6675
7012,2020-08-10,(10000) Portal 20 de Julio - alimentacion,3979,1707,2309,7995
7013,2020-06-22,(07000) Portal Sur - alimentacion,2823,1457,1361,5641
7014,2020-07-03,(02303) Calle 85,786,524,419,1729
7015,2020-02-13,(07000) Portal Sur,8070,4556,4193,16819
7016,2020-02-29,(07000) Portal Sur,4798,2324,3688,10810
7017,2020-08-25,(02201) Prado,785,535,493,1813
7018,2020-08-15,(09004) Santa Lucía,2199,993,1282,4474
7019,2020-08-18,(09000) Cabecera Usme - alimentacion,7934,4317,4648,16899
7020,2020-01-19,(40003) Mirador del Paraiso,1877,813,1315,4005
7021,2020-01-10,(09109) Tercer Milenio,1061,625,727,2413
7022,2020-04-19,(07503) SAN MATEO,1918,1270,796,3984
7023,2020-05-28,(09116) Avenida 39,236,196,175,607
7024,2020-01-21,(03000) Portal Suba,1811,2126,3155,7092
7025,2020-08-03,(06108) Concejo de Bogotá,134,76,79,289
7026,2020-09-26,(06108) Concejo de Bogotá,83,60,131,274
7027,2020-02-21,(02300) Calle 100,7185,4532,3800,15517
7028,2020-04-29,(02201) Prado,475,340,278,1093
7029,2020-07-21,(02201) Prado,789,532,402,1723
7030,2020-02-13,(10007) Las Nieves,2111,1256,1234,4601
7031,2020-05-20,(06001) Modelia,366,226,157,749
7032,2020-06-17,(09118) Marly,1505,997,731,3233
7033,2020-06-11,(05002) Tintal,1982,1098,1092,4172
7034,2020-06-20,(05002) Tintal,2126,985,1218,4329
7035,2020-07-06,(02300) Calle 100,1324,848,719,2891
7036,2020-10-10,(02300) Calle 100,743,569,895,2207
7037,2020-02-25,(03012) SUBA - CALLE 95,1524,989,946,3459
7038,2020-07-11,(04106) Carrera 47,261,134,173,568
7039,2020-09-01,(10010) San Bernardo,602,322,411,1335
7040,2020-09-17,(05105) Pradera,642,424,339,1405
7041,2020-02-19,(06109) Centro Memoria,1260,673,619,2552
7042,2020-08-19,(06109) Centro Memoria,239,140,127,506
7043,2020-02-26,(10007) Las Nieves,2091,1295,1205,4591
7044,2020-01-23,(09121) Las Flores,2985,1879,1820,6684
7045,2020-07-24,(08000) Portal Tunal,580,226,223,1029
7046,2020-08-26,(03009) Av. Suba- Calle 116,521,323,232,1076
7047,2020-09-08,(03009) Av. Suba- Calle 116,551,338,281,1170
7048,2020-01-27,(03006) NIZA - CALLE 127,2325,1503,1399,5227
7049,2020-01-14,(04108) El Polo,1638,1029,960,3627
7050,2020-09-21,(07505) LEON XIII,2471,1114,1174,4759
7051,2020-02-19,(07108) Av. El Dorado,1029,630,595,2254
7052,2020-04-01,(02101) Toberín,569,391,415,1375
7053,2020-03-24,(06101) El Tiempo,390,305,218,913
7054,2020-01-08,(40003) Mirador del Paraiso,3779,1996,2303,8078
7055,2020-05-16,(07104) Simon Bolivar,393,230,199,822
7056,2020-02-29,(07113) SANTA ISABEL,1230,632,1112,2974
7057,2020-06-26,(04003) Avenida Ciudad de Cali,1111,624,772,2507
7058,2020-09-13,(03000) Portal Suba,402,207,448,1057
7059,2020-03-27,(02104) Calle 146,362,225,236,823
7060,2020-02-15,(04001) Quirigua,1191,595,949,2735
7061,2020-06-22,(04100) Carrera 77,394,198,329,921
7062,2020-05-25,(02205) Calle 106,72,62,55,189
7063,2020-08-15,(02001) Centro Comercial Santa Fe,369,187,340,896
7064,2020-07-30,(02302) Virrey,620,436,316,1372
7065,2020-05-31,(07106) EL CAMPIN,98,71,58,227
7066,2020-01-16,(07003) SEVILLANA,1761,876,1114,3751
7067,2020-03-10,(07107) U. NACIONAL,1218,153,442,1813
7068,2020-07-13,(05002) Tintal,2050,1207,1228,4485
7069,2020-04-01,(07005) ALQUERIA,230,155,158,543
7070,2020-08-25,(02104) Calle 146,717,421,543,1681
7071,2020-08-27,(05100) Banderas P. Central - alimentacion,2943,1621,1794,6358
7072,2020-01-02,(07103) AV. CHILE,1448,894,1004,3346
7073,2020-03-10,(14005) Las Aguas,1439,274,477,2190
7074,2020-08-23,(40002) Manitas,107,55,108,270
7075,2020-05-03,(06108) Concejo de Bogotá,40,34,22,96
7076,2020-04-25,(03001) LA CAMPIÑA,344,168,193,705
7077,2020-05-28,(02001) Centro Comercial Santa Fe,372,237,234,843
7078,2020-07-23,(02001) Centro Comercial Santa Fe,411,246,263,920
7079,2020-05-17,(05100) Banderas P. Central - alimentacion,627,283,316,1226
7080,2020-03-10,(03006) NIZA - CALLE 127,808,371,415,1594
7081,2020-02-16,(09109) Tercer Milenio,359,199,376,934
7082,2020-07-13,(04105) Carrera 53,254,142,123,519
7083,2020-02-02,(02502) Terminal,357,348,866,1571
7084,2020-06-27,(02104) Calle 146,613,361,453,1427
7085,2020-04-10,(07004) VENECIA,151,79,76,306
7086,2020-09-02,(02200) Alcalá,1986,1332,1070,4388
7087,2020-03-12,(03011) SUBA - CALLE 100,1232,251,365,1848
7088,2020-09-25,(10009) Museo Nacional,574,359,458,1391
7089,2020-04-19,(05105) Pradera,108,65,56,229
7090,2020-03-10,(08002) Biblioteca,101,267,211,579
7091,2020-04-23,(09119) Calle 57,291,193,202,686
7092,2020-06-08,(06111) Universidades,0,147,381,528
7093,2020-08-01,(06111) Universidades,234,126,219,579
7094,2020-09-15,(06111) Universidades,470,235,421,1126
7095,2020-09-09,(02202) Calle 127,1192,792,709,2693
7096,2020-05-07,(07107) U. NACIONAL,231,139,135,505
7097,2020-03-18,(03006) NIZA - CALLE 127,1096,751,628,2475
7098,2020-06-14,(09004) Santa Lucía,792,328,520,1640
7099,2020-01-08,(14005) Las Aguas,1184,783,1012,2979
7100,2020-08-11,(07111) NQS - RICAURTE,1048,626,461,2135
7101,2020-09-23,(12002) CDS - Carrera 32,216,137,109,462
7102,2020-04-24,(06109) Centro Memoria,187,110,90,387
7103,2020-10-04,(06109) Centro Memoria,69,51,105,225
7104,2020-04-08,(09103) Olaya,469,275,270,1014
7105,2020-03-01,(06101) El Tiempo,304,221,424,949
7106,2020-01-25,(04102) Avenida Boyaca,1388,724,1022,3134
7107,2020-08-25,(02302) Virrey,590,404,337,1331
7108,2020-03-10,(07506) DESPENSA,70,433,333,836
7109,2020-02-20,(07506) DESPENSA,1463,966,872,3301
7110,2020-06-13,(06109) Centro Memoria,202,129,119,450
7111,2020-03-06,(07008) NQS - Calle 30 Sur,1952,958,1128,4038
7112,2020-08-12,(03001) LA CAMPIÑA,898,556,531,1985
7113,2020-05-20,(06107) Ciudad Universitaria,167,88,84,339
7114,2020-02-15,(07108) Av. El Dorado,393,278,478,1149
7115,2020-05-07,(40002) Manitas,221,137,142,500
7116,2020-03-21,(07008) NQS - Calle 30 Sur,96,41,47,184
7117,2020-05-12,(07112) COMUNEROS,582,344,321,1247
7118,2020-04-24,(40002) Manitas,202,112,116,430
7119,2020-07-15,(03010) PUENTE LARGO,322,191,163,676
7120,2020-05-28,(12000) Puente Aranda,91,49,25,165
7121,2020-01-12,(02205) Calle 106,170,186,304,660
7122,2020-08-18,(09121) Las Flores,663,430,413,1506
7123,2020-03-19,(10007) Las Nieves,1224,790,667,2681
7124,2020-10-08,(06000) Portal Eldorado,957,658,699,2314
7125,2020-05-10,(10009) Museo Nacional,65,52,74,191
7126,2020-06-10,(10004) Policarpa,229,112,142,483
7127,2020-02-23,(06002) Normandía,334,169,390,893
7128,2020-08-21,(07008) NQS - Calle 30 Sur,287,150,193,630
7129,2020-06-28,(14001) La Sabana,59,33,53,145
7130,2020-04-14,(07112) COMUNEROS,419,271,201,891
7131,2020-08-16,(02001) Centro Comercial Santa Fe,109,70,122,301
7132,2020-06-08,(12002) CDS - Carrera 32,190,136,70,396
7133,2020-09-04,(12002) CDS - Carrera 32,220,133,84,437
7134,2020-06-03,(06100) Av. Rojas,204,109,118,431
7135,2020-08-26,(07006) General Santander,524,326,258,1108
7136,2020-04-25,(04000) Cabecera Calle 80,401,247,266,914
7137,2020-08-06,(12002) CDS - Carrera 32,165,103,59,327
7138,2020-04-22,(04103) Las Ferias,208,141,85,434
7139,2020-04-24,(04103) Las Ferias,197,123,99,419
7140,2020-06-05,(09003) Socorro,575,293,309,1177
7141,2020-09-13,(04002) Carrera 90,239,97,197,533
7142,2020-08-28,(09116) Avenida 39,338,216,253,807
7143,2020-03-27,(07004) VENECIA,466,294,261,1021
7144,2020-05-30,(07010) Bosa,487,234,318,1039
7145,2020-10-03,(07010) Bosa,0,262,871,1133
7146,2020-03-31,(09108) Hospital,27,18,29,74
7147,2020-08-13,(07008) NQS - Calle 30 Sur,296,136,196,628
7148,2020-05-01,(09119) Calle 57,189,120,111,420
7149,2020-08-19,(02304) Heroes,696,472,406,1574
7150,2020-05-09,(10004) Policarpa,109,59,103,271
7151,2020-08-16,(12004) Carrera 22,63,49,62,174
7152,2020-03-30,(07010) Bosa,239,160,210,609
7153,2020-05-04,(04001) Quirigua,226,138,149,513
7154,2020-05-30,(06108) Concejo de Bogotá,73,43,60,176
7155,2020-05-30,(03005) SUBA - AV. BOYACA,297,174,195,666
7156,2020-06-16,(03005) SUBA - AV. BOYACA,438,269,268,975
7157,2020-05-31,(10008) San Diego,72,49,55,176
7158,2020-04-06,(09121) Las Flores,389,283,242,914
7159,2020-04-07,(06111) Universidades,0,69,216,285
7160,2020-10-03,(12004) Carrera 22,210,145,162,517
7161,2020-08-03,(07106) EL CAMPIN,327,217,176,720
7162,2020-08-12,(09105) Río Fucha,0,62,120,182
7163,2020-10-12,(14005) Las Aguas,83,63,158,304
7164,2020-04-02,(06104) Gobernación,133,113,77,323
7165,2020-09-20,(02304) Heroes,221,193,245,659
7166,2020-09-19,(07108) Av. El Dorado,99,69,116,284
7167,2020-04-04,(03010) PUENTE LARGO,149,112,87,348
7168,2020-09-09,(03007) HUMEDAL CORDOBA,185,106,84,375
7169,2020-09-27,(04103) Las Ferias,110,81,128,319
7170,2020-04-19,(07108) Av. El Dorado,27,17,15,59
7171,2020-01-05,(07107) U. NACIONAL,156,157,295,608
7172,2020-04-12,(40002) Manitas,63,22,43,128
7173,2020-05-08,(04001) Quirigua,257,168,139,564
7174,2020-06-15,(09114) Calle 26,76,45,84,205
7175,2020-05-23,(10003) Ciudad Jardín,110,42,90,242
7176,2020-04-04,(04102) Avenida Boyaca,85,48,61,194
7177,2020-05-13,(10003) Ciudad Jardín,154,79,99,332
7178,2020-03-21,(04000) Cabecera Calle 80 - intermunicipal,26,18,43,87
7179,2020-08-02,(05102) Av. Américas - Av. Boyacá,67,25,42,134
7180,2020-09-30,(12000) Puente Aranda,101,56,72,229
7181,2020-04-26,(09105) Río Fucha,23,17,24,64
7182,2020-04-10,(05100) Banderas P. Central,76,38,45,159
7183,2020-04-10,(09003) Socorro,101,52,52,205
7184,2020-07-14,(05102) Av. Américas - Av. Boyacá,190,103,125,418
7185,2020-04-12,(06106) Recinto Ferial,39,22,24,85
7186,2020-03-23,(04101) Minuto de Dios,66,49,56,171
7187,2020-05-01,(14004) Museo del Oro,0,24,40,64
7188,2020-09-12,(03014) SAN MARTIN,0,7,47,54
7189,2020-07-26,(12003) Ricaurte,38,38,40,116
7190,2020-06-19,(04000) Cabecera Calle 80 - alimentacion,4270,2378,2784,9432
7191,2020-02-29,(09002) Consuelo,976,453,708,2137
7192,2020-08-29,(09002) Consuelo,415,198,272,885
7193,2020-01-15,(07504) TERREROS,16032,9356,8855,34243
7194,2020-02-08,(07504) TERREROS,12216,6169,7681,26066
7195,2020-07-22,(05000) Portal Américas - alimentacion,9841,5404,5584,20829
7196,2020-09-01,(09119) Calle 57,595,380,372,1347
7197,2020-01-27,(02101) Toberín,14274,9289,7431,30994
7198,2020-07-08,(07503) SAN MATEO,11839,7019,5828,24686
7199,2020-09-26,(07503) SAN MATEO,10991,4960,6478,22429
7200,2020-01-30,(02200) Alcalá,14538,9080,6766,30384
7201,2020-01-24,(06000) Portal Eldorado - alimentacion,16773,8395,8953,34121
7202,2020-09-20,(09003) Socorro,212,115,186,513
7203,2020-10-10,(04101) Minuto de Dios,273,147,368,788
7204,2020-03-17,(05001) Patio Bonito,5027,2674,2417,10118
7205,2020-08-10,(07000) Portal Sur - alimentacion,7633,4352,3667,15652
7206,2020-09-28,(09004) Santa Lucía,2764,1397,1770,5931
7207,2020-01-06,(10001) Country Sur,686,298,760,1744
7208,2020-01-11,(06102) Salitre El Greco,576,389,394,1359
7209,2020-03-09,(02204) Pepe Sierra,1889,486,534,2909
7210,2020-03-29,(05000) Portal Américas - alimentacion,2364,1103,1008,4475
7211,2020-05-28,(07001) PERDOMO,798,430,440,1668
7212,2020-09-13,(07001) PERDOMO,309,134,298,741
7213,2020-08-27,(07505) LEON XIII,2768,1476,1190,5434
7214,2020-01-10,(02101) Toberín,10165,5711,5925,21801
7215,2020-02-07,(09110) Avenida Jimenez,5117,3489,3043,11649
7216,2020-08-11,(07102) NQS - CALLE 75,336,226,188,750
7217,2020-01-10,(09103) Olaya,3011,1648,2013,6672
7218,2020-01-23,(09110) Avenida Jimenez,4352,3089,2737,10178
7219,2020-02-16,(05100) Banderas P. Central - alimentacion,3266,1266,2551,7083
7220,2020-01-16,(09103) Olaya,3508,1968,2191,7667
7221,2020-04-16,(14001) La Sabana,87,65,57,209
7222,2020-10-08,(07111) NQS - RICAURTE,1237,787,707,2731
7223,2020-01-04,(07106) EL CAMPIN,622,445,517,1584
7224,2020-08-20,(07106) EL CAMPIN,343,223,190,756
7225,2020-06-10,(02200) Alcalá,1745,1169,836,3750
7226,2020-10-11,(04102) Avenida Boyaca,171,98,171,440
7227,2020-04-04,(04105) Carrera 53,119,89,63,271
7228,2020-09-26,(09004) Santa Lucía,2458,1038,1599,5095
7229,2020-05-22,(05000) Portal Américas,2071,1380,1495,4946
7230,2020-01-24,(07506) DESPENSA,1629,892,914,3435
7231,2020-09-16,(09000) Cabecera Usme - alimentacion,9369,5008,5931,20308
7232,2020-10-10,(10006) San Victorino,526,317,426,1269
7233,2020-06-18,(03000) Portal Suba,1202,812,813,2827
7234,2020-02-14,(06000) Portal Eldorado,6577,3916,3065,13558
7235,2020-01-19,(05002) Tintal,2125,885,1924,4934
7236,2020-01-19,(07505) LEON XIII,2128,921,1390,4439
7237,2020-05-29,(06105) Quinta Paredes,135,78,66,279
7238,2020-01-20,(02302) Virrey,3559,2311,1899,7769
7239,2020-10-09,(03000) Portal Suba,1764,1001,1511,4276
7240,2020-01-29,(09101) Quiroga,1521,970,1149,3640
7241,2020-02-26,(09119) Calle 57,3604,2398,2219,8221
7242,2020-02-26,(10002) Av. Primero de Mayo,8586,4172,4737,17495
7243,2020-08-28,(04001) Quirigua,394,237,284,915
7244,2020-01-31,(09116) Avenida 39,2535,1717,1559,5811
7245,2020-03-09,(03007) HUMEDAL CORDOBA,192,152,116,460
7246,2020-03-12,(02001) Centro Comercial Santa Fe,340,1017,781,2138
7247,2020-06-18,(07004) VENECIA,988,591,556,2135
7248,2020-02-20,(02300) Calle 100,7335,4523,3620,15478
7249,2020-08-23,(08001) Parque el Tunal,110,53,88,251
7250,2020-07-16,(09116) Avenida 39,310,201,176,687
7251,2020-03-04,(07008) NQS - Calle 30 Sur,1959,1018,1139,4116
7252,2020-02-05,(06108) Concejo de Bogotá,971,474,448,1893
7253,2020-05-19,(06108) Concejo de Bogotá,130,63,76,269
7254,2020-10-10,(14004) Museo del Oro,145,154,297,596
7255,2020-02-14,(02202) Calle 127,5965,3741,3008,12714
7256,2020-09-10,(06102) Salitre El Greco,200,129,158,487
7257,2020-05-05,(09123) Calle 76,593,452,356,1401
7258,2020-02-22,(03011) SUBA - CALLE 100,1229,743,1045,3017
7259,2020-05-16,(02300) Calle 100,681,453,386,1520
7260,2020-06-24,(08000) Portal Tunal,770,314,282,1366
7261,2020-02-09,(05100) Banderas P. Central,863,358,959,2180
7262,2020-03-01,(05100) Banderas P. Central,932,375,926,2233
7263,2020-04-14,(10002) Av. Primero de Mayo,1209,658,740,2607
7264,2020-01-25,(07006) General Santander,1533,745,1070,3348
7265,2020-06-06,(09104) Restrepo,1077,659,806,2542
7266,2020-01-22,(04105) Carrera 53,1301,726,732,2759
7267,2020-03-24,(05100) Banderas P. Central - alimentacion,2610,1171,1406,5187
7268,2020-01-03,(10007) Las Nieves,966,700,781,2447
7269,2020-06-23,(02205) Calle 106,403,288,229,920
7270,2020-07-13,(03000) Portal Suba - alimentacion,5535,3231,2963,11729
7271,2020-08-16,(04000) Cabecera Calle 80,250,167,279,696
7272,2020-10-05,(09118) Marly,1581,1046,1137,3764
7273,2020-01-10,(04108) El Polo,1401,907,966,3274
7274,2020-01-15,(07101) CASTELLANA,858,519,559,1936
7275,2020-03-01,(07010) Bosa,488,237,547,1272
7276,2020-03-14,(14004) Museo del Oro,715,694,1036,2445
7277,2020-09-12,(06111) Universidades,331,199,384,914
7278,2020-07-09,(08002) Biblioteca,312,196,197,705
7279,2020-01-08,(03005) SUBA - AV. BOYACA,1851,1109,1116,4076
7280,2020-02-25,(04105) Carrera 53,1511,875,821,3207
7281,2020-04-06,(05100) Banderas P. Central - alimentacion,1515,653,697,2865
7282,2020-03-31,(02304) Heroes,410,306,223,939
7283,2020-08-28,(04107) Escuela Militar,136,86,93,315
7284,2020-05-14,(10010) San Bernardo,501,289,321,1111
7285,2020-05-18,(02303) Calle 85,511,397,270,1178
7286,2020-02-08,(02200) Alcalá,6378,3392,4275,14045
7287,2020-10-03,(07113) SANTA ISABEL,354,194,391,939
7288,2020-07-21,(09100) Calle 40 Sur,1290,770,872,2932
7289,2020-07-30,(09117) Calle 45,667,422,405,1494
7290,2020-07-13,(02202) Calle 127,1037,730,482,2249
7291,2020-03-13,(06104) Gobernación,362,70,124,556
7292,2020-07-07,(06104) Gobernación,273,156,133,562
7293,2020-05-03,(02205) Calle 106,53,49,33,135
7294,2020-07-28,(02304) Heroes,796,532,445,1773
7295,2020-02-21,(07101) CASTELLANA,895,584,587,2066
7296,2020-05-26,(09120) Calle 63,964,654,586,2204
7297,2020-10-10,(07003) SEVILLANA,383,187,330,900
7298,2020-09-20,(02001) Centro Comercial Santa Fe,163,108,196,467
7299,2020-02-18,(07008) NQS - Calle 30 Sur,2041,1096,1103,4240
7300,2020-08-23,(06100) Av. Rojas,32,34,46,112
7301,2020-09-11,(06100) Av. Rojas,254,155,153,562
7302,2020-03-23,(02302) Virrey,226,153,114,493
7303,2020-07-04,(02302) Virrey,455,325,319,1099
7304,2020-08-22,(02302) Virrey,378,296,273,947
7305,2020-06-08,(03010) PUENTE LARGO,340,220,208,768
7306,2020-04-18,(03010) PUENTE LARGO,151,118,72,341
7307,2020-09-06,(10010) San Bernardo,260,115,264,639
7308,2020-06-19,(06001) Modelia,407,258,242,907
7309,2020-08-09,(02105) Calle 142,164,104,138,406
7310,2020-02-06,(10005) Bicentenario,853,468,387,1708
7311,2020-07-30,(03002) SUBA - TV- 91,770,437,465,1672
7312,2020-06-02,(07007) NQS - Calle 38A Sur,337,195,218,750
7313,2020-09-24,(07007) NQS - Calle 38A Sur,484,303,335,1122
7314,2020-05-21,(07103) AV. CHILE,768,515,351,1634
7315,2020-01-07,(10005) Bicentenario,511,270,286,1067
7316,2020-06-05,(02001) Centro Comercial Santa Fe,423,269,292,984
7317,2020-03-13,(04105) Carrera 53,227,200,163,590
7318,2020-03-14,(02102) Calle 161,719,365,641,1725
7319,2020-01-10,(06105) Quinta Paredes,665,377,361,1403
7320,2020-07-19,(07004) VENECIA,234,106,187,527
7321,2020-05-28,(10008) San Diego,245,156,151,552
7322,2020-09-24,(09120) Calle 63,1263,838,973,3074
7323,2020-09-08,(10009) Museo Nacional,566,346,372,1284
7324,2020-07-24,(09003) Socorro,466,230,239,935
7325,2020-05-25,(05105) Pradera,119,93,64,276
7326,2020-05-27,(06111) Universidades,0,129,349,478
7327,2020-06-16,(06111) Universidades,233,181,362,776
7328,2020-07-16,(06111) Universidades,239,143,211,593
7329,2020-01-11,(06002) Normandía,700,366,665,1731
7330,2020-05-21,(40001) Juan Pablo II,465,278,242,985
7331,2020-06-28,(05002) Tintal,727,302,499,1528
7332,2020-09-11,(02204) Pepe Sierra,818,551,466,1835
7333,2020-04-16,(07000) Portal Sur,891,582,461,1934
7334,2020-04-10,(07110) PALOQUEMAO,78,50,38,166
7335,2020-09-04,(07110) PALOQUEMAO,698,419,366,1483
7336,2020-10-03,(07110) PALOQUEMAO,486,337,398,1221
7337,2020-02-02,(04108) El Polo,291,190,453,934
7338,2020-08-27,(12004) Carrera 22,269,154,137,560
7339,2020-09-21,(05102) Av. Américas - Av. Boyacá,172,86,151,409
7340,2020-05-24,(09122) Calle 72,269,198,200,667
7341,2020-08-19,(09122) Calle 72,1074,731,677,2482
7342,2020-08-22,(09122) Calle 72,796,504,648,1948
7343,2020-02-15,(06109) Centro Memoria,546,369,537,1452
7344,2020-05-07,(06109) Centro Memoria,201,118,108,427
7345,2020-02-25,(07006) General Santander - alimentacion,1533,868,948,3349
7346,2020-01-04,(07107) U. NACIONAL,325,293,438,1056
7347,2020-03-24,(09121) Las Flores,702,460,438,1600
7348,2020-05-22,(07003) SEVILLANA,386,200,201,787
7349,2020-04-16,(02303) Calle 85,316,249,216,781
7350,2020-09-30,(10007) Las Nieves,780,469,473,1722
7351,2020-06-07,(07110) PALOQUEMAO,135,108,80,323
7352,2020-06-19,(04103) Las Ferias,371,200,199,770
7353,2020-07-23,(04103) Las Ferias,308,164,136,608
7354,2020-09-23,(04103) Las Ferias,394,213,246,853
7355,2020-10-09,(04103) Las Ferias,388,210,270,868
7356,2020-09-18,(06102) Salitre El Greco,287,165,168,620
7357,2020-04-16,(09119) Calle 57,245,188,183,616
7358,2020-10-10,(40002) Manitas,353,193,342,888
7359,2020-04-08,(10004) Policarpa,120,60,87,267
7360,2020-06-18,(12000) Puente Aranda,84,53,58,195
7361,2020-04-06,(14005) Las Aguas,0,39,101,140
7362,2020-05-04,(04107) Escuela Militar,69,42,47,158
7363,2020-03-20,(03006) NIZA - CALLE 127,269,195,126,590
7364,2020-03-12,(05101) Mandalay - Cr.73,38,240,144,422
7365,2020-03-28,(04000) Cabecera Calle 80,305,201,220,726
7366,2020-04-22,(07006) General Santander - alimentacion,198,115,99,412
7367,2020-07-30,(04107) Escuela Militar,121,85,74,280
7368,2020-05-21,(07113) SANTA ISABEL,310,213,162,685
7369,2020-04-25,(07104) Simon Bolivar,202,117,121,440
7370,2020-08-29,(07200) Tygua-San José,191,110,145,446
7371,2020-09-14,(09117) Calle 45,687,411,498,1596
7372,2020-05-19,(09113) Calle 22,363,219,266,848
7373,2020-05-26,(03010) PUENTE LARGO,317,227,183,727
7374,2020-04-25,(04102) Avenida Boyaca,110,71,83,264
7375,2020-08-22,(12002) CDS - Carrera 32,125,74,57,256
7376,2020-05-21,(04000) Cabecera Calle 80 - intermunicipal,227,126,185,538
7377,2020-09-28,(07108) Av. El Dorado,188,120,133,441
7378,2020-05-04,(04101) Minuto de Dios,192,124,123,439
7379,2020-08-10,(07200) Tygua-San José,228,137,137,502
7380,2020-06-28,(14004) Museo del Oro,23,30,48,101
7381,2020-04-12,(03001) LA CAMPIÑA,182,104,79,365
7382,2020-09-15,(09108) Hospital,70,41,63,174
7383,2020-07-19,(02103) Mazurén,33,26,42,101
7384,2020-05-11,(09117) Calle 45,580,381,301,1262
7385,2020-05-11,(04103) Las Ferias,258,129,103,490
7386,2020-06-30,(03005) SUBA - AV. BOYACA,484,296,297,1077
7387,2020-05-23,(06105) Quinta Paredes,81,54,49,184
7388,2020-07-01,(06105) Quinta Paredes,133,82,79,294
7389,2020-08-06,(06105) Quinta Paredes,142,81,73,296
7390,2020-04-06,(07003) SEVILLANA,218,117,116,451
7391,2020-04-15,(07506) DESPENSA,226,129,125,480
7392,2020-09-14,(10004) Policarpa,262,123,192,577
7393,2020-04-10,(07107) U. NACIONAL,86,63,42,191
7394,2020-07-25,(09108) Hospital,50,16,53,119
7395,2020-08-01,(09109) Tercer Milenio,266,164,185,615
7396,2020-05-25,(07109) CAD,183,128,89,400
7397,2020-04-20,(03010) PUENTE LARGO,200,151,114,465
7398,2020-04-11,(02303) Calle 85,196,138,114,448
7399,2020-04-27,(10003) Ciudad Jardín,71,13,13,97
7400,2020-05-17,(07008) NQS - Calle 30 Sur,59,35,40,134
7401,2020-10-12,(06107) Ciudad Universitaria,64,34,97,195
7402,2020-03-30,(10006) San Victorino,177,148,131,456
7403,2020-10-12,(07010) Bosa,0,120,357,477
7404,2020-08-08,(06101) El Tiempo,186,118,149,453
7405,2020-09-02,(03004) GRATAMIRA,0,14,25,39
7406,2020-09-19,(07003) SEVILLANA,389,186,304,879
7407,2020-05-24,(07104) Simon Bolivar,92,79,79,250
7408,2020-05-25,(02103) Mazurén,31,29,46,106
7409,2020-07-11,(09106) Nariño,314,195,295,804
7410,2020-06-15,(10007) Las Nieves,103,84,113,300
7411,2020-04-28,(03002) SUBA - TV- 91,458,280,248,986
7412,2020-06-22,(09115) Calle 34,155,126,172,453
7413,2020-09-03,(03007) HUMEDAL CORDOBA,160,105,94,359
7414,2020-07-26,(09111) Calle 19,147,100,168,415
7415,2020-05-01,(03002) SUBA - TV- 91,206,112,130,448
7416,2020-06-22,(40002) Manitas,120,79,90,289
7417,2020-04-26,(07006) General Santander,94,54,57,205
7418,2020-05-17,(07200) Tygua-San José,37,27,52,116
7419,2020-04-02,(07105) MOVISTAR ARENA,142,94,80,316
7420,2020-08-17,(09117) Calle 45,230,142,183,555
7421,2020-04-10,(10007) Las Nieves,35,38,27,100
7422,2020-08-29,(03014) SAN MARTIN,0,10,26,36
7423,2020-08-27,(50006) Corral Carrera 77,3,0,9,12
7424,2020-05-24,(07101) CASTELLANA,23,20,32,75
7425,2020-08-05,(02502) Terminal,378,251,311,940
7426,2020-08-20,(09118) Marly,1329,876,668,2873
7427,2020-01-22,(05000) Portal Américas - alimentacion,33052,18941,18939,70932
7428,2020-01-27,(05000) Portal Américas - alimentacion,35197,20244,19574,75015
7429,2020-01-07,(02200) Alcalá,8416,5354,4617,18387
7430,2020-02-04,(09100) Calle 40 Sur,7706,4299,4286,16291
7431,2020-01-06,(09003) Socorro,438,200,351,989
7432,2020-02-03,(08001) Parque el Tunal,1704,957,1010,3671
7433,2020-06-27,(10000) Portal 20 de Julio - alimentacion,3834,1692,2360,7886
7434,2020-10-01,(09001) Molinos,2894,1454,2298,6646
7435,2020-08-30,(05000) Portal Américas - alimentacion,3570,1548,2358,7476
7436,2020-05-09,(07112) COMUNEROS,412,221,211,844
7437,2020-09-16,(07112) COMUNEROS,894,511,653,2058
7438,2020-01-25,(09004) Santa Lucía,5045,2464,3350,10859
7439,2020-02-15,(09004) Santa Lucía,5383,2636,3601,11620
7440,2020-10-09,(09104) Restrepo,1694,1009,1755,4458
7441,2020-10-01,(05100) Banderas P. Central,1152,624,866,2642
7442,2020-05-29,(09115) Calle 34,590,395,325,1310
7443,2020-05-27,(09000) Cabecera Usme - alimentacion,7388,4131,4076,15595
7444,2020-09-15,(09104) Restrepo,1698,933,1303,3934
7445,2020-04-28,(07505) LEON XIII,1284,833,688,2805
7446,2020-07-21,(07505) LEON XIII,2563,1392,1020,4975
7447,2020-08-10,(07505) LEON XIII,2584,1404,1146,5134
7448,2020-09-17,(02204) Pepe Sierra,767,568,539,1874
7449,2020-01-18,(06002) Normandía,823,464,810,2097
7450,2020-02-28,(09004) Santa Lucía,7735,4081,4173,15989
7451,2020-06-03,(10000) Portal 20 de Julio - alimentacion,3961,1888,2219,8068
7452,2020-05-21,(09101) Quiroga,358,202,275,835
7453,2020-02-20,(06106) Recinto Ferial,1521,829,738,3088
7454,2020-05-09,(07102) NQS - CALLE 75,171,125,116,412
7455,2020-06-27,(03013) RIO NEGRO,204,135,159,498
7456,2020-02-18,(07110) PALOQUEMAO,2815,1675,1221,5711
7457,2020-01-24,(04100) Carrera 77,6160,3395,3800,13355
7458,2020-02-26,(09116) Avenida 39,2946,2103,1788,6837
7459,2020-03-14,(02103) Mazurén,951,410,980,2341
7460,2020-07-08,(07000) Portal Sur - alimentacion,8421,4884,4269,17574
7461,2020-04-24,(09103) Olaya,551,325,303,1179
7462,2020-06-25,(14001) La Sabana,191,127,100,418
7463,2020-08-12,(14001) La Sabana,172,108,85,365
7464,2020-01-04,(04105) Carrera 53,452,254,349,1055
7465,2020-09-08,(09004) Santa Lucía,2618,1307,1504,5429
7466,2020-09-19,(09004) Santa Lucía,2278,1080,1681,5039
7467,2020-05-08,(04000) Cabecera Calle 80,716,448,469,1633
7468,2020-09-20,(07010) Bosa,0,112,358,470
7469,2020-01-07,(09114) Calle 26,1999,1297,1246,4542
7470,2020-03-19,(04100) Carrera 77,2942,1613,1810,6365
7471,2020-02-20,(40003) Mirador del Paraiso,4630,2647,2487,9764
7472,2020-04-06,(40003) Mirador del Paraiso,781,437,549,1767
7473,2020-01-14,(06000) Portal Eldorado - alimentacion,14706,7658,8068,30432
7474,2020-10-04,(04001) Quirigua,142,64,163,369
7475,2020-08-07,(07505) LEON XIII,1050,529,539,2118
7476,2020-02-15,(10005) Bicentenario - alimentacion,453,199,438,1090
7477,2020-03-01,(10005) Bicentenario - alimentacion,148,92,242,482
7478,2020-03-11,(02001) Centro Comercial Santa Fe,4506,2848,2528,9882
7479,2020-04-24,(05001) Patio Bonito,988,548,587,2123
7480,2020-09-12,(10000) Portal 20 de Julio - alimentacion,3749,1509,2518,7776
7481,2020-01-05,(09101) Quiroga,427,159,418,1004
7482,2020-07-23,(07112) COMUNEROS,641,359,376,1376
7483,2020-06-04,(09004) Santa Lucía,2364,1234,1193,4791
7484,2020-07-12,(07503) SAN MATEO,3550,1848,2027,7425
7485,2020-01-24,(09113) Calle 22,1389,842,1046,3277
7486,2020-04-23,(06108) Concejo de Bogotá,114,75,55,244
7487,2020-08-19,(02000) Cabecera Autopista Norte - alimentacion,4075,2169,2366,8610
7488,2020-04-21,(10002) Av. Primero de Mayo,1161,675,804,2640
7489,2020-04-20,(09107) Hortúa,419,283,222,924
7490,2020-01-09,(05101) Mandalay - Cr.73,715,394,411,1520
7491,2020-07-21,(05101) Mandalay - Cr.73,105,58,55,218
7492,2020-09-25,(02300) Calle 100,1248,933,964,3145
7493,2020-06-08,(03012) SUBA - CALLE 95,297,201,195,693
7494,2020-01-05,(05100) Banderas P. Central,623,239,669,1531
7495,2020-09-16,(05005) Transversal 86,454,243,312,1009
7496,2020-05-02,(02202) Calle 127,574,429,275,1278
7497,2020-06-26,(02202) Calle 127,1249,805,629,2683
7498,2020-08-18,(03009) Av. Suba- Calle 116,526,316,235,1077
7499,2020-10-07,(04003) Avenida Ciudad de Cali,1101,655,1082,2838
7500,2020-02-22,(04108) El Polo,996,672,894,2562
7501,2020-07-06,(04108) El Polo,525,323,275,1123
7502,2020-01-30,(12007) Zona Industrial,1283,804,557,2644
7503,2020-06-22,(06000) Portal Eldorado - alimentacion,1394,701,803,2898
7504,2020-03-02,(07103) AV. CHILE,3588,2228,1739,7555
7505,2020-08-01,(07113) SANTA ISABEL,233,136,181,550
7506,2020-06-26,(03003) 21 ANGELES,383,172,198,753
7507,2020-08-21,(03001) LA CAMPIÑA,1055,581,616,2252
7508,2020-06-23,(07000) Portal Sur,1950,1259,1077,4286
7509,2020-07-06,(02101) Toberín,1571,1007,1009,3587
7510,2020-05-10,(09103) Olaya,256,118,159,533
7511,2020-02-09,(04102) Avenida Boyaca,635,307,525,1467
7512,2020-04-06,(09100) Calle 40 Sur,832,471,533,1836
7513,2020-06-08,(09100) Calle 40 Sur,1671,987,1018,3676
7514,2020-06-23,(09000) Cabecera Usme,1779,1150,1244,4173
7515,2020-06-30,(02204) Pepe Sierra,874,584,477,1935
7516,2020-09-25,(07113) SANTA ISABEL,442,263,349,1054
7517,2020-06-04,(05103) Marsella,301,176,180,657
7518,2020-01-05,(09109) Tercer Milenio,236,145,287,668
7519,2020-01-03,(06111) Universidades,1068,661,1050,2779
7520,2020-07-03,(09110) Avenida Jimenez,1454,1029,990,3473
7521,2020-07-08,(09120) Calle 63,1205,784,751,2740
7522,2020-10-12,(09120) Calle 63,353,277,529,1159
7523,2020-07-01,(02204) Pepe Sierra,851,570,442,1863
7524,2020-06-23,(02304) Heroes,896,633,484,2013
7525,2020-05-27,(06000) Portal Eldorado,963,647,464,2074
7526,2020-05-29,(06000) Portal Eldorado,943,646,466,2055
7527,2020-09-01,(02302) Virrey,673,493,385,1551
7528,2020-01-04,(09122) Calle 72,1669,1146,1617,4432
7529,2020-02-08,(09122) Calle 72,3258,2268,3025,8551
7530,2020-10-10,(12003) Ricaurte,288,244,253,785
7531,2020-08-15,(10010) San Bernardo,466,220,420,1106
7532,2020-04-30,(03009) Av. Suba- Calle 116,332,243,162,737
7533,2020-07-16,(10000) Portal 20 de Julio - alimentacion,2807,1279,1747,5833
7534,2020-03-25,(02105) Calle 142,448,322,252,1022
7535,2020-06-20,(02105) Calle 142,592,352,392,1336
7536,2020-10-11,(03006) NIZA - CALLE 127,165,131,145,441
7537,2020-02-21,(10005) Bicentenario,717,392,414,1523
7538,2020-07-22,(03002) SUBA - TV- 91,674,412,419,1505
7539,2020-05-29,(07103) AV. CHILE,866,556,395,1817
7540,2020-07-19,(07103) AV. CHILE,199,117,144,460
7541,2020-07-28,(10005) Bicentenario,91,55,64,210
7542,2020-07-29,(40002) Manitas,407,216,252,875
7543,2020-01-13,(04102) Avenida Boyaca,2298,1333,1411,5042
7544,2020-01-19,(02001) Centro Comercial Santa Fe,559,360,821,1740
7545,2020-07-17,(07113) SANTA ISABEL,357,200,243,800
7546,2020-03-05,(10004) Policarpa,882,468,578,1928
7547,2020-07-24,(05105) Pradera,452,251,198,901
7548,2020-08-11,(06111) Universidades,319,179,301,799
7549,2020-09-25,(09122) Calle 72,1398,934,1133,3465
7550,2020-08-30,(07110) PALOQUEMAO,172,112,122,406
7551,2020-09-12,(06100) Av. Rojas,149,95,160,404
7552,2020-04-19,(09122) Calle 72,256,179,153,588
7553,2020-01-19,(06001) Modelia,259,174,373,806
7554,2020-05-12,(06109) Centro Memoria,238,142,128,508
7555,2020-09-18,(07009) SENA,706,431,551,1688
7556,2020-04-04,(09103) Olaya,328,177,151,656
7557,2020-09-17,(06104) Gobernación,303,153,175,631
7558,2020-06-12,(50002) Corral Calle 40 Sur,24,9,22,55
7559,2020-05-21,(09114) Calle 26,239,179,157,575
7560,2020-07-28,(07201) Guatoque -Veraguas,166,94,109,369
7561,2020-08-19,(07201) Guatoque -Veraguas,184,83,122,389
7562,2020-09-19,(07105) MOVISTAR ARENA,202,123,174,499
7563,2020-01-21,(09105) Río Fucha,505,284,296,1085
7564,2020-06-15,(02200) Alcalá,593,435,385,1413
7565,2020-06-10,(06109) Centro Memoria,280,154,135,569
7566,2020-09-13,(06109) Centro Memoria,76,55,90,221
7567,2020-09-12,(03003) 21 ANGELES,258,110,166,534
7568,2020-01-04,(10007) Las Nieves,626,533,646,1805
7569,2020-03-07,(10003) Ciudad Jardín,588,296,534,1418
7570,2020-09-04,(40001) Juan Pablo II,649,409,436,1494
7571,2020-09-20,(06000) Portal Eldorado,152,159,357,668
7572,2020-07-31,(06107) Ciudad Universitaria,169,98,103,370
7573,2020-01-19,(40002) Manitas,343,149,277,769
7574,2020-05-28,(40002) Manitas,353,204,227,784
7575,2020-04-25,(10007) Las Nieves,149,120,118,387
7576,2020-05-30,(08002) Biblioteca,194,99,122,415
7577,2020-02-14,(12000) Puente Aranda,311,183,195,689
7578,2020-02-27,(12000) Puente Aranda,326,173,189,688
7579,2020-06-21,(09004) Santa Lucía,867,418,511,1796
7580,2020-06-10,(07506) DESPENSA,473,236,232,941
7581,2020-05-20,(02102) Calle 161,193,114,124,431
7582,2020-01-01,(02105) Calle 142,305,202,524,1031
7583,2020-04-12,(09118) Marly,413,256,169,838
7584,2020-05-20,(06002) Normandía,286,154,142,582
7585,2020-08-22,(08000) Portal Tunal,574,258,261,1093
7586,2020-08-18,(07008) NQS - Calle 30 Sur,270,161,171,602
7587,2020-07-21,(06106) Recinto Ferial,225,123,141,489
7588,2020-06-08,(09113) Calle 22,384,222,354,960
7589,2020-10-03,(07108) Av. El Dorado,119,89,137,345
7590,2020-07-17,(06100) Av. Rojas,205,121,109,435
7591,2020-05-12,(03005) SUBA - AV. BOYACA,307,202,196,705
7592,2020-04-20,(03012) SUBA - CALLE 95,181,118,99,398
7593,2020-04-27,(07111) NQS - RICAURTE,83,318,123,524
7594,2020-06-14,(03009) Av. Suba- Calle 116,153,101,80,334
7595,2020-09-10,(09121) Las Flores,646,356,510,1512
7596,2020-04-30,(10008) San Diego,175,108,105,388
7597,2020-08-14,(05103) Marsella,439,221,224,884
7598,2020-04-02,(02001) Centro Comercial Santa Fe,172,123,147,442
7599,2020-04-07,(07107) U. NACIONAL,177,167,105,449
7600,2020-01-02,(07006) General Santander - alimentacion,611,387,561,1559
7601,2020-07-13,(07008) NQS - Calle 30 Sur,271,149,134,554
7602,2020-09-05,(10004) Policarpa,233,100,168,501
7603,2020-08-29,(03005) SUBA - AV. BOYACA,361,188,274,823
7604,2020-01-01,(05005) Transversal 86,120,60,159,339
7605,2020-04-19,(04003) Avenida Ciudad de Cali,167,111,130,408
7606,2020-07-12,(09109) Tercer Milenio,124,87,115,326
7607,2020-08-24,(04103) Las Ferias,357,170,169,696
7608,2020-08-09,(04000) Cabecera Calle 80,185,136,248,569
7609,2020-02-16,(06103) CAN,287,226,357,870
7610,2020-05-02,(07113) SANTA ISABEL,166,104,110,380
7611,2020-04-11,(12001) Carrera 43,127,94,64,285
7612,2020-05-29,(07006) General Santander,463,290,251,1004
7613,2020-04-20,(09114) Calle 26,160,134,120,414
7614,2020-08-16,(02102) Calle 161,57,34,63,154
7615,2020-08-17,(02201) Prado,250,201,210,661
7616,2020-06-28,(05101) Mandalay - Cr.73,28,8,22,58
7617,2020-04-14,(04107) Escuela Militar,62,49,51,162
7618,2020-01-02,(12000) Puente Aranda,126,86,92,304
7619,2020-01-05,(09105) Río Fucha,102,69,147,318
7620,2020-03-01,(03014) SAN MARTIN,38,22,56,116
7621,2020-10-11,(03009) Av. Suba- Calle 116,120,99,149,368
7622,2020-10-09,(09105) Río Fucha,0,80,177,257
7623,2020-04-12,(07108) Av. El Dorado,24,19,16,59
7624,2020-03-29,(09114) Calle 26,38,28,33,99
7625,2020-04-27,(07506) DESPENSA,203,28,52,283
7626,2020-04-05,(04003) Avenida Ciudad de Cali,161,93,124,378
7627,2020-07-23,(09105) Río Fucha,72,35,55,162
7628,2020-05-02,(04101) Minuto de Dios,114,78,69,261
7629,2020-03-29,(04101) Minuto de Dios,46,33,49,128
7630,2020-01-17,(12000) Puente Aranda,225,125,168,518
7631,2020-06-11,(12007) Zona Industrial,304,217,161,682
7632,2020-05-01,(12000) Puente Aranda,11,10,8,29
7633,2019-12-31,(02000) Cabecera Autopista Norte - intermunicipal,14,17,26,57
7634,2020-05-01,(03014) SAN MARTIN,8,9,10,27
7635,2020-03-30,(03003) 21 ANGELES,169,85,89,343
7636,2020-02-13,(50006) Corral Carrera 77,36,21,37,94
7637,2020-08-31,(12000) Puente Aranda,78,35,50,163
7638,2020-05-01,(12007) Zona Industrial,63,37,51,151
7639,2020-05-03,(10006) San Victorino,58,49,50,157
7640,2020-07-09,(03004) GRATAMIRA,36,20,25,81
7641,2020-06-29,(07101) CASTELLANA,35,26,40,101
7642,2020-04-09,(12000) Puente Aranda,15,7,7,29
7643,2020-08-05,(03014) SAN MARTIN,0,16,20,36
7644,2020-04-09,(10005) Bicentenario,24,10,11,45
7645,2020-04-30,(03004) GRATAMIRA,26,18,8,52
7646,2020-01-30,(09002) Consuelo,1437,733,839,3009
7647,2020-09-12,(02502) Terminal,288,182,339,809
7648,2020-07-05,(07504) TERREROS,1711,884,1072,3667
7649,2020-09-17,(07504) TERREROS,6787,3573,3809,14169
7650,2020-05-14,(09119) Calle 57,391,265,222,878
7651,2020-08-04,(09119) Calle 57,518,342,352,1212
7652,2020-01-16,(06104) Gobernación,1163,724,620,2507
7653,2020-02-21,(04101) Minuto de Dios,3362,1866,1819,7047
7654,2020-09-03,(04002) Carrera 90,770,394,465,1629
7655,2020-09-22,(04002) Carrera 90,864,442,584,1890
7656,2020-08-15,(05000) Portal Américas - alimentacion,8476,4317,5189,17982
7657,2020-03-16,(07010) Bosa,1653,959,1090,3702
7658,2020-06-25,(04103) Las Ferias,368,226,179,773
7659,2020-01-20,(08000) Portal Tunal - alimentacion,21802,11644,11176,44622
7660,2020-07-10,(05100) Banderas P. Central,879,474,566,1919
7661,2020-03-07,(09000) Cabecera Usme,3848,1888,3355,9091
7662,2020-08-11,(09000) Cabecera Usme,1600,958,1148,3706
7663,2020-09-19,(09000) Cabecera Usme,1552,765,1506,3823
7664,2020-05-12,(06000) Portal Eldorado - alimentacion,3072,1532,1416,6020
7665,2020-03-05,(02000) Cabecera Autopista Norte,11364,6790,6283,24437
7666,2020-01-08,(07009) SENA,2301,1319,1550,5170
7667,2020-02-25,(09109) Tercer Milenio,1400,887,849,3136
7668,2020-06-25,(07505) LEON XIII,2826,1521,1171,5518
7669,2020-06-19,(03000) Portal Suba - alimentacion,6241,3723,3688,13652
7670,2020-09-01,(03000) Portal Suba - alimentacion,6392,3581,3872,13845
7671,2020-02-26,(09110) Avenida Jimenez,2982,3434,3480,9896
7672,2020-06-27,(07111) NQS - RICAURTE,957,608,438,2003
7673,2020-09-19,(04000) Cabecera Calle 80 - alimentacion,3621,1739,3088,8448
7674,2020-06-13,(09101) Quiroga,515,191,313,1019
7675,2020-02-14,(07102) NQS - CALLE 75,1516,969,970,3455
7676,2020-01-19,(09103) Olaya,900,421,894,2215
7677,2020-03-18,(09103) Olaya,2265,1264,1307,4836
7678,2020-05-04,(09110) Avenida Jimenez,517,374,450,1341
7679,2020-01-27,(06001) Modelia,2418,1474,1221,5113
7680,2020-02-25,(03007) HUMEDAL CORDOBA,1050,673,510,2233
7681,2020-01-31,(07106) EL CAMPIN,2045,1246,1228,4519
7682,2020-03-28,(09104) Restrepo,477,320,432,1229
7683,2020-04-23,(09104) Restrepo,789,533,589,1911
7684,2020-07-16,(07000) Portal Sur - alimentacion,7129,4051,3362,14542
7685,2020-07-28,(05100) Banderas P. Central - alimentacion,2552,1383,1431,5366
7686,2020-10-05,(05100) Banderas P. Central - alimentacion,3697,1990,2519,8206
7687,2020-02-06,(14001) La Sabana,445,347,359,1151
7688,2020-09-11,(07002) MADELENA,868,502,601,1971
7689,2020-06-23,(09113) Calle 22,434,275,337,1046
7690,2020-09-05,(09113) Calle 22,410,224,346,980
7691,2020-02-24,(06105) Quinta Paredes,1063,601,485,2149
7692,2020-05-08,(50003) Corral Molinos,996,482,656,2134
7693,2020-04-23,(10001) Country Sur,573,269,361,1203
7694,2020-01-01,(09002) Consuelo,147,49,166,362
7695,2020-01-05,(06109) Centro Memoria,130,88,181,399
7696,2020-06-02,(03000) Portal Suba,1076,677,721,2474
7697,2020-08-11,(10000) Portal 20 de Julio - alimentacion,4103,1777,2483,8363
7698,2020-01-15,(09107) Hortúa,2031,1187,1326,4544
7699,2020-01-21,(09107) Hortúa,1598,940,1018,3556
7700,2020-01-18,(05001) Patio Bonito,4349,2227,2764,9340
7701,2020-01-17,(02302) Virrey,3392,2323,1770,7485
7702,2020-09-18,(03000) Portal Suba,1643,1014,1268,3925
7703,2020-10-02,(10010) San Bernardo,668,335,585,1588
7704,2020-01-18,(09116) Avenida 39,595,539,847,1981
7705,2020-04-03,(07000) Portal Sur - alimentacion,3931,2035,1680,7646
7706,2020-05-25,(07000) Portal Sur - alimentacion,2380,1226,1026,4632
7707,2020-01-18,(02303) Calle 85,1299,1056,1384,3739
7708,2020-06-25,(02303) Calle 85,761,515,345,1621
7709,2020-09-03,(02303) Calle 85,759,502,480,1741
7710,2020-02-11,(02300) Calle 100,7366,4723,3866,15955
7711,2020-07-02,(08001) Parque el Tunal,511,302,287,1100
7712,2020-02-20,(05102) Av. Américas - Av. Boyacá,1930,1155,882,3967
7713,2020-03-04,(07007) NQS - Calle 38A Sur,2160,1293,1290,4743
7714,2020-09-09,(02302) Virrey,722,497,422,1641
7715,2020-01-17,(07001) PERDOMO,4143,2273,2499,8915
7716,2020-08-27,(04000) Cabecera Calle 80,1089,644,835,2568
7717,2020-02-09,(09116) Avenida 39,229,213,448,890
7718,2020-07-11,(09100) Calle 40 Sur,1525,826,1079,3430
7719,2020-08-01,(02201) Prado,484,330,360,1174
7720,2020-03-09,(03005) SUBA - AV. BOYACA,597,494,434,1525
7721,2020-07-02,(09107) Hortúa,624,371,394,1389
7722,2020-10-03,(07005) ALQUERIA,583,293,498,1374
7723,2020-05-19,(02000) Cabecera Autopista Norte - alimentacion,4009,2286,1904,8199
7724,2020-03-06,(03011) SUBA - CALLE 100,2438,1328,1541,5307
7725,2020-03-01,(03000) Portal Suba,1444,708,1641,3793
7726,2020-01-09,(09001) Molinos,5929,3234,4645,13808
7727,2020-09-27,(03000) Portal Suba - alimentacion,2310,1017,2125,5452
7728,2020-02-29,(02104) Calle 146,3515,1604,3033,8152
7729,2020-01-19,(03012) SUBA - CALLE 95,311,190,348,849
7730,2020-07-17,(02205) Calle 106,376,227,186,789
7731,2020-07-23,(04003) Avenida Ciudad de Cali,850,490,590,1930
7732,2020-07-31,(04003) Avenida Ciudad de Cali,788,444,571,1803
7733,2020-08-18,(04003) Avenida Ciudad de Cali,884,513,686,2083
7734,2020-08-15,(04108) El Polo,298,188,224,710
7735,2020-03-30,(08002) Biblioteca,168,98,91,357
7736,2020-07-06,(02000) Cabecera Autopista Norte - alimentacion,5007,2855,2973,10835
7737,2020-01-03,(06101) El Tiempo,1240,723,727,2690
7738,2020-01-17,(06101) El Tiempo,2427,1290,1287,5004
7739,2020-02-24,(06101) El Tiempo,3013,1661,1302,5976
7740,2020-05-23,(09100) Calle 40 Sur,1064,632,681,2377
7741,2020-08-08,(09100) Calle 40 Sur,1211,657,858,2726
7742,2020-06-02,(07104) Simon Bolivar,591,385,224,1200
7743,2020-01-05,(04107) Escuela Militar,72,61,116,249
7744,2020-02-10,(04107) Escuela Militar,711,436,437,1584
7745,2020-10-07,(07004) VENECIA,1161,715,898,2774
7746,2020-08-18,(09000) Cabecera Usme,1625,952,1208,3785
7747,2020-03-19,(09106) Nariño,962,575,647,2184
7748,2020-09-28,(09109) Tercer Milenio,366,239,275,880
7749,2020-02-07,(03003) 21 ANGELES,1799,873,940,3612
7750,2020-09-12,(04104) Avenida 68,476,232,380,1088
7751,2020-06-19,(02202) Calle 127,1219,829,635,2683
7752,2020-06-26,(02204) Pepe Sierra,906,589,453,1948
7753,2020-07-22,(02204) Pepe Sierra,732,523,382,1637
7754,2020-08-08,(09001) Molinos,1835,890,1295,4020
7755,2020-06-22,(02302) Virrey,199,146,133,478
7756,2020-08-16,(02302) Virrey,163,111,131,405
7757,2020-01-24,(09122) Calle 72,6046,4160,3754,13960
7758,2020-03-04,(12003) Ricaurte,1260,819,699,2778
7759,2020-07-25,(06000) Portal Eldorado,519,375,365,1259
7760,2020-02-03,(03013) RIO NEGRO,1239,785,886,2910
7761,2020-01-07,(06103) CAN,1570,950,846,3366
7762,2020-06-24,(06001) Modelia,405,253,221,879
7763,2020-06-13,(02105) Calle 142,566,348,415,1329
7764,2020-09-26,(02105) Calle 142,693,397,599,1689
7765,2020-06-24,(04003) Avenida Ciudad de Cali,1085,617,759,2461
7766,2020-06-15,(03002) SUBA - TV- 91,238,130,182,550
7767,2020-09-21,(05107) Américas - Cr.53,217,208,229,654
7768,2020-06-04,(05100) Banderas P. Central - alimentacion,1728,1064,1460,4252
7769,2020-02-06,(07201) Guatoque -Veraguas,1075,552,690,2317
7770,2020-04-06,(06102) Salitre El Greco,160,112,81,353
7771,2020-02-04,(07105) MOVISTAR ARENA,1401,834,818,3053
7772,2020-02-13,(10005) Bicentenario,829,424,371,1624
7773,2020-02-07,(40002) Manitas,1353,750,835,2938
7774,2020-06-11,(40002) Manitas,353,209,255,817
7775,2020-08-31,(02001) Centro Comercial Santa Fe,459,300,343,1102
7776,2020-09-04,(10008) San Diego,321,198,207,726
7777,2020-08-21,(10009) Museo Nacional,432,257,298,987
7778,2020-07-08,(05107) Américas - Cr.53,468,257,271,996
7779,2020-07-09,(06111) Universidades,370,219,319,908
7780,2020-08-24,(06111) Universidades,325,159,283,767
7781,2020-04-13,(09004) Santa Lucía,1068,593,595,2256
7782,2020-08-18,(40001) Juan Pablo II,547,319,369,1235
7783,2020-09-14,(04000) Cabecera Calle 80 - intermunicipal,376,180,372,928
7784,2020-06-27,(03006) NIZA - CALLE 127,391,222,213,826
7785,2020-10-11,(07006) General Santander,232,88,239,559
7786,2020-09-06,(07110) PALOQUEMAO,193,144,157,494
7787,2020-03-03,(09111) Calle 19,2375,1438,1634,5447
7788,2020-03-09,(09107) Hortúa,502,464,391,1357
7789,2020-06-12,(06104) Gobernación,239,148,123,510
7790,2020-09-13,(07009) SENA,208,137,228,573
7791,2020-10-05,(04105) Carrera 53,307,180,249,736
7792,2020-10-10,(07000) Portal Sur,1709,793,1518,4020
7793,2020-05-27,(06104) Gobernación,215,132,87,434
7794,2020-01-01,(06101) El Tiempo,102,95,210,407
7795,2020-08-05,(07003) SEVILLANA,397,201,223,821
7796,2020-01-16,(09105) Río Fucha,662,361,526,1549
7797,2020-03-22,(02200) Alcalá,419,293,227,939
7798,2020-09-14,(06001) Modelia,398,237,267,902
7799,2020-06-27,(04003) Avenida Ciudad de Cali,847,439,638,1924
7800,2020-09-11,(03003) 21 ANGELES,358,172,202,732
7801,2020-09-17,(03003) 21 ANGELES,373,183,238,794
7802,2020-10-09,(03003) 21 ANGELES,382,195,263,840
7803,2020-04-15,(06000) Portal Eldorado,780,545,356,1681
7804,2020-09-20,(09119) Calle 57,225,162,275,662
7805,2020-04-07,(40002) Manitas,155,83,118,356
7806,2020-08-06,(02304) Heroes,785,536,430,1751
7807,2020-10-12,(07007) NQS - Calle 38A Sur,221,124,191,536
7808,2020-10-04,(14005) Las Aguas,72,59,184,315
7809,2020-09-09,(12004) Carrera 22,292,187,153,632
7810,2020-05-06,(10004) Policarpa,146,76,117,339
7811,2020-08-07,(12003) Ricaurte,90,65,52,207
7812,2020-10-09,(06106) Recinto Ferial,278,195,211,684
7813,2020-05-09,(10009) Museo Nacional,185,126,136,447
7814,2020-01-06,(09107) Hortúa,425,271,452,1148
7815,2020-05-01,(10004) Policarpa,72,41,65,178
7816,2020-02-19,(07200) Tygua-San José,822,514,625,1961
7817,2020-09-13,(02202) Calle 127,322,281,282,885
7818,2020-01-31,(12003) Ricaurte,1188,770,638,2596
7819,2020-04-02,(02302) Virrey,297,232,188,717
7820,2020-06-25,(09113) Calle 22,441,270,352,1063
7821,2020-04-03,(02001) Centro Comercial Santa Fe,159,112,147,418
7822,2020-03-28,(14001) La Sabana,51,37,42,130
7823,2020-03-16,(12002) CDS - Carrera 32,487,298,253,1038
7824,2020-08-11,(12002) CDS - Carrera 32,194,112,75,381
7825,2020-04-03,(40001) Juan Pablo II,247,136,160,543
7826,2020-07-04,(04102) Avenida Boyaca,309,169,223,701
7827,2020-09-09,(09122) Calle 72,1324,851,936,3111
7828,2020-09-17,(06103) CAN,416,246,239,901
7829,2020-05-29,(06002) Normandía,272,157,169,598
7830,2020-01-28,(07506) DESPENSA,1535,923,911,3369
7831,2020-07-15,(40002) Manitas,270,186,180,636
7832,2020-05-04,(09117) Calle 45,530,334,237,1101
7833,2020-01-19,(06103) CAN,285,187,321,793
7834,2020-05-31,(09122) Calle 72,325,225,254,804
7835,2020-07-03,(07506) DESPENSA,494,271,285,1050
7836,2020-07-12,(09117) Calle 45,255,160,247,662
7837,2020-03-18,(05101) Mandalay - Cr.73,458,245,237,940
7838,2020-06-15,(03011) SUBA - CALLE 100,161,74,95,330
7839,2020-06-03,(07010) Bosa,644,373,374,1391
7840,2020-05-16,(02000) Cabecera Autopista Norte - intermunicipal,183,128,168,479
7841,2020-06-13,(10005) Bicentenario,85,51,76,212
7842,2020-03-25,(06001) Modelia,279,208,184,671
7843,2020-08-08,(02204) Pepe Sierra,477,359,355,1191
7844,2020-08-18,(05105) Pradera,503,309,282,1094
7845,2020-03-26,(09111) Calle 19,197,144,157,498
7846,2020-04-02,(04001) Quirigua,159,109,81,349
7847,2020-01-28,(03004) GRATAMIRA,311,187,173,671
7848,2020-03-27,(05100) Banderas P. Central,301,176,214,691
7849,2020-08-22,(10003) Ciudad Jardín,149,63,104,316
7850,2020-05-22,(09105) Río Fucha,118,64,81,263
7851,2020-04-27,(04106) Carrera 47,67,50,23,140
7852,2020-04-11,(07007) NQS - Calle 38A Sur,93,70,57,220
7853,2020-06-21,(07007) NQS - Calle 38A Sur,166,113,88,367
7854,2020-06-29,(09002) Consuelo,173,88,110,371
7855,2020-04-09,(04102) Avenida Boyaca,40,31,18,89
7856,2020-04-07,(06106) Recinto Ferial,118,83,65,266
7857,2020-05-12,(40002) Manitas,292,155,193,640
7858,2020-06-15,(04102) Avenida Boyaca,101,64,85,250
7859,2020-07-13,(09105) Río Fucha,91,45,56,192
7860,2020-03-21,(10005) Bicentenario - alimentacion,70,30,49,149
7861,2020-07-12,(09114) Calle 26,60,51,96,207
7862,2020-10-12,(10003) Ciudad Jardín,76,29,84,189
7863,2020-04-29,(12004) Carrera 22,122,72,62,256
7864,2020-06-06,(09105) Río Fucha,80,35,73,188
7865,2020-04-19,(06101) El Tiempo,82,57,50,189
7866,2020-06-14,(05101) Mandalay - Cr.73,25,10,20,55
7867,2020-07-21,(50006) Corral Carrera 77,6,2,8,16
7868,2020-08-23,(07107) U. NACIONAL,90,50,76,216
7869,2020-07-25,(12004) Carrera 22,97,61,63,221
7870,2020-09-01,(12000) Puente Aranda,79,38,40,157
7871,2020-06-07,(08002) Biblioteca,87,38,42,167
7872,2020-06-29,(50006) Corral Carrera 77,2,1,4,7
7873,2020-04-03,(03004) GRATAMIRA,20,12,12,44
7874,2020-08-07,(03004) GRATAMIRA,0,5,17,22
7875,2020-07-03,(04000) Cabecera Calle 80 - alimentacion,4570,2550,3065,10185
7876,2020-02-02,(09002) Consuelo,436,152,411,999
7877,2020-08-15,(09002) Consuelo,388,188,279,855
7878,2020-01-02,(07504) TERREROS,8597,4962,5288,18847
7879,2020-04-07,(07504) TERREROS,2243,1343,1227,4813
7880,2020-05-12,(07504) TERREROS,3945,2397,1899,8241
7881,2020-05-11,(09119) Calle 57,398,292,229,919
7882,2020-02-18,(02200) Alcalá,15394,9757,6661,31812
7883,2020-07-17,(05000) Portal Américas,2534,1623,1771,5928
7884,2020-04-01,(04000) Cabecera Calle 80 - alimentacion,1790,982,1032,3804
7885,2020-01-28,(10000) Portal 20 de Julio - alimentacion,10546,5367,7228,23141
7886,2020-08-02,(04000) Cabecera Calle 80 - alimentacion,810,478,642,1930
7887,2020-03-07,(06107) Ciudad Universitaria,668,438,743,1849
7888,2020-02-11,(07010) Bosa,2357,1338,1463,5158
7889,2020-01-18,(07112) COMUNEROS,2113,1137,1643,4893
7890,2020-03-27,(07000) Portal Sur - alimentacion,3800,1946,1451,7197
7891,2020-09-16,(05100) Banderas P. Central,1072,631,745,2448
7892,2020-07-13,(10001) Country Sur,725,367,436,1528
7893,2020-01-09,(02102) Calle 161,1291,772,821,2884
7894,2020-08-10,(02101) Toberín,1315,817,882,3014
7895,2020-03-21,(07504) TERREROS,1656,853,823,3332
7896,2020-05-31,(07504) TERREROS,1237,694,749,2680
7897,2020-01-28,(06002) Normandía,2561,1534,1329,5424
7898,2020-03-04,(09110) Avenida Jimenez,5493,3450,2884,11827
7899,2020-03-02,(05002) Tintal,10684,6384,6164,23232
7900,2020-09-14,(03000) Portal Suba - alimentacion,6630,3776,4238,14644
7901,2020-05-30,(02000) Cabecera Autopista Norte - alimentacion,3458,1884,1844,7186
7902,2020-10-09,(09000) Cabecera Usme - alimentacion,10036,4869,6914,21819
7903,2020-01-15,(07110) PALOQUEMAO,2181,1312,1052,4545
7904,2020-02-12,(03001) LA CAMPIÑA,6837,4313,4242,15392
7905,2020-02-06,(03007) HUMEDAL CORDOBA,1077,619,557,2253
7906,2020-03-09,(09104) Restrepo,1016,1103,1049,3168
7907,2020-04-14,(09104) Restrepo,723,516,611,1850
7908,2020-09-04,(07000) Portal Sur - alimentacion,9025,5008,5261,19294
7909,2020-08-07,(09103) Olaya,467,228,272,967
7910,2020-01-09,(14001) La Sabana,266,228,282,776
7911,2020-09-20,(02000) Cabecera Autopista Norte - alimentacion,2156,907,1793,4856
7912,2020-04-13,(02000) Cabecera Autopista Norte,502,358,324,1184
7913,2020-07-27,(09113) Calle 22,381,202,303,886
7914,2020-01-16,(04105) Carrera 53,1158,648,751,2557
7915,2020-01-27,(06105) Quinta Paredes,1034,587,510,2131
7916,2020-06-22,(05000) Portal Américas,761,499,625,1885
7917,2020-01-25,(04000) Cabecera Calle 80,3492,1655,3117,8264
7918,2020-06-04,(04000) Cabecera Calle 80,995,608,691,2294
7919,2020-06-18,(04000) Cabecera Calle 80,1058,666,792,2516
7920,2020-08-03,(09110) Avenida Jimenez,1307,906,709,2922
7921,2020-02-19,(05107) Américas - Cr.53,2716,1471,1440,5627
7922,2020-01-13,(09120) Calle 63,3746,2680,2942,9368
7923,2020-04-16,(04100) Carrera 77,638,367,394,1399
7924,2020-01-15,(06109) Centro Memoria,942,588,574,2104
7925,2020-08-14,(40003) Mirador del Paraiso,1613,1016,1050,3679
7926,2020-08-20,(05002) Tintal,2233,1325,1409,4967
7927,2020-01-27,(10005) Bicentenario - alimentacion,620,305,504,1429
7928,2020-03-02,(10005) Bicentenario - alimentacion,708,334,558,1600
7929,2020-05-11,(09000) Cabecera Usme - alimentacion,5954,3318,3332,12604
7930,2020-08-08,(09000) Cabecera Usme - alimentacion,6166,3060,3835,13061
7931,2020-08-15,(10000) Portal 20 de Julio - alimentacion,3555,1561,2402,7518
7932,2020-06-08,(10000) Portal 20 de Julio,2134,1079,1027,4240
7933,2020-09-24,(02303) Calle 85,838,551,478,1867
7934,2020-06-14,(07503) SAN MATEO,2598,1587,1522,5707
7935,2020-02-26,(03003) 21 ANGELES,1834,865,950,3649
7936,2020-05-26,(02201) Prado,851,580,450,1881
7937,2020-09-09,(07001) PERDOMO,1011,608,730,2349
7938,2020-03-12,(02304) Heroes,2299,126,460,2885
7939,2020-01-03,(07110) PALOQUEMAO,1112,682,678,2472
7940,2020-07-06,(09123) Calle 76,1155,769,640,2564
7941,2020-08-21,(09123) Calle 76,878,634,571,2083
7942,2020-02-18,(04102) Avenida Boyaca,3230,1942,1648,6820
7943,2020-09-16,(02000) Cabecera Autopista Norte - alimentacion,5016,2739,3299,11054
7944,2020-08-14,(02300) Calle 100,1088,724,720,2532
7945,2020-09-17,(03012) SUBA - CALLE 95,362,194,219,775
7946,2020-06-11,(10000) Portal 20 de Julio,2205,1051,989,4245
7947,2020-02-29,(07006) General Santander,1580,751,1256,3587
7948,2020-02-18,(02104) Calle 146,9423,6355,5461,21239
7949,2020-02-07,(10008) San Diego,1448,886,833,3167
7950,2020-07-04,(10008) San Diego,203,120,175,498
7951,2020-02-17,(04105) Carrera 53,1518,823,758,3099
7952,2020-03-15,(07009) SENA,733,357,652,1742
7953,2020-09-12,(06109) Centro Memoria,192,119,164,475
7954,2020-07-11,(02205) Calle 106,226,181,207,614
7955,2020-03-23,(12000) Puente Aranda,10,10,5,25
7956,2020-01-18,(03006) NIZA - CALLE 127,1103,700,924,2727
7957,2020-07-23,(04108) El Polo,413,232,222,867
7958,2020-08-22,(04108) El Polo,332,195,196,723
7959,2020-04-03,(09000) Cabecera Usme,813,435,567,1815
7960,2020-07-17,(02201) Prado,785,514,419,1718
7961,2020-01-19,(02000) Cabecera Autopista Norte - intermunicipal,605,387,703,1695
7962,2020-02-03,(03010) PUENTE LARGO,2142,1452,1218,4812
7963,2020-09-13,(02101) Toberín,345,201,489,1035
7964,2020-01-21,(05103) Marsella,1875,679,781,3335
7965,2020-04-09,(10000) Portal 20 de Julio,512,243,216,971
7966,2020-05-25,(02000) Cabecera Autopista Norte - alimentacion,1677,910,885,3472
7967,2020-03-20,(02304) Heroes,466,326,229,1021
7968,2020-09-01,(04107) Escuela Militar,140,81,77,298
7969,2020-09-30,(06000) Portal Eldorado,912,679,726,2317
7970,2020-03-15,(03006) NIZA - CALLE 127,397,257,355,1009
7971,2020-04-18,(02000) Cabecera Autopista Norte,377,275,238,890
7972,2020-01-15,(09109) Tercer Milenio,1201,722,851,2774
7973,2020-03-08,(09117) Calle 45,744,562,1115,2421
7974,2020-05-03,(10000) Portal 20 de Julio - alimentacion,1130,440,697,2267
7975,2020-09-17,(09117) Calle 45,737,496,514,1747
7976,2020-09-13,(04104) Avenida 68,186,126,205,517
7977,2020-05-09,(03011) SUBA - CALLE 100,217,136,132,485
7978,2020-07-06,(09120) Calle 63,1232,786,760,2778
7979,2020-04-22,(03001) LA CAMPIÑA,533,299,277,1109
7980,2020-06-02,(03001) LA CAMPIÑA,941,520,509,1970
7981,2020-09-30,(40001) Juan Pablo II,636,368,477,1481
7982,2020-06-10,(06106) Recinto Ferial,244,142,109,495
7983,2020-02-10,(07008) NQS - Calle 30 Sur,1974,1076,1117,4167
7984,2020-05-07,(06000) Portal Eldorado,914,592,363,1869
7985,2020-06-23,(02302) Virrey,759,488,354,1601
7986,2020-07-13,(02302) Virrey,516,337,233,1086
7987,2020-08-18,(12003) Ricaurte,408,241,170,819
7988,2020-06-29,(02105) Calle 142,228,172,211,611
7989,2020-04-07,(09109) Tercer Milenio,159,102,108,369
7990,2020-05-01,(09116) Avenida 39,102,72,68,242
7991,2020-09-25,(03006) NIZA - CALLE 127,584,336,344,1264
7992,2020-07-05,(09104) Restrepo,505,275,461,1241
7993,2020-01-12,(03002) SUBA - TV- 91,728,352,783,1863
7994,2020-07-01,(05107) Américas - Cr.53,435,243,286,964
7995,2020-05-22,(40002) Manitas,344,195,221,760
7996,2020-09-11,(04002) Carrera 90,725,386,420,1531
7997,2020-05-28,(02304) Heroes,682,483,359,1524
7998,2020-06-11,(02304) Heroes,745,537,411,1693
7999,2020-10-03,(07003) SEVILLANA,409,183,343,935
8000,2020-03-10,(07104) Simon Bolivar,946,229,316,1491
8001,2020-05-13,(05100) Banderas P. Central,510,309,302,1121
8002,2020-07-24,(03011) SUBA - CALLE 100,498,227,172,897
8003,2020-09-16,(10009) Museo Nacional,578,323,425,1326
8004,2020-05-31,(05002) Tintal,588,263,379,1230
8005,2020-02-10,(03004) GRATAMIRA,314,181,161,656
8006,2020-06-29,(07001) PERDOMO,319,156,219,694
8007,2020-09-09,(07201) Guatoque -Veraguas,220,113,136,469
8008,2020-06-11,(07110) PALOQUEMAO,632,346,258,1236
8009,2020-09-24,(07110) PALOQUEMAO,726,425,361,1512
8010,2020-09-27,(04000) Cabecera Calle 80,334,204,516,1054
8011,2020-01-03,(12004) Carrera 22,290,197,261,748
8012,2020-04-25,(09122) Calle 72,460,329,285,1074
8013,2020-04-01,(09111) Calle 19,217,147,195,559
8014,2020-06-11,(12002) CDS - Carrera 32,189,127,73,389
8015,2020-05-28,(06109) Centro Memoria,241,151,117,509
8016,2020-07-30,(05102) Av. Américas - Av. Boyacá,197,109,135,441
8017,2020-09-24,(07009) SENA,713,432,563,1708
8018,2020-06-09,(04105) Carrera 53,273,144,169,586
8019,2020-04-14,(02303) Calle 85,332,253,215,800
8020,2020-03-17,(07107) U. NACIONAL,890,632,584,2106
8021,2020-04-23,(03000) Portal Suba,664,413,421,1498
8022,2020-07-06,(07105) MOVISTAR ARENA,274,165,182,621
8023,2020-08-11,(07105) MOVISTAR ARENA,204,125,117,446
8024,2020-04-21,(07113) SANTA ISABEL,209,149,118,476
8025,2020-09-06,(02204) Pepe Sierra,208,181,206,595
8026,2020-04-17,(09119) Calle 57,282,199,208,689
8027,2020-04-27,(04103) Las Ferias,85,68,35,188
8028,2020-04-20,(04101) Minuto de Dios,161,101,101,363
8029,2020-03-28,(04100) Carrera 77,380,216,198,794
8030,2020-09-14,(03011) SUBA - CALLE 100,572,273,285,1130
8031,2020-01-02,(07109) CAD,1316,752,756,2824
8032,2020-04-17,(08002) Biblioteca,141,111,91,343
8033,2020-05-05,(03007) HUMEDAL CORDOBA,73,47,36,156
8034,2020-08-17,(12000) Puente Aranda,12,14,23,49
8035,2020-05-07,(12001) Carrera 43,346,187,167,700
8036,2020-09-21,(12001) Carrera 43,302,202,216,720
8037,2020-04-17,(07109) CAD,411,285,189,885
8038,2020-03-28,(03005) SUBA - AV. BOYACA,138,103,96,337
8039,2020-06-18,(05102) Av. Américas - Av. Boyacá,247,142,161,550
8040,2020-05-04,(02102) Calle 161,137,91,74,302
8041,2020-08-04,(14001) La Sabana,160,100,79,339
8042,2020-09-24,(09111) Calle 19,820,505,581,1906
8043,2020-05-09,(07005) ALQUERIA,250,169,161,580
8044,2020-08-07,(10009) Museo Nacional,108,100,118,326
8045,2020-04-02,(04106) Carrera 47,173,98,97,368
8046,2020-06-03,(06101) El Tiempo,321,193,163,677
8047,2020-10-10,(09003) Socorro,558,232,421,1211
8048,2020-06-06,(04106) Carrera 47,244,112,141,497
8049,2020-08-05,(02201) Prado,676,482,389,1547
8050,2020-05-30,(06002) Normandía,182,90,151,423
8051,2020-01-23,(07200) Tygua-San José,751,444,526,1721
8052,2020-04-02,(07200) Tygua-San José,70,36,71,177
8053,2020-10-11,(02001) Centro Comercial Santa Fe,146,102,223,471
8054,2020-06-17,(12002) CDS - Carrera 32,198,136,76,410
8055,2020-04-22,(02502) Terminal,175,124,124,423
8056,2020-09-03,(07108) Av. El Dorado,160,107,102,369
8057,2020-09-12,(08000) Portal Tunal,269,120,330,719
8058,2020-07-02,(06100) Av. Rojas,244,157,147,548
8059,2020-09-29,(04001) Quirigua,460,281,363,1104
8060,2020-03-20,(09100) Calle 40 Sur,798,472,413,1683
8061,2020-08-20,(07200) Tygua-San José,227,129,150,506
8062,2020-04-29,(06001) Modelia,302,193,167,662
8063,2020-04-07,(09108) Hospital,40,25,38,103
8064,2020-08-11,(07009) SENA,568,345,380,1293
8065,2020-07-02,(14004) Museo del Oro,321,195,236,752
8066,2020-07-18,(07112) COMUNEROS,614,356,348,1318
8067,2020-05-04,(06103) CAN,295,207,124,626
8068,2020-07-12,(07105) MOVISTAR ARENA,53,40,81,174
8069,2020-04-18,(04104) Avenida 68,232,142,93,467
8070,2020-04-27,(04104) Avenida 68,81,125,48,254
8071,2020-07-31,(07108) Av. El Dorado,125,75,76,276
8072,2020-08-30,(09117) Calle 45,228,147,219,594
8073,2020-09-06,(10009) Museo Nacional,104,86,181,371
8074,2020-05-18,(07006) General Santander,404,254,198,856
8075,2020-05-04,(07008) NQS - Calle 30 Sur,166,112,90,368
8076,2020-07-05,(09107) Hortúa,203,118,147,468
8077,2020-08-21,(06100) Av. Rojas,223,130,145,498
8078,2020-08-30,(02204) Pepe Sierra,225,168,199,592
8079,2020-09-20,(02502) Terminal,91,88,193,372
8080,2020-05-10,(04003) Avenida Ciudad de Cali,199,118,128,445
8081,2020-07-17,(07506) DESPENSA,470,258,248,976
8082,2020-10-11,(06000) Portal Eldorado,151,170,391,712
8083,2020-06-14,(09111) Calle 19,192,132,229,553
8084,2020-08-02,(07001) PERDOMO,221,105,182,508
8085,2020-05-18,(07506) DESPENSA,381,206,171,758
8086,2020-01-06,(06102) Salitre El Greco,268,177,202,647
8087,2020-03-13,(03005) SUBA - AV. BOYACA,429,316,354,1099
8088,2020-01-12,(12001) Carrera 43,172,122,253,547
8089,2020-09-22,(03005) SUBA - AV. BOYACA,576,338,430,1344
8090,2020-03-25,(04106) Carrera 47,157,103,98,358
8091,2020-07-26,(07000) Portal Sur,363,190,277,830
8092,2020-03-22,(07006) General Santander,113,46,73,232
8093,2020-07-18,(07007) NQS - Calle 38A Sur,308,194,160,662
8094,2020-03-26,(07200) Tygua-San José,45,42,56,143
8095,2020-01-31,(03014) SAN MARTIN,254,156,158,568
8096,2020-08-02,(40001) Juan Pablo II,131,67,123,321
8097,2020-03-13,(09105) Río Fucha,150,94,111,355
8098,2020-07-30,(06106) Recinto Ferial,225,130,116,471
8099,2020-06-29,(04105) Carrera 53,102,60,60,222
8100,2020-04-15,(09105) Río Fucha,83,44,48,175
8101,2020-04-18,(07101) CASTELLANA,51,45,62,158
8102,2020-05-02,(07101) CASTELLANA,61,48,54,163
8103,2020-07-04,(07101) CASTELLANA,132,72,104,308
8104,2020-08-06,(07101) CASTELLANA,186,99,119,404
8105,2020-06-04,(50002) Corral Calle 40 Sur,21,8,16,45
8106,2020-05-31,(09108) Hospital,28,30,34,92
8107,2020-04-22,(10003) Ciudad Jardín,103,66,48,217
8108,2020-02-16,(07201) Guatoque -Veraguas,98,91,263,452
8109,2020-04-23,(09108) Hospital,42,30,35,107
8110,2020-04-11,(06106) Recinto Ferial,64,46,32,142
8111,2020-09-02,(50006) Corral Carrera 77,7,3,8,18
8112,2020-08-02,(10005) Bicentenario - alimentacion,48,36,81,165
8113,2020-10-11,(12000) Puente Aranda,13,10,30,53
8114,2020-04-02,(03014) SAN MARTIN,14,7,17,38
8115,2020-06-11,(50006) Corral Carrera 77,8,1,11,20
8116,2020-09-27,(50006) Corral Carrera 77,2,1,3,6
8117,2020-03-05,(02502) Terminal,5233,3312,3030,11575
8118,2020-01-23,(09118) Marly,5914,3951,3490,13355
8119,2020-02-25,(09118) Marly,8429,5483,4023,17935
8120,2020-02-13,(07504) TERREROS,18048,10251,9345,37644
8121,2020-08-19,(07504) TERREROS,5687,3108,2629,11424
8122,2020-07-12,(10000) Portal 20 de Julio - alimentacion,1777,701,1222,3700
8123,2020-03-07,(09119) Calle 57,1731,1066,1608,4405
8124,2020-08-11,(09119) Calle 57,544,341,377,1262
8125,2020-08-31,(09119) Calle 57,538,360,363,1261
8126,2020-02-07,(03002) SUBA - TV- 91,4673,2562,2619,9854
8127,2020-03-10,(07505) LEON XIII,386,2203,1402,3991
8128,2020-01-15,(02200) Alcalá,11745,7216,6110,25071
8129,2020-02-17,(02200) Alcalá,15041,9749,6622,31412
8130,2020-03-12,(02200) Alcalá,1972,2420,1572,5964
8131,2020-02-17,(06104) Gobernación,1503,822,651,2976
8132,2020-09-12,(05000) Portal Américas - alimentacion,9232,4485,5851,19568
8133,2020-02-12,(06107) Ciudad Universitaria,1728,1024,934,3686
8134,2020-03-12,(08000) Portal Tunal - alimentacion,905,4999,3258,9162
8135,2020-01-30,(02201) Prado,5684,3600,2873,12157
8136,2020-03-18,(14004) Museo del Oro,1353,955,840,3148
8137,2020-02-06,(05005) Transversal 86,2754,1538,1363,5655
8138,2020-02-24,(09104) Restrepo,5287,3290,3827,12404
8139,2020-08-05,(05100) Banderas P. Central,642,385,461,1488
8140,2020-06-10,(09100) Calle 40 Sur,1658,1010,999,3667
8141,2020-01-22,(40001) Juan Pablo II,1551,867,966,3384
8142,2020-02-04,(02102) Calle 161,2017,1183,1203,4403
8143,2020-09-08,(09000) Cabecera Usme,1810,1112,1426,4348
8144,2020-02-05,(02205) Calle 106,2843,1810,1412,6065
8145,2020-08-01,(07001) PERDOMO,577,277,457,1311
8146,2020-09-28,(40003) Mirador del Paraiso,1802,1018,1312,4132
8147,2020-03-11,(04101) Minuto de Dios,3400,2058,1818,7276
8148,2020-03-12,(04100) Carrera 77,422,1480,1037,2939
8149,2020-01-21,(07505) LEON XIII,6267,3015,2762,12044
8150,2020-06-23,(02204) Pepe Sierra,871,631,502,2004
8151,2020-02-19,(06106) Recinto Ferial,1571,871,839,3281
8152,2020-05-09,(09118) Marly,875,589,404,1868
8153,2020-05-31,(09118) Marly,441,314,299,1054
8154,2020-02-26,(02103) Mazurén,3520,2059,1930,7509
8155,2020-05-05,(07000) Portal Sur - alimentacion,5041,2776,2203,10020
8156,2020-06-05,(07000) Portal Sur - alimentacion,7456,4167,3474,15097
8157,2020-08-20,(09103) Olaya,959,519,500,1978
8158,2020-09-02,(09103) Olaya,1033,635,613,2281
8159,2020-09-18,(09103) Olaya,1160,616,742,2518
8160,2020-08-15,(07000) Portal Sur - alimentacion,6463,3288,3741,13492
8161,2020-07-18,(07106) EL CAMPIN,264,207,148,619
8162,2020-03-25,(07112) COMUNEROS,377,270,224,871
8163,2020-06-17,(02000) Cabecera Autopista Norte,1327,867,758,2952
8164,2020-06-24,(02000) Cabecera Autopista Norte,1386,881,853,3120
8165,2020-09-07,(02000) Cabecera Autopista Norte,1457,936,1053,3446
8166,2020-04-09,(09113) Calle 22,125,76,88,289
8167,2020-07-18,(09113) Calle 22,270,149,260,679
8168,2020-07-17,(09000) Cabecera Usme - alimentacion,5859,3375,3679,12913
8169,2020-02-12,(04105) Carrera 53,1573,847,803,3223
8170,2020-07-30,(08000) Portal Tunal - alimentacion,5931,3370,3334,12635
8171,2020-01-07,(50003) Corral Molinos,2599,1630,2837,7066
8172,2020-04-15,(05000) Portal Américas,1323,878,961,3162
8173,2020-01-19,(02000) Cabecera Autopista Norte - alimentacion,6419,2489,4969,13877
8174,2020-01-08,(04106) Carrera 47,957,514,659,2130
8175,2020-01-28,(05002) Tintal,11319,6283,5630,23232
8176,2020-03-14,(09114) Calle 26,631,565,1002,2198
8177,2020-09-14,(02201) Prado,912,603,682,2197
8178,2020-01-17,(10001) Country Sur,4581,1864,2577,9022
8179,2020-04-14,(10001) Country Sur,539,239,376,1154
8180,2020-04-15,(04002) Carrera 90,384,214,163,761
8181,2020-02-22,(10000) Portal 20 de Julio,5561,2380,3344,11285
8182,2020-01-27,(04001) Quirigua,1889,1160,1130,4179
8183,2020-10-11,(05100) Banderas P. Central - alimentacion,1174,383,974,2531
8184,2020-08-12,(12001) Carrera 43,448,231,230,909
8185,2020-02-22,(09107) Hortúa,1286,812,1179,3277
8186,2020-02-03,(10005) Bicentenario - alimentacion,671,319,559,1549
8187,2020-02-13,(10005) Bicentenario - alimentacion,721,322,477,1520
8188,2020-02-21,(06111) Universidades,5387,3427,2557,11371
8189,2020-02-28,(14004) Museo del Oro,3836,2457,2201,8494
8190,2020-09-30,(03000) Portal Suba,1685,1055,1357,4097
8191,2020-06-03,(02000) Cabecera Autopista Norte - intermunicipal,469,346,328,1143
8192,2020-03-26,(09101) Quiroga,199,115,159,473
8193,2020-04-20,(08000) Portal Tunal - alimentacion,3557,1830,1881,7268
8194,2020-02-22,(10002) Av. Primero de Mayo,4794,2348,3693,10835
8195,2020-06-10,(02303) Calle 85,689,466,317,1472
8196,2020-01-19,(09116) Avenida 39,188,195,427,810
8197,2020-09-23,(09003) Socorro,644,324,420,1388
8198,2020-04-18,(07503) SAN MATEO,3466,2339,1505,7310
8199,2020-07-10,(06108) Concejo de Bogotá,158,68,96,322
8200,2020-01-08,(02300) Calle 100,5281,3374,2937,11592
8201,2020-05-06,(10002) Av. Primero de Mayo,1453,775,815,3043
8202,2020-02-06,(03005) SUBA - AV. BOYACA,2826,1653,1662,6141
8203,2020-04-18,(09107) Hortúa,282,172,133,587
8204,2020-05-14,(09123) Calle 76,766,522,387,1675
8205,2020-09-28,(05101) Mandalay - Cr.73,168,94,93,355
8206,2020-01-24,(05105) Pradera,2279,1400,1180,4859
8207,2020-04-15,(10000) Portal 20 de Julio,1265,635,611,2511
8208,2020-02-09,(03000) Portal Suba,1443,717,1581,3741
8209,2020-05-05,(09001) Molinos,1547,906,1147,3600
8210,2020-07-30,(50002) Corral Calle 40 Sur,24,11,21,56
8211,2020-01-27,(10010) San Bernardo,1747,971,1216,3934
8212,2020-03-30,(05005) Transversal 86,187,108,97,392
8213,2020-10-05,(05005) Transversal 86,528,280,369,1177
8214,2020-07-22,(02000) Cabecera Autopista Norte,1244,765,726,2735
8215,2020-05-20,(05001) Patio Bonito,1420,756,774,2950
8216,2020-03-17,(05105) Pradera,1717,1059,739,3515
8217,2020-07-22,(10008) San Diego,204,120,128,452
8218,2020-04-13,(08000) Portal Tunal,366,165,169,700
8219,2020-07-16,(08000) Portal Tunal,566,202,193,961
8220,2020-07-04,(02205) Calle 106,227,158,209,594
8221,2020-08-28,(09101) Quiroga,472,302,411,1185
8222,2020-10-09,(09118) Marly,1528,1024,1154,3706
8223,2020-03-03,(07000) Portal Sur,7820,4564,4341,16725
8224,2020-02-21,(07201) Guatoque -Veraguas,1017,450,602,2069
8225,2020-07-21,(07106) EL CAMPIN,415,276,197,888
8226,2020-07-17,(03007) HUMEDAL CORDOBA,142,90,63,295
8227,2020-07-27,(10006) San Victorino,646,326,289,1261
8228,2020-08-10,(10006) San Victorino,691,359,334,1384
8229,2020-09-23,(08002) Biblioteca,354,190,230,774
8230,2020-10-09,(08002) Biblioteca,360,177,277,814
8231,2020-07-06,(07000) Portal Sur,1947,1259,1211,4417
8232,2020-04-07,(05100) Banderas P. Central - alimentacion,1502,677,690,2869
8233,2020-08-11,(10005) Bicentenario - alimentacion,205,106,175,486
8234,2020-05-11,(05101) Mandalay - Cr.73,81,49,41,171
8235,2020-09-22,(09109) Tercer Milenio,394,245,270,909
8236,2020-03-10,(03007) HUMEDAL CORDOBA,207,152,133,492
8237,2020-10-12,(07004) VENECIA,357,170,364,891
8238,2020-02-13,(09111) Calle 19,2458,1373,1562,5393
8239,2020-04-07,(07000) Portal Sur - alimentacion,3770,1934,1532,7236
8240,2020-04-01,(04100) Carrera 77,596,335,398,1329
8241,2020-04-30,(04100) Carrera 77,744,401,479,1624
8242,2020-08-07,(02205) Calle 106,89,63,66,218
8243,2020-06-10,(05001) Patio Bonito,1494,795,868,3157
8244,2020-08-18,(07109) CAD,595,372,287,1254
8245,2020-08-29,(09120) Calle 63,912,634,643,2189
8246,2020-04-05,(06100) Av. Rojas,28,25,16,69
8247,2020-09-02,(06000) Portal Eldorado,972,640,607,2219
8248,2020-02-06,(03013) RIO NEGRO,1251,814,896,2961
8249,2020-09-04,(10010) San Bernardo,621,349,528,1498
8250,2020-08-13,(04106) Carrera 47,250,141,164,555
8251,2020-05-29,(02502) Terminal,358,230,287,875
8252,2020-04-25,(09002) Consuelo,175,93,101,369
8253,2020-08-28,(07007) NQS - Calle 38A Sur,402,242,287,931
8254,2020-09-13,(09001) Molinos,890,388,765,2043
8255,2020-07-16,(09123) Calle 76,805,571,462,1838
8256,2020-09-15,(12007) Zona Industrial,370,234,177,781
8257,2020-01-12,(02201) Prado,959,504,978,2441
8258,2020-05-04,(09113) Calle 22,270,179,244,693
8259,2020-06-26,(05105) Pradera,648,406,307,1361
8260,2020-06-07,(09113) Calle 22,220,114,181,515
8261,2020-08-27,(07111) NQS - RICAURTE,1134,658,480,2272
8262,2020-08-22,(07110) PALOQUEMAO,440,322,268,1030
8263,2020-01-04,(14005) Las Aguas,370,252,538,1160
8264,2020-04-09,(03012) SUBA - CALLE 95,67,42,43,152
8265,2020-08-13,(09122) Calle 72,1043,726,716,2485
8266,2020-06-28,(10000) Portal 20 de Julio - alimentacion,1531,602,1028,3161
8267,2020-05-19,(06104) Gobernación,216,143,97,456
8268,2020-03-05,(07006) General Santander - alimentacion,1483,841,1027,3351
8269,2020-08-20,(09114) Calle 26,300,175,202,677
8270,2020-05-09,(03000) Portal Suba,538,311,350,1199
8271,2020-07-24,(07003) SEVILLANA,356,218,187,761
8272,2020-07-05,(09118) Marly,482,325,378,1185
8273,2020-06-29,(06109) Centro Memoria,87,50,72,209
8274,2020-03-08,(09119) Calle 57,597,345,757,1699
8275,2020-08-10,(40001) Juan Pablo II,506,316,312,1134
8276,2020-08-17,(08000) Portal Tunal,258,135,142,535
8277,2020-04-18,(04000) Cabecera Calle 80,367,239,222,828
8278,2020-03-12,(06106) Recinto Ferial,465,145,175,785
8279,2020-01-25,(05005) Transversal 86,1329,502,896,2727
8280,2020-04-01,(10000) Portal 20 de Julio,1160,569,593,2322
8281,2020-01-12,(10005) Bicentenario - alimentacion,147,80,248,475
8282,2020-03-12,(10005) Bicentenario - alimentacion,62,86,111,259
8283,2020-07-17,(10007) Las Nieves,386,232,254,872
8284,2020-05-09,(07007) NQS - Calle 38A Sur,185,117,122,424
8285,2020-01-26,(12000) Puente Aranda,34,26,57,117
8286,2020-06-01,(12000) Puente Aranda,80,43,42,165
8287,2020-06-27,(02102) Calle 161,190,130,147,467
8288,2020-05-27,(07107) U. NACIONAL,297,166,141,604
8289,2020-07-11,(06106) Recinto Ferial,201,119,123,443
8290,2020-10-02,(07101) CASTELLANA,281,163,173,617
8291,2020-05-21,(07102) NQS - CALLE 75,354,223,175,752
8292,2020-09-26,(08001) Parque el Tunal,454,203,369,1026
8293,2020-07-26,(04001) Quirigua,107,60,79,246
8294,2020-07-08,(03010) PUENTE LARGO,363,241,221,825
8295,2020-06-30,(07009) SENA,671,431,428,1530
8296,2020-08-06,(02502) Terminal,351,247,327,925
8297,2020-07-19,(06106) Recinto Ferial,77,38,46,161
8298,2020-06-02,(04102) Avenida Boyaca,278,182,177,637
8299,2020-01-13,(12002) CDS - Carrera 32,459,305,289,1053
8300,2020-04-20,(12002) CDS - Carrera 32,192,123,51,366
8301,2020-05-19,(12002) CDS - Carrera 32,193,139,84,416
8302,2020-08-31,(12002) CDS - Carrera 32,205,110,87,402
8303,2020-08-27,(04000) Cabecera Calle 80 - intermunicipal,358,164,310,832
8304,2020-07-13,(04102) Avenida Boyaca,329,176,191,696
8305,2020-03-20,(07001) PERDOMO,451,288,218,957
8306,2020-08-26,(07108) Av. El Dorado,131,85,75,291
8307,2020-08-04,(06001) Modelia,297,203,186,686
8308,2020-02-04,(09108) Hospital,255,156,201,612
8309,2020-06-16,(09108) Hospital,78,43,57,178
8310,2020-08-14,(07006) General Santander - alimentacion,367,209,267,843
8311,2020-08-24,(05105) Pradera,488,283,214,985
8312,2020-06-20,(09114) Calle 26,151,135,194,480
8313,2020-01-15,(03004) GRATAMIRA,245,114,133,492
8314,2020-02-02,(03004) GRATAMIRA,52,38,61,151
8315,2020-10-12,(03009) Av. Suba- Calle 116,143,98,151,392
8316,2020-03-10,(07006) General Santander,241,711,536,1488
8317,2020-05-01,(07112) COMUNEROS,227,137,111,475
8318,2020-08-08,(04106) Carrera 47,162,94,121,377
8319,2020-10-03,(06109) Centro Memoria,202,148,207,557
8320,2020-06-13,(07010) Bosa,584,287,330,1201
8321,2020-04-07,(06001) Modelia,213,167,145,525
8322,2020-09-19,(07107) U. NACIONAL,275,223,285,783
8323,2020-05-16,(12007) Zona Industrial,170,116,94,380
8324,2020-06-19,(10005) Bicentenario - alimentacion,235,104,194,533
8325,2020-05-05,(06101) El Tiempo,239,155,116,510
8326,2020-03-27,(09114) Calle 26,162,142,123,427
8327,2020-09-15,(07113) SANTA ISABEL,434,238,342,1014
8328,2020-05-30,(14004) Museo del Oro,0,54,143,197
8329,2020-02-02,(12002) CDS - Carrera 32,47,77,88,212
8330,2020-05-10,(03001) LA CAMPIÑA,176,113,110,399
8331,2020-07-06,(09106) Nariño,420,258,334,1012
8332,2020-04-03,(04106) Carrera 47,194,107,98,399
8333,2020-09-06,(03002) SUBA - TV- 91,272,138,297,707
8334,2020-05-27,(07506) DESPENSA,442,226,251,919
8335,2020-04-28,(09114) Calle 26,159,127,120,406
8336,2020-04-26,(04000) Cabecera Calle 80,158,117,146,421
8337,2020-07-26,(09122) Calle 72,278,183,234,695
8338,2020-05-14,(09114) Calle 26,224,175,149,548
8339,2020-10-02,(05102) Av. Américas - Av. Boyacá,294,191,265,750
8340,2020-05-02,(06100) Av. Rojas,55,36,37,128
8341,2020-06-07,(02105) Calle 142,172,151,161,484
8342,2020-04-27,(02304) Heroes,65,253,111,429
8343,2020-06-23,(07201) Guatoque -Veraguas,216,111,139,466
8344,2020-06-29,(09114) Calle 26,67,48,76,191
8345,2020-07-29,(05103) Marsella,314,182,182,678
8346,2020-09-17,(05103) Marsella,507,278,337,1122
8347,2020-04-13,(12003) Ricaurte,117,110,73,300
8348,2020-04-08,(09106) Nariño,184,99,146,429
8349,2020-08-20,(07108) Av. El Dorado,130,71,92,293
8350,2020-04-02,(10003) Ciudad Jardín,73,50,68,191
8351,2020-05-17,(09105) Río Fucha,28,18,41,87
8352,2020-10-11,(05102) Av. Américas - Av. Boyacá,78,35,74,187
8353,2020-05-16,(06106) Recinto Ferial,141,92,85,318
8354,2020-03-26,(06105) Quinta Paredes,62,49,44,155
8355,2020-08-23,(06107) Ciudad Universitaria,47,31,43,121
8356,2020-10-03,(50002) Corral Calle 40 Sur,19,9,32,60
8357,2020-04-10,(12002) CDS - Carrera 32,31,34,17,82
8358,2020-04-16,(07113) SANTA ISABEL,204,128,123,455
8359,2020-05-20,(50002) Corral Calle 40 Sur,18,9,11,38
8360,2020-05-21,(04000) Cabecera Calle 80 - alimentacion,3156,1824,1821,6801
8361,2020-08-21,(04000) Cabecera Calle 80 - alimentacion,3774,2014,2569,8357
8362,2020-02-27,(09118) Marly,8253,5304,4036,17593
8363,2020-04-17,(09118) Marly,1020,704,474,2198
8364,2020-09-25,(09118) Marly,1569,1069,1046,3684
8365,2020-04-14,(07504) TERREROS,2370,1509,1248,5127
8366,2020-07-15,(07504) TERREROS,5544,3087,2350,10981
8367,2020-03-07,(07111) NQS - RICAURTE,2091,1510,1478,5079
8368,2020-01-09,(03000) Portal Suba - alimentacion,19989,11116,11989,43094
8369,2020-02-07,(03000) Portal Suba - alimentacion,29532,16428,17015,62975
8370,2020-02-06,(02101) Toberín,15035,9645,7851,32531
8371,2020-01-15,(09122) Calle 72,5466,3682,3583,12731
8372,2020-07-10,(04002) Carrera 90,823,446,462,1731
8373,2020-02-01,(09003) Socorro,1272,589,865,2726
8374,2020-10-07,(06107) Ciudad Universitaria,194,129,167,490
8375,2020-03-10,(04103) Las Ferias,343,290,216,849
8376,2020-03-12,(07000) Portal Sur - alimentacion,896,6773,4242,11911
8377,2020-01-03,(09000) Cabecera Usme - alimentacion,15080,7513,10607,33200
8378,2020-09-29,(09104) Restrepo,1683,1031,1546,4260
8379,2020-01-01,(10001) Country Sur,337,138,470,945
8380,2020-03-18,(10001) Country Sur,2744,1147,1515,5406
8381,2020-06-10,(09115) Calle 34,647,403,334,1384
8382,2020-02-13,(06102) Salitre El Greco,1617,898,681,3196
8383,2020-03-02,(07002) MADELENA,5003,2897,2578,10478
8384,2020-02-25,(05100) Banderas P. Central,8449,5040,3789,17278
8385,2020-06-12,(09109) Tercer Milenio,366,218,230,814
8386,2020-03-16,(04100) Carrera 77,4249,2549,2666,9464
8387,2020-03-16,(04104) Avenida 68,2389,1267,1228,4884
8388,2020-02-29,(02000) Cabecera Autopista Norte - alimentacion,14833,6910,10087,31830
8389,2020-03-16,(07102) NQS - CALLE 75,1260,821,684,2765
8390,2020-05-17,(03013) RIO NEGRO,52,38,54,144
8391,2020-08-28,(02103) Mazurén,232,142,177,551
8392,2020-02-29,(09103) Olaya,2655,1267,1854,5776
8393,2020-03-17,(09103) Olaya,2542,1467,1485,5494
8394,2020-03-07,(14001) La Sabana,325,266,317,908
8395,2020-10-01,(14001) La Sabana,174,96,138,408
8396,2020-10-08,(02000) Cabecera Autopista Norte - alimentacion,5348,2769,3881,11998
8397,2020-07-08,(08000) Portal Tunal - alimentacion,6512,3789,3575,13876
8398,2020-10-10,(08000) Portal Tunal - alimentacion,5429,2634,4372,12435
8399,2020-03-09,(07002) MADELENA,187,1442,895,2524
8400,2020-02-04,(07112) COMUNEROS,3867,2313,2342,8522
8401,2020-10-06,(02000) Cabecera Autopista Norte,1704,1042,1411,4157
8402,2020-01-08,(10007) Las Nieves,1471,947,958,3376
8403,2020-01-13,(04105) Carrera 53,1103,613,654,2370
8404,2020-07-17,(09001) Molinos,1856,1031,1267,4154
8405,2020-08-28,(08000) Portal Tunal - alimentacion,6289,3496,3731,13516
8406,2020-02-20,(05002) Tintal,11163,6499,5722,23384
8407,2020-03-09,(05002) Tintal,284,3267,2118,5669
8408,2020-02-09,(02201) Prado,1066,568,1089,2723
8409,2020-04-21,(04002) Carrera 90,380,204,192,776
8410,2020-01-15,(04100) Carrera 77,5511,3116,3618,12245
8411,2020-01-02,(06109) Centro Memoria,471,286,352,1109
8412,2020-04-14,(40003) Mirador del Paraiso,721,430,524,1675
8413,2020-08-26,(12001) Carrera 43,412,212,214,838
8414,2020-01-05,(10005) Bicentenario - alimentacion,98,60,170,328
8415,2020-09-17,(05001) Patio Bonito,2207,1175,1308,4690
8416,2020-01-09,(07106) EL CAMPIN,1446,944,895,3285
8417,2020-08-15,(03000) Portal Suba,938,544,743,2225
8418,2020-01-06,(09101) Quiroga,410,152,397,959
8419,2020-02-03,(09101) Quiroga,1574,974,1285,3833
8420,2020-01-06,(08001) Parque el Tunal,299,130,253,682
8421,2020-01-14,(08001) Parque el Tunal,1456,792,916,3164
8422,2020-01-28,(03007) HUMEDAL CORDOBA,1028,673,523,2224
8423,2020-02-04,(04108) El Polo,2013,1231,1177,4421
8424,2020-08-27,(10000) Portal 20 de Julio,2165,1089,1063,4317
8425,2020-06-21,(07000) Portal Sur - alimentacion,2509,1193,1294,4996
8426,2020-06-27,(02303) Calle 85,458,343,342,1143
8427,2020-05-17,(08002) Biblioteca,87,42,40,169
8428,2020-02-18,(06102) Salitre El Greco,1605,935,757,3297
8429,2020-08-16,(07504) TERREROS,1572,755,967,3294
8430,2020-09-01,(09003) Socorro,563,307,365,1235
8431,2020-04-14,(07503) SAN MATEO,5370,3408,2323,11101
8432,2020-01-26,(03000) Portal Suba,1427,701,1562,3690
8433,2020-02-12,(05102) Av. Américas - Av. Boyacá,2076,1236,978,4290
8434,2020-01-06,(02101) Toberín,1359,665,1458,3482
8435,2020-08-06,(02101) Toberín,1174,737,884,2795
8436,2020-08-22,(08000) Portal Tunal - alimentacion,4649,2407,2819,9875
8437,2020-04-11,(02201) Prado,280,184,160,624
8438,2020-04-15,(09107) Hortúa,448,287,216,951
8439,2020-05-02,(09107) Hortúa,278,180,171,629
8440,2020-05-09,(09107) Hortúa,291,208,180,679
8441,2020-07-28,(09107) Hortúa,526,336,365,1227
8442,2020-09-15,(09123) Calle 76,1051,710,721,2482
8443,2020-02-04,(05101) Mandalay - Cr.73,1253,693,551,2497
8444,2020-04-30,(40003) Mirador del Paraiso,1051,605,706,2362
8445,2020-05-11,(40003) Mirador del Paraiso,1218,761,805,2784
8446,2020-04-24,(05002) Tintal,1414,749,711,2874
8447,2020-03-14,(07005) ALQUERIA,1465,766,941,3172
8448,2020-09-26,(10000) Portal 20 de Julio,2017,925,1456,4398
8449,2020-02-28,(50002) Corral Calle 40 Sur,134,83,153,370
8450,2020-09-07,(50002) Corral Calle 40 Sur,25,15,27,67
8451,2020-02-29,(05107) Américas - Cr.53,1301,850,1114,3265
8452,2020-02-03,(05101) Mandalay - Cr.73,1234,666,592,2492
8453,2020-03-15,(07104) Simon Bolivar,288,193,392,873
8454,2020-06-25,(02202) Calle 127,1212,863,600,2675
8455,2020-08-01,(05105) Pradera,328,234,229,791
8456,2020-01-17,(06109) Centro Memoria,904,558,641,2103
8457,2020-06-03,(07007) NQS - Calle 38A Sur,345,219,215,779
8458,2020-09-15,(07007) NQS - Calle 38A Sur,382,261,321,964
8459,2020-01-09,(09121) Las Flores,2420,1463,1492,5375
8460,2020-02-13,(09121) Las Flores,3482,2206,2050,7738
8461,2020-02-26,(03006) NIZA - CALLE 127,2421,1575,1473,5469
8462,2020-07-07,(04003) Avenida Ciudad de Cali,1134,629,736,2499
8463,2020-02-28,(09101) Quiroga,1664,1008,1252,3924
8464,2020-06-25,(09101) Quiroga,608,303,402,1313
8465,2020-01-22,(07201) Guatoque -Veraguas,938,475,588,2001
8466,2020-08-24,(06000) Portal Eldorado - alimentacion,3540,1700,1753,6993
8467,2020-07-22,(07106) EL CAMPIN,392,244,202,838
8468,2020-07-06,(03003) 21 ANGELES,368,186,210,764
8469,2020-01-11,(14004) Museo del Oro,384,430,746,1560
8470,2020-02-16,(04102) Avenida Boyaca,619,348,555,1522
8471,2020-02-21,(02104) Calle 146,9163,4969,4908,19040
8472,2020-09-01,(10006) San Victorino,583,280,340,1203
8473,2020-04-03,(07110) PALOQUEMAO,332,232,189,753
8474,2020-05-15,(09100) Calle 40 Sur,1323,792,814,2929
8475,2020-07-20,(09100) Calle 40 Sur,469,259,318,1046
8476,2020-05-22,(07104) Simon Bolivar,539,360,228,1127
8477,2020-07-09,(07104) Simon Bolivar,611,355,291,1257
8478,2020-07-03,(04107) Escuela Militar,147,105,116,368
8479,2020-08-11,(02304) Heroes,815,561,434,1810
8480,2020-04-29,(05103) Marsella,236,122,122,480
8481,2020-07-02,(05001) Patio Bonito,0,808,2141,2949
8482,2020-09-12,(07004) VENECIA,880,463,604,1947
8483,2020-08-14,(02104) Calle 146,693,413,514,1620
8484,2020-04-25,(09000) Cabecera Usme - alimentacion,3654,1943,1977,7574
8485,2020-02-25,(03003) 21 ANGELES,1815,964,892,3671
8486,2020-03-30,(07505) LEON XIII,1220,672,610,2502
8487,2020-09-16,(09121) Las Flores,758,475,507,1740
8488,2020-05-03,(09001) Molinos,518,281,344,1143
8489,2020-08-29,(07101) CASTELLANA,138,78,110,326
8490,2020-04-03,(05001) Patio Bonito,866,449,534,1849
8491,2020-06-28,(09002) Consuelo,148,70,98,316
8492,2020-05-04,(06100) Av. Rojas,135,83,77,295
8493,2020-05-26,(06000) Portal Eldorado,982,654,455,2091
8494,2020-03-26,(02302) Virrey,344,280,186,810
8495,2020-06-10,(07009) SENA,620,378,349,1347
8496,2020-05-08,(12003) Ricaurte,251,189,134,574
8497,2020-09-29,(12003) Ricaurte,460,292,242,994
8498,2020-01-31,(03013) RIO NEGRO,1177,733,878,2788
8499,2020-09-11,(03013) RIO NEGRO,288,161,199,648
8500,2020-08-11,(10010) San Bernardo,613,319,402,1334
8501,2020-08-26,(07106) EL CAMPIN,348,206,213,767
8502,2020-04-25,(02105) Calle 142,323,203,169,695
8503,2020-07-14,(05002) Tintal,2026,1181,1189,4396
8504,2020-05-02,(09002) Consuelo,214,98,131,443
8505,2020-03-30,(10010) San Bernardo,342,244,273,859
8506,2020-05-03,(09000) Cabecera Usme - alimentacion,1707,911,942,3560
8507,2020-07-31,(07103) AV. CHILE,636,419,365,1420
8508,2020-09-02,(12007) Zona Industrial,427,245,181,853
8509,2020-10-01,(09100) Calle 40 Sur,1908,1095,1530,4533
8510,2020-01-12,(40002) Manitas,321,136,297,754
8511,2020-05-31,(06108) Concejo de Bogotá,36,32,27,95
8512,2020-07-04,(02102) Calle 161,193,110,137,440
8513,2020-01-12,(07001) PERDOMO,874,377,812,2063
8514,2020-02-27,(40001) Juan Pablo II,1661,961,966,3588
8515,2020-09-21,(10010) San Bernardo,455,232,367,1054
8516,2020-05-30,(09003) Socorro,442,227,283,952
8517,2020-03-17,(06105) Quinta Paredes,466,271,254,991
8518,2020-07-09,(07111) NQS - RICAURTE,1217,741,462,2420
8519,2020-08-28,(07111) NQS - RICAURTE,1137,677,534,2348
8520,2020-06-26,(03006) NIZA - CALLE 127,568,280,294,1142
8521,2020-04-09,(02204) Pepe Sierra,192,165,104,461
8522,2020-08-14,(03013) RIO NEGRO,241,138,184,563
8523,2020-05-13,(07000) Portal Sur,1383,888,746,3017
8524,2020-02-23,(07110) PALOQUEMAO,380,302,389,1071
8525,2020-04-07,(04000) Cabecera Calle 80,488,321,343,1152
8526,2020-09-10,(50003) Corral Molinos,1456,708,1072,3236
8527,2020-06-05,(02302) Virrey,648,425,301,1374
8528,2020-07-07,(07201) Guatoque -Veraguas,199,101,126,426
8529,2020-08-25,(07201) Guatoque -Veraguas,197,86,161,444
8530,2020-09-17,(12001) Carrera 43,504,271,311,1086
8531,2020-06-04,(09115) Calle 34,626,398,397,1421
8532,2020-06-25,(03003) 21 ANGELES,346,171,172,689
8533,2020-08-22,(03003) 21 ANGELES,237,103,131,471
8534,2020-09-13,(10007) Las Nieves,79,115,192,386
8535,2020-04-21,(06102) Salitre El Greco,130,81,92,303
8536,2020-06-30,(03011) SUBA - CALLE 100,561,290,282,1133
8537,2020-05-05,(40002) Manitas,213,135,149,497
8538,2020-03-23,(03002) SUBA - TV- 91,176,90,89,355
8539,2020-03-31,(03002) SUBA - TV- 91,416,250,243,909
8540,2020-04-12,(10007) Las Nieves,41,41,51,133
8541,2020-09-13,(14005) Las Aguas,39,41,131,211
8542,2020-08-07,(12000) Puente Aranda,17,14,18,49
8543,2020-06-01,(05100) Banderas P. Central,439,263,345,1047
8544,2020-03-25,(03005) SUBA - AV. BOYACA,218,168,140,526
8545,2020-07-27,(09121) Las Flores,654,416,397,1467
8546,2020-04-02,(12004) Carrera 22,44,30,43,117
8547,2020-07-22,(12004) Carrera 22,136,80,122,338
8548,2020-05-28,(09111) Calle 19,472,408,460,1340
8549,2020-05-21,(10009) Museo Nacional,418,270,227,915
8550,2020-09-20,(10009) Museo Nacional,113,107,191,411
8551,2020-06-23,(04106) Carrera 47,342,169,187,698
8552,2020-04-09,(09107) Hortúa,197,137,97,431
8553,2020-10-06,(04106) Carrera 47,362,178,254,794
8554,2020-01-26,(06109) Centro Memoria,207,123,265,595
8555,2020-10-05,(07008) NQS - Calle 30 Sur,360,203,318,881
8556,2020-04-15,(03012) SUBA - CALLE 95,188,122,103,413
8557,2020-09-07,(07103) AV. CHILE,1018,611,525,2154
8558,2020-04-28,(07003) SEVILLANA,245,143,112,500
8559,2020-06-04,(12003) Ricaurte,325,222,167,714
8560,2020-06-27,(07008) NQS - Calle 30 Sur,278,132,162,572
8561,2020-06-03,(12002) CDS - Carrera 32,182,129,69,380
8562,2020-06-26,(12002) CDS - Carrera 32,188,143,94,425
8563,2020-09-30,(12002) CDS - Carrera 32,198,132,119,449
8564,2020-04-17,(40001) Juan Pablo II,272,154,182,608
8565,2020-06-19,(04000) Cabecera Calle 80 - intermunicipal,311,196,298,805
8566,2020-05-04,(07108) Av. El Dorado,84,53,56,193
8567,2020-04-21,(06100) Av. Rojas,110,72,86,268
8568,2020-04-30,(07113) SANTA ISABEL,241,152,149,542
8569,2020-03-01,(07107) U. NACIONAL,256,205,481,942
8570,2020-10-04,(07107) U. NACIONAL,122,97,151,370
8571,2020-01-03,(03004) GRATAMIRA,96,52,58,206
8572,2020-04-20,(07006) General Santander,281,182,141,604
8573,2020-06-04,(03002) SUBA - TV- 91,645,412,450,1507
8574,2020-07-14,(07006) General Santander,486,325,269,1080
8575,2020-08-25,(07008) NQS - Calle 30 Sur,294,157,197,648
8576,2020-03-26,(06001) Modelia,279,190,167,636
8577,2020-05-23,(04003) Avenida Ciudad de Cali,604,348,394,1346
8578,2020-10-05,(06105) Quinta Paredes,168,111,111,390
8579,2020-03-09,(07108) Av. El Dorado,366,84,160,610
8580,2020-05-19,(07108) Av. El Dorado,113,75,68,256
8581,2020-05-31,(04001) Quirigua,113,66,67,246
8582,2020-01-19,(03004) GRATAMIRA,66,37,57,160
8583,2020-06-30,(06103) CAN,395,257,186,838
8584,2020-04-17,(06101) El Tiempo,205,146,125,476
8585,2020-05-21,(14005) Las Aguas,0,58,153,211
8586,2020-08-02,(07106) EL CAMPIN,100,69,74,243
8587,2020-08-28,(03004) GRATAMIRA,0,15,34,49
8588,2020-06-19,(14005) Las Aguas,146,103,206,455
8589,2020-05-10,(05107) Américas - Cr.53,75,64,57,196
8590,2020-03-23,(03003) 21 ANGELES,69,34,42,145
8591,2020-05-03,(10005) Bicentenario - alimentacion,37,20,59,116
8592,2020-07-17,(09105) Río Fucha,96,37,57,190
8593,2020-04-08,(05103) Marsella,185,95,96,376
8594,2020-09-17,(06107) Ciudad Universitaria,217,122,145,484
8595,2020-05-10,(12001) Carrera 43,42,36,45,123
8596,2020-06-07,(03011) SUBA - CALLE 100,131,68,71,270
8597,2020-04-12,(07105) MOVISTAR ARENA,44,33,29,106
8598,2020-04-14,(07003) SEVILLANA,218,132,104,454
8599,2020-04-15,(06105) Quinta Paredes,70,50,46,166
8600,2020-07-24,(09105) Río Fucha,81,40,66,187
8601,2020-09-19,(12000) Puente Aranda,64,37,57,158
8602,2020-04-05,(04101) Minuto de Dios,50,37,44,131
8603,2020-05-23,(03010) PUENTE LARGO,206,134,114,454
8604,2020-08-15,(03014) SAN MARTIN,0,12,40,52
8605,2020-06-26,(50002) Corral Calle 40 Sur,25,14,18,57
8606,2020-09-03,(03014) SAN MARTIN,0,20,35,55
8607,2020-02-17,(04000) Cabecera Calle 80 - alimentacion,24172,15264,14721,54157
8608,2020-06-20,(04000) Cabecera Calle 80 - alimentacion,3034,1611,2078,6723
8609,2020-06-11,(09002) Consuelo,475,229,256,960
8610,2020-07-25,(09118) Marly,942,609,486,2037
8611,2020-09-10,(07504) TERREROS,0,2049,4974,7023
8612,2020-07-23,(09119) Calle 57,422,275,281,978
8613,2020-01-07,(03000) Portal Suba - alimentacion,18782,10395,11970,41147
8614,2020-03-31,(03000) Portal Suba - alimentacion,3211,1688,1674,6573
8615,2020-03-14,(05000) Portal Américas - alimentacion,22461,11380,14097,47938
8616,2020-02-17,(03002) SUBA - TV- 91,4596,2856,2337,9789
8617,2020-08-11,(07503) SAN MATEO,10818,5909,5156,21883
8618,2020-03-10,(07003) SEVILLANA,193,519,433,1145
8619,2020-02-22,(10000) Portal 20 de Julio - alimentacion,8697,3794,5964,18455
8620,2020-06-23,(04103) Las Ferias,391,233,191,815
8621,2020-02-05,(07000) Portal Sur - alimentacion,29510,17091,14826,61427
8622,2020-02-20,(05005) Transversal 86,2757,1564,1254,5575
8623,2020-09-15,(07112) COMUNEROS,869,489,575,1933
8624,2020-09-02,(07503) SAN MATEO,12292,6987,6055,25334
8625,2020-02-13,(07002) MADELENA,5287,2828,2637,10752
8626,2020-10-01,(09104) Restrepo,1705,988,1649,4342
8627,2020-07-12,(10001) Country Sur,435,192,371,998
8628,2020-07-04,(09000) Cabecera Usme,1455,834,1202,3491
8629,2020-02-27,(09115) Calle 34,4599,2927,2553,10079
8630,2020-03-01,(07000) Portal Sur - alimentacion,7560,3142,5411,16113
8631,2020-03-12,(02204) Pepe Sierra,1648,393,465,2506
8632,2020-07-06,(07001) PERDOMO,976,553,583,2112
8633,2020-01-03,(05001) Patio Bonito,3435,1891,2291,7617
8634,2020-02-24,(06106) Recinto Ferial,1518,922,771,3211
8635,2020-03-14,(07102) NQS - CALLE 75,755,583,734,2072
8636,2020-06-13,(03013) RIO NEGRO,187,113,137,437
8637,2020-06-06,(07110) PALOQUEMAO,432,260,208,900
8638,2020-03-06,(03001) LA CAMPIÑA,6507,3622,4244,14373
8639,2020-10-07,(07000) Portal Sur - alimentacion,9366,4983,6023,20372
8640,2020-04-17,(14001) La Sabana,85,58,59,202
8641,2020-06-16,(07002) MADELENA,828,478,456,1762
8642,2020-09-03,(02000) Cabecera Autopista Norte,1507,904,942,3353
8643,2020-02-25,(07107) U. NACIONAL,2253,1404,1219,4876
8644,2020-02-23,(02201) Prado,975,545,991,2511
8645,2020-03-01,(02204) Pepe Sierra,625,457,833,1915
8646,2020-01-08,(09004) Santa Lucía,5448,2858,3544,11850
8647,2020-01-22,(02104) Calle 146,8785,5491,4841,19117
8648,2020-01-12,(05000) Portal Américas,2412,1065,2414,5891
8649,2020-04-17,(05000) Portal Américas,1316,972,1041,3329
8650,2020-10-04,(05000) Portal Américas,987,485,1145,2617
8651,2020-05-06,(04000) Cabecera Calle 80,711,447,410,1568
8652,2020-10-05,(07010) Bosa,0,376,968,1344
8653,2020-03-04,(10000) Portal 20 de Julio,9066,4181,3807,17054
8654,2020-01-02,(04001) Quirigua,813,468,629,1910
8655,2020-08-03,(12001) Carrera 43,375,203,193,771
8656,2020-06-23,(10002) Av. Primero de Mayo,2295,1263,1352,4910
8657,2020-08-01,(10002) Av. Primero de Mayo,1489,725,1004,3218
8658,2020-08-04,(10002) Av. Primero de Mayo,2031,1059,1213,4303
8659,2020-08-31,(05001) Patio Bonito,1873,990,1041,3904
8660,2020-01-04,(09110) Avenida Jimenez,1695,1179,1319,4193
8661,2020-04-01,(03000) Portal Suba,570,354,388,1312
8662,2020-09-04,(03000) Portal Suba,1515,910,1121,3546
8663,2020-02-27,(09101) Quiroga,1614,1015,1221,3850
8664,2020-09-08,(09101) Quiroga,573,280,416,1269
8665,2020-06-15,(10000) Portal 20 de Julio,747,358,444,1549
8666,2020-06-29,(10000) Portal 20 de Julio,870,376,512,1758
8667,2020-08-19,(10000) Portal 20 de Julio,1993,986,1077,4056
8668,2020-01-12,(07000) Portal Sur,1382,634,1359,3375
8669,2020-08-07,(09004) Santa Lucía,1151,499,650,2300
8670,2020-03-07,(07008) NQS - Calle 30 Sur,1122,481,880,2483
8671,2020-02-12,(02300) Calle 100,7417,4694,3872,15983
8672,2020-07-09,(09116) Avenida 39,384,235,230,849
8673,2020-01-09,(07008) NQS - Calle 30 Sur,1339,731,803,2873
8674,2020-02-16,(02101) Toberín,1817,870,2231,4918
8675,2020-02-24,(06108) Concejo de Bogotá,899,430,427,1756
8676,2020-07-21,(09000) Cabecera Usme - alimentacion,6271,3557,3673,13501
8677,2020-03-27,(02101) Toberín,574,436,391,1401
8678,2020-03-12,(02201) Prado,927,1005,737,2669
8679,2020-09-07,(07001) PERDOMO,915,561,649,2125
8680,2020-06-14,(09107) Hortúa,191,121,152,464
8681,2020-05-11,(10000) Portal 20 de Julio,1722,847,823,3392
8682,2020-09-23,(03012) SUBA - CALLE 95,379,232,239,850
8683,2020-01-18,(09001) Molinos,5156,2394,4109,11659
8684,2020-06-20,(05005) Transversal 86,316,142,179,637
8685,2020-09-13,(05005) Transversal 86,140,48,151,339
8686,2020-06-12,(02202) Calle 127,1144,770,565,2479
8687,2020-01-28,(06109) Centro Memoria,1087,623,602,2312
8688,2020-04-20,(02205) Calle 106,195,138,116,449
8689,2020-03-21,(10002) Av. Primero de Mayo,731,358,376,1465
8690,2020-03-14,(04003) Avenida Ciudad de Cali,2715,1318,2232,6265
8691,2020-09-11,(04003) Avenida Ciudad de Cali,1004,583,763,2350
8692,2020-03-11,(07000) Portal Sur,7504,4355,4173,16032
8693,2020-01-27,(12007) Zona Industrial,1268,743,606,2617
8694,2020-08-06,(07106) EL CAMPIN,347,222,212,781
8695,2020-09-12,(07106) EL CAMPIN,353,250,246,849
8696,2020-03-01,(07113) SANTA ISABEL,474,252,579,1305
8697,2020-09-26,(04100) Carrera 77,1052,539,1026,2617
8698,2020-05-07,(03011) SUBA - CALLE 100,316,169,159,644
8699,2020-02-08,(03005) SUBA - AV. BOYACA,1446,801,1094,3341
8700,2020-01-02,(06101) El Tiempo,1164,663,699,2526
8701,2020-04-09,(09100) Calle 40 Sur,344,202,199,745
8702,2020-08-15,(09100) Calle 40 Sur,1416,753,1014,3183
8703,2020-09-01,(07104) Simon Bolivar,617,383,319,1319
8704,2020-03-29,(05000) Portal Américas,429,295,290,1014
8705,2020-01-10,(07109) CAD,2141,1275,1210,4626
8706,2020-05-16,(10010) San Bernardo,409,188,291,888
8707,2020-04-18,(02000) Cabecera Autopista Norte - alimentacion,2081,1173,857,4111
8708,2020-06-09,(05103) Marsella,314,161,188,663
8709,2020-04-22,(09118) Marly,1026,738,453,2217
8710,2020-01-13,(09117) Calle 45,2905,2143,2237,7285
8711,2020-03-09,(02300) Calle 100,3202,395,758,4355
8712,2020-07-03,(06002) Normandía,341,203,201,745
8713,2020-07-07,(02204) Pepe Sierra,870,583,450,1903
8714,2020-04-12,(02205) Calle 106,63,52,40,155
8715,2020-01-31,(06000) Portal Eldorado,6046,3607,2965,12618
8716,2020-04-12,(05000) Portal Américas - alimentacion,2299,1151,948,4398
8717,2020-04-29,(07109) CAD,456,296,227,979
8718,2020-06-18,(02302) Virrey,683,463,360,1506
8719,2020-06-08,(09104) Restrepo,1431,881,976,3288
8720,2020-10-08,(03010) PUENTE LARGO,427,276,337,1040
8721,2020-08-03,(10010) San Bernardo,569,304,419,1292
8722,2020-07-04,(09123) Calle 76,701,536,624,1861
8723,2020-07-22,(09123) Calle 76,817,568,518,1903
8724,2020-04-03,(06108) Concejo de Bogotá,91,71,63,225
8725,2020-07-15,(02102) Calle 161,211,121,131,463
8726,2020-02-08,(06105) Quinta Paredes,448,256,348,1052
8727,2020-08-01,(06002) Normandía,172,103,135,410
8728,2020-10-10,(09122) Calle 72,900,682,1033,2615
8729,2020-07-22,(08002) Biblioteca,227,136,152,515
8730,2020-07-22,(03012) SUBA - CALLE 95,308,188,201,697
8731,2020-06-05,(10009) Museo Nacional,471,302,268,1041
8732,2020-10-02,(07000) Portal Sur,2445,1342,1784,5571
8733,2020-04-17,(07003) SEVILLANA,219,118,125,462
8734,2020-01-01,(06106) Recinto Ferial,98,66,165,329
8735,2019-12-31,(03006) NIZA - CALLE 127,60,6,23,89
8736,2020-05-30,(03006) NIZA - CALLE 127,302,188,144,634
8737,2020-05-11,(10001) Country Sur,842,402,512,1756
8738,2020-07-26,(10002) Av. Primero de Mayo,487,198,367,1052
8739,2020-03-23,(07110) PALOQUEMAO,109,97,97,303
8740,2020-01-21,(14004) Museo del Oro,407,1429,2049,3885
8741,2020-03-09,(07006) General Santander,214,693,519,1426
8742,2020-02-23,(09111) Calle 19,464,297,513,1274
8743,2020-02-23,(07101) CASTELLANA,75,69,177,321
8744,2020-03-26,(02105) Calle 142,406,293,244,943
8745,2020-04-16,(07004) VENECIA,492,325,285,1102
8746,2020-02-05,(04102) Avenida Boyaca,3153,1875,1683,6711
8747,2020-05-10,(02200) Alcalá,415,309,225,949
8748,2020-09-12,(08001) Parque el Tunal,401,215,294,910
8749,2020-10-04,(04102) Avenida Boyaca,189,91,192,472
8750,2020-07-30,(07001) PERDOMO,815,465,526,1806
8751,2020-08-25,(07004) VENECIA,951,575,536,2062
8752,2020-10-03,(07007) NQS - Calle 38A Sur,425,239,367,1031
8753,2020-08-14,(09107) Hortúa,546,373,364,1283
8754,2020-01-01,(14005) Las Aguas,57,56,234,347
8755,2020-10-07,(04000) Cabecera Calle 80 - intermunicipal,427,238,480,1145
8756,2020-05-03,(04100) Carrera 77,230,108,165,503
8757,2020-02-16,(07506) DESPENSA,289,169,362,820
8758,2020-10-06,(07506) DESPENSA,396,277,400,1073
8759,2020-08-28,(12004) Carrera 22,274,164,163,601
8760,2020-02-26,(07108) Av. El Dorado,997,644,631,2272
8761,2020-03-13,(04106) Carrera 47,230,144,196,570
8762,2020-10-07,(09114) Calle 26,365,248,347,960
8763,2020-03-28,(10009) Museo Nacional,144,117,114,375
8764,2020-04-07,(04106) Carrera 47,183,92,80,355
8765,2020-07-22,(06109) Centro Memoria,238,121,104,463
8766,2020-03-22,(09002) Consuelo,83,44,50,177
8767,2020-04-22,(07200) Tygua-San José,98,62,80,240
8768,2020-06-06,(14001) La Sabana,126,78,91,295
8769,2020-02-12,(07008) NQS - Calle 30 Sur,2074,1106,1146,4326
8770,2020-07-07,(07008) NQS - Calle 30 Sur,333,180,221,734
8771,2020-04-14,(06002) Normandía,175,101,99,375
8772,2020-06-10,(06002) Normandía,278,163,173,614
8773,2020-08-25,(06002) Normandía,307,173,167,647
8774,2020-04-20,(04000) Cabecera Calle 80 - intermunicipal,137,81,106,324
8775,2020-09-03,(03010) PUENTE LARGO,380,229,243,852
8776,2020-04-01,(06001) Modelia,232,185,160,577
8777,2020-05-02,(03005) SUBA - AV. BOYACA,175,112,106,393
8778,2020-04-12,(09100) Calle 40 Sur,255,155,210,620
8779,2020-04-09,(02502) Terminal,49,44,34,127
8780,2020-08-21,(10003) Ciudad Jardín,207,84,130,421
8781,2020-07-27,(09115) Calle 34,630,369,345,1344
8782,2020-06-27,(03011) SUBA - CALLE 100,376,215,225,816
8783,2020-08-25,(09106) Nariño,411,234,293,938
8784,2020-03-24,(07506) DESPENSA,402,178,243,823
8785,2020-02-16,(09108) Hospital,101,57,104,262
8786,2020-07-05,(07111) NQS - RICAURTE,193,171,166,530
8787,2020-07-20,(07111) NQS - RICAURTE,182,147,139,468
8788,2020-08-17,(06001) Modelia,95,67,83,245
8789,2020-04-17,(03010) PUENTE LARGO,198,126,117,441
8790,2020-09-08,(06106) Recinto Ferial,251,157,133,541
8791,2020-06-14,(04000) Cabecera Calle 80,250,146,237,633
8792,2020-08-30,(07105) MOVISTAR ARENA,60,36,78,174
8793,2020-01-19,(12000) Puente Aranda,39,38,53,130
8794,2020-09-20,(07006) General Santander,200,81,216,497
8795,2020-05-31,(06111) Universidades,0,39,140,179
8796,2020-07-25,(07006) General Santander - alimentacion,226,114,150,490
8797,2020-05-16,(14001) La Sabana,120,69,66,255
8798,2020-03-30,(07506) DESPENSA,190,112,148,450
8799,2020-04-19,(09000) Cabecera Usme,295,186,217,698
8800,2020-04-14,(04106) Carrera 47,179,92,110,381
8801,2020-08-08,(14001) La Sabana,128,93,81,302
8802,2020-07-20,(10010) San Bernardo,228,103,153,484
8803,2020-04-30,(07008) NQS - Calle 30 Sur,157,91,65,313
8804,2020-05-03,(06100) Av. Rojas,32,17,32,81
8805,2020-05-28,(05101) Mandalay - Cr.73,96,54,53,203
8806,2020-06-07,(04107) Escuela Militar,33,25,39,97
8807,2020-07-03,(10003) Ciudad Jardín,248,118,156,522
8808,2020-09-17,(09114) Calle 26,351,224,304,879
8809,2020-08-07,(04103) Las Ferias,121,59,68,248
8810,2020-08-08,(09106) Nariño,266,152,233,651
8811,2020-06-12,(09105) Río Fucha,128,60,73,261
8812,2020-04-09,(04101) Minuto de Dios,63,42,34,139
8813,2020-09-09,(04101) Minuto de Dios,357,193,277,827
8814,2020-04-19,(03005) SUBA - AV. BOYACA,80,49,60,189
8815,2020-04-10,(07201) Guatoque -Veraguas,9,7,19,35
8816,2020-09-13,(08002) Biblioteca,107,52,76,235
8817,2020-04-11,(05102) Av. Américas - Av. Boyacá,69,47,47,163
8818,2020-07-18,(09105) Río Fucha,81,24,56,161
8819,2020-05-25,(06106) Recinto Ferial,73,41,39,153
8820,2020-06-28,(04101) Minuto de Dios,96,55,94,245
8821,2020-05-10,(03014) SAN MARTIN,6,5,4,15
8822,2020-03-21,(07200) Tygua-San José,28,28,48,104
8823,2020-05-15,(03014) SAN MARTIN,32,10,20,62
8824,2020-10-11,(02102) Calle 161,78,42,91,211
8825,2020-09-05,(50006) Corral Carrera 77,6,2,6,14
8826,2020-06-24,(04000) Cabecera Calle 80 - alimentacion,4226,2419,2698,9343
8827,2020-07-30,(04000) Cabecera Calle 80 - alimentacion,3970,2204,2587,8761
8828,2020-09-12,(07504) TERREROS,5105,2401,3135,10641
8829,2020-06-09,(10000) Portal 20 de Julio - alimentacion,4152,1850,2277,8279
8830,2020-09-04,(10000) Portal 20 de Julio - alimentacion,4602,2004,2937,9543
8831,2020-01-10,(07111) NQS - RICAURTE,2328,1522,1479,5329
8832,2020-02-18,(07503) SAN MATEO,41997,23776,17738,83511
8833,2020-02-26,(06000) Portal Eldorado - alimentacion,18299,9729,10110,38138
8834,2020-02-27,(05000) Portal Américas,15243,8502,7639,31384
8835,2020-03-08,(50003) Corral Molinos,686,500,1276,2462
8836,2020-10-05,(09001) Molinos,3007,1481,2337,6825
8837,2020-03-30,(04000) Cabecera Calle 80 - alimentacion,1850,1043,1089,3982
8838,2020-04-24,(02000) Cabecera Autopista Norte - alimentacion,2949,1622,1381,5952
8839,2020-01-08,(07010) Bosa,1650,999,1161,3810
8840,2020-01-29,(07112) COMUNEROS,3689,2271,2298,8258
8841,2020-06-13,(04103) Las Ferias,264,128,146,538
8842,2020-01-28,(05001) Patio Bonito,6805,3840,3638,14283
8843,2020-02-21,(14004) Museo del Oro,2897,2346,2257,7500
8844,2020-09-23,(09104) Restrepo,1841,979,1367,4187
8845,2020-02-26,(05100) Banderas P. Central,8446,4327,3798,16571
8846,2020-07-27,(05100) Banderas P. Central,576,364,431,1371
8847,2020-03-23,(07009) SENA,156,87,86,329
8848,2020-01-24,(02105) Calle 142,6796,3752,3775,14323
8849,2020-03-25,(06000) Portal Eldorado - alimentacion,2500,1161,993,4654
8850,2020-03-04,(10003) Ciudad Jardín,1033,591,679,2303
8851,2020-06-21,(10000) Portal 20 de Julio - alimentacion,1431,609,951,2991
8852,2020-03-05,(05100) Banderas P. Central,8064,4511,3716,16291
8853,2020-03-17,(02205) Calle 106,1302,923,716,2941
8854,2020-06-17,(07001) PERDOMO,940,531,506,1977
8855,2020-03-18,(07113) SANTA ISABEL,1077,625,693,2395
8856,2020-06-21,(04101) Minuto de Dios,80,43,82,205
8857,2020-06-10,(07505) LEON XIII,2491,1454,1131,5076
8858,2020-08-25,(03000) Portal Suba - alimentacion,5768,3304,3542,12614
8859,2020-03-29,(07504) TERREROS,1046,544,499,2089
8860,2020-02-28,(09115) Calle 34,4295,2788,2596,9679
8861,2020-03-06,(04104) Avenida 68,3501,1832,2063,7396
8862,2020-02-13,(09110) Avenida Jimenez,5286,3602,2877,11765
8863,2020-05-09,(09101) Quiroga,209,128,197,534
8864,2020-05-11,(09101) Quiroga,368,203,301,872
8865,2020-09-16,(05000) Portal Américas,3630,2197,2550,8377
8866,2020-02-12,(04100) Carrera 77,7083,4288,3985,15356
8867,2020-05-02,(07102) NQS - CALLE 75,110,89,95,294
8868,2020-05-05,(07102) NQS - CALLE 75,254,177,134,565
8869,2020-09-18,(09000) Cabecera Usme - alimentacion,9701,4994,6295,20990
8870,2020-03-19,(09103) Olaya,2112,1131,1273,4516
8871,2020-06-24,(06000) Portal Eldorado - alimentacion,4006,2117,2145,8268
8872,2020-08-14,(50003) Corral Molinos,1408,720,1027,3155
8873,2020-07-23,(07000) Portal Sur - alimentacion,5912,3490,2876,12278
8874,2020-07-16,(05100) Banderas P. Central - alimentacion,2665,1356,1383,5404
8875,2020-01-10,(14001) La Sabana,286,232,293,811
8876,2020-04-27,(14001) La Sabana,13,39,20,72
8877,2020-07-03,(14001) La Sabana,165,97,132,394
8878,2020-04-25,(07111) NQS - RICAURTE,400,281,211,892
8879,2020-05-12,(07002) MADELENA,532,321,286,1139
8880,2020-06-19,(07106) EL CAMPIN,385,252,218,855
8881,2020-03-26,(07112) COMUNEROS,362,246,213,821
8882,2020-08-11,(02000) Cabecera Autopista Norte,1223,716,818,2757
8883,2020-01-01,(05000) Portal Américas,795,469,1260,2524
8884,2020-09-13,(05000) Portal Américas,839,459,876,2174
8885,2020-09-11,(10006) San Victorino,677,356,356,1389
8886,2020-01-03,(03000) Portal Suba,3771,2167,2686,8624
8887,2020-05-22,(03000) Portal Suba,1011,620,663,2294
8888,2020-02-18,(10008) San Diego,1678,881,783,3342
8889,2020-10-01,(40003) Mirador del Paraiso,1862,1044,1357,4263
8890,2020-05-11,(12001) Carrera 43,351,199,158,708
8891,2020-09-15,(02000) Cabecera Autopista Norte - intermunicipal,569,383,485,1437
8892,2020-01-23,(06100) Av. Rojas,2371,1380,1215,4966
8893,2020-03-12,(06100) Av. Rojas,535,339,297,1171
8894,2020-08-06,(07000) Portal Sur,1764,1038,1061,3863
8895,2020-01-05,(09116) Avenida 39,152,137,279,568
8896,2020-03-16,(10007) Las Nieves,1619,1010,898,3527
8897,2020-07-12,(07504) TERREROS,1925,941,1135,4001
8898,2020-04-25,(07503) SAN MATEO,3775,2501,1799,8075
8899,2020-09-29,(08001) Parque el Tunal,533,281,363,1177
8900,2020-01-22,(07008) NQS - Calle 30 Sur,1775,952,1072,3799
8901,2020-03-03,(06103) CAN,2707,1520,1166,5393
8902,2020-04-13,(14004) Museo del Oro,0,52,119,171
8903,2020-08-04,(03000) Portal Suba - alimentacion,4890,2820,2814,10524
8904,2020-01-08,(10009) Museo Nacional,2915,1557,1466,5938
8905,2020-07-27,(02300) Calle 100,1170,760,588,2518
8906,2020-03-23,(07007) NQS - Calle 38A Sur,79,61,54,194
8907,2020-01-11,(04104) Avenida 68,1370,803,1075,3248
8908,2020-05-28,(09001) Molinos,2089,1168,1332,4589
8909,2020-02-27,(06109) Centro Memoria,1224,653,614,2491
8910,2020-03-20,(08000) Portal Tunal,337,173,154,664
8911,2020-06-17,(02205) Calle 106,374,246,214,834
8912,2020-08-01,(03000) Portal Suba - alimentacion,3486,1872,2081,7439
8913,2020-07-08,(03006) NIZA - CALLE 127,522,289,215,1026
8914,2020-02-18,(14004) Museo del Oro,4404,2629,2018,9051
8915,2020-06-02,(03007) HUMEDAL CORDOBA,131,84,62,277
8916,2020-07-19,(03007) HUMEDAL CORDOBA,33,21,23,77
8917,2020-01-13,(03005) SUBA - AV. BOYACA,2257,1272,1364,4893
8918,2020-09-16,(07000) Portal Sur,2216,1347,1523,5086
8919,2020-07-28,(02101) Toberín,1345,839,824,3008
8920,2020-01-23,(04103) Las Ferias,1449,793,821,3063
8921,2020-05-17,(10010) San Bernardo,207,117,135,459
8922,2020-02-28,(04107) Escuela Militar,649,446,451,1546
8923,2020-07-16,(04107) Escuela Militar,114,81,75,270
8924,2020-03-14,(05107) Américas - Cr.53,1189,746,933,2868
8925,2020-09-24,(07109) CAD,700,426,412,1538
8926,2020-04-16,(09121) Las Flores,386,281,235,902
8927,2020-04-15,(03000) Portal Suba - alimentacion,2467,1782,1779,6028
8928,2020-01-04,(09001) Molinos,3367,1584,2726,7677
8929,2020-05-20,(04108) El Polo,386,236,202,824
8930,2020-06-06,(09103) Olaya,730,420,446,1596
8931,2020-03-15,(07109) CAD,427,251,409,1087
8932,2020-03-27,(40003) Mirador del Paraiso,616,388,359,1363
8933,2020-05-12,(02202) Calle 127,878,604,437,1919
8934,2020-09-29,(09121) Las Flores,797,489,590,1876
8935,2020-01-11,(06100) Av. Rojas,580,353,622,1555
8936,2020-06-15,(04100) Carrera 77,408,200,318,926
8937,2020-06-20,(02204) Pepe Sierra,562,441,390,1393
8938,2020-08-21,(07101) CASTELLANA,219,109,125,453
8939,2020-09-17,(40001) Juan Pablo II,546,345,423,1314
8940,2020-05-27,(02105) Calle 142,681,417,381,1479
8941,2020-06-15,(02302) Virrey,204,148,142,494
8942,2020-06-27,(10010) San Bernardo,470,249,360,1079
8943,2020-04-30,(05100) Banderas P. Central,410,229,271,910
8944,2020-05-30,(06103) CAN,239,170,115,524
8945,2020-10-09,(06103) CAN,431,251,289,971
8946,2020-06-10,(09004) Santa Lucía,2465,1241,1283,4989
8947,2020-01-05,(09110) Avenida Jimenez,628,567,771,1966
8948,2020-04-30,(09109) Tercer Milenio,196,125,137,458
8949,2020-01-11,(05102) Av. Américas - Av. Boyacá,570,304,527,1401
8950,2020-03-06,(10005) Bicentenario,722,439,389,1550
8951,2020-05-09,(07103) AV. CHILE,398,284,241,923
8952,2020-08-27,(07004) VENECIA,977,565,541,2083
8953,2020-05-29,(05002) Tintal,2144,1064,1141,4349
8954,2020-06-30,(02304) Heroes,896,612,576,2084
8955,2020-09-09,(10008) San Diego,329,165,223,717
8956,2020-08-15,(02304) Heroes,547,416,418,1381
8957,2020-04-12,(02202) Calle 127,334,236,135,705
8958,2020-08-29,(09122) Calle 72,887,636,818,2341
8959,2020-08-15,(07110) PALOQUEMAO,444,297,259,1000
8960,2020-09-29,(07110) PALOQUEMAO,714,445,346,1505
8961,2020-09-03,(10003) Ciudad Jardín,225,110,190,525
8962,2020-02-17,(12004) Carrera 22,750,446,470,1666
8963,2020-02-04,(07200) Tygua-San José,824,511,621,1956
8964,2020-02-01,(09106) Nariño,1160,603,1016,2779
8965,2020-05-08,(06109) Centro Memoria,202,135,105,442
8966,2020-07-21,(05103) Marsella,364,197,176,737
8967,2020-04-01,(02303) Calle 85,314,255,212,781
8968,2020-01-08,(50002) Corral Calle 40 Sur,92,47,91,230
8969,2020-09-21,(02302) Virrey,650,414,384,1448
8970,2020-05-29,(07105) MOVISTAR ARENA,232,156,129,517
8971,2020-07-24,(07105) MOVISTAR ARENA,232,120,108,460
8972,2020-07-17,(14005) Las Aguas,153,87,130,370
8973,2020-06-21,(02200) Alcalá,559,391,402,1352
8974,2020-05-20,(02303) Calle 85,581,388,282,1251
8975,2020-02-01,(06109) Centro Memoria,525,325,520,1370
8976,2020-09-02,(10007) Las Nieves,728,412,395,1535
8977,2020-10-09,(10007) Las Nieves,720,463,573,1756
8978,2020-09-21,(06102) Salitre El Greco,178,125,106,409
8979,2020-08-28,(12000) Puente Aranda,82,42,46,170
8980,2020-01-05,(07109) CAD,425,274,400,1099
8981,2020-08-14,(09121) Las Flores,642,394,366,1402
8982,2020-07-30,(02102) Calle 161,211,130,147,488
8983,2020-08-05,(14001) La Sabana,145,105,90,340
8984,2020-05-11,(02104) Calle 146,528,389,315,1232
8985,2020-05-15,(07111) NQS - RICAURTE,839,536,315,1690
8986,2020-03-31,(10009) Museo Nacional,334,220,198,752
8987,2020-10-01,(04106) Carrera 47,400,185,283,868
8988,2020-07-24,(07110) PALOQUEMAO,518,320,258,1096
8989,2020-08-17,(09115) Calle 34,162,114,163,439
8990,2020-01-01,(07006) General Santander,221,111,295,627
8991,2020-05-16,(07008) NQS - Calle 30 Sur,164,102,93,359
8992,2020-08-01,(04101) Minuto de Dios,144,89,152,385
8993,2020-02-03,(09105) Río Fucha,812,463,519,1794
8994,2020-07-11,(02000) Cabecera Autopista Norte - intermunicipal,429,253,315,997
8995,2020-06-12,(09114) Calle 26,307,205,191,703
8996,2020-07-23,(06106) Recinto Ferial,215,123,91,429
8997,2020-01-01,(02001) Centro Comercial Santa Fe,138,110,349,597
8998,2020-08-28,(04102) Avenida Boyaca,375,234,250,859
8999,2020-04-15,(10009) Museo Nacional,321,204,177,702
9000,2020-03-27,(09100) Calle 40 Sur,797,464,497,1758
9001,2020-01-26,(07108) Av. El Dorado,136,99,208,443
9002,2020-08-15,(06103) CAN,214,151,150,515
9003,2020-08-19,(06103) CAN,339,213,187,739
9004,2020-07-06,(09108) Hospital,62,42,54,158
9005,2020-08-03,(09108) Hospital,58,31,50,139
9006,2020-08-24,(09108) Hospital,56,33,54,143
9007,2020-03-30,(07006) General Santander,245,143,141,529
9008,2020-05-12,(03010) PUENTE LARGO,269,188,150,607
9009,2020-09-27,(10009) Museo Nacional,101,111,185,397
9010,2020-09-21,(04106) Carrera 47,294,154,168,616
9011,2020-06-15,(09122) Calle 72,372,265,271,908
9012,2020-08-29,(12002) CDS - Carrera 32,130,83,70,283
9013,2020-06-20,(02000) Cabecera Autopista Norte - intermunicipal,376,218,275,869
9014,2020-03-21,(09107) Hortúa,255,172,119,546
9015,2020-08-04,(07008) NQS - Calle 30 Sur,262,130,156,548
9016,2020-09-18,(05103) Marsella,544,289,382,1215
9017,2020-03-27,(07010) Bosa,239,157,211,607
9018,2019-12-31,(04002) Carrera 90,30,19,39,88
9019,2020-05-02,(02303) Calle 85,273,202,175,650
9020,2020-07-25,(10004) Policarpa,125,68,119,312
9021,2020-05-02,(06000) Portal Eldorado,521,355,290,1166
9022,2020-10-12,(08002) Biblioteca,110,60,106,276
9023,2020-05-24,(04001) Quirigua,107,56,88,251
9024,2020-04-25,(05100) Banderas P. Central,225,127,158,510
9025,2020-06-20,(06108) Concejo de Bogotá,76,50,58,184
9026,2020-08-30,(07004) VENECIA,301,179,249,729
9027,2020-02-23,(09106) Nariño,413,223,451,1087
9028,2020-07-23,(07007) NQS - Calle 38A Sur,260,169,205,634
9029,2020-04-18,(10006) San Victorino,115,86,101,302
9030,2020-06-16,(09105) Río Fucha,131,63,90,284
9031,2020-08-04,(09111) Calle 19,711,428,434,1573
9032,2020-09-29,(03004) GRATAMIRA,0,27,50,77
9033,2020-08-28,(05103) Marsella,448,225,276,949
9034,2020-04-17,(06111) Universidades,0,72,211,283
9035,2020-09-15,(06105) Quinta Paredes,171,104,100,375
9036,2020-07-31,(04106) Carrera 47,239,127,126,492
9037,2020-04-08,(07008) NQS - Calle 30 Sur,149,69,89,307
9038,2020-04-02,(03006) NIZA - CALLE 127,233,187,112,532
9039,2020-04-04,(07106) EL CAMPIN,106,88,61,255
9040,2020-05-15,(07109) CAD,532,354,233,1119
9041,2020-05-24,(07007) NQS - Calle 38A Sur,90,57,55,202
9042,2020-04-09,(07108) Av. El Dorado,31,22,14,67
9043,2020-06-22,(10007) Las Nieves,93,76,127,296
9044,2020-04-28,(10005) Bicentenario,58,30,55,143
9045,2020-05-17,(04105) Carrera 53,63,41,48,152
9046,2020-04-17,(04001) Quirigua,196,113,98,407
9047,2020-03-13,(10005) Bicentenario - alimentacion,55,70,115,240
9048,2020-06-28,(04000) Cabecera Calle 80 - intermunicipal,53,33,66,152
9049,2020-08-01,(06108) Concejo de Bogotá,79,47,59,185
9050,2020-07-23,(03014) SAN MARTIN,0,12,41,53
9051,2020-03-23,(03010) PUENTE LARGO,117,83,50,250
9052,2020-03-29,(03010) PUENTE LARGO,90,63,51,204
9053,2020-04-11,(09108) Hospital,29,17,20,66
9054,2020-09-13,(50006) Corral Carrera 77,2,1,4,7
9055,2020-02-23,(07504) TERREROS,4537,1890,3247,9674
9056,2020-06-16,(09119) Calle 57,573,386,420,1379
9057,2020-02-19,(05000) Portal Américas - alimentacion,37236,22905,21694,81835
9058,2020-02-12,(03002) SUBA - TV- 91,4762,2850,2574,10186
9059,2020-02-20,(05000) Portal Américas,15028,8480,7467,30975
9060,2020-08-26,(05000) Portal Américas,2736,1745,1866,6347
9061,2020-06-13,(10000) Portal 20 de Julio - alimentacion,3618,1547,2064,7229
9062,2020-02-29,(09000) Cabecera Usme - alimentacion,18287,9103,13247,40637
9063,2020-05-27,(07503) SAN MATEO,9181,5548,4208,18937
9064,2020-09-02,(05000) Portal Américas - alimentacion,11816,6492,6608,24916
9065,2020-09-05,(05000) Portal Américas - alimentacion,9475,4696,6258,20429
9066,2020-02-03,(06107) Ciudad Universitaria,1654,983,829,3466
9067,2020-01-14,(07112) COMUNEROS,3205,1936,2125,7266
9068,2020-02-20,(04103) Las Ferias,1511,867,799,3177
9069,2020-01-24,(02201) Prado,5375,3246,2962,11583
9070,2020-02-13,(07000) Portal Sur - alimentacion,30284,16449,14356,61089
9071,2020-01-25,(04100) Carrera 77,3577,1667,2713,7957
9072,2020-01-22,(09000) Cabecera Usme - alimentacion,24130,13298,14950,52378
9073,2020-08-12,(05100) Banderas P. Central,766,423,489,1678
9074,2020-09-28,(05100) Banderas P. Central,1103,623,859,2585
9075,2020-05-06,(09100) Calle 40 Sur,1042,640,693,2375
9076,2020-02-25,(09000) Cabecera Usme,6160,3700,4065,13925
9077,2020-04-02,(06000) Portal Eldorado - alimentacion,2233,1037,971,4241
9078,2020-08-02,(10003) Ciudad Jardín,72,24,55,151
9079,2020-08-24,(10000) Portal 20 de Julio - alimentacion,3651,1476,2146,7273
9080,2020-05-28,(08000) Portal Tunal - alimentacion,5692,2927,2805,11424
9081,2020-02-22,(05100) Banderas P. Central,3586,1584,2495,7665
9082,2020-05-05,(09109) Tercer Milenio,242,160,177,579
9083,2020-09-18,(09104) Restrepo,1766,968,1477,4211
9084,2020-07-07,(07505) LEON XIII,2926,1583,1209,5718
9085,2020-01-13,(02204) Pepe Sierra,4090,2701,2106,8897
9086,2020-01-03,(06002) Normandía,942,552,655,2149
9087,2020-02-25,(09110) Avenida Jimenez,5127,3469,2788,11384
9088,2020-04-01,(02000) Cabecera Autopista Norte - alimentacion,2641,1288,1312,5241
9089,2020-02-21,(07110) PALOQUEMAO,2761,1616,1169,5546
9090,2020-02-03,(07102) NQS - CALLE 75,1533,985,916,3434
9091,2020-04-24,(07102) NQS - CALLE 75,188,142,124,454
9092,2020-09-21,(07102) NQS - CALLE 75,396,276,262,934
9093,2020-03-20,(03013) RIO NEGRO,116,91,66,273
9094,2020-02-04,(09103) Olaya,4312,2584,2451,9347
9095,2020-09-15,(09103) Olaya,1070,579,670,2319
9096,2020-01-04,(07000) Portal Sur - alimentacion,11486,5587,6753,23826
9097,2020-04-20,(09110) Avenida Jimenez,300,240,298,838
9098,2020-01-11,(07110) PALOQUEMAO,1086,694,775,2555
9099,2020-08-18,(07000) Portal Sur - alimentacion,7542,4305,3982,15829
9100,2020-01-21,(09103) Olaya,2939,1554,1552,6045
9101,2020-04-22,(14001) La Sabana,88,65,48,201
9102,2020-04-23,(14001) La Sabana,86,64,68,218
9103,2020-01-14,(07002) MADELENA,4100,2333,2240,8673
9104,2020-09-02,(07002) MADELENA,851,520,650,2021
9105,2020-01-28,(09113) Calle 22,1463,875,1032,3370
9106,2020-06-15,(09113) Calle 22,224,126,186,536
9107,2020-03-13,(03003) 21 ANGELES,48,278,261,587
9108,2020-03-06,(10007) Las Nieves,1912,1231,1250,4393
9109,2020-02-18,(07007) NQS - Calle 38A Sur,2221,1325,1244,4790
9110,2020-10-01,(05000) Portal Américas,3894,2084,2746,8724
9111,2020-05-26,(04000) Cabecera Calle 80,894,576,681,2151
9112,2020-01-08,(07112) COMUNEROS,2574,1519,1784,5877
9113,2020-02-10,(10001) Country Sur,5157,2474,2746,10377
9114,2020-04-30,(04002) Carrera 90,434,263,219,916
9115,2020-01-12,(09000) Cabecera Usme - alimentacion,5670,2449,4603,12722
9116,2020-07-13,(03000) Portal Suba,1111,695,650,2456
9117,2020-06-08,(40003) Mirador del Paraiso,1669,1016,1037,3722
9118,2020-06-18,(10002) Av. Primero de Mayo,2243,1181,1335,4759
9119,2020-07-08,(09101) Quiroga,605,309,403,1317
9120,2020-02-18,(03007) HUMEDAL CORDOBA,1060,641,550,2251
9121,2020-08-13,(07112) COMUNEROS,789,460,429,1678
9122,2020-09-08,(02303) Calle 85,810,543,433,1786
9123,2020-09-16,(02303) Calle 85,826,504,492,1822
9124,2020-06-08,(09004) Santa Lucía,2498,1303,1273,5074
9125,2020-01-05,(08001) Parque el Tunal,310,123,287,720
9126,2020-05-27,(08001) Parque el Tunal,429,264,227,920
9127,2020-05-28,(08001) Parque el Tunal,415,221,259,895
9128,2020-08-10,(08001) Parque el Tunal,467,258,259,984
9129,2020-09-08,(07505) LEON XIII,2839,1535,1364,5738
9130,2020-02-06,(07008) NQS - Calle 30 Sur,1969,1017,1053,4039
9131,2020-07-02,(02101) Toberín,1622,1013,938,3573
9132,2020-02-17,(03000) Portal Suba,9860,5945,4998,20803
9133,2020-10-04,(09004) Santa Lucía,1020,386,905,2311
9134,2020-03-31,(03003) 21 ANGELES,167,96,80,343
9135,2020-03-09,(09120) Calle 63,3375,428,814,4617
9136,2020-03-03,(02202) Calle 127,5841,3826,2939,12606
9137,2020-02-28,(07001) PERDOMO,4788,2546,2685,10019
9138,2020-10-03,(02103) Mazurén,187,109,243,539
9139,2020-02-19,(03012) SUBA - CALLE 95,1505,1001,981,3487
9140,2020-02-23,(04106) Carrera 47,359,188,298,845
9141,2020-01-15,(08000) Portal Tunal,1859,995,944,3798
9142,2020-05-08,(08000) Portal Tunal,550,234,203,987
9143,2020-07-11,(06109) Centro Memoria,207,133,137,477
9144,2020-03-24,(03012) SUBA - CALLE 95,292,223,196,711
9145,2020-06-26,(08000) Portal Tunal,805,357,316,1478
9146,2020-08-31,(02205) Calle 106,390,260,216,866
9147,2020-07-18,(06111) Universidades,184,118,198,500
9148,2020-02-06,(03006) NIZA - CALLE 127,2376,1534,1485,5395
9149,2020-09-01,(04003) Avenida Ciudad de Cali,1016,561,778,2355
9150,2020-01-13,(04108) El Polo,1594,995,1008,3597
9151,2020-01-02,(07000) Portal Sur,3698,2149,2449,8296
9152,2020-03-05,(07000) Portal Sur,7766,4386,4474,16626
9153,2020-01-10,(12007) Zona Industrial,954,669,555,2178
9154,2020-09-20,(06000) Portal Eldorado - alimentacion,1555,635,1392,3582
9155,2020-07-19,(04000) Cabecera Calle 80 - alimentacion,1014,468,723,2205
9156,2020-06-14,(08002) Biblioteca,95,44,54,193
9157,2020-09-15,(08002) Biblioteca,324,169,204,697
9158,2020-10-05,(04100) Carrera 77,1469,801,1268,3538
9159,2020-03-15,(07000) Portal Sur,1160,584,1077,2821
9160,2020-02-06,(04103) Las Ferias,1594,947,847,3388
9161,2020-09-23,(14005) Las Aguas,240,163,315,718
9162,2020-01-21,(02105) Calle 142,5031,2598,2300,9929
9163,2020-07-24,(09100) Calle 40 Sur,1264,733,845,2842
9164,2020-09-03,(09100) Calle 40 Sur,1845,1108,1290,4243
9165,2020-04-16,(10005) Bicentenario - alimentacion,151,67,137,355
9166,2020-05-23,(10005) Bicentenario - alimentacion,142,66,108,316
9167,2020-07-07,(04107) Escuela Militar,154,101,103,358
9168,2020-08-05,(04107) Escuela Militar,95,50,66,211
9169,2020-08-19,(04107) Escuela Militar,141,81,77,299
9170,2020-08-21,(04107) Escuela Militar,159,86,82,327
9171,2020-10-08,(04107) Escuela Militar,156,107,142,405
9172,2020-07-27,(04100) Carrera 77,1149,659,712,2520
9173,2020-05-06,(02304) Heroes,591,407,314,1312
9174,2020-01-05,(06101) El Tiempo,206,160,326,692
9175,2020-03-26,(07109) CAD,399,303,209,911
9176,2020-01-08,(06100) Av. Rojas,1382,831,854,3067
9177,2020-08-17,(05001) Patio Bonito,575,306,352,1233
9178,2020-08-06,(09116) Avenida 39,328,202,219,749
9179,2020-02-24,(07004) VENECIA,4791,2751,2387,9929
9180,2020-02-09,(02302) Virrey,396,348,552,1296
9181,2020-09-26,(02001) Centro Comercial Santa Fe,423,226,442,1091
9182,2020-07-25,(07009) SENA,331,210,261,802
9183,2020-02-29,(07008) NQS - Calle 30 Sur,1119,488,837,2444
9184,2020-05-05,(06000) Portal Eldorado,902,564,372,1838
9185,2020-08-10,(03013) RIO NEGRO,210,128,184,522
9186,2020-06-12,(03009) Av. Suba- Calle 116,513,304,228,1045
9187,2020-06-17,(07106) EL CAMPIN,377,251,203,831
9188,2020-01-29,(07107) U. NACIONAL,2501,1515,1363,5379
9189,2020-03-03,(09113) Calle 22,1534,943,1030,3507
9190,2020-07-10,(09110) Avenida Jimenez,1505,1071,920,3496
9191,2020-01-24,(09109) Tercer Milenio,1289,771,868,2928
9192,2020-04-17,(09002) Consuelo,223,116,129,468
9193,2020-01-05,(06108) Concejo de Bogotá,101,55,106,262
9194,2020-02-07,(10005) Bicentenario,740,416,423,1579
9195,2020-05-02,(05107) Américas - Cr.53,183,151,112,446
9196,2020-07-23,(02103) Mazurén,164,111,152,427
9197,2020-08-17,(07103) AV. CHILE,211,155,199,565
9198,2020-09-11,(07103) AV. CHILE,888,522,505,1915
9199,2020-01-26,(06107) Ciudad Universitaria,225,135,375,735
9200,2020-07-01,(02101) Toberín,1640,994,1023,3657
9201,2020-04-10,(08000) Portal Tunal - alimentacion,1300,678,570,2548
9202,2020-07-08,(10005) Bicentenario,119,53,93,265
9203,2020-02-06,(06109) Centro Memoria,1233,729,703,2665
9204,2020-08-26,(02001) Centro Comercial Santa Fe,455,279,321,1055
9205,2020-01-15,(07006) General Santander,2394,1358,1431,5183
9206,2020-02-23,(02102) Calle 161,226,133,296,655
9207,2020-07-30,(09123) Calle 76,983,724,595,2302
9208,2020-03-13,(07102) NQS - CALLE 75,446,86,242,774
9209,2020-06-03,(05100) Banderas P. Central,445,288,328,1061
9210,2020-08-08,(02200) Alcalá,1167,779,745,2691
9211,2020-05-29,(40001) Juan Pablo II,528,324,324,1176
9212,2020-08-22,(40001) Juan Pablo II,453,228,318,999
9213,2020-06-17,(07111) NQS - RICAURTE,1217,722,439,2378
9214,2020-09-04,(07006) General Santander,632,360,409,1401
9215,2020-04-14,(07110) PALOQUEMAO,439,301,199,939
9216,2020-08-27,(07110) PALOQUEMAO,656,370,276,1302
9217,2020-05-14,(02101) Toberín,1094,706,643,2443
9218,2020-10-04,(05002) Tintal,793,372,826,1991
9219,2020-09-25,(05103) Marsella,524,292,363,1179
9220,2020-08-03,(07111) NQS - RICAURTE,967,585,406,1958
9221,2020-09-08,(09002) Consuelo,488,263,301,1052
9222,2020-07-15,(09114) Calle 26,265,164,153,582
9223,2020-08-07,(07201) Guatoque -Veraguas,72,42,70,184
9224,2020-04-28,(07105) MOVISTAR ARENA,173,104,88,365
9225,2020-08-15,(07105) MOVISTAR ARENA,162,100,139,401
9226,2020-06-13,(02302) Virrey,426,316,243,985
9227,2020-06-22,(06109) Centro Memoria,83,64,87,234
9228,2020-08-16,(06109) Centro Memoria,65,46,71,182
9229,2020-06-24,(03003) 21 ANGELES,362,152,167,681
9230,2020-06-11,(10007) Las Nieves,592,332,341,1265
9231,2020-05-23,(07004) VENECIA,583,305,341,1229
9232,2020-05-01,(10006) San Victorino,80,61,88,229
9233,2020-04-19,(02104) Calle 146,183,127,86,396
9234,2020-04-27,(10010) San Bernardo,197,113,67,377
9235,2020-09-09,(05005) Transversal 86,451,234,342,1027
9236,2020-04-18,(40003) Mirador del Paraiso,702,432,465,1599
9237,2020-04-16,(08002) Biblioteca,163,91,114,368
9238,2020-03-06,(12000) Puente Aranda,262,161,202,625
9239,2020-05-27,(04000) Cabecera Calle 80 - intermunicipal,253,154,188,595
9240,2020-08-13,(12004) Carrera 22,248,145,131,524
9241,2020-06-05,(09120) Calle 63,1047,703,620,2370
9242,2020-07-08,(06001) Modelia,386,241,217,844
9243,2020-09-28,(06001) Modelia,408,274,270,952
9244,2020-09-28,(07008) NQS - Calle 30 Sur,392,217,301,910
9245,2020-04-21,(07200) Tygua-San José,109,66,97,272
9246,2020-05-23,(09120) Calle 63,693,455,450,1598
9247,2020-09-28,(03010) PUENTE LARGO,416,253,279,948
9248,2020-08-07,(06000) Portal Eldorado,265,192,247,704
9249,2020-05-22,(07004) VENECIA,810,466,392,1668
9250,2020-09-08,(04102) Avenida Boyaca,341,213,277,831
9251,2020-04-20,(06002) Normandía,165,105,94,364
9252,2020-05-12,(06100) Av. Rojas,147,97,107,351
9253,2020-07-01,(04000) Cabecera Calle 80 - intermunicipal,368,181,324,873
9254,2020-03-13,(06107) Ciudad Universitaria,298,111,198,607
9255,2020-04-10,(03012) SUBA - CALLE 95,49,33,36,118
9256,2020-03-10,(10008) San Diego,959,90,173,1222
9257,2020-03-08,(12003) Ricaurte,113,99,171,383
9258,2020-04-10,(07000) Portal Sur,246,169,140,555
9259,2020-04-19,(07102) NQS - CALLE 75,36,27,38,101
9260,2020-08-15,(07006) General Santander - alimentacion,268,142,209,619
9261,2020-05-04,(10008) San Diego,161,114,98,373
9262,2020-09-06,(07010) Bosa,193,80,199,472
9263,2020-07-21,(09106) Nariño,344,179,241,764
9264,2020-04-10,(07003) SEVILLANA,50,30,31,111
9265,2020-08-24,(07008) NQS - Calle 30 Sur,262,140,145,547
9266,2020-04-01,(04101) Minuto de Dios,144,113,105,362
9267,2020-05-16,(07006) General Santander - alimentacion,218,131,126,475
9268,2020-03-13,(09101) Quiroga,51,322,295,668
9269,2020-04-12,(04106) Carrera 47,70,46,30,146
9270,2020-03-21,(10007) Las Nieves,94,74,85,253
9271,2020-06-03,(10005) Bicentenario - alimentacion,252,94,168,514
9272,2020-05-08,(09113) Calle 22,273,188,245,706
9273,2020-07-23,(04001) Quirigua,362,226,186,774
9274,2020-05-11,(06002) Normandía,234,145,143,522
9275,2020-05-19,(07006) General Santander,380,266,196,842
9276,2020-07-17,(14004) Museo del Oro,255,160,185,600
9277,2020-09-06,(09110) Avenida Jimenez,589,486,430,1505
9278,2020-04-17,(09003) Socorro,291,162,181,634
9279,2020-03-28,(06111) Universidades,0,49,135,184
9280,2020-09-21,(10003) Ciudad Jardín,168,67,108,343
9281,2020-04-29,(07006) General Santander,284,194,128,606
9282,2020-05-03,(07007) NQS - Calle 38A Sur,87,52,61,200
9283,2020-09-28,(06105) Quinta Paredes,168,121,105,394
9284,2020-04-17,(04106) Carrera 47,183,110,92,385
9285,2020-04-05,(03002) SUBA - TV- 91,149,75,86,310
9286,2020-10-06,(05102) Av. Américas - Av. Boyacá,291,155,264,710
9287,2020-07-07,(07101) CASTELLANA,221,123,126,470
9288,2020-06-18,(09105) Río Fucha,123,58,84,265
9289,2020-09-29,(09105) Río Fucha,0,76,158,234
9290,2020-05-11,(14005) Las Aguas,0,39,125,164
9291,2020-05-31,(02204) Pepe Sierra,187,147,135,469
9292,2020-06-22,(07008) NQS - Calle 30 Sur,109,58,56,223
9293,2020-04-17,(10003) Ciudad Jardín,121,65,80,266
9294,2020-03-22,(04101) Minuto de Dios,61,43,46,150
9295,2020-09-27,(05107) Américas - Cr.53,84,88,173,345
9296,2020-10-11,(06106) Recinto Ferial,79,62,85,226
9297,2020-03-29,(07007) NQS - Calle 38A Sur,60,38,28,126
9298,2020-04-09,(10004) Policarpa,75,31,45,151
9299,2020-08-14,(03004) GRATAMIRA,0,16,24,40
9300,2020-04-19,(06106) Recinto Ferial,44,32,26,102
9301,2020-05-03,(50006) Corral Carrera 77,1,1,3,5
9302,2020-01-15,(04000) Cabecera Calle 80 - alimentacion,19528,10953,13109,43590
9303,2020-06-15,(04000) Cabecera Calle 80 - alimentacion,1151,653,921,2725
9304,2020-02-28,(07005) ALQUERIA,2672,1458,1410,5540
9305,2020-06-03,(09002) Consuelo,433,243,227,903
9306,2020-05-29,(07504) TERREROS,4887,2903,2423,10213
9307,2020-09-04,(07504) TERREROS,6766,3619,3517,13902
9308,2020-09-09,(10000) Portal 20 de Julio - alimentacion,4419,2047,2913,9379
9309,2020-10-05,(09119) Calle 57,664,474,562,1700
9310,2020-01-10,(07503) SAN MATEO,32956,17353,15477,65786
9311,2020-05-28,(04101) Minuto de Dios,269,157,181,607
9312,2020-04-10,(05000) Portal Américas - alimentacion,2211,1145,812,4168
9313,2020-06-11,(05001) Patio Bonito,1509,787,921,3217
9314,2020-01-27,(07112) COMUNEROS,3594,2224,2172,7990
9315,2020-08-25,(04103) Las Ferias,359,181,183,723
9316,2020-02-12,(07002) MADELENA,5308,3089,2605,11002
9317,2020-04-07,(09104) Restrepo,669,529,579,1777
9318,2020-10-07,(09104) Restrepo,1682,997,1660,4339
9319,2020-01-23,(05100) Banderas P. Central,6969,4053,3497,14519
9320,2020-01-15,(09000) Cabecera Usme,5036,2942,3628,11606
9321,2020-02-12,(40001) Juan Pablo II,1708,1002,1047,3757
9322,2020-01-02,(02102) Calle 161,664,392,535,1591
9323,2020-08-19,(09000) Cabecera Usme,1629,992,1169,3790
9324,2020-02-28,(06000) Portal Eldorado - alimentacion,18396,9534,9931,37861
9325,2020-01-27,(06102) Salitre El Greco,1544,858,713,3115
9326,2020-01-07,(10003) Ciudad Jardín,713,384,567,1664
9327,2020-02-04,(10003) Ciudad Jardín,1130,574,679,2383
9328,2020-09-08,(02101) Toberín,1529,1002,1093,3624
9329,2020-06-13,(09000) Cabecera Usme - alimentacion,6692,3548,4054,14294
9330,2020-01-30,(09120) Calle 63,5823,3775,3484,13082
9331,2020-06-26,(40003) Mirador del Paraiso,1813,1127,1121,4061
9332,2020-08-12,(09104) Restrepo,1522,830,1064,3416
9333,2020-09-20,(07505) LEON XIII,921,395,608,1924
9334,2020-03-18,(06002) Normandía,1022,618,562,2202
9335,2020-02-07,(07112) COMUNEROS,3910,2328,2528,8766
9336,2020-02-25,(07110) PALOQUEMAO,2775,1654,1223,5652
9337,2020-09-12,(02000) Cabecera Autopista Norte - alimentacion,4078,1967,2812,8857
9338,2020-07-30,(09101) Quiroga,401,273,340,1014
9339,2020-05-28,(04100) Carrera 77,1080,571,634,2285
9340,2020-08-26,(07102) NQS - CALLE 75,433,260,243,936
9341,2020-07-13,(03013) RIO NEGRO,251,146,156,553
9342,2020-06-25,(03000) Portal Suba - alimentacion,6285,3686,3506,13477
9343,2020-03-04,(02302) Virrey,3831,2628,1924,8383
9344,2020-03-18,(02302) Virrey,1779,1288,987,4054
9345,2020-04-06,(07111) NQS - RICAURTE,379,290,242,911
9346,2020-04-14,(07111) NQS - RICAURTE,449,350,238,1037
9347,2020-02-01,(07112) COMUNEROS,2311,1217,1766,5294
9348,2020-02-14,(07112) COMUNEROS,3954,2334,2329,8617
9349,2020-06-30,(02000) Cabecera Autopista Norte,1401,902,903,3206
9350,2020-09-30,(08000) Portal Tunal - alimentacion,6953,3816,4597,15366
9351,2020-06-03,(50003) Corral Molinos,1364,701,975,3040
9352,2020-09-07,(05000) Portal Américas,3317,2019,2159,7495
9353,2020-01-21,(06106) Recinto Ferial,929,577,544,2050
9354,2020-07-15,(05002) Tintal,2123,1253,1234,4610
9355,2020-04-28,(04002) Carrera 90,441,260,221,922
9356,2020-02-22,(10001) Country Sur,2969,1189,2115,6273
9357,2020-08-27,(10006) San Victorino,643,294,299,1236
9358,2020-10-02,(06000) Portal Eldorado,923,677,772,2372
9359,2020-07-18,(10005) Bicentenario - alimentacion,144,79,143,366
9360,2020-02-14,(06111) Universidades,5606,3682,2754,12042
9361,2020-03-17,(10006) San Victorino,1235,872,834,2941
9362,2020-10-09,(02304) Heroes,989,725,752,2466
9363,2020-05-22,(02000) Cabecera Autopista Norte - intermunicipal,432,288,291,1011
9364,2020-06-12,(02000) Cabecera Autopista Norte - intermunicipal,553,363,358,1274
9365,2020-08-22,(09000) Cabecera Usme - alimentacion,6536,3156,3998,13690
9366,2020-01-07,(06111) Universidades,1448,1049,1514,4011
9367,2020-06-02,(07010) Bosa,624,328,390,1342
9368,2020-07-11,(10000) Portal 20 de Julio,1949,937,1195,4081
9369,2020-08-07,(10000) Portal 20 de Julio,952,489,558,1999
9370,2020-04-07,(07112) COMUNEROS,385,258,243,886
9371,2020-09-21,(07112) COMUNEROS,741,406,466,1613
9372,2020-04-09,(07000) Portal Sur - alimentacion,1686,910,624,3220
9373,2020-08-12,(02303) Calle 85,701,472,337,1510
9374,2020-01-18,(09109) Tercer Milenio,834,431,686,1951
9375,2020-09-06,(07505) LEON XIII,926,441,645,2012
9376,2020-04-20,(06108) Concejo de Bogotá,96,65,72,233
9377,2020-03-07,(09113) Calle 22,1165,658,926,2749
9378,2020-10-05,(10002) Av. Primero de Mayo,2408,1234,1884,5526
9379,2020-02-08,(02202) Calle 127,2878,1879,2092,6849
9380,2020-07-01,(02201) Prado,910,612,588,2110
9381,2020-03-26,(02000) Cabecera Autopista Norte,507,346,337,1190
9382,2020-01-21,(06001) Modelia,1638,920,893,3451
9383,2020-03-03,(06001) Modelia,2673,1592,1309,5574
9384,2020-02-01,(04003) Avenida Ciudad de Cali,3084,1467,2498,7049
9385,2020-02-10,(10009) Museo Nacional,4696,2404,1872,8972
9386,2020-05-13,(02300) Calle 100,1046,678,464,2188
9387,2020-03-02,(03012) SUBA - CALLE 95,1300,901,1028,3229
9388,2020-03-18,(03012) SUBA - CALLE 95,800,507,556,1863
9389,2020-04-17,(09001) Molinos,1210,739,878,2827
9390,2020-05-22,(08000) Portal Tunal,683,303,255,1241
9391,2020-05-21,(09001) Molinos,2024,1103,1254,4381
9392,2020-03-20,(05005) Transversal 86,235,130,105,470
9393,2020-03-29,(05005) Transversal 86,65,31,29,125
9394,2020-09-17,(05005) Transversal 86,438,240,295,973
9395,2020-02-02,(02202) Calle 127,1007,712,1013,2732
9396,2020-07-11,(02202) Calle 127,942,645,521,2108
9397,2020-07-17,(10008) San Diego,192,119,158,469
9398,2020-02-20,(06109) Centro Memoria,1194,644,584,2422
9399,2020-06-10,(05107) Américas - Cr.53,400,264,189,853
9400,2020-09-25,(02205) Calle 106,434,300,346,1080
9401,2020-09-28,(02205) Calle 106,437,305,309,1051
9402,2020-03-15,(02001) Centro Comercial Santa Fe,477,282,647,1406
9403,2020-02-17,(04003) Avenida Ciudad de Cali,5810,3536,3574,12920
9404,2020-05-10,(09101) Quiroga,101,65,108,274
9405,2020-09-06,(06000) Portal Eldorado - alimentacion,1536,705,1241,3482
9406,2020-01-12,(07009) SENA,779,367,746,1892
9407,2020-01-14,(07103) AV. CHILE,3215,1966,1698,6879
9408,2020-06-19,(06111) Universidades,269,201,394,864
9409,2020-08-16,(03007) HUMEDAL CORDOBA,28,28,26,82
9410,2020-09-22,(04000) Cabecera Calle 80,1305,792,1103,3200
9411,2020-01-28,(07108) Av. El Dorado,885,560,573,2018
9412,2020-04-15,(03011) SUBA - CALLE 100,291,138,144,573
9413,2020-05-12,(02000) Cabecera Autopista Norte - alimentacion,3775,2124,1943,7842
9414,2020-03-27,(02202) Calle 127,649,463,336,1448
9415,2020-07-02,(10005) Bicentenario - alimentacion,239,114,182,535
9416,2020-01-15,(04003) Avenida Ciudad de Cali,4833,2691,3095,10619
9417,2020-10-01,(04003) Avenida Ciudad de Cali,1183,637,1029,2849
9418,2020-01-12,(02000) Cabecera Autopista Norte,1562,787,1522,3871
9419,2020-07-10,(05103) Marsella,493,233,249,975
9420,2020-09-28,(04103) Las Ferias,371,220,254,845
9421,2020-07-12,(03000) Portal Suba - alimentacion,2148,1088,1548,4784
9422,2020-08-21,(05001) Patio Bonito,1711,953,1119,3783
9423,2020-03-12,(02300) Calle 100,2775,351,693,3819
9424,2020-03-11,(04105) Carrera 53,1422,797,741,2960
9425,2020-02-02,(03002) SUBA - TV- 91,848,406,891,2145
9426,2020-01-15,(09111) Calle 19,1693,1186,1423,4302
9427,2020-04-21,(02202) Calle 127,648,491,299,1438
9428,2020-09-17,(09121) Las Flores,724,474,495,1693
9429,2020-01-11,(07003) SEVILLANA,943,477,646,2066
9430,2020-03-27,(10001) Country Sur,476,208,382,1066
9431,2020-08-09,(02205) Calle 106,43,47,49,139
9432,2020-03-12,(07101) CASTELLANA,342,63,129,534
9433,2020-01-25,(40001) Juan Pablo II,1152,581,776,2509
9434,2020-10-06,(40001) Juan Pablo II,598,346,464,1408
9435,2020-08-07,(10000) Portal 20 de Julio - alimentacion,1796,817,1105,3718
9436,2020-08-08,(05100) Banderas P. Central,482,239,381,1102
9437,2020-08-18,(07009) SENA,549,339,399,1287
9438,2020-03-09,(07107) U. NACIONAL,1166,165,341,1672
9439,2020-05-09,(09109) Tercer Milenio,199,126,138,463
9440,2020-03-24,(04104) Avenida 68,510,335,367,1212
9441,2020-03-17,(10005) Bicentenario,507,246,266,1019
9442,2020-06-09,(02103) Mazurén,167,123,156,446
9443,2020-09-25,(12007) Zona Industrial,364,255,222,841
9444,2020-07-29,(10005) Bicentenario,81,53,77,211
9445,2020-06-15,(40002) Manitas,145,76,95,316
9446,2020-03-13,(02304) Heroes,1828,118,438,2384
9447,2020-06-02,(09117) Calle 45,668,386,382,1436
9448,2020-01-03,(12002) CDS - Carrera 32,243,182,204,629
9449,2020-03-17,(09106) Nariño,1151,684,761,2596
9450,2020-09-02,(02001) Centro Comercial Santa Fe,492,322,387,1201
9451,2020-03-05,(07006) General Santander,2834,1587,1665,6086
9452,2020-01-01,(02200) Alcalá,674,399,914,1987
9453,2020-01-25,(14001) La Sabana,204,192,253,649
9454,2020-07-31,(08002) Biblioteca,302,171,161,634
9455,2020-01-19,(02201) Prado,965,506,1030,2501
9456,2020-08-26,(03011) SUBA - CALLE 100,522,218,253,993
9457,2020-05-09,(05107) Américas - Cr.53,227,162,158,547
9458,2020-08-26,(05105) Pradera,582,320,272,1174
9459,2020-06-25,(12007) Zona Industrial,376,232,179,787
9460,2020-10-05,(06111) Universidades,499,276,544,1319
9461,2020-05-09,(09004) Santa Lucía,1278,631,713,2622
9462,2020-06-20,(09115) Calle 34,435,294,351,1080
9463,2020-04-10,(05100) Banderas P. Central - alimentacion,461,247,173,881
9464,2020-04-29,(02204) Pepe Sierra,460,332,213,1005
9465,2020-10-10,(07001) PERDOMO,785,397,788,1970
9466,2020-03-09,(07110) PALOQUEMAO,1292,173,270,1735
9467,2020-08-23,(05001) Patio Bonito,490,230,293,1013
9468,2020-04-11,(02000) Cabecera Autopista Norte,302,222,150,674
9469,2020-02-24,(12004) Carrera 22,710,429,467,1606
9470,2020-09-22,(09122) Calle 72,1355,882,1034,3271
9471,2020-01-13,(09111) Calle 19,1804,1143,1330,4277
9472,2020-01-05,(07111) NQS - RICAURTE,340,304,425,1069
9473,2020-07-16,(07201) Guatoque -Veraguas,119,70,85,274
9474,2020-07-24,(07201) Guatoque -Veraguas,115,64,100,279
9475,2020-08-08,(07105) MOVISTAR ARENA,128,81,119,328
9476,2020-09-07,(07506) DESPENSA,435,285,353,1073
9477,2020-04-03,(02200) Alcalá,863,606,454,1923
9478,2020-09-16,(10007) Las Nieves,756,481,459,1696
9479,2020-04-05,(05001) Patio Bonito,305,154,192,651
9480,2020-04-11,(02204) Pepe Sierra,291,238,156,685
9481,2020-07-22,(04103) Las Ferias,337,165,147,649
9482,2020-09-29,(04103) Las Ferias,369,229,223,821
9483,2020-07-02,(06102) Salitre El Greco,248,144,133,525
9484,2020-04-23,(04100) Carrera 77,667,414,383,1464
9485,2020-09-08,(03011) SUBA - CALLE 100,615,260,289,1164
9486,2020-08-26,(05102) Av. Américas - Av. Boyacá,241,132,130,503
9487,2020-09-20,(04101) Minuto de Dios,115,68,181,364
9488,2020-07-31,(12003) Ricaurte,332,226,171,729
9489,2020-10-04,(10000) Portal 20 de Julio,883,375,843,2101
9490,2020-07-06,(09114) Calle 26,318,198,246,762
9491,2020-05-19,(09122) Calle 72,974,673,527,2174
9492,2020-03-27,(08002) Biblioteca,161,88,80,329
9493,2020-01-31,(12000) Puente Aranda,278,160,181,619
9494,2020-03-21,(02102) Calle 161,37,36,41,114
9495,2020-04-20,(02102) Calle 161,91,59,51,201
9496,2020-05-05,(02102) Calle 161,152,88,89,329
9497,2020-05-05,(12004) Carrera 22,119,76,90,285
9498,2020-09-10,(09111) Calle 19,742,450,509,1701
9499,2020-10-01,(03013) RIO NEGRO,291,200,257,748
9500,2020-03-08,(10009) Museo Nacional,299,284,545,1128
9501,2020-05-25,(04000) Cabecera Calle 80,229,156,217,602
9502,2020-04-15,(07009) SENA,338,187,189,714
9503,2020-05-02,(04106) Carrera 47,156,79,68,303
9504,2020-01-25,(09108) Hospital,137,84,139,360
9505,2020-05-21,(07200) Tygua-San José,198,100,129,427
9506,2020-05-17,(09120) Calle 63,279,176,189,644
9507,2020-02-02,(10010) San Bernardo,409,243,624,1276
9508,2020-07-18,(07506) DESPENSA,314,189,177,680
9509,2020-07-14,(09110) Avenida Jimenez,465,420,513,1398
9510,2020-03-23,(04000) Cabecera Calle 80 - intermunicipal,18,18,48,84
9511,2020-06-30,(07200) Tygua-San José,258,148,161,567
9512,2020-08-09,(05105) Pradera,171,121,122,414
9513,2020-07-16,(12002) CDS - Carrera 32,163,106,85,354
9514,2020-03-23,(04103) Las Ferias,97,55,39,191
9515,2020-07-29,(07010) Bosa,630,305,355,1290
9516,2020-05-30,(04104) Avenida 68,390,216,245,851
9517,2020-07-16,(09111) Calle 19,415,282,350,1047
9518,2020-09-01,(07006) General Santander - alimentacion,388,208,289,885
9519,2020-07-17,(40002) Manitas,282,178,184,644
9520,2020-06-20,(04106) Carrera 47,271,137,162,570
9521,2020-07-06,(12002) CDS - Carrera 32,187,91,89,367
9522,2020-10-07,(09113) Calle 22,398,252,425,1075
9523,2020-04-26,(07006) General Santander - alimentacion,55,50,50,155
9524,2020-05-25,(02303) Calle 85,169,133,115,417
9525,2020-10-09,(07108) Av. El Dorado,177,124,169,470
9526,2020-04-23,(04001) Quirigua,203,128,110,441
9527,2020-09-20,(10003) Ciudad Jardín,83,41,109,233
9528,2020-05-13,(06103) CAN,340,206,142,688
9529,2020-08-24,(09105) Río Fucha,0,60,100,160
9530,2020-05-27,(07008) NQS - Calle 30 Sur,234,112,131,477
9531,2020-04-30,(09106) Nariño,266,124,164,554
9532,2020-10-11,(03005) SUBA - AV. BOYACA,154,76,212,442
9533,2020-03-21,(09111) Calle 19,117,77,91,285
9534,2020-07-20,(12004) Carrera 22,23,21,38,82
9535,2020-01-12,(07006) General Santander,565,260,500,1325
9536,2020-06-09,(09105) Río Fucha,125,59,76,260
9537,2020-05-13,(07200) Tygua-San José,159,72,101,332
9538,2020-04-01,(06100) Av. Rojas,107,96,90,293
9539,2020-06-17,(07101) CASTELLANA,198,136,109,443
9540,2020-05-17,(06105) Quinta Paredes,29,20,18,67
9541,2020-03-25,(09003) Socorro,244,142,140,526
9542,2020-04-22,(09113) Calle 22,226,120,177,523
9543,2020-04-12,(06108) Concejo de Bogotá,39,31,22,92
9544,2020-08-29,(50002) Corral Calle 40 Sur,13,8,17,38
9545,2020-01-12,(50002) Corral Calle 40 Sur,12,9,24,45
9546,2020-05-08,(04102) Avenida Boyaca,205,114,129,448
9547,2020-05-01,(09108) Hospital,36,19,24,79
9548,2020-03-31,(07108) Av. El Dorado,60,48,45,153
9549,2020-04-05,(07101) CASTELLANA,11,16,20,47
9550,2020-04-05,(05103) Marsella,54,35,33,122
9551,2020-04-04,(05101) Mandalay - Cr.73,27,16,15,58
9552,2020-08-09,(07106) EL CAMPIN,86,66,78,230
9553,2020-07-04,(50006) Corral Carrera 77,5,4,8,17
9554,2020-03-22,(03004) GRATAMIRA,11,8,5,24
9555,2020-05-07,(03004) GRATAMIRA,27,18,13,58
9556,2020-01-03,(04000) Cabecera Calle 80 - alimentacion,10972,5674,7980,24626
9557,2020-03-16,(04000) Cabecera Calle 80 - alimentacion,15427,9028,9488,33943
9558,2020-10-09,(04000) Cabecera Calle 80 - alimentacion,5192,2717,4290,12199
9559,2020-02-10,(07005) ALQUERIA,2611,1564,1444,5619
9560,2020-09-17,(09002) Consuelo,525,284,376,1185
9561,2020-10-06,(02502) Terminal,545,383,541,1469
9562,2020-09-13,(09118) Marly,473,312,436,1221
9563,2020-06-02,(07504) TERREROS,5002,3004,2440,10446
9564,2020-06-09,(07504) TERREROS,5323,3134,2616,11073
9565,2020-07-08,(07504) TERREROS,6378,3586,2909,12873
9566,2020-07-08,(10000) Portal 20 de Julio - alimentacion,4416,1998,2530,8944
9567,2020-01-20,(02101) Toberín,13635,8547,7343,29525
9568,2020-05-26,(07505) LEON XIII,2313,1337,1062,4712
9569,2020-02-10,(09122) Calle 72,8732,5555,4288,18575
9570,2020-02-28,(09122) Calle 72,8051,5308,4447,17806
9571,2020-01-07,(08001) Parque el Tunal,1179,678,793,2650
9572,2020-02-20,(04002) Carrera 90,3593,2270,1834,7697
9573,2020-01-15,(05000) Portal Américas,12917,7340,7335,27592
9574,2020-02-22,(04103) Las Ferias,867,463,677,2007
9575,2020-01-16,(02000) Cabecera Autopista Norte - intermunicipal,3967,2520,2630,9117
9576,2020-02-17,(07000) Portal Sur - alimentacion,29156,17407,14444,61007
9577,2020-03-16,(14004) Museo del Oro,2240,1430,1145,4815
9578,2020-09-19,(10000) Portal 20 de Julio - alimentacion,3941,1721,2907,8569
9579,2020-10-02,(09004) Santa Lucía,2896,1406,1936,6238
9580,2020-09-24,(09000) Cabecera Usme,1951,1146,1485,4582
9581,2020-01-23,(06102) Salitre El Greco,1480,807,606,2893
9582,2020-01-16,(10003) Ciudad Jardín,877,471,639,1987
9583,2020-02-06,(10002) Av. Primero de Mayo,8416,4336,4719,17471
9584,2020-02-11,(02204) Pepe Sierra,5212,3424,2511,11147
9585,2020-02-26,(02204) Pepe Sierra,5015,3199,2441,10655
9586,2020-06-11,(07001) PERDOMO,879,493,471,1843
9587,2020-04-22,(09109) Tercer Milenio,144,100,121,365
9588,2020-01-23,(09104) Restrepo,4913,3031,3616,11560
9589,2020-01-15,(04101) Minuto de Dios,2135,1256,1416,4807
9590,2020-06-29,(04101) Minuto de Dios,84,51,98,233
9591,2020-08-21,(04101) Minuto de Dios,328,174,287,789
9592,2020-08-29,(07505) LEON XIII,2316,1133,1115,4564
9593,2020-01-14,(06002) Normandía,1902,1126,1164,4192
9594,2020-02-29,(09110) Avenida Jimenez,3291,2398,2253,7942
9595,2020-02-25,(07112) COMUNEROS,3852,2424,2269,8545
9596,2020-02-05,(09123) Calle 76,5836,3870,3156,12862
9597,2020-02-06,(06106) Recinto Ferial,1634,953,803,3390
9598,2020-07-17,(04100) Carrera 77,1148,638,693,2479
9599,2020-08-27,(07102) NQS - CALLE 75,446,296,215,957
9600,2020-02-26,(09103) Olaya,4285,2378,2418,9081
9601,2020-03-15,(02103) Mazurén,211,111,333,655
9602,2020-02-21,(09104) Restrepo,5041,3020,3865,11926
9603,2020-06-24,(09103) Olaya,1081,609,633,2323
9604,2020-03-18,(14001) La Sabana,293,219,219,731
9605,2020-05-29,(07002) MADELENA,692,368,373,1433
9606,2020-09-01,(07112) COMUNEROS,869,485,525,1879
9607,2020-05-14,(02000) Cabecera Autopista Norte,925,636,516,2077
9608,2020-09-08,(09113) Calle 22,408,237,340,985
9609,2020-07-08,(03003) 21 ANGELES,386,183,211,780
9610,2020-04-15,(09000) Cabecera Usme - alimentacion,4610,2333,2591,9534
9611,2020-10-03,(05000) Portal Américas,3160,1379,2720,7259
9612,2020-01-17,(02104) Calle 146,7807,4378,4496,16681
9613,2020-07-16,(08000) Portal Tunal - alimentacion,4051,2371,2506,8928
9614,2020-08-20,(08000) Portal Tunal - alimentacion,5693,3122,3246,12061
9615,2020-03-14,(05000) Portal Américas,8135,3576,5314,17025
9616,2020-10-07,(09123) Calle 76,1180,807,936,2923
9617,2020-01-06,(09114) Calle 26,148,143,333,624
9618,2020-03-07,(10001) Country Sur,3000,1154,2395,6549
9619,2020-09-23,(10006) San Victorino,806,434,449,1689
9620,2020-10-11,(10000) Portal 20 de Julio - alimentacion,1694,635,1491,3820
9621,2020-06-25,(12001) Carrera 43,453,271,268,992
9622,2020-02-19,(10002) Av. Primero de Mayo,8682,4437,4600,17719
9623,2020-03-13,(10002) Av. Primero de Mayo,322,1263,1151,2736
9624,2020-05-06,(02000) Cabecera Autopista Norte - intermunicipal,277,180,180,637
9625,2020-03-06,(09101) Quiroga,1577,945,1247,3769
9626,2020-08-13,(10000) Portal 20 de Julio - alimentacion,4031,1815,2427,8273
9627,2020-01-05,(03007) HUMEDAL CORDOBA,127,65,111,303
9628,2020-09-08,(04108) El Polo,502,323,266,1091
9629,2020-01-26,(08002) Biblioteca,246,88,238,572
9630,2020-01-30,(08002) Biblioteca,958,540,648,2146
9631,2020-07-01,(10000) Portal 20 de Julio,2421,1235,1282,4938
9632,2020-02-12,(07000) Portal Sur,8183,4951,4260,17394
9633,2020-03-15,(09116) Avenida 39,150,170,319,639
9634,2020-02-20,(02001) Centro Comercial Santa Fe,4728,2953,2448,10129
9635,2020-02-22,(09116) Avenida 39,882,666,1021,2569
9636,2020-03-14,(06108) Concejo de Bogotá,282,164,345,791
9637,2020-08-18,(04000) Cabecera Calle 80,965,618,816,2399
9638,2020-05-11,(14004) Museo del Oro,0,75,160,235
9639,2020-02-19,(07001) PERDOMO,4721,2853,2504,10078
9640,2020-07-03,(05000) Portal Américas,2694,1872,2046,6612
9641,2020-01-14,(10009) Museo Nacional,3480,1823,1688,6991
9642,2020-04-07,(09107) Hortúa,416,283,231,930
9643,2020-04-25,(09107) Hortúa,316,191,146,653
9644,2020-05-18,(09107) Hortúa,558,322,309,1189
9645,2020-03-27,(05000) Portal Américas,1193,764,964,2921
9646,2020-10-03,(03012) SUBA - CALLE 95,230,167,260,657
9647,2020-07-10,(09119) Calle 57,632,408,411,1451
9648,2020-07-27,(50002) Corral Calle 40 Sur,23,13,25,61
9649,2020-03-05,(08000) Portal Tunal,2197,1186,1037,4420
9650,2020-01-20,(03009) Av. Suba- Calle 116,2424,1516,1327,5267
9651,2020-02-07,(03009) Av. Suba- Calle 116,2478,1661,1531,5670
9652,2020-02-29,(06111) Universidades,1960,1315,1897,5172
9653,2020-04-03,(12000) Puente Aranda,43,29,27,99
9654,2020-01-15,(03006) NIZA - CALLE 127,1946,1211,1290,4447
9655,2020-03-11,(04108) El Polo,1817,1175,1117,4109
9656,2020-07-11,(07201) Guatoque -Veraguas,152,106,122,380
9657,2020-09-01,(07101) CASTELLANA,253,133,138,524
9658,2020-01-21,(03007) HUMEDAL CORDOBA,595,374,322,1291
9659,2020-02-08,(03007) HUMEDAL CORDOBA,480,265,366,1111
9660,2020-02-09,(03007) HUMEDAL CORDOBA,146,90,175,411
9661,2020-07-29,(03007) HUMEDAL CORDOBA,128,86,68,282
9662,2020-03-09,(03011) SUBA - CALLE 100,1391,288,430,2109
9663,2020-03-30,(02000) Cabecera Autopista Norte - alimentacion,2579,1333,1250,5162
9664,2020-01-31,(07108) Av. El Dorado,857,561,589,2007
9665,2020-04-13,(08000) Portal Tunal - alimentacion,3358,1794,1760,6912
9666,2020-03-25,(02000) Cabecera Autopista Norte - alimentacion,2812,1460,1200,5472
9667,2020-03-19,(02101) Toberín,5206,2966,2809,10981
9668,2020-01-23,(07104) Simon Bolivar,2208,1379,1152,4739
9669,2020-08-05,(07104) Simon Bolivar,331,243,223,797
9670,2020-08-06,(07104) Simon Bolivar,355,250,226,831
9671,2020-07-13,(10005) Bicentenario - alimentacion,157,67,142,366
9672,2020-01-30,(07004) VENECIA,4568,2587,2526,9681
9673,2020-08-22,(07113) SANTA ISABEL,272,150,225,647
9674,2020-03-31,(09106) Nariño,144,101,123,368
9675,2020-09-17,(09109) Tercer Milenio,372,219,259,850
9676,2020-02-25,(06105) Quinta Paredes,1094,631,452,2177
9677,2020-10-06,(03001) LA CAMPIÑA,1485,788,1010,3283
9678,2020-04-05,(04105) Carrera 53,45,41,23,109
9679,2020-06-07,(40003) Mirador del Paraiso,534,291,375,1200
9680,2020-08-22,(04104) Avenida 68,454,241,279,974
9681,2020-07-11,(09110) Avenida Jimenez,1312,996,923,3231
9682,2020-03-16,(06000) Portal Eldorado,4750,2832,1962,9544
9683,2020-03-01,(03011) SUBA - CALLE 100,439,251,466,1156
9684,2020-05-30,(07009) SENA,462,250,328,1040
9685,2020-05-06,(06000) Portal Eldorado,910,566,379,1855
9686,2020-06-28,(02302) Virrey,179,121,127,427
9687,2020-09-12,(12003) Ricaurte,289,225,207,721
9688,2020-02-08,(06103) CAN,721,514,837,2072
9689,2020-06-14,(06001) Modelia,84,57,70,211
9690,2020-03-08,(03012) SUBA - CALLE 95,314,187,329,830
9691,2020-04-27,(05102) Av. Américas - Av. Boyacá,54,19,14,87
9692,2020-04-11,(07005) ALQUERIA,140,80,85,305
9693,2020-03-21,(10010) San Bernardo,189,127,118,434
9694,2020-05-24,(04003) Avenida Ciudad de Cali,251,131,167,549
9695,2020-08-26,(10005) Bicentenario,85,53,77,215
9696,2020-06-03,(02001) Centro Comercial Santa Fe,383,242,277,902
9697,2020-06-07,(05100) Banderas P. Central - alimentacion,564,277,427,1268
9698,2020-09-11,(06000) Portal Eldorado - alimentacion,3809,1872,2120,7801
9699,2020-03-27,(06103) CAN,342,263,149,754
9700,2020-03-23,(02101) Toberín,252,193,213,658
9701,2020-06-03,(03013) RIO NEGRO,258,185,175,618
9702,2020-06-14,(09120) Calle 63,348,226,283,857
9703,2020-07-15,(09003) Socorro,371,191,195,757
9704,2020-06-30,(06111) Universidades,342,196,368,906
9705,2020-05-22,(02204) Pepe Sierra,698,472,315,1485
9706,2020-10-02,(02200) Alcalá,2280,1435,1602,5317
9707,2020-03-08,(07008) NQS - Calle 30 Sur,450,175,418,1043
9708,2020-07-03,(06109) Centro Memoria,304,176,163,643
9709,2020-03-09,(10007) Las Nieves,1233,74,251,1558
9710,2020-06-04,(06104) Gobernación,249,158,91,498
9711,2020-07-28,(09002) Consuelo,463,266,244,973
9712,2020-05-09,(07105) MOVISTAR ARENA,101,76,78,255
9713,2020-09-23,(07105) MOVISTAR ARENA,283,176,160,619
9714,2020-08-02,(09123) Calle 76,206,162,192,560
9715,2020-09-03,(09113) Calle 22,436,243,374,1053
9716,2020-10-04,(07001) PERDOMO,377,156,364,897
9717,2020-01-11,(40001) Juan Pablo II,1085,519,713,2317
9718,2020-08-04,(06000) Portal Eldorado,820,530,401,1751
9719,2020-05-02,(09119) Calle 57,216,151,154,521
9720,2020-07-16,(06107) Ciudad Universitaria,150,86,82,318
9721,2020-08-04,(12007) Zona Industrial,227,144,119,490
9722,2020-04-19,(10007) Las Nieves,45,40,46,131
9723,2020-09-08,(03005) SUBA - AV. BOYACA,514,303,349,1166
9724,2020-07-13,(03010) PUENTE LARGO,332,215,163,710
9725,2020-05-28,(12004) Carrera 22,158,117,137,412
9726,2020-10-10,(04001) Quirigua,353,178,330,861
9727,2020-03-15,(10009) Museo Nacional,236,222,464,922
9728,2020-05-04,(04106) Carrera 47,211,125,113,449
9729,2020-08-03,(04106) Carrera 47,241,130,141,512
9730,2020-04-28,(09110) Avenida Jimenez,464,350,378,1192
9731,2020-03-30,(07009) SENA,260,181,168,609
9732,2020-04-19,(03013) RIO NEGRO,44,20,23,87
9733,2020-05-31,(08001) Parque el Tunal,118,65,75,258
9734,2020-06-24,(09113) Calle 22,423,242,361,1026
9735,2020-04-08,(09000) Cabecera Usme,828,443,579,1850
9736,2020-09-20,(40001) Juan Pablo II,181,93,196,470
9737,2020-05-13,(07001) PERDOMO,655,375,408,1438
9738,2020-06-01,(04102) Avenida Boyaca,297,177,181,655
9739,2020-07-17,(09100) Calle 40 Sur,1237,776,815,2828
9740,2020-03-25,(04101) Minuto de Dios,154,121,97,372
9741,2020-08-08,(04001) Quirigua,203,123,164,490
9742,2020-07-04,(07109) CAD,445,316,304,1065
9743,2020-09-22,(03010) PUENTE LARGO,411,246,262,919
9744,2020-04-17,(40002) Manitas,175,100,148,423
9745,2020-03-09,(09108) Hospital,31,52,41,124
9746,2020-03-23,(03012) SUBA - CALLE 95,60,45,47,152
9747,2020-04-22,(03012) SUBA - CALLE 95,180,121,93,394
9748,2020-05-14,(10008) San Diego,232,128,138,498
9749,2020-04-19,(02304) Heroes,156,111,86,353
9750,2020-01-12,(09111) Calle 19,285,267,561,1113
9751,2020-08-16,(07000) Portal Sur,439,233,399,1071
9752,2020-01-19,(09108) Hospital,71,47,97,215
9753,2020-04-10,(10002) Av. Primero de Mayo,365,215,180,760
9754,2020-04-17,(10008) San Diego,160,115,102,377
9755,2020-06-20,(12002) CDS - Carrera 32,121,90,66,277
9756,2020-04-21,(12001) Carrera 43,276,189,154,619
9757,2020-08-18,(12007) Zona Industrial,316,205,152,673
9758,2020-06-02,(07008) NQS - Calle 30 Sur,246,128,134,508
9759,2020-10-12,(09108) Hospital,36,27,54,117
9760,2020-05-11,(10005) Bicentenario,84,37,56,177
9761,2020-07-28,(06102) Salitre El Greco,196,134,111,441
9762,2020-07-01,(03004) GRATAMIRA,40,11,24,75
9763,2020-03-20,(09121) Las Flores,464,312,235,1011
9764,2020-04-01,(09106) Nariño,157,116,138,411
9765,2020-04-25,(09121) Las Flores,279,208,190,677
9766,2020-07-02,(04101) Minuto de Dios,358,208,281,847
9767,2020-09-26,(12004) Carrera 22,209,150,152,511
9768,2020-04-01,(07010) Bosa,244,160,197,601
9769,2020-07-21,(07007) NQS - Calle 38A Sur,344,217,225,786
9770,2020-08-11,(07006) General Santander - alimentacion,341,196,238,775
9771,2020-08-20,(09106) Nariño,397,215,279,891
9772,2020-07-14,(10008) San Diego,197,114,119,430
9773,2020-01-31,(50006) Corral Carrera 77,36,23,40,99
9774,2020-03-21,(02000) Cabecera Autopista Norte - intermunicipal,53,53,38,144
9775,2020-03-31,(07104) Simon Bolivar,184,134,109,427
9776,2020-04-08,(04107) Escuela Militar,56,30,35,121
9777,2020-04-10,(03010) PUENTE LARGO,96,69,37,202
9778,2020-01-15,(12000) Puente Aranda,241,145,149,535
9779,2020-03-27,(09105) Río Fucha,59,42,54,155
9780,2020-09-25,(05102) Av. Américas - Av. Boyacá,307,177,202,686
9781,2020-10-12,(09101) Quiroga,204,96,218,518
9782,2020-05-04,(14005) Las Aguas,0,41,104,145
9783,2020-04-19,(12002) CDS - Carrera 32,36,39,16,91
9784,2020-09-07,(09105) Río Fucha,0,64,143,207
9785,2020-04-26,(03011) SUBA - CALLE 100,117,85,67,269
9786,2020-08-17,(14005) Las Aguas,46,24,71,141
9787,2020-10-09,(50002) Corral Calle 40 Sur,29,16,49,94
9788,2020-03-15,(50002) Corral Calle 40 Sur,16,8,33,57
9789,2020-06-15,(04108) El Polo,111,66,100,277
9790,2020-08-07,(50002) Corral Calle 40 Sur,4,0,10,14
9791,2020-09-13,(12003) Ricaurte,50,39,65,154
9792,2020-04-14,(05101) Mandalay - Cr.73,58,36,26,120
9793,2020-06-07,(07106) EL CAMPIN,104,65,74,243
9794,2020-09-05,(09108) Hospital,36,41,76,153
9795,2020-09-27,(09105) Río Fucha,0,30,81,111
9796,2020-02-18,(50006) Corral Carrera 77,33,16,37,86
9797,2020-09-19,(03014) SAN MARTIN,0,4,30,34
9798,2020-08-21,(03014) SAN MARTIN,0,12,36,48
9799,2020-08-09,(07101) CASTELLANA,23,18,37,78
9800,2020-04-09,(50006) Corral Carrera 77,4,5,2,11
9801,2020-06-18,(50006) Corral Carrera 77,7,1,8,16
9802,2020-03-05,(04000) Cabecera Calle 80 - alimentacion,23964,14148,14804,52916
9803,2020-06-03,(04000) Cabecera Calle 80 - alimentacion,3524,2011,2147,7682
9804,2020-07-14,(03013) RIO NEGRO,252,142,161,555
9805,2020-05-18,(07504) TERREROS,4162,2599,2168,8929
9806,2020-09-18,(09119) Calle 57,658,426,526,1610
9807,2020-09-25,(09119) Calle 57,690,454,581,1725
9808,2020-10-02,(09119) Calle 57,663,460,598,1721
9809,2020-03-19,(03000) Portal Suba - alimentacion,14414,7586,7974,29974
9810,2020-01-10,(03002) SUBA - TV- 91,3224,1711,1928,6863
9811,2020-03-04,(03002) SUBA - TV- 91,4570,2656,2502,9728
9812,2020-03-16,(07503) SAN MATEO,30806,17314,12763,60883
9813,2020-09-11,(07503) SAN MATEO,9801,5940,6363,22104
9814,2020-02-17,(05000) Portal Américas,15104,8923,8057,32084
9815,2020-03-04,(09100) Calle 40 Sur,7535,4301,4010,15846
9816,2020-02-16,(05000) Portal Américas - alimentacion,9656,4013,7182,20851
9817,2020-01-23,(09100) Calle 40 Sur,6862,3715,3901,14478
9818,2020-06-19,(07503) SAN MATEO,11454,6899,5920,24273
9819,2020-07-13,(07503) SAN MATEO,10393,6062,4649,21104
9820,2020-06-24,(05000) Portal Américas - alimentacion,11211,6009,5481,22701
9821,2020-03-03,(06107) Ciudad Universitaria,1825,1058,937,3820
9822,2020-03-04,(06107) Ciudad Universitaria,1770,1027,945,3742
9823,2020-10-06,(09001) Molinos,2975,1504,2333,6812
9824,2020-02-02,(05000) Portal Américas,2740,1249,2716,6705
9825,2020-03-05,(07010) Bosa,2216,1198,1429,4843
9826,2020-01-26,(09104) Restrepo,1104,692,1412,3208
9827,2020-08-18,(05100) Banderas P. Central,720,415,477,1612
9828,2020-09-14,(09100) Calle 40 Sur,1803,1048,1245,4096
9829,2020-02-06,(02102) Calle 161,1861,1139,1148,4148
9830,2020-03-04,(09115) Calle 34,4508,2821,2491,9820
9831,2020-03-05,(02105) Calle 142,6981,4230,3893,15104
9832,2020-03-02,(04000) Cabecera Calle 80,7419,4560,4912,16891
9833,2020-09-13,(10000) Portal 20 de Julio - alimentacion,1570,591,1241,3402
9834,2020-02-02,(03000) Portal Suba - alimentacion,6067,2796,5867,14730
9835,2020-02-07,(06104) Gobernación,1396,789,706,2891
9836,2020-06-15,(09104) Restrepo,536,346,446,1328
9837,2020-07-27,(09104) Restrepo,1325,832,981,3138
9838,2020-06-02,(07505) LEON XIII,2436,1406,1067,4909
9839,2020-02-26,(06002) Normandía,2753,1551,1311,5615
9840,2020-02-10,(07112) COMUNEROS,3856,2348,2287,8491
9841,2020-02-19,(09123) Calle 76,6008,3878,3232,13118
9842,2020-06-24,(09118) Marly,1493,967,766,3226
9843,2020-03-14,(03001) LA CAMPIÑA,2958,1239,2178,6375
9844,2020-02-20,(14001) La Sabana,600,386,356,1342
9845,2020-08-23,(07106) EL CAMPIN,81,75,107,263
9846,2020-03-10,(04102) Avenida Boyaca,666,584,476,1726
9847,2020-02-02,(10002) Av. Primero de Mayo,1694,768,1846,4308
9848,2020-07-11,(08000) Portal Tunal - alimentacion,5516,2978,3310,11804
9849,2020-07-30,(50003) Corral Molinos,1416,729,950,3095
9850,2020-01-11,(04000) Cabecera Calle 80,3002,1460,2732,7194
9851,2020-10-08,(09110) Avenida Jimenez,1579,1090,1190,3859
9852,2020-03-03,(05002) Tintal,11426,6490,6012,23928
9853,2020-07-21,(09001) Molinos,1895,1052,1302,4249
9854,2020-06-24,(10001) Country Sur,1244,582,739,2565
9855,2020-10-05,(40003) Mirador del Paraiso,1827,1010,1387,4224
9856,2020-04-15,(10002) Av. Primero de Mayo,1175,632,759,2566
9857,2020-05-15,(10000) Portal 20 de Julio - alimentacion,3371,1582,1939,6892
9858,2020-04-21,(08000) Portal Tunal - alimentacion,3496,1833,1801,7130
9859,2020-03-06,(09108) Hospital,244,166,177,587
9860,2020-06-16,(08002) Biblioteca,332,184,195,711
9861,2020-08-20,(10000) Portal 20 de Julio,2011,985,1109,4105
9862,2020-04-19,(07000) Portal Sur - alimentacion,1520,844,594,2958
9863,2020-09-01,(02303) Calle 85,804,502,417,1723
9864,2020-03-17,(09004) Santa Lucía,5401,2812,2754,10967
9865,2020-05-19,(08001) Parque el Tunal,394,212,193,799
9866,2020-05-24,(08001) Parque el Tunal,106,51,78,235
9867,2020-08-05,(08001) Parque el Tunal,443,235,274,952
9868,2020-07-24,(10001) Country Sur,865,394,537,1796
9869,2020-05-07,(10002) Av. Primero de Mayo,1467,769,923,3159
9870,2020-04-17,(02201) Prado,450,302,265,1017
9871,2020-03-31,(02000) Cabecera Autopista Norte,505,357,304,1166
9872,2020-05-27,(06001) Modelia,373,236,182,791
9873,2020-08-19,(06102) Salitre El Greco,216,117,132,465
9874,2020-01-04,(07110) PALOQUEMAO,748,505,532,1785
9875,2020-09-05,(05002) Tintal,2148,1056,1648,4852
9876,2020-01-10,(05105) Pradera,1757,1120,1002,3879
9877,2020-08-15,(50002) Corral Calle 40 Sur,14,11,19,44
9878,2020-02-01,(04104) Avenida 68,1735,986,1401,4122
9879,2020-06-16,(05101) Mandalay - Cr.73,126,71,79,276
9880,2020-06-30,(05005) Transversal 86,0,192,484,676
9881,2020-07-26,(05005) Transversal 86,64,35,60,159
9882,2020-09-27,(05105) Pradera,181,114,174,469
9883,2020-02-25,(06109) Centro Memoria,1236,686,596,2518
9884,2020-08-12,(06109) Centro Memoria,238,136,132,506
9885,2020-08-27,(05107) Américas - Cr.53,397,242,219,858
9886,2020-01-28,(09106) Nariño,1948,1196,1315,4459
9887,2020-07-28,(02205) Calle 106,324,213,165,702
9888,2020-09-10,(09101) Quiroga,542,251,376,1169
9889,2020-01-20,(10008) San Diego,1308,696,765,2769
9890,2020-09-14,(04101) Minuto de Dios,344,211,306,861
9891,2020-02-23,(07201) Guatoque -Veraguas,116,78,254,448
9892,2020-09-16,(05001) Patio Bonito,2245,1217,1381,4843
9893,2020-08-28,(02201) Prado,862,602,555,2019
9894,2020-07-10,(07010) Bosa,790,356,521,1667
9895,2020-08-30,(07113) SANTA ISABEL,136,60,146,342
9896,2020-08-29,(14004) Museo del Oro,141,103,164,408
9897,2020-02-10,(06101) El Tiempo,2941,1740,1460,6141
9898,2020-05-22,(03007) HUMEDAL CORDOBA,133,87,56,276
9899,2020-09-17,(04104) Avenida 68,732,346,393,1471
9900,2020-03-11,(03011) SUBA - CALLE 100,2431,1363,1417,5211
9901,2020-02-29,(03005) SUBA - AV. BOYACA,1468,817,1178,3463
9902,2020-01-29,(04103) Las Ferias,1549,848,849,3246
9903,2020-06-21,(09100) Calle 40 Sur,565,318,435,1318
9904,2020-01-15,(07109) CAD,2547,1528,1377,5452
9905,2020-06-10,(08002) Biblioteca,301,168,149,618
9906,2020-03-04,(06109) Centro Memoria,1135,654,645,2434
9907,2020-10-01,(07103) AV. CHILE,1006,645,656,2307
9908,2020-09-15,(03001) LA CAMPIÑA,1295,700,798,2793
9909,2020-10-08,(03001) LA CAMPIÑA,1435,752,1006,3193
9910,2020-09-17,(04105) Carrera 53,326,169,198,693
9911,2020-01-22,(06101) El Tiempo,2691,1525,1361,5577
9912,2020-03-14,(06101) El Tiempo,844,586,872,2302
9913,2020-09-16,(04001) Quirigua,432,279,319,1030
9914,2020-05-15,(05001) Patio Bonito,1254,670,730,2654
9915,2020-01-26,(03001) LA CAMPIÑA,1163,534,1062,2759
9916,2020-01-25,(07003) SEVILLANA,1207,577,795,2579
9917,2020-09-06,(07003) SEVILLANA,110,52,143,305
9918,2020-08-21,(02105) Calle 142,698,443,418,1559
9919,2020-05-21,(07009) SENA,535,308,291,1134
9920,2020-05-21,(06000) Portal Eldorado,983,657,383,2023
9921,2020-07-15,(02302) Virrey,491,336,249,1076
9922,2020-05-11,(12003) Ricaurte,281,197,131,609
9923,2020-05-20,(12003) Ricaurte,321,204,163,688
9924,2020-08-06,(03010) PUENTE LARGO,267,187,173,627
9925,2020-09-06,(03010) PUENTE LARGO,70,71,112,253
9926,2020-05-02,(04000) Cabecera Calle 80,411,267,259,937
9927,2020-09-02,(10010) San Bernardo,606,311,448,1365
9928,2020-02-23,(06001) Modelia,290,180,326,796
9929,2020-09-05,(02105) Calle 142,627,359,531,1517
9930,2020-01-14,(08002) Biblioteca,860,455,598,1913
9931,2020-03-26,(07005) ALQUERIA,247,160,133,540
9932,2020-04-29,(09000) Cabecera Usme,944,610,663,2217
9933,2020-08-19,(07103) AV. CHILE,915,551,423,1889
9934,2020-01-09,(06108) Concejo de Bogotá,600,317,346,1263
9935,2020-01-24,(10005) Bicentenario,707,390,376,1473
9936,2020-03-16,(04000) Cabecera Calle 80 - intermunicipal,1091,788,1307,3186
9937,2020-07-18,(09123) Calle 76,548,401,381,1330
9938,2020-05-18,(05100) Banderas P. Central - alimentacion,2217,1116,1125,4458
9939,2020-09-09,(12007) Zona Industrial,409,242,213,864
9940,2020-09-18,(12007) Zona Industrial,385,246,226,857
9941,2020-09-26,(12007) Zona Industrial,278,210,198,686
9942,2020-03-18,(07105) MOVISTAR ARENA,688,510,339,1537
9943,2020-04-01,(06109) Centro Memoria,154,110,106,370
9944,2020-07-26,(09001) Molinos,570,287,408,1265
9945,2020-05-14,(10006) San Victorino,356,208,225,789
9946,2020-09-26,(02101) Toberín,1182,598,1224,3004
9947,2020-05-12,(02104) Calle 146,548,383,316,1247
9948,2020-07-07,(02200) Alcalá,1978,1335,1082,4395
9949,2020-10-02,(10008) San Diego,328,192,262,782
9950,2020-09-22,(10009) Museo Nacional,564,337,419,1320
9951,2020-09-05,(09120) Calle 63,1020,718,819,2557
9952,2020-08-27,(05105) Pradera,585,330,291,1206
9953,2020-07-10,(06111) Universidades,365,231,349,945
9954,2020-03-05,(07111) NQS - RICAURTE,3113,2016,1785,6914
9955,2020-07-28,(09115) Calle 34,612,377,334,1323
9956,2020-04-13,(07000) Portal Sur,867,554,520,1941
9957,2020-05-30,(07000) Portal Sur,1268,746,778,2792
9958,2020-04-29,(07110) PALOQUEMAO,510,318,218,1046
9959,2020-05-18,(02200) Alcalá,1422,1020,735,3177
9960,2020-03-19,(07006) General Santander,1329,694,663,2686
9961,2020-06-08,(09111) Calle 19,748,453,411,1612
9962,2020-01-19,(07004) VENECIA,1026,505,924,2455
9963,2020-07-25,(03012) SUBA - CALLE 95,194,128,100,422
9964,2020-07-15,(09122) Calle 72,964,611,599,2174
9965,2020-08-07,(09122) Calle 72,368,260,323,951
9966,2020-05-18,(12002) CDS - Carrera 32,182,124,68,374
9967,2020-03-26,(06104) Gobernación,136,118,65,319
9968,2020-04-05,(06109) Centro Memoria,58,42,29,129
9969,2020-08-25,(09111) Calle 19,653,385,430,1468
9970,2020-09-22,(07009) SENA,697,435,553,1685
9971,2020-06-26,(07105) MOVISTAR ARENA,280,167,150,597
9972,2020-06-12,(02200) Alcalá,1819,1240,900,3959
9973,2020-09-09,(09115) Calle 34,682,428,532,1642
9974,2020-03-08,(07107) U. NACIONAL,288,223,494,1005
9975,2020-09-07,(09114) Calle 26,345,225,271,841
9976,2020-04-05,(07000) Portal Sur,251,134,178,563
9977,2020-07-05,(04100) Carrera 77,382,191,360,933
9978,2020-08-27,(10004) Policarpa,223,115,129,467
9979,2020-06-05,(04103) Las Ferias,331,189,174,694
9980,2020-09-16,(14005) Las Aguas,232,149,268,649
9981,2020-05-16,(07506) DESPENSA,264,165,174,603
9982,2020-07-28,(12004) Carrera 22,225,117,116,458
9983,2020-09-03,(09111) Calle 19,824,496,547,1867
9984,2020-05-30,(04107) Escuela Militar,88,69,56,213
9985,2020-04-23,(09003) Socorro,264,157,225,646
9986,2020-09-06,(40003) Mirador del Paraiso,702,345,584,1631
9987,2020-07-30,(03010) PUENTE LARGO,316,215,179,710
9988,2020-04-02,(09122) Calle 72,539,420,346,1305
9989,2020-04-03,(07001) PERDOMO,455,266,320,1041
9990,2020-08-01,(04102) Avenida Boyaca,180,113,154,447
9991,2020-07-24,(12002) CDS - Carrera 32,170,86,61,317
9992,2020-09-11,(04000) Cabecera Calle 80 - intermunicipal,369,183,353,905
9993,2020-04-13,(04101) Minuto de Dios,159,117,122,398
9994,2020-08-22,(06108) Concejo de Bogotá,76,43,77,196
9995,2020-09-01,(04001) Quirigua,379,219,282,880
9996,2020-09-02,(04000) Cabecera Calle 80 - intermunicipal,407,195,350,952
9997,2020-05-06,(03010) PUENTE LARGO,238,176,134,548
9998,2020-09-16,(09108) Hospital,70,40,50,160
9999,2020-03-23,(06102) Salitre El Greco,79,66,41,186
10000,2020-05-30,(09117) Calle 45,447,268,305,1020
10001,2020-04-15,(03003) 21 ANGELES,119,62,97,278
10002,2020-03-27,(03014) SAN MARTIN,18,8,19,45
10003,2020-05-25,(07104) Simon Bolivar,158,111,112,381
10004,2020-08-22,(07010) Bosa,497,227,339,1063
10005,2020-10-04,(02502) Terminal,104,88,236,428
10006,2020-05-22,(07107) U. NACIONAL,277,184,142,603
10007,2020-07-05,(07006) General Santander,183,78,138,399
10008,2020-07-30,(09106) Nariño,356,217,248,821
10009,2020-03-20,(09113) Calle 22,151,81,76,308
10010,2020-04-12,(07506) DESPENSA,81,49,40,170
10011,2020-05-10,(07006) General Santander - alimentacion,66,43,54,163
10012,2020-05-09,(06101) El Tiempo,161,97,110,368
10013,2020-05-20,(03004) GRATAMIRA,29,14,15,58
10014,2020-04-07,(03006) NIZA - CALLE 127,230,162,105,497
10015,2020-05-10,(07004) VENECIA,190,97,108,395
10016,2020-01-01,(10008) San Diego,60,67,164,291
10017,2020-06-28,(04002) Carrera 90,220,99,136,455
10018,2020-08-07,(12001) Carrera 43,106,70,84,260
10019,2020-06-10,(12004) Carrera 22,208,104,112,424
10020,2020-04-16,(09114) Calle 26,146,120,104,370
10021,2020-04-04,(06104) Gobernación,74,74,49,197
10022,2020-08-27,(14004) Museo del Oro,288,178,218,684
10023,2020-04-18,(10003) Ciudad Jardín,73,34,38,145
10024,2020-05-17,(02000) Cabecera Autopista Norte - intermunicipal,56,53,61,170
10025,2020-04-02,(04107) Escuela Militar,55,42,39,136
10026,2020-05-27,(04102) Avenida Boyaca,252,159,154,565
10027,2020-08-03,(03007) HUMEDAL CORDOBA,110,74,53,237
10028,2020-05-07,(04102) Avenida Boyaca,186,112,129,427
10029,2020-04-26,(05107) Américas - Cr.53,73,69,69,211
10030,2020-05-25,(10003) Ciudad Jardín,51,25,28,104
10031,2020-05-13,(50002) Corral Calle 40 Sur,15,10,14,39
10032,2020-05-01,(05102) Av. Américas - Av. Boyacá,73,41,31,145
10033,2020-06-14,(09108) Hospital,39,17,19,75
10034,2020-07-07,(50006) Corral Carrera 77,7,2,8,17
10035,2020-04-01,(06106) Recinto Ferial,119,84,69,272
10036,2020-03-21,(14005) Las Aguas,0,27,57,84
10037,2020-06-15,(06105) Quinta Paredes,35,30,42,107
10038,2020-04-09,(04001) Quirigua,60,47,24,131
10039,2020-06-26,(50006) Corral Carrera 77,7,2,8,17
10040,2020-10-13,(05001) Patio Bonito,0,0,1,1
10041,2020-01-11,(09002) Consuelo,826,372,657,1855
10042,2020-02-12,(09002) Consuelo,1510,811,872,3193
10043,2020-01-10,(02502) Terminal,3348,2046,2260,7654
10044,2020-04-02,(09118) Marly,1046,712,468,2226
10045,2020-08-06,(09118) Marly,1354,849,656,2859
10046,2020-10-03,(09118) Marly,1139,759,1048,2946
10047,2020-09-09,(07504) TERREROS,6636,3598,3483,13717
10048,2020-10-02,(07504) TERREROS,7433,3609,4392,15434
10049,2020-09-15,(05000) Portal Américas - alimentacion,11531,6308,6558,24397
10050,2020-03-15,(08000) Portal Tunal - alimentacion,4646,2057,3162,9865
10051,2020-09-30,(03000) Portal Suba - alimentacion,7419,4012,5068,16499
10052,2020-01-28,(09122) Calle 72,7135,4586,3891,15612
10053,2020-02-05,(09122) Calle 72,7415,4812,4048,16275
10054,2020-09-30,(06000) Portal Eldorado - alimentacion,4444,2139,2808,9391
10055,2020-01-17,(03010) PUENTE LARGO,1845,1153,1115,4113
10056,2020-01-29,(07111) NQS - RICAURTE,3139,1943,1770,6852
10057,2020-02-04,(07111) NQS - RICAURTE,3235,2074,1817,7126
10058,2020-01-03,(10000) Portal 20 de Julio - alimentacion,7062,3154,5103,15319
10059,2020-04-21,(05000) Portal Américas - alimentacion,6246,3275,2631,12152
10060,2020-04-25,(05000) Portal Américas - alimentacion,4872,2621,2064,9557
10061,2020-01-23,(06107) Ciudad Universitaria,1452,857,854,3163
10062,2020-02-21,(06107) Ciudad Universitaria,1398,859,914,3171
10063,2020-08-28,(06107) Ciudad Universitaria,162,101,154,417
10064,2020-07-30,(09001) Molinos,2364,1357,1602,5323
10065,2020-01-17,(02000) Cabecera Autopista Norte - alimentacion,20259,10703,12439,43401
10066,2020-01-10,(07000) Portal Sur - alimentacion,22605,12014,12083,46702
10067,2020-03-11,(08000) Portal Tunal - alimentacion,23028,12271,11096,46395
10068,2020-10-10,(07112) COMUNEROS,689,371,618,1678
10069,2020-09-04,(09100) Calle 40 Sur,1932,1127,1314,4373
10070,2020-06-11,(09000) Cabecera Usme,1648,1027,1133,3808
10071,2020-06-16,(09000) Cabecera Usme,1684,1109,1123,3916
10072,2020-01-03,(02102) Calle 161,709,415,572,1696
10073,2020-02-29,(07009) SENA,2271,1154,1602,5027
10074,2020-01-25,(07005) ALQUERIA,1563,817,1013,3393
10075,2020-03-10,(08000) Portal Tunal - alimentacion,985,6081,3956,11022
10076,2020-03-06,(40003) Mirador del Paraiso,4707,2677,2591,9975
10077,2020-01-16,(04100) Carrera 77,5576,3022,3659,12257
10078,2020-05-07,(07505) LEON XIII,1572,978,817,3367
10079,2020-08-23,(07505) LEON XIII,745,357,424,1526
10080,2020-10-12,(07504) TERREROS,1991,934,1756,4681
10081,2020-09-07,(05002) Tintal,2621,1601,1668,5890
10082,2020-02-28,(05001) Patio Bonito,7340,3844,3750,14934
10083,2020-04-15,(09101) Quiroga,259,126,141,526
10084,2020-05-03,(03013) RIO NEGRO,54,35,29,118
10085,2020-02-12,(50003) Corral Molinos,3574,2237,3591,9402
10086,2020-02-12,(03007) HUMEDAL CORDOBA,1084,651,522,2257
10087,2020-02-04,(09116) Avenida 39,3191,2000,1660,6851
10088,2020-01-20,(02303) Calle 85,3486,2344,1856,7686
10089,2020-02-03,(02303) Calle 85,3772,2476,1900,8148
10090,2020-01-25,(07000) Portal Sur - alimentacion,18721,9411,10934,39066
10091,2020-07-29,(07000) Portal Sur - alimentacion,6744,3888,3483,14115
10092,2020-08-26,(07000) Portal Sur - alimentacion,7542,4398,3924,15864
10093,2020-09-11,(05100) Banderas P. Central - alimentacion,3256,1600,1969,6825
10094,2020-09-04,(09103) Olaya,1146,616,651,2413
10095,2020-04-30,(07111) NQS - RICAURTE,624,420,232,1276
10096,2020-08-21,(07111) NQS - RICAURTE,1118,668,462,2248
10097,2020-09-26,(02000) Cabecera Autopista Norte - alimentacion,4489,1931,3223,9643
10098,2020-01-19,(02104) Calle 146,1145,555,1308,3008
10099,2020-01-15,(09114) Calle 26,2343,1635,1415,5393
10100,2020-01-20,(04000) Cabecera Calle 80,6685,4041,4525,15251
10101,2020-01-03,(05002) Tintal,5925,2925,3527,12377
10102,2020-02-02,(02201) Prado,1134,548,1162,2844
10103,2020-01-02,(04003) Avenida Ciudad de Cali,2387,1385,1670,5442
10104,2020-01-09,(10001) Country Sur,3779,1628,2115,7522
10105,2020-03-24,(09000) Cabecera Usme - alimentacion,6730,3138,4338,14206
10106,2020-03-04,(03000) Portal Suba,9715,5635,5170,20520
10107,2020-03-05,(03000) Portal Suba,9665,5417,5153,20235
10108,2020-09-12,(03000) Portal Suba,1070,578,877,2525
10109,2020-02-05,(40003) Mirador del Paraiso,4944,2751,2806,10501
10110,2020-01-08,(12001) Carrera 43,1140,702,848,2690
10111,2020-05-16,(12001) Carrera 43,233,142,147,522
10112,2020-02-15,(40003) Mirador del Paraiso,3998,2043,2444,8485
10113,2020-02-22,(40003) Mirador del Paraiso,3994,2010,2316,8320
10114,2020-06-12,(02105) Calle 142,745,461,424,1630
10115,2020-09-23,(09000) Cabecera Usme - alimentacion,9806,4983,6086,20875
10116,2020-07-14,(09000) Cabecera Usme - alimentacion,5203,3085,3128,11416
10117,2020-02-26,(08001) Parque el Tunal,1731,880,964,3575
10118,2020-06-12,(08001) Parque el Tunal,473,281,273,1027
10119,2020-06-07,(10000) Portal 20 de Julio,628,279,408,1315
10120,2020-01-11,(10006) San Victorino,793,597,782,2172
10121,2020-06-04,(02303) Calle 85,612,443,289,1344
10122,2020-01-08,(07008) NQS - Calle 30 Sur,1328,703,833,2864
10123,2020-04-02,(07503) SAN MATEO,5445,2998,2687,11130
10124,2020-04-23,(08001) Parque el Tunal,236,133,130,499
10125,2020-06-02,(09116) Avenida 39,291,188,177,656
10126,2020-07-08,(09116) Avenida 39,398,235,206,839
10127,2020-03-26,(14004) Museo del Oro,0,63,121,184
10128,2020-01-05,(06002) Normandía,232,114,253,599
10129,2020-10-02,(09123) Calle 76,1186,814,927,2927
10130,2020-05-25,(05103) Marsella,88,53,50,191
10131,2020-03-05,(10009) Museo Nacional,4259,2337,1963,8559
10132,2020-09-19,(07005) ALQUERIA,523,272,391,1186
10133,2020-02-13,(03007) HUMEDAL CORDOBA,1040,619,536,2195
10134,2020-08-24,(02201) Prado,772,543,430,1745
10135,2020-03-01,(07007) NQS - Calle 38A Sur,686,375,502,1563
10136,2020-01-27,(02104) Calle 146,8968,5909,4636,19513
10137,2020-02-14,(05105) Pradera,2618,1596,1223,5437
10138,2020-02-20,(05105) Pradera,2639,1599,1125,5363
10139,2020-08-23,(07104) Simon Bolivar,109,74,121,304
10140,2020-10-07,(07104) Simon Bolivar,656,388,410,1454
10141,2020-05-20,(09001) Molinos,1985,1133,1288,4406
10142,2020-05-06,(09104) Restrepo,880,561,613,2054
10143,2020-05-25,(09104) Restrepo,426,270,341,1037
10144,2020-09-30,(02302) Virrey,756,548,467,1771
10145,2020-09-28,(05105) Pradera,641,418,401,1460
10146,2020-06-09,(06109) Centro Memoria,274,158,132,564
10147,2020-05-02,(02205) Calle 106,134,102,81,317
10148,2020-09-15,(02205) Calle 106,428,269,273,970
10149,2020-06-01,(06000) Portal Eldorado - alimentacion,3758,1935,1739,7432
10150,2020-06-27,(02300) Calle 100,800,579,605,1984
10151,2020-02-25,(10009) Museo Nacional,4764,2485,1892,9141
10152,2020-03-01,(07101) CASTELLANA,68,81,185,334
10153,2020-10-05,(07113) SANTA ISABEL,458,286,424,1168
10154,2020-07-02,(10006) San Victorino,755,325,342,1422
10155,2020-09-23,(04104) Avenida 68,762,371,493,1626
10156,2020-02-02,(04000) Cabecera Calle 80,1308,680,1582,3570
10157,2020-06-20,(04000) Cabecera Calle 80,798,458,672,1928
10158,2020-08-20,(02204) Pepe Sierra,682,506,372,1560
10159,2020-08-28,(02101) Toberín,1462,885,1049,3396
10160,2020-05-11,(09115) Calle 34,483,335,254,1072
10161,2020-01-01,(04102) Avenida Boyaca,184,104,243,531
10162,2020-04-17,(02304) Heroes,394,306,240,940
10163,2020-05-26,(09100) Calle 40 Sur,1484,899,969,3352
10164,2020-07-09,(10005) Bicentenario - alimentacion,205,98,183,486
10165,2020-09-16,(10005) Bicentenario - alimentacion,216,119,215,550
10166,2020-03-04,(04107) Escuela Militar,667,429,421,1517
10167,2020-03-01,(03001) LA CAMPIÑA,1130,488,1213,2831
10168,2020-01-09,(04108) El Polo,1391,895,938,3224
10169,2020-03-13,(14005) Las Aguas,872,167,437,1476
10170,2020-09-21,(06101) El Tiempo,277,190,183,650
10171,2020-03-30,(09000) Cabecera Usme - alimentacion,4367,2048,2400,8815
10172,2020-08-30,(06100) Av. Rojas,32,34,72,138
10173,2020-02-06,(03003) 21 ANGELES,1746,870,881,3497
10174,2020-04-02,(02202) Calle 127,625,500,340,1465
10175,2020-05-06,(10001) Country Sur,709,318,439,1466
10176,2020-07-30,(09120) Calle 63,1091,744,645,2480
10177,2020-04-19,(06100) Av. Rojas,33,22,20,75
10178,2020-06-08,(07106) EL CAMPIN,322,228,221,771
10179,2020-07-01,(10010) San Bernardo,635,364,495,1494
10180,2020-03-28,(10000) Portal 20 de Julio - alimentacion,1945,707,977,3629
10181,2020-06-10,(02105) Calle 142,715,445,441,1601
10182,2020-09-14,(02105) Calle 142,882,545,622,2049
10183,2020-03-10,(09109) Tercer Milenio,357,241,207,805
10184,2020-04-23,(09109) Tercer Milenio,174,131,118,423
10185,2020-03-20,(05102) Av. Américas - Av. Boyacá,142,73,70,285
10186,2020-05-12,(07007) NQS - Calle 38A Sur,250,158,157,565
10187,2020-08-26,(02103) Mazurén,199,128,161,488
10188,2020-01-07,(07201) Guatoque -Veraguas,628,348,486,1462
10189,2020-07-19,(10005) Bicentenario,26,18,25,69
10190,2020-08-01,(40002) Manitas,310,172,211,693
10191,2020-03-13,(02102) Calle 161,129,280,253,662
10192,2020-08-05,(10006) San Victorino,724,330,272,1326
10193,2020-08-25,(06105) Quinta Paredes,133,74,79,286
10194,2020-03-21,(09120) Calle 63,362,215,181,758
10195,2020-08-31,(09120) Calle 63,1091,713,712,2516
10196,2020-06-19,(10009) Museo Nacional,493,320,368,1181
10197,2020-07-27,(06111) Universidades,326,200,269,795
10198,2020-09-29,(06100) Av. Rojas,284,182,212,678
10199,2020-05-22,(40001) Juan Pablo II,453,292,267,1012
10200,2020-06-17,(40001) Juan Pablo II,558,376,345,1279
10201,2020-03-24,(06105) Quinta Paredes,134,97,77,308
10202,2020-04-27,(02201) Prado,218,145,87,450
10203,2020-05-11,(12004) Carrera 22,155,86,90,331
10204,2020-05-02,(09123) Calle 76,350,296,283,929
10205,2020-05-18,(07004) VENECIA,775,473,404,1652
10206,2020-05-30,(09122) Calle 72,741,533,495,1769
10207,2020-10-11,(04002) Carrera 90,272,105,251,628
10208,2020-06-26,(07111) NQS - RICAURTE,1212,723,505,2440
10209,2020-09-07,(06102) Salitre El Greco,219,121,143,483
10210,2020-07-18,(06104) Gobernación,114,70,78,262
10211,2020-03-20,(04000) Cabecera Calle 80,549,349,347,1245
10212,2020-07-20,(07201) Guatoque -Veraguas,29,21,48,98
10213,2020-06-16,(09121) Las Flores,735,473,404,1612
10214,2020-02-03,(07506) DESPENSA,1672,975,955,3602
10215,2020-10-01,(02200) Alcalá,2164,1381,1561,5106
10216,2020-05-08,(07107) U. NACIONAL,244,152,139,535
10217,2020-06-03,(07107) U. NACIONAL,317,178,140,635
10218,2020-10-07,(10004) Policarpa,296,136,233,665
10219,2020-08-17,(06107) Ciudad Universitaria,49,37,39,125
10220,2020-06-16,(10004) Policarpa,218,112,137,467
10221,2020-05-13,(10007) Las Nieves,399,240,255,894
10222,2020-07-14,(12003) Ricaurte,199,154,112,465
10223,2020-05-29,(12000) Puente Aranda,82,43,23,148
10224,2020-05-23,(07506) DESPENSA,287,166,182,635
10225,2020-09-04,(02102) Calle 161,281,163,208,652
10226,2020-09-08,(02102) Calle 161,273,159,207,639
10227,2020-04-03,(06101) El Tiempo,213,169,125,507
10228,2020-10-03,(09107) Hortúa,475,275,448,1198
10229,2020-06-03,(09119) Calle 57,495,347,289,1131
10230,2020-07-22,(07200) Tygua-San José,157,87,135,379
10231,2020-09-29,(07200) Tygua-San José,287,160,203,650
10232,2020-02-17,(09105) Río Fucha,854,497,495,1846
10233,2020-05-21,(04104) Avenida 68,508,285,262,1055
10234,2020-06-23,(02502) Terminal,418,328,342,1088
10235,2019-12-31,(06000) Portal Eldorado - alimentacion,306,117,180,603
10236,2020-04-20,(07112) COMUNEROS,423,290,211,924
10237,2020-05-05,(04102) Avenida Boyaca,200,122,141,463
10238,2020-04-21,(40001) Juan Pablo II,274,150,170,594
10239,2020-07-26,(07108) Av. El Dorado,32,19,32,83
10240,2020-02-23,(03003) 21 ANGELES,353,129,296,778
10241,2020-06-09,(04000) Cabecera Calle 80 - intermunicipal,284,155,263,702
10242,2020-09-26,(04001) Quirigua,308,182,300,790
10243,2020-05-16,(06001) Modelia,223,134,161,518
10244,2020-08-05,(09108) Hospital,65,34,63,162
10245,2020-08-20,(07006) General Santander - alimentacion,337,182,231,750
10246,2020-03-27,(03012) SUBA - CALLE 95,156,114,105,375
10247,2020-01-12,(04107) Escuela Militar,102,65,172,339
10248,2020-06-04,(10008) San Diego,266,148,148,562
10249,2020-03-21,(02502) Terminal,87,69,68,224
10250,2020-03-01,(05105) Pradera,505,352,468,1325
10251,2020-09-03,(07200) Tygua-San José,260,131,168,559
10252,2020-08-22,(09111) Calle 19,537,337,387,1261
10253,2020-01-19,(07506) DESPENSA,386,162,357,905
10254,2020-08-22,(07005) ALQUERIA,409,220,248,877
10255,2020-03-15,(05101) Mandalay - Cr.73,90,38,86,214
10256,2020-07-15,(12002) CDS - Carrera 32,169,99,62,330
10257,2020-08-17,(09004) Santa Lucía,839,369,553,1761
10258,2020-03-29,(09117) Calle 45,202,136,113,451
10259,2020-09-27,(08001) Parque el Tunal,162,72,165,399
10260,2020-09-16,(09113) Calle 22,420,226,378,1024
10261,2020-04-27,(06101) El Tiempo,40,90,38,168
10262,2020-04-04,(06000) Portal Eldorado,456,309,246,1011
10263,2020-04-26,(05105) Pradera,103,89,60,252
10264,2020-03-20,(09109) Tercer Milenio,129,86,82,297
10265,2020-03-28,(08000) Portal Tunal,261,153,143,557
10266,2020-05-02,(09106) Nariño,170,103,108,381
10267,2020-07-20,(09110) Avenida Jimenez,134,129,176,439
10268,2020-04-23,(07201) Guatoque -Veraguas,90,70,79,239
10269,2020-05-05,(14005) Las Aguas,0,41,128,169
10270,2020-05-01,(12004) Carrera 22,47,32,34,113
10271,2020-04-25,(09119) Calle 57,216,144,162,522
10272,2020-03-26,(07008) NQS - Calle 30 Sur,152,75,72,299
10273,2020-06-11,(05102) Av. Américas - Av. Boyacá,206,100,130,436
10274,2020-03-22,(03005) SUBA - AV. BOYACA,79,55,63,197
10275,2020-03-20,(09114) Calle 26,255,189,164,608
10276,2020-06-21,(04105) Carrera 53,96,61,80,237
10277,2020-06-21,(07006) General Santander - alimentacion,82,67,87,236
10278,2020-04-27,(50002) Corral Calle 40 Sur,5,1,2,8
10279,2020-04-10,(06106) Recinto Ferial,33,27,14,74
10280,2020-05-24,(09105) Río Fucha,40,20,35,95
10281,2020-04-26,(03007) HUMEDAL CORDOBA,27,26,23,76
10282,2020-07-05,(04103) Las Ferias,108,69,82,259
10283,2020-03-23,(12002) CDS - Carrera 32,33,51,30,114
10284,2020-08-02,(04000) Cabecera Calle 80 - intermunicipal,50,26,45,121
10285,2020-09-13,(06107) Ciudad Universitaria,49,32,90,171
10286,2020-05-10,(12003) Ricaurte,38,34,30,102
10287,2020-07-17,(03004) GRATAMIRA,26,14,20,60
10288,2020-04-28,(04000) Cabecera Calle 80 - alimentacion,2317,1351,1377,5045
10289,2020-06-05,(07005) ALQUERIA,525,318,274,1117
10290,2020-01-16,(07504) TERREROS,16156,8778,8815,33749
10291,2020-02-18,(07504) TERREROS,17872,10959,9220,38051
10292,2020-07-16,(07504) TERREROS,5483,2945,2485,10913
10293,2020-09-15,(07504) TERREROS,6500,3458,3319,13277
10294,2020-09-22,(07504) TERREROS,6555,3518,3697,13770
10295,2020-05-14,(05000) Portal Américas - alimentacion,8519,4407,3836,16762
10296,2020-01-07,(05000) Portal Américas - alimentacion,26756,14308,15970,57034
10297,2020-10-04,(03002) SUBA - TV- 91,287,130,328,745
10298,2020-03-10,(09122) Calle 72,4075,614,1171,5860
10299,2020-03-17,(07003) SEVILLANA,1253,683,654,2590
10300,2020-06-06,(10000) Portal 20 de Julio - alimentacion,3186,1537,2079,6802
10301,2020-06-01,(07503) SAN MATEO,9998,6048,5003,21049
10302,2020-07-29,(07503) SAN MATEO,10493,6216,5051,21760
10303,2020-04-26,(04000) Cabecera Calle 80 - alimentacion,619,346,385,1350
10304,2020-02-07,(05001) Patio Bonito,7329,4029,3778,15136
10305,2020-09-28,(05001) Patio Bonito,2215,1151,1442,4808
10306,2020-07-21,(04103) Las Ferias,326,172,133,631
10307,2020-03-08,(07504) TERREROS,4322,1829,3232,9383
10308,2020-01-02,(14004) Museo del Oro,953,611,686,2250
10309,2020-01-29,(05100) Banderas P. Central,7769,4581,3680,16030
10310,2020-04-23,(06000) Portal Eldorado - alimentacion,2415,1209,1048,4672
10311,2020-01-03,(05100) Banderas P. Central - alimentacion,7083,3504,4415,15002
10312,2020-02-26,(02000) Cabecera Autopista Norte,11814,6757,6136,24707
10313,2020-03-18,(06000) Portal Eldorado - alimentacion,9858,4905,4805,19568
10314,2020-04-30,(06000) Portal Eldorado - alimentacion,2629,1282,1212,5123
10315,2020-06-26,(06000) Portal Eldorado - alimentacion,4102,2159,2190,8451
10316,2020-06-23,(07001) PERDOMO,976,569,578,2123
10317,2020-10-11,(07001) PERDOMO,334,151,344,829
10318,2020-01-03,(09109) Tercer Milenio,634,380,592,1606
10319,2020-06-10,(09109) Tercer Milenio,358,210,213,781
10320,2020-01-17,(09104) Restrepo,4817,2843,3614,11274
10321,2020-10-06,(04101) Minuto de Dios,406,248,395,1049
10322,2020-02-13,(04100) Carrera 77,6998,4082,4096,15176
10323,2020-06-24,(07505) LEON XIII,2815,1596,1158,5569
10324,2020-07-03,(07505) LEON XIII,2969,1567,1343,5879
10325,2020-02-24,(09115) Calle 34,4519,2825,2548,9892
10326,2020-01-22,(02502) Terminal,4716,3048,2804,10568
10327,2020-09-18,(05000) Portal Américas,3948,2199,2790,8937
10328,2020-01-06,(03000) Portal Suba - alimentacion,4543,2154,3873,10570
10329,2020-05-05,(09000) Cabecera Usme - alimentacion,5372,2943,3190,11505
10330,2020-07-01,(06000) Portal Eldorado - alimentacion,4275,2188,2217,8680
10331,2020-03-09,(07503) SAN MATEO,1598,10831,6080,18509
10332,2020-01-02,(09116) Avenida 39,944,608,668,2220
10333,2020-01-23,(14001) La Sabana,378,330,346,1054
10334,2020-07-14,(14001) La Sabana,91,67,69,227
10335,2020-01-16,(07111) NQS - RICAURTE,2694,1831,1640,6165
10336,2020-09-26,(02104) Calle 146,740,384,664,1788
10337,2020-05-26,(09113) Calle 22,398,221,339,958
10338,2020-09-10,(09113) Calle 22,407,221,316,944
10339,2020-01-11,(10002) Av. Primero de Mayo,3874,1806,3055,8735
10340,2020-03-14,(07007) NQS - Calle 38A Sur,1254,621,812,2687
10341,2020-07-21,(08000) Portal Tunal - alimentacion,4523,2640,2626,9789
10342,2020-05-13,(05000) Portal Américas,1837,1308,1408,4553
10343,2020-09-25,(04000) Cabecera Calle 80,1402,814,1215,3431
10344,2020-07-01,(02000) Cabecera Autopista Norte - alimentacion,5013,2746,2926,10685
10345,2020-01-08,(05100) Banderas P. Central - alimentacion,10120,5330,6045,21495
10346,2020-02-12,(10008) San Diego,1614,849,800,3263
10347,2020-01-29,(04001) Quirigua,1969,1189,1180,4338
10348,2020-07-30,(12001) Carrera 43,395,196,199,790
10349,2020-05-28,(10002) Av. Primero de Mayo,1773,940,1000,3713
10350,2020-01-07,(10005) Bicentenario - alimentacion,505,212,443,1160
10351,2020-08-19,(10005) Bicentenario - alimentacion,193,105,189,487
10352,2020-07-17,(06105) Quinta Paredes,132,77,64,273
10353,2020-06-14,(05001) Patio Bonito,453,247,310,1010
10354,2020-01-24,(06100) Av. Rojas,2314,1273,1208,4795
10355,2020-08-21,(03000) Portal Suba - alimentacion,5859,3262,3376,12497
10356,2020-06-17,(08001) Parque el Tunal,475,301,271,1047
10357,2020-09-07,(02101) Toberín,1547,966,1089,3602
10358,2020-10-11,(07503) SAN MATEO,3909,1666,3035,8610
10359,2020-01-21,(03003) 21 ANGELES,541,452,618,1611
10360,2020-09-21,(03003) 21 ANGELES,328,168,183,679
10361,2020-03-22,(05002) Tintal,358,224,230,812
10362,2020-01-17,(02103) Mazurén,2878,1594,1720,6192
10363,2020-04-01,(05000) Portal Américas,1265,853,939,3057
10364,2020-02-28,(04102) Avenida Boyaca,3064,1749,1677,6490
10365,2020-01-13,(02300) Calle 100,5933,3762,3434,13129
10366,2020-02-19,(04108) El Polo,1965,1235,1182,4382
10367,2020-02-17,(12007) Zona Industrial,1375,817,618,2810
10368,2020-08-07,(06000) Portal Eldorado - alimentacion,1646,730,850,3226
10369,2020-05-26,(07106) EL CAMPIN,297,211,209,717
10370,2020-03-13,(06101) El Tiempo,780,175,326,1281
10371,2020-07-15,(04104) Avenida 68,588,299,281,1168
10372,2020-07-06,(09000) Cabecera Usme,1778,1156,1302,4236
10373,2020-06-21,(05000) Portal Américas - alimentacion,3352,1621,1791,6764
10374,2020-07-29,(07000) Portal Sur,1779,1090,1071,3940
10375,2020-08-19,(07000) Portal Sur,1786,1115,1102,4003
10376,2020-04-29,(02101) Toberín,775,508,530,1813
10377,2020-06-01,(02101) Toberín,1328,852,816,2996
10378,2020-02-03,(06105) Quinta Paredes,1024,599,524,2147
10379,2020-05-11,(07104) Simon Bolivar,389,245,221,855
10380,2020-07-13,(07104) Simon Bolivar,556,351,214,1121
10381,2020-07-31,(07104) Simon Bolivar,315,220,222,757
10382,2020-03-17,(10005) Bicentenario - alimentacion,525,251,338,1114
10383,2020-01-28,(04107) Escuela Militar,610,412,412,1434
10384,2020-05-18,(10010) San Bernardo,528,282,392,1202
10385,2020-05-22,(09000) Cabecera Usme,1385,919,947,3251
10386,2020-02-21,(06109) Centro Memoria,1113,609,624,2346
10387,2020-04-21,(09106) Nariño,229,153,159,541
10388,2020-10-07,(10009) Museo Nacional,593,399,513,1505
10389,2020-06-06,(05001) Patio Bonito,1172,639,704,2515
10390,2020-07-21,(09117) Calle 45,622,387,367,1376
10391,2020-09-25,(09117) Calle 45,764,495,622,1881
10392,2020-02-02,(04001) Quirigua,413,194,469,1076
10393,2020-06-18,(09121) Las Flores,740,485,379,1604
10394,2020-04-24,(09001) Molinos,1379,767,935,3081
10395,2020-06-26,(06106) Recinto Ferial,271,154,122,547
10396,2020-08-24,(02302) Virrey,571,399,322,1292
10397,2020-08-29,(10010) San Bernardo,468,219,393,1080
10398,2020-09-19,(02105) Calle 142,684,374,524,1582
10399,2020-07-06,(03002) SUBA - TV- 91,828,496,508,1832
10400,2020-09-28,(10010) San Bernardo,604,298,506,1408
10401,2020-04-13,(02105) Calle 142,446,292,215,953
10402,2020-08-18,(02104) Calle 146,639,436,455,1530
10403,2020-09-06,(02104) Calle 146,302,174,282,758
10404,2020-05-01,(07103) AV. CHILE,270,176,164,610
10405,2020-09-26,(07111) NQS - RICAURTE,912,656,564,2132
10406,2020-05-16,(03001) LA CAMPIÑA,546,283,336,1165
10407,2020-04-24,(02001) Centro Comercial Santa Fe,208,154,161,523
10408,2020-07-08,(02001) Centro Comercial Santa Fe,540,330,375,1245
10409,2020-05-30,(09120) Calle 63,746,518,456,1720
10410,2020-07-09,(09120) Calle 63,1180,806,685,2671
10411,2020-08-29,(02200) Alcalá,1466,889,905,3260
10412,2020-02-15,(05102) Av. Américas - Av. Boyacá,862,430,690,1982
10413,2020-01-26,(09119) Calle 57,529,336,749,1614
10414,2020-06-10,(06100) Av. Rojas,214,123,126,463
10415,2020-06-15,(09004) Santa Lucía,924,468,559,1951
10416,2020-06-29,(02204) Pepe Sierra,275,209,174,658
10417,2020-07-05,(06000) Portal Eldorado,167,167,246,580
10418,2020-02-02,(06105) Quinta Paredes,130,79,193,402
10419,2020-06-26,(12004) Carrera 22,283,163,161,607
10420,2020-05-04,(07200) Tygua-San José,154,77,105,336
10421,2020-01-25,(09106) Nariño,1097,526,955,2578
10422,2020-05-24,(09123) Calle 76,158,118,156,432
10423,2020-01-13,(07005) ALQUERIA,2040,1169,1210,4419
10424,2020-04-24,(03002) SUBA - TV- 91,408,265,241,914
10425,2020-04-10,(09123) Calle 76,170,131,90,391
10426,2020-09-21,(50003) Corral Molinos,1369,614,1037,3020
10427,2020-09-22,(50003) Corral Molinos,1611,853,1272,3736
10428,2020-06-08,(09121) Las Flores,664,450,399,1513
10429,2020-03-29,(02200) Alcalá,373,276,193,842
10430,2020-08-16,(02200) Alcalá,476,349,374,1199
10431,2020-09-24,(07107) U. NACIONAL,389,229,316,934
10432,2020-08-25,(04102) Avenida Boyaca,362,215,213,790
10433,2020-08-18,(08000) Portal Tunal,782,291,274,1347
10434,2020-08-20,(08000) Portal Tunal,777,290,256,1323
10435,2020-06-02,(03011) SUBA - CALLE 100,441,201,209,851
10436,2020-07-21,(03011) SUBA - CALLE 100,513,240,225,978
10437,2020-04-30,(04104) Avenida 68,360,210,175,745
10438,2020-04-18,(10007) Las Nieves,123,87,106,316
10439,2020-04-11,(07103) AV. CHILE,219,169,126,514
10440,2020-09-29,(02102) Calle 161,317,184,236,737
10441,2020-06-29,(07002) MADELENA,266,120,193,579
10442,2020-09-07,(12004) Carrera 22,229,146,125,500
10443,2020-07-15,(09115) Calle 34,563,344,309,1216
10444,2020-07-02,(09111) Calle 19,803,477,557,1837
10445,2020-05-14,(07005) ALQUERIA,413,246,219,878
10446,2020-06-29,(10009) Museo Nacional,76,62,97,235
10447,2020-10-12,(03013) RIO NEGRO,82,62,122,266
10448,2020-01-15,(07102) NQS - CALLE 75,1279,884,908,3071
10449,2020-05-23,(09003) Socorro,403,199,234,836
10450,2020-05-10,(04106) Carrera 47,70,43,44,157
10451,2020-03-21,(02300) Calle 100,448,385,298,1131
10452,2020-09-09,(02000) Cabecera Autopista Norte - intermunicipal,588,376,455,1419
10453,2020-04-18,(09120) Calle 63,405,285,248,938
10454,2020-05-10,(09120) Calle 63,260,170,171,601
10455,2020-07-21,(09000) Cabecera Usme,1228,806,955,2989
10456,2020-07-30,(12002) CDS - Carrera 32,161,93,61,315
10457,2020-10-06,(09113) Calle 22,438,247,429,1114
10458,2020-07-25,(06002) Normandía,150,99,117,366
10459,2020-09-09,(06002) Normandía,353,190,210,753
10460,2020-05-05,(05107) Américas - Cr.53,333,230,177,740
10461,2020-08-01,(04001) Quirigua,201,111,152,464
10462,2020-10-01,(04001) Quirigua,479,303,375,1157
10463,2020-10-09,(04001) Quirigua,488,279,394,1161
10464,2020-04-10,(09119) Calle 57,109,82,82,273
10465,2020-06-27,(09119) Calle 57,475,319,390,1184
10466,2020-04-23,(03003) 21 ANGELES,148,86,86,320
10467,2020-06-07,(03012) SUBA - CALLE 95,76,51,66,193
10468,2020-04-04,(06103) CAN,197,153,111,461
10469,2020-03-23,(02502) Terminal,51,44,63,158
10470,2020-08-07,(07005) ALQUERIA,203,89,143,435
10471,2020-04-29,(04104) Avenida 68,395,208,202,805
10472,2020-09-07,(07005) ALQUERIA,505,318,392,1215
10473,2020-07-20,(09122) Calle 72,289,203,204,696
10474,2020-08-10,(07005) ALQUERIA,506,270,328,1104
10475,2020-03-15,(07506) DESPENSA,304,122,257,683
10476,2020-06-02,(10004) Policarpa,209,107,156,472
10477,2020-04-30,(09121) Las Flores,439,320,293,1052
10478,2020-09-06,(03005) SUBA - AV. BOYACA,118,68,144,330
10479,2020-01-01,(04101) Minuto de Dios,132,76,244,452
10480,2020-04-02,(04104) Avenida 68,271,190,191,652
10481,2020-04-25,(04101) Minuto de Dios,112,66,87,265
10482,2020-07-02,(10004) Policarpa,262,128,154,544
10483,2020-09-13,(09109) Tercer Milenio,122,70,121,313
10484,2020-09-26,(08002) Biblioteca,258,141,232,631
10485,2020-10-01,(40002) Manitas,455,267,371,1093
10486,2020-08-01,(03000) Portal Suba,605,370,496,1471
10487,2020-04-25,(04001) Quirigua,141,92,92,325
10488,2020-01-26,(10005) Bicentenario,63,59,118,240
10489,2020-08-16,(09002) Consuelo,135,47,127,309
10490,2020-05-12,(09105) Río Fucha,112,59,63,234
10491,2020-05-28,(09105) Río Fucha,114,60,60,234
10492,2020-10-05,(07107) U. NACIONAL,416,267,303,986
10493,2020-08-16,(07104) Simon Bolivar,110,74,133,317
10494,2020-01-06,(09105) Río Fucha,88,62,146,296
10495,2020-03-17,(10003) Ciudad Jardín,528,333,392,1253
10496,2020-04-08,(06103) CAN,316,216,149,681
10497,2020-09-06,(09114) Calle 26,65,67,128,260
10498,2020-06-22,(10003) Ciudad Jardín,71,33,68,172
10499,2020-07-16,(06106) Recinto Ferial,225,122,108,455
10500,2020-07-26,(07109) CAD,136,105,80,321
10501,2020-05-22,(04108) El Polo,403,256,222,881
10502,2020-04-05,(09003) Socorro,111,62,58,231
10503,2020-04-21,(07108) Av. El Dorado,63,58,35,156
10504,2020-04-07,(07506) DESPENSA,184,106,127,417
10505,2020-06-01,(07003) SEVILLANA,412,224,197,833
10506,2020-06-28,(07200) Tygua-San José,65,27,60,152
10507,2020-04-07,(04001) Quirigua,167,106,86,359
10508,2020-03-22,(06103) CAN,160,113,67,340
10509,2020-04-20,(05103) Marsella,180,106,97,383
10510,2020-10-12,(04101) Minuto de Dios,109,73,174,356
10511,2020-03-23,(03004) GRATAMIRA,7,5,5,17
10512,2020-07-19,(03003) 21 ANGELES,82,48,50,180
10513,2020-06-27,(50006) Corral Carrera 77,6,3,3,12
10514,2020-08-30,(12000) Puente Aranda,11,15,19,45
10515,2020-05-29,(50006) Corral Carrera 77,5,4,6,15
10516,2020-01-04,(50004) Corral Avenida Ciudad de Cali,0,0,2,2
10517,2020-02-05,(04000) Cabecera Calle 80 - alimentacion,24986,15043,15120,55149
10518,2020-03-04,(09002) Consuelo,1421,750,843,3014
10519,2020-07-27,(09002) Consuelo,453,244,237,934
10520,2020-02-25,(02502) Terminal,5365,3495,2930,11790
10521,2020-09-12,(09118) Marly,1076,675,829,2580
10522,2020-03-02,(07504) TERREROS,16727,10522,9347,36596
10523,2020-08-13,(09119) Calle 57,542,358,362,1262
10524,2020-01-22,(02200) Alcalá,13552,8399,6394,28345
10525,2020-02-27,(02200) Alcalá,14753,9213,6706,30672
10526,2020-02-26,(05000) Portal Américas,15397,7870,8082,31349
10527,2020-01-20,(09114) Calle 26,2490,1746,1608,5844
10528,2020-02-25,(09003) Socorro,1704,1006,1024,3734
10529,2020-02-10,(09001) Molinos,7694,4783,5989,18466
10530,2020-07-15,(07503) SAN MATEO,10146,6017,4655,20818
10531,2020-07-28,(06107) Ciudad Universitaria,157,90,104,351
10532,2020-01-14,(05000) Portal Américas,12660,7230,7092,26982
10533,2020-02-01,(04103) Las Ferias,867,433,717,2017
10534,2020-01-24,(02000) Cabecera Autopista Norte - intermunicipal,4453,2838,2902,10193
10535,2020-09-05,(07112) COMUNEROS,712,392,476,1580
10536,2020-01-17,(09004) Santa Lucía,6815,3517,3995,14327
10537,2020-07-08,(05100) Banderas P. Central,825,485,527,1837
10538,2020-08-03,(05100) Banderas P. Central,655,377,436,1468
10539,2020-01-05,(10001) Country Sur,719,317,819,1855
10540,2020-03-02,(02204) Pepe Sierra,5028,3236,2405,10669
10541,2020-01-28,(02205) Calle 106,2674,1782,1275,5731
10542,2020-05-11,(07001) PERDOMO,658,367,393,1418
10543,2020-01-13,(02000) Cabecera Autopista Norte,8161,4998,5064,18223
10544,2020-05-28,(07505) LEON XIII,2216,1324,955,4495
10545,2020-02-20,(06002) Normandía,2632,1480,1278,5390
10546,2020-03-20,(09004) Santa Lucía,943,486,404,1833
10547,2020-08-27,(04100) Carrera 77,1201,675,805,2681
10548,2020-07-09,(07102) NQS - CALLE 75,445,284,261,990
10549,2020-05-07,(09118) Marly,1091,749,523,2363
10550,2020-02-08,(07110) PALOQUEMAO,1310,884,925,3119
10551,2020-02-20,(03001) LA CAMPIÑA,6580,4028,3885,14493
10552,2020-10-10,(50003) Corral Molinos,1311,631,1313,3255
10553,2020-09-02,(05100) Banderas P. Central - alimentacion,3400,1873,2037,7310
10554,2020-09-23,(05100) Banderas P. Central - alimentacion,3774,1976,2310,8060
10555,2020-08-09,(09103) Olaya,317,161,265,743
10556,2020-07-28,(09103) Olaya,1000,594,529,2123
10557,2020-01-27,(14001) La Sabana,431,322,345,1098
10558,2020-08-27,(14001) La Sabana,162,107,82,351
10559,2020-08-13,(07111) NQS - RICAURTE,1103,659,443,2205
10560,2020-09-21,(07111) NQS - RICAURTE,919,632,426,1977
10561,2020-01-26,(02000) Cabecera Autopista Norte - alimentacion,6455,2581,4833,13869
10562,2020-07-19,(02200) Alcalá,497,326,292,1115
10563,2020-09-12,(04102) Avenida Boyaca,344,191,267,802
10564,2020-02-25,(09113) Calle 22,1550,910,967,3427
10565,2020-01-31,(02201) Prado,5542,3346,2985,11873
10566,2020-02-05,(05100) Banderas P. Central - alimentacion,15967,9420,8844,34231
10567,2020-06-23,(09001) Molinos,2574,1497,1726,5797
10568,2020-07-02,(09001) Molinos,2688,1498,1838,6024
10569,2020-08-19,(07010) Bosa,626,312,349,1287
10570,2020-07-15,(02000) Cabecera Autopista Norte - alimentacion,4284,2319,2220,8823
10571,2020-02-04,(09120) Calle 63,7336,4556,3855,15747
10572,2020-09-13,(02201) Prado,290,173,328,791
10573,2020-03-11,(07506) DESPENSA,1523,892,804,3219
10574,2020-01-12,(10001) Country Sur,798,350,995,2143
10575,2020-03-12,(10006) San Victorino,1218,154,270,1642
10576,2020-05-18,(03000) Portal Suba,980,616,656,2252
10577,2020-02-11,(40003) Mirador del Paraiso,4912,2888,2626,10426
10578,2020-02-14,(10000) Portal 20 de Julio,9381,4185,4042,17608
10579,2020-05-30,(05002) Tintal,1566,790,891,3247
10580,2020-02-04,(12001) Carrera 43,1694,1003,1086,3783
10581,2020-05-15,(12001) Carrera 43,351,215,153,719
10582,2020-06-26,(10005) Bicentenario - alimentacion,233,100,238,571
10583,2020-02-10,(06111) Universidades,5947,3602,2598,12147
10584,2020-04-17,(05001) Patio Bonito,965,540,585,2090
10585,2020-06-15,(05001) Patio Bonito,563,271,395,1229
10586,2020-02-12,(02302) Virrey,3966,2692,1896,8554
10587,2020-02-10,(07106) EL CAMPIN,2194,1409,1214,4817
10588,2020-04-24,(03000) Portal Suba,646,406,389,1441
10589,2020-04-24,(02000) Cabecera Autopista Norte - intermunicipal,186,131,134,451
10590,2020-06-30,(02000) Cabecera Autopista Norte - intermunicipal,647,409,478,1534
10591,2020-07-07,(10000) Portal 20 de Julio,2463,1204,1290,4957
10592,2020-07-12,(07000) Portal Sur - alimentacion,2910,1329,1675,5914
10593,2020-05-29,(09116) Avenida 39,275,198,188,661
10594,2020-01-24,(06102) Salitre El Greco,1428,849,744,3021
10595,2020-07-22,(09116) Avenida 39,300,185,212,697
10596,2020-09-30,(09116) Avenida 39,442,260,370,1072
10597,2020-01-19,(09113) Calle 22,323,274,513,1110
10598,2020-01-22,(06103) CAN,2412,1415,1108,4935
10599,2020-08-05,(10002) Av. Primero de Mayo,2071,1017,1224,4312
10600,2020-01-29,(02105) Calle 142,7147,4310,3688,15145
10601,2020-08-27,(40003) Mirador del Paraiso,1606,1006,982,3594
10602,2020-04-18,(05002) Tintal,875,512,392,1779
10603,2020-06-25,(09119) Calle 57,603,394,404,1401
10604,2020-03-06,(07006) General Santander,2777,1507,1614,5898
10605,2020-04-28,(05005) Transversal 86,244,131,128,503
10606,2020-04-05,(07504) TERREROS,949,479,464,1892
10607,2020-03-07,(05105) Pradera,1543,1064,1048,3655
10608,2020-09-30,(03009) Av. Suba- Calle 116,556,348,370,1274
10609,2020-07-21,(02205) Calle 106,366,205,169,740
10610,2020-08-30,(03000) Portal Suba - alimentacion,2032,963,1633,4628
10611,2020-01-01,(12000) Puente Aranda,7,13,30,50
10612,2020-04-21,(09101) Quiroga,297,148,212,657
10613,2020-07-30,(04108) El Polo,468,288,251,1007
10614,2020-07-03,(02300) Calle 100,1348,824,759,2931
10615,2020-03-02,(12007) Zona Industrial,1241,725,677,2643
10616,2020-02-22,(10009) Museo Nacional,1118,964,1354,3436
10617,2020-02-25,(07201) Guatoque -Veraguas,1075,511,592,2178
10618,2020-03-27,(02200) Alcalá,803,553,480,1836
10619,2020-08-16,(02205) Calle 106,0,51,113,164
10620,2020-08-23,(03007) HUMEDAL CORDOBA,37,24,22,83
10621,2020-08-03,(10006) San Victorino,676,306,306,1288
10622,2020-06-12,(04104) Avenida 68,612,304,307,1223
10623,2020-09-03,(08002) Biblioteca,343,163,205,711
10624,2020-10-01,(04000) Cabecera Calle 80,1298,826,1174,3298
10625,2020-03-20,(02000) Cabecera Autopista Norte - alimentacion,2453,1332,882,4667
10626,2020-09-17,(05101) Mandalay - Cr.73,158,92,100,350
10627,2020-07-14,(07000) Portal Sur,1506,968,895,3369
10628,2020-07-02,(09103) Olaya,1080,610,615,2305
10629,2020-06-12,(10010) San Bernardo,594,325,414,1333
10630,2020-04-16,(02304) Heroes,405,341,258,1004
10631,2020-02-20,(07102) NQS - CALLE 75,1546,1006,912,3464
10632,2020-06-23,(09100) Calle 40 Sur,1890,1167,1206,4263
10633,2020-05-09,(07104) Simon Bolivar,277,174,175,626
10634,2020-06-26,(04107) Escuela Militar,149,94,91,334
10635,2020-07-05,(05000) Portal Américas,694,463,700,1857
10636,2020-07-24,(10010) San Bernardo,506,268,342,1116
10637,2020-10-12,(04003) Avenida Ciudad de Cali,320,181,450,951
10638,2020-06-13,(09109) Tercer Milenio,300,188,195,683
10639,2020-08-11,(04105) Carrera 53,224,125,132,481
10640,2020-09-25,(09110) Avenida Jimenez,1513,1144,1039,3696
10641,2020-09-04,(06104) Gobernación,294,166,154,614
10642,2020-03-29,(09001) Molinos,376,228,251,855
10643,2020-02-10,(07101) CASTELLANA,1016,608,583,2207
10644,2020-07-13,(03001) LA CAMPIÑA,955,570,519,2044
10645,2020-01-28,(07003) SEVILLANA,2043,1120,1092,4255
10646,2020-03-01,(09002) Consuelo,403,164,360,927
10647,2020-04-12,(06100) Av. Rojas,30,20,14,64
10648,2020-04-16,(06000) Portal Eldorado,802,557,400,1759
10649,2020-07-03,(02302) Virrey,718,475,410,1603
10650,2020-01-12,(12003) Ricaurte,137,116,195,448
10651,2020-04-25,(06000) Portal Eldorado - alimentacion,1735,867,787,3389
10652,2020-04-06,(03009) Av. Suba- Calle 116,320,223,164,707
10653,2020-01-13,(07200) Tygua-San José,732,409,536,1677
10654,2020-01-30,(07107) U. NACIONAL,2498,1550,1363,5411
10655,2020-09-23,(07010) Bosa,0,393,947,1340
10656,2020-09-19,(03006) NIZA - CALLE 127,406,239,268,913
10657,2020-03-22,(08000) Portal Tunal - alimentacion,1461,681,633,2775
10658,2020-01-27,(10005) Bicentenario,780,375,368,1523
10659,2020-07-04,(07007) NQS - Calle 38A Sur,363,209,248,820
10660,2020-09-26,(07103) AV. CHILE,627,424,553,1604
10661,2020-02-10,(12007) Zona Industrial,1331,807,642,2780
10662,2020-02-15,(09122) Calle 72,3419,2336,3162,8917
10663,2020-08-04,(10005) Bicentenario,75,51,78,204
10664,2020-05-08,(09106) Nariño,269,158,179,606
10665,2020-02-15,(08001) Parque el Tunal,1123,550,746,2419
10666,2020-06-14,(06108) Concejo de Bogotá,39,30,49,118
10667,2020-08-02,(05100) Banderas P. Central - alimentacion,745,320,499,1564
10668,2020-07-22,(04105) Carrera 53,276,146,118,540
10669,2020-09-02,(02102) Calle 161,259,146,222,627
10670,2020-06-13,(02104) Calle 146,579,326,337,1242
10671,2020-03-07,(09106) Nariño,1183,619,1083,2885
10672,2020-05-20,(10008) San Diego,235,135,140,510
10673,2020-08-28,(02200) Alcalá,1910,1246,1046,4202
10674,2020-03-26,(12007) Zona Industrial,165,130,91,386
10675,2020-03-31,(02201) Prado,385,312,215,912
10676,2020-06-12,(12002) CDS - Carrera 32,179,119,78,376
10677,2020-02-16,(06109) Centro Memoria,183,119,249,551
10678,2020-07-15,(09111) Calle 19,425,278,364,1067
10679,2020-09-23,(07009) SENA,763,467,556,1786
10680,2020-05-09,(09103) Olaya,519,280,290,1089
10681,2020-05-15,(06104) Gobernación,203,141,88,432
10682,2020-04-12,(02200) Alcalá,369,271,194,834
10683,2020-05-27,(02200) Alcalá,1595,1132,778,3505
10684,2020-05-18,(12007) Zona Industrial,269,170,125,564
10685,2020-06-09,(09115) Calle 34,636,412,366,1414
10686,2020-06-27,(09123) Calle 76,714,560,546,1820
10687,2020-09-17,(04102) Avenida Boyaca,471,243,316,1030
10688,2020-04-30,(07110) PALOQUEMAO,529,327,192,1048
10689,2020-01-01,(02502) Terminal,92,107,327,526
10690,2020-01-26,(04101) Minuto de Dios,434,215,546,1195
10691,2020-04-23,(04104) Avenida 68,380,212,195,787
10692,2020-01-18,(10004) Policarpa,490,214,410,1114
10693,2020-04-29,(10007) Las Nieves,280,197,188,665
10694,2020-07-13,(10007) Las Nieves,333,195,222,750
10695,2020-07-25,(07007) NQS - Calle 38A Sur,228,137,134,499
10696,2020-01-24,(12000) Puente Aranda,246,148,194,588
10697,2020-03-25,(09000) Cabecera Usme,847,464,546,1857
10698,2020-03-16,(04102) Avenida Boyaca,1739,1072,985,3796
10699,2020-03-24,(04000) Cabecera Calle 80 - intermunicipal,161,113,199,473
10700,2020-04-01,(02102) Calle 161,79,57,67,203
10701,2020-07-07,(02102) Calle 161,259,149,165,573
10702,2020-05-29,(12004) Carrera 22,211,105,124,440
10703,2020-06-12,(12004) Carrera 22,213,121,106,440
10704,2020-03-29,(03009) Av. Suba- Calle 116,130,112,70,312
10705,2020-01-25,(03010) PUENTE LARGO,900,543,752,2195
10706,2020-07-02,(04106) Carrera 47,341,172,178,691
10707,2020-03-21,(08000) Portal Tunal,237,153,107,497
10708,2020-01-05,(07506) DESPENSA,236,119,251,606
10709,2020-08-05,(07008) NQS - Calle 30 Sur,224,125,137,486
10710,2020-08-28,(02000) Cabecera Autopista Norte - intermunicipal,558,351,403,1312
10711,2020-08-14,(05105) Pradera,575,331,280,1186
10712,2020-01-06,(02103) Mazurén,217,100,302,619
10713,2020-08-05,(07005) ALQUERIA,423,243,249,915
10714,2020-09-17,(07004) VENECIA,1092,659,726,2477
10715,2020-03-28,(02001) Centro Comercial Santa Fe,86,72,86,244
10716,2020-06-16,(03002) SUBA - TV- 91,749,453,428,1630
10717,2020-05-14,(10009) Museo Nacional,405,242,211,858
10718,2020-06-20,(07005) ALQUERIA,502,260,256,1018
10719,2020-10-12,(09122) Calle 72,353,283,543,1179
10720,2020-05-18,(06002) Normandía,260,151,148,559
10721,2020-08-19,(07506) DESPENSA,448,249,271,968
10722,2020-10-03,(09101) Quiroga,541,217,447,1205
10723,2020-10-04,(02204) Pepe Sierra,206,165,261,632
10724,2020-04-01,(09101) Quiroga,204,96,160,460
10725,2020-07-03,(14004) Museo del Oro,295,189,258,742
10726,2020-07-04,(03010) PUENTE LARGO,271,164,178,613
10727,2020-10-02,(07006) General Santander - alimentacion,426,231,348,1005
10728,2020-05-13,(06105) Quinta Paredes,108,73,50,231
10729,2020-08-20,(10004) Policarpa,209,95,157,461
10730,2020-10-06,(07007) NQS - Calle 38A Sur,453,289,403,1145
10731,2020-08-30,(09119) Calle 57,201,134,215,550
10732,2020-04-12,(09117) Calle 45,184,154,86,424
10733,2020-09-30,(06100) Av. Rojas,300,197,204,701
10734,2020-07-25,(10010) San Bernardo,369,179,278,826
10735,2020-05-02,(10008) San Diego,100,72,83,255
10736,2020-04-02,(02303) Calle 85,309,240,201,750
10737,2020-05-18,(03011) SUBA - CALLE 100,367,190,190,747
10738,2020-05-20,(06101) El Tiempo,273,176,122,571
10739,2020-04-05,(09117) Calle 45,201,119,97,417
10740,2019-12-31,(07007) NQS - Calle 38A Sur,52,18,32,102
10741,2020-04-11,(06001) Modelia,140,109,80,329
10742,2020-09-28,(06100) Av. Rojas,297,174,241,712
10743,2020-07-26,(04105) Carrera 53,71,36,48,155
10744,2020-04-12,(09114) Calle 26,37,27,33,97
10745,2020-06-15,(06107) Ciudad Universitaria,66,50,46,162
10746,2020-07-15,(05103) Marsella,338,178,168,684
10747,2020-07-22,(05102) Av. Américas - Av. Boyacá,204,103,125,432
10748,2020-04-06,(10005) Bicentenario,57,32,34,123
10749,2020-05-23,(05101) Mandalay - Cr.73,52,29,32,113
10750,2020-05-13,(14005) Las Aguas,0,55,148,203
10751,2020-04-05,(12002) CDS - Carrera 32,33,38,20,91
10752,2020-04-04,(10007) Las Nieves,130,86,110,326
10753,2020-06-22,(06108) Concejo de Bogotá,50,29,38,117
10754,2020-04-10,(04003) Avenida Ciudad de Cali,151,100,107,358
10755,2020-06-16,(03014) SAN MARTIN,31,11,31,73
10756,2020-04-02,(07108) Av. El Dorado,48,46,42,136
10757,2020-06-15,(05101) Mandalay - Cr.73,27,11,15,53
10758,2020-08-12,(50006) Corral Carrera 77,5,2,9,16
10759,2020-03-22,(07104) Simon Bolivar,47,48,54,149
10760,2020-09-20,(09105) Río Fucha,0,22,76,98
10761,2020-04-13,(50002) Corral Calle 40 Sur,5,5,6,16
10762,2020-06-01,(50002) Corral Calle 40 Sur,16,10,23,49
10763,2020-09-26,(50006) Corral Carrera 77,4,3,7,14
10764,2020-10-13,(09110) Avenida Jimenez,1,0,0,1
10765,2020-08-22,(09002) Consuelo,357,191,259,807
10766,2020-03-14,(02502) Terminal,1512,847,1658,4017
10767,2020-05-12,(09119) Calle 57,414,272,248,934
10768,2020-02-21,(08000) Portal Tunal - alimentacion,24580,12332,11753,48665
10769,2020-06-15,(03000) Portal Suba - alimentacion,2074,1109,1310,4493
10770,2020-01-31,(05000) Portal Américas - alimentacion,35759,20008,20737,76504
10771,2020-09-28,(07503) SAN MATEO,13702,6888,7051,27641
10772,2020-01-17,(07003) SEVILLANA,1859,973,1091,3923
10773,2020-01-23,(03010) PUENTE LARGO,2046,1269,1262,4577
10774,2020-02-05,(03010) PUENTE LARGO,2262,1480,1269,5011
10775,2020-02-08,(09003) Socorro,1341,618,844,2803
10776,2020-10-07,(05000) Portal Américas - alimentacion,12283,6718,8272,27273
10777,2020-06-26,(07503) SAN MATEO,11354,6955,6161,24470
10778,2020-02-26,(06107) Ciudad Universitaria,1620,948,904,3472
10779,2020-09-11,(06107) Ciudad Universitaria,175,98,147,420
10780,2020-09-08,(09001) Molinos,2653,1413,1915,5981
10781,2020-06-24,(08000) Portal Tunal - alimentacion,6567,3678,3608,13853
10782,2020-09-04,(04103) Las Ferias,373,201,238,812
10783,2020-10-10,(04103) Las Ferias,293,138,224,655
10784,2020-02-18,(07000) Portal Sur - alimentacion,29921,17480,14314,61715
10785,2020-01-15,(05005) Transversal 86,2249,1209,1154,4612
10786,2020-08-20,(10001) Country Sur,1126,488,651,2265
10787,2020-09-21,(09100) Calle 40 Sur,1545,784,1046,3375
10788,2020-02-06,(06000) Portal Eldorado - alimentacion,18892,9810,9478,38180
10789,2020-02-17,(07009) SENA,3794,2261,1979,8034
10790,2020-01-17,(02205) Calle 106,2324,1439,1264,5027
10791,2020-02-14,(09109) Tercer Milenio,1423,879,896,3198
10792,2020-06-12,(09104) Restrepo,1524,908,1066,3498
10793,2020-09-05,(04101) Minuto de Dios,254,161,276,691
10794,2020-03-07,(06002) Normandía,1048,577,994,2619
10795,2020-02-21,(09110) Avenida Jimenez,4538,3419,2925,10882
10796,2020-01-17,(12003) Ricaurte,1130,754,607,2491
10797,2020-01-08,(03009) Av. Suba- Calle 116,1971,1140,1074,4185
10798,2020-01-02,(09101) Quiroga,730,465,722,1917
10799,2020-02-10,(07102) NQS - CALLE 75,1588,1056,949,3593
10800,2020-04-13,(07102) NQS - CALLE 75,172,113,115,400
10801,2020-10-08,(07102) NQS - CALLE 75,487,324,355,1166
10802,2020-07-31,(03013) RIO NEGRO,213,124,136,473
10803,2020-01-06,(02304) Heroes,544,390,489,1423
10804,2020-04-23,(09118) Marly,1029,718,459,2206
10805,2020-02-09,(03000) Portal Suba - alimentacion,6141,2877,5450,14468
10806,2020-02-16,(02103) Mazurén,322,163,503,988
10807,2020-05-19,(07002) MADELENA,596,344,324,1264
10808,2020-09-06,(02000) Cabecera Autopista Norte,478,278,455,1211
10809,2020-04-22,(04102) Avenida Boyaca,167,94,104,365
10810,2020-09-13,(04102) Avenida Boyaca,160,86,149,395
10811,2020-05-29,(09113) Calle 22,386,257,313,956
10812,2020-01-14,(10007) Las Nieves,1788,1143,1078,4009
10813,2020-01-10,(09117) Calle 45,2227,1646,2051,5924
10814,2020-10-09,(04000) Cabecera Calle 80,1374,792,1306,3472
10815,2020-08-22,(09001) Molinos,1985,957,1473,4415
10816,2020-03-26,(04002) Carrera 90,348,199,163,710
10817,2020-07-03,(04002) Carrera 90,840,434,494,1768
10818,2020-07-17,(04002) Carrera 90,661,366,361,1388
10819,2020-09-13,(02000) Cabecera Autopista Norte - alimentacion,2024,901,1545,4470
10820,2020-07-21,(12001) Carrera 43,420,232,197,849
10821,2020-03-25,(07000) Portal Sur - alimentacion,4191,2130,1634,7955
10822,2020-09-30,(10002) Av. Primero de Mayo,2535,1251,1772,5558
10823,2020-06-21,(10005) Bicentenario - alimentacion,70,32,70,172
10824,2020-09-06,(06105) Quinta Paredes,30,23,35,88
10825,2020-01-18,(09119) Calle 57,1271,863,1283,3417
10826,2020-06-19,(06101) El Tiempo,344,219,195,758
10827,2020-07-17,(03000) Portal Suba,1195,685,800,2680
10828,2020-03-12,(09101) Quiroga,77,397,308,782
10829,2020-02-27,(08001) Parque el Tunal,1713,1005,942,3660
10830,2020-03-17,(06100) Av. Rojas,1130,660,595,2385
10831,2020-09-03,(10000) Portal 20 de Julio,2346,1185,1328,4859
10832,2020-02-20,(10010) San Bernardo,1802,1025,1258,4085
10833,2020-07-28,(07112) COMUNEROS,693,381,377,1451
10834,2020-02-29,(02303) Calle 85,1477,1194,1405,4076
10835,2020-08-04,(09003) Socorro,535,294,316,1145
10836,2020-03-07,(09116) Avenida 39,836,674,1116,2626
10837,2020-03-01,(07505) LEON XIII,2073,876,1424,4373
10838,2020-01-05,(07007) NQS - Calle 38A Sur,466,241,343,1050
10839,2020-02-07,(07007) NQS - Calle 38A Sur,2334,1273,1327,4934
10840,2020-02-12,(07007) NQS - Calle 38A Sur,2243,1357,1267,4867
10841,2020-03-13,(08000) Portal Tunal - alimentacion,770,4315,3138,8223
10842,2020-02-19,(02202) Calle 127,6041,3881,2974,12896
10843,2020-05-13,(02201) Prado,675,444,393,1512
10844,2020-06-25,(02201) Prado,968,646,524,2138
10845,2020-01-21,(03005) SUBA - AV. BOYACA,1522,967,971,3460
10846,2020-08-26,(03012) SUBA - CALLE 95,341,179,163,683
10847,2020-07-29,(09119) Calle 57,532,345,340,1217
10848,2020-02-15,(50002) Corral Calle 40 Sur,61,36,79,176
10849,2020-02-28,(08000) Portal Tunal,2221,1185,1107,4513
10850,2020-01-10,(07104) Simon Bolivar,1638,1016,1033,3687
10851,2020-05-03,(09104) Restrepo,281,203,237,721
10852,2020-09-30,(05005) Transversal 86,518,269,371,1158
10853,2020-07-18,(10008) San Diego,150,92,111,353
10854,2020-02-20,(09121) Las Flores,3483,2088,1869,7440
10855,2020-02-01,(04108) El Polo,957,644,926,2527
10856,2020-07-30,(02300) Calle 100,1127,733,669,2529
10857,2020-05-23,(05001) Patio Bonito,1136,617,640,2393
10858,2020-09-21,(09000) Cabecera Usme,1646,857,1124,3627
10859,2020-05-31,(07505) LEON XIII,623,340,348,1311
10860,2020-08-26,(07000) Portal Sur,1851,1160,1182,4193
10861,2020-01-25,(06101) El Tiempo,915,609,963,2487
10862,2020-03-08,(07000) Portal Sur,1338,589,1419,3346
10863,2020-08-17,(05100) Banderas P. Central - alimentacion,850,389,499,1738
10864,2020-05-16,(10005) Bicentenario - alimentacion,127,73,121,321
10865,2020-01-21,(04107) Escuela Militar,414,274,314,1002
10866,2020-06-19,(04107) Escuela Militar,146,96,72,314
10867,2020-08-20,(04107) Escuela Militar,146,80,97,323
10868,2020-09-22,(04107) Escuela Militar,171,119,117,407
10869,2020-02-12,(04003) Avenida Ciudad de Cali,5848,3457,3562,12867
10870,2020-02-17,(03012) SUBA - CALLE 95,1394,892,1039,3325
10871,2020-08-20,(04101) Minuto de Dios,287,169,218,674
10872,2020-05-01,(05103) Marsella,96,51,62,209
10873,2020-06-04,(09109) Tercer Milenio,328,191,229,748
10874,2020-02-23,(07109) CAD,522,348,510,1380
10875,2020-03-09,(04105) Carrera 53,298,237,197,732
10876,2020-04-23,(09000) Cabecera Usme - alimentacion,3917,2357,2615,8889
10877,2020-09-02,(07101) CASTELLANA,240,137,146,523
10878,2020-02-16,(06106) Recinto Ferial,257,156,299,712
10879,2020-09-07,(07009) SENA,669,405,511,1585
10880,2020-04-13,(09120) Calle 63,536,390,342,1268
10881,2020-01-28,(12003) Ricaurte,1269,787,667,2723
10882,2020-09-18,(12003) Ricaurte,445,300,244,989
10883,2020-07-31,(10010) San Bernardo,541,302,355,1198
10884,2020-02-09,(03009) Av. Suba- Calle 116,367,286,425,1078
10885,2020-08-26,(04106) Carrera 47,339,165,163,667
10886,2020-04-29,(02105) Calle 142,464,312,243,1019
10887,2020-03-25,(09109) Tercer Milenio,150,97,95,342
10888,2020-01-06,(03013) RIO NEGRO,191,112,224,527
10889,2020-03-31,(07005) ALQUERIA,243,146,132,521
10890,2020-02-23,(07505) LEON XIII,2054,916,1283,4253
10891,2020-09-30,(12007) Zona Industrial,387,269,219,875
10892,2020-09-22,(10005) Bicentenario,116,67,105,288
10893,2020-01-12,(06001) Modelia,259,180,320,759
10894,2020-09-19,(02304) Heroes,605,486,541,1632
10895,2020-06-12,(04105) Carrera 53,286,158,166,610
10896,2020-04-27,(40003) Mirador del Paraiso,633,74,151,858
10897,2020-05-19,(10008) San Diego,228,137,147,512
10898,2020-04-22,(09101) Quiroga,285,133,170,588
10899,2020-09-17,(02200) Alcalá,2108,1335,1281,4724
10900,2020-03-13,(04107) Escuela Militar,186,51,85,322
10901,2020-02-22,(10004) Policarpa,579,258,483,1320
10902,2020-06-13,(09117) Calle 45,537,326,369,1232
10903,2020-07-27,(05107) Américas - Cr.53,363,192,228,783
10904,2020-08-06,(05107) Américas - Cr.53,342,208,245,795
10905,2020-06-10,(06111) Universidades,0,136,404,540
10906,2020-07-24,(12007) Zona Industrial,245,137,108,490
10907,2020-03-08,(12001) Carrera 43,180,131,294,605
10908,2020-05-09,(02200) Alcalá,928,635,454,2017
10909,2020-06-28,(03003) 21 ANGELES,100,36,66,202
10910,2020-03-28,(03000) Portal Suba,371,233,266,870
10911,2020-07-13,(02200) Alcalá,1632,1112,830,3574
10912,2020-08-29,(09114) Calle 26,175,139,221,535
10913,2020-04-30,(09113) Calle 22,271,169,218,658
10914,2020-09-29,(10007) Las Nieves,760,451,477,1688
10915,2020-08-02,(10006) San Victorino,157,103,123,383
10916,2020-09-04,(07107) U. NACIONAL,378,250,246,874
10917,2020-01-05,(06107) Ciudad Universitaria,96,107,221,424
10918,2020-05-25,(06107) Ciudad Universitaria,58,43,40,141
10919,2020-04-17,(10007) Las Nieves,230,184,165,579
10920,2020-08-14,(03011) SUBA - CALLE 100,430,213,209,852
10921,2020-04-14,(12003) Ricaurte,128,114,78,320
10922,2020-04-05,(07007) NQS - Calle 38A Sur,63,39,37,139
10923,2020-02-24,(50002) Corral Calle 40 Sur,160,103,146,409
10924,2020-04-17,(07006) General Santander - alimentacion,193,114,122,429
10925,2020-04-24,(07103) AV. CHILE,520,358,234,1112
10926,2020-04-28,(12004) Carrera 22,90,63,68,221
10927,2020-08-25,(03013) RIO NEGRO,272,148,195,615
10928,2020-07-04,(05100) Banderas P. Central,574,268,417,1259
10929,2020-01-20,(07006) General Santander - alimentacion,1383,778,910,3071
10930,2020-05-21,(04106) Carrera 47,261,166,138,565
10931,2020-06-29,(04001) Quirigua,151,83,93,327
10932,2020-09-29,(07008) NQS - Calle 30 Sur,379,214,316,909
10933,2020-04-17,(07200) Tygua-San José,107,47,89,243
10934,2020-09-11,(07200) Tygua-San José,228,114,172,514
10935,2020-01-14,(09106) Nariño,1593,969,1183,3745
10936,2020-03-23,(07001) PERDOMO,184,85,102,371
10937,2020-08-03,(07008) NQS - Calle 30 Sur,232,133,142,507
10938,2020-07-22,(40001) Juan Pablo II,369,227,254,850
10939,2020-08-29,(06002) Normandía,255,122,190,567
10940,2020-09-12,(04001) Quirigua,331,167,302,800
10941,2020-01-12,(07109) CAD,523,349,510,1382
10942,2020-01-26,(03010) PUENTE LARGO,273,170,343,786
10943,2020-06-14,(03010) PUENTE LARGO,95,64,57,216
10944,2020-04-16,(03005) SUBA - AV. BOYACA,178,135,110,423
10945,2020-03-25,(07005) ALQUERIA,262,155,122,539
10946,2020-04-19,(02205) Calle 106,56,44,30,130
10947,2020-02-04,(03004) GRATAMIRA,326,176,142,644
10948,2020-02-16,(03004) GRATAMIRA,52,32,64,148
10949,2020-04-07,(07108) Av. El Dorado,41,37,57,135
10950,2020-08-22,(07506) DESPENSA,378,196,239,813
10951,2020-10-06,(07200) Tygua-San José,280,146,223,649
10952,2020-04-04,(03006) NIZA - CALLE 127,182,136,79,397
10953,2020-05-10,(09118) Marly,442,281,244,967
10954,2020-08-16,(07506) DESPENSA,146,67,127,340
10955,2020-05-03,(08001) Parque el Tunal,84,47,55,186
10956,2020-07-30,(07109) CAD,531,374,271,1176
10957,2020-07-24,(07006) General Santander - alimentacion,304,163,194,661
10958,2020-05-18,(06102) Salitre El Greco,152,98,88,338
10959,2020-01-12,(10005) Bicentenario,59,62,117,238
10960,2020-01-05,(14001) La Sabana,51,61,96,208
10961,2020-06-27,(08002) Biblioteca,256,138,152,546
10962,2020-09-08,(40002) Manitas,413,254,303,970
10963,2020-04-08,(07105) MOVISTAR ARENA,126,100,79,305
10964,2020-08-17,(14004) Museo del Oro,22,17,40,79
10965,2020-07-04,(02304) Heroes,605,447,432,1484
10966,2020-06-10,(06103) CAN,360,225,156,741
10967,2020-04-03,(03005) SUBA - AV. BOYACA,188,147,148,483
10968,2020-07-01,(07106) EL CAMPIN,400,258,232,890
10969,2020-04-12,(04003) Avenida Ciudad de Cali,157,100,93,350
10970,2020-08-27,(06105) Quinta Paredes,135,79,80,294
10971,2020-04-05,(04106) Carrera 47,77,45,21,143
10972,2020-06-12,(14005) Las Aguas,73,81,213,367
10973,2020-07-21,(06108) Concejo de Bogotá,119,57,75,251
10974,2020-04-26,(09111) Calle 19,119,75,93,287
10975,2020-07-14,(14005) Las Aguas,126,93,149,368
10976,2020-04-11,(09113) Calle 22,150,94,130,374
10977,2020-03-25,(09105) Río Fucha,60,39,58,157
10978,2020-04-13,(07108) Av. El Dorado,61,49,43,153
10979,2020-07-06,(50002) Corral Calle 40 Sur,25,18,34,77
10980,2020-06-13,(12000) Puente Aranda,52,36,43,131
10981,2020-04-21,(07101) CASTELLANA,79,57,58,194
10982,2020-07-10,(03014) SAN MARTIN,30,13,26,69
10983,2020-07-04,(03007) HUMEDAL CORDOBA,138,77,65,280
10984,2020-09-11,(50006) Corral Carrera 77,5,3,7,15
10985,2020-03-31,(50006) Corral Carrera 77,8,3,6,17
10986,2020-04-09,(14004) Museo del Oro,0,11,23,34
10987,2020-07-08,(50006) Corral Carrera 77,4,2,8,14
10988,2020-04-23,(04000) Cabecera Calle 80 - alimentacion,1982,1181,1182,4345
10989,2020-01-17,(09118) Marly,5255,3537,3434,12226
10990,2020-06-11,(07504) TERREROS,5550,3200,2486,11236
10991,2020-01-30,(08000) Portal Tunal - alimentacion,23397,12695,11386,47478
10992,2020-02-11,(07003) SEVILLANA,2216,1276,1170,4662
10993,2020-08-20,(08001) Parque el Tunal,412,233,240,885
10994,2020-03-09,(04101) Minuto de Dios,895,579,455,1929
10995,2020-01-31,(03000) Portal Suba - alimentacion,27366,14977,16313,58656
10996,2020-09-28,(05000) Portal Américas - alimentacion,12155,6313,7598,26066
10997,2020-08-24,(06107) Ciudad Universitaria,128,92,116,336
10998,2020-02-24,(05001) Patio Bonito,7051,4132,3681,14864
10999,2020-09-19,(04103) Las Ferias,290,174,191,655
11000,2020-02-14,(05001) Patio Bonito,7471,4044,3717,15232
11001,2020-01-27,(05005) Transversal 86,2596,1564,1261,5421
11002,2020-09-30,(07112) COMUNEROS,927,546,665,2138
11003,2020-02-10,(07002) MADELENA,5219,3023,2537,10779
11004,2020-01-14,(09004) Santa Lucía,6354,3458,4039,13851
11005,2020-02-12,(09004) Santa Lucía,7863,4458,4259,16580
11006,2020-01-14,(03009) Av. Suba- Calle 116,2246,1432,1220,4898
11007,2020-07-30,(09100) Calle 40 Sur,1621,958,1098,3677
11008,2020-01-31,(09113) Calle 22,1534,891,1062,3487
11009,2020-07-13,(07005) ALQUERIA,453,258,259,970
11010,2020-03-09,(05100) Banderas P. Central,287,2258,1278,3823
11011,2020-08-13,(02105) Calle 142,712,450,462,1624
11012,2020-02-11,(02205) Calle 106,2818,1774,1376,5968
11013,2020-06-09,(07001) PERDOMO,877,498,502,1877
11014,2020-06-24,(07001) PERDOMO,1000,546,589,2135
11015,2020-01-29,(40003) Mirador del Paraiso,4828,2691,2551,10070
11016,2020-08-18,(04101) Minuto de Dios,295,171,240,706
11017,2020-06-03,(07505) LEON XIII,2435,1404,1060,4899
11018,2020-01-30,(09110) Avenida Jimenez,4611,3243,2730,10584
11019,2020-01-19,(09104) Restrepo,1124,674,1359,3157
11020,2020-03-14,(03000) Portal Suba - alimentacion,14874,7216,9954,32044
11021,2020-02-03,(09004) Santa Lucía,7420,4157,4370,15947
11022,2020-06-08,(03002) SUBA - TV- 91,732,444,445,1621
11023,2020-08-11,(04100) Carrera 77,1010,570,780,2360
11024,2020-02-25,(03013) RIO NEGRO,1261,843,897,3001
11025,2020-07-06,(03000) Portal Suba - alimentacion,6664,4007,3775,14446
11026,2020-01-02,(09104) Restrepo,2417,1541,2331,6289
11027,2020-09-12,(02103) Mazurén,164,85,180,429
11028,2020-08-08,(09103) Olaya,743,394,505,1642
11029,2020-09-11,(14001) La Sabana,173,101,116,390
11030,2020-10-06,(07002) MADELENA,1069,592,784,2445
11031,2020-02-14,(06105) Quinta Paredes,1080,611,524,2215
11032,2020-03-19,(50003) Corral Molinos,2310,1367,2098,5775
11033,2020-06-08,(50003) Corral Molinos,1457,692,992,3141
11034,2020-08-01,(05000) Portal Américas,1617,961,1382,3960
11035,2020-01-18,(10001) Country Sur,2682,1092,1957,5731
11036,2020-09-20,(10001) Country Sur,423,184,385,992
11037,2020-07-14,(12001) Carrera 43,372,227,172,771
11038,2020-06-20,(06105) Quinta Paredes,105,57,57,219
11039,2020-07-03,(06105) Quinta Paredes,135,91,79,305
11040,2020-09-19,(09101) Quiroga,438,196,415,1049
11041,2020-03-09,(09119) Calle 57,1435,346,458,2239
11042,2020-02-09,(09108) Hospital,96,49,107,252
11043,2020-09-27,(05100) Banderas P. Central - alimentacion,1157,445,920,2522
11044,2020-01-22,(10000) Portal 20 de Julio,8294,3898,3781,15973
11045,2020-09-02,(07112) COMUNEROS,903,513,499,1915
11046,2020-01-01,(09116) Avenida 39,93,83,191,367
11047,2020-09-02,(09004) Santa Lucía,2677,1423,1423,5523
11048,2020-06-04,(09003) Socorro,539,294,287,1120
11049,2020-08-13,(06108) Concejo de Bogotá,152,85,86,323
11050,2020-08-07,(10002) Av. Primero de Mayo,824,381,580,1785
11051,2020-10-02,(10001) Country Sur,1554,659,1079,3292
11052,2020-09-15,(14004) Museo del Oro,370,229,280,879
11053,2020-01-13,(07001) PERDOMO,3886,2292,2323,8501
11054,2020-03-11,(03005) SUBA - AV. BOYACA,2567,1605,1531,5703
11055,2020-07-02,(09123) Calle 76,1143,770,587,2500
11056,2020-09-14,(05002) Tintal,2681,1575,1741,5997
11057,2020-01-11,(02102) Calle 161,616,302,565,1483
11058,2020-02-29,(02200) Alcalá,6403,3420,4294,14117
11059,2020-09-28,(02300) Calle 100,1335,944,927,3206
11060,2020-01-04,(03012) SUBA - CALLE 95,424,300,387,1111
11061,2020-05-20,(10000) Portal 20 de Julio,1953,954,911,3818
11062,2020-02-14,(50002) Corral Calle 40 Sur,149,89,144,382
11063,2020-08-22,(50002) Corral Calle 40 Sur,13,10,15,38
11064,2020-06-02,(05101) Mandalay - Cr.73,80,48,39,167
11065,2020-02-26,(04105) Carrera 53,1540,839,748,3127
11066,2020-10-02,(03009) Av. Suba- Calle 116,560,356,402,1318
11067,2020-09-21,(02205) Calle 106,360,249,270,879
11068,2020-04-25,(10002) Av. Primero de Mayo,869,469,618,1956
11069,2020-02-29,(10008) San Diego,634,464,676,1774
11070,2020-01-15,(04108) El Polo,1614,1024,1047,3685
11071,2020-07-04,(04108) El Polo,359,238,206,803
11072,2020-02-05,(07000) Portal Sur,8095,4797,4466,17358
11073,2020-02-18,(07000) Portal Sur,8133,4865,4302,17300
11074,2020-01-25,(06106) Recinto Ferial,730,397,544,1671
11075,2020-08-14,(07113) SANTA ISABEL,341,182,263,786
11076,2020-08-15,(07113) SANTA ISABEL,287,163,232,682
11077,2020-05-25,(03007) HUMEDAL CORDOBA,38,28,20,86
11078,2020-07-03,(08002) Biblioteca,322,203,241,766
11079,2020-09-18,(05101) Mandalay - Cr.73,175,104,107,386
11080,2020-06-10,(09103) Olaya,959,540,487,1986
11081,2020-02-13,(05103) Marsella,3366,1911,1521,6798
11082,2020-06-17,(10005) Bicentenario - alimentacion,222,107,184,513
11083,2020-02-21,(04107) Escuela Militar,616,384,464,1464
11084,2020-08-12,(04107) Escuela Militar,105,64,83,252
11085,2020-07-01,(04003) Avenida Ciudad de Cali,1162,659,827,2648
11086,2020-02-09,(03006) NIZA - CALLE 127,530,303,495,1328
11087,2020-10-02,(04107) Escuela Militar,171,111,133,415
11088,2020-06-13,(05103) Marsella,262,131,184,577
11089,2020-07-21,(07002) MADELENA,587,375,417,1379
11090,2020-02-24,(07109) CAD,2902,1729,1428,6059
11091,2020-03-17,(07004) VENECIA,2841,1663,1545,6049
11092,2020-04-19,(09110) Avenida Jimenez,97,92,134,323
11093,2020-07-22,(04104) Avenida 68,576,298,327,1201
11094,2020-01-07,(12003) Ricaurte,726,504,482,1712
11095,2020-07-19,(02202) Calle 127,361,253,181,795
11096,2020-09-20,(02202) Calle 127,343,305,379,1027
11097,2020-04-16,(03011) SUBA - CALLE 100,294,175,159,628
11098,2020-07-06,(02204) Pepe Sierra,848,607,506,1961
11099,2020-06-28,(05000) Portal Américas - alimentacion,3469,1596,1734,6799
11100,2020-01-18,(06106) Recinto Ferial,702,404,558,1664
11101,2020-08-01,(02001) Centro Comercial Santa Fe,274,133,242,649
11102,2020-03-24,(02302) Virrey,543,414,389,1346
11103,2020-04-26,(12003) Ricaurte,42,33,33,108
11104,2020-05-02,(12003) Ricaurte,121,102,64,287
11105,2020-06-19,(12003) Ricaurte,406,294,203,903
11106,2020-02-29,(10010) San Bernardo,991,600,1093,2684
11107,2020-05-10,(04100) Carrera 77,256,126,193,575
11108,2020-04-26,(09116) Avenida 39,73,60,41,174
11109,2020-03-07,(06104) Gobernación,391,332,506,1229
11110,2020-02-01,(04106) Carrera 47,873,425,663,1961
11111,2020-03-20,(12001) Carrera 43,243,177,136,556
11112,2020-08-01,(09001) Molinos,1824,879,1284,3987
11113,2020-10-09,(05107) Américas - Cr.53,461,327,398,1186
11114,2020-03-01,(07103) AV. CHILE,548,363,736,1647
11115,2020-06-13,(07103) AV. CHILE,633,391,398,1422
11116,2020-03-27,(08000) Portal Tunal - alimentacion,3209,1670,1674,6553
11117,2020-08-22,(10005) Bicentenario,60,42,64,166
11118,2020-01-30,(40002) Manitas,1271,698,761,2730
11119,2020-06-10,(09117) Calle 45,688,417,412,1517
11120,2020-08-29,(04002) Carrera 90,556,268,378,1202
11121,2020-03-20,(06108) Concejo de Bogotá,89,71,58,218
11122,2020-08-22,(02001) Centro Comercial Santa Fe,327,193,252,772
11123,2020-07-19,(05100) Banderas P. Central - alimentacion,749,323,453,1525
11124,2020-04-03,(02000) Cabecera Autopista Norte,500,337,330,1167
11125,2020-01-21,(06105) Quinta Paredes,626,359,333,1318
11126,2020-07-28,(07004) VENECIA,869,514,495,1878
11127,2020-06-08,(02200) Alcalá,1697,1249,909,3855
11128,2020-07-06,(10009) Museo Nacional,530,275,320,1125
11129,2020-02-24,(10004) Policarpa,913,460,551,1924
11130,2020-03-03,(10004) Policarpa,920,476,534,1930
11131,2020-09-27,(02202) Calle 127,381,303,328,1012
11132,2020-03-12,(03009) Av. Suba- Calle 116,939,191,289,1419
11133,2020-09-03,(09122) Calle 72,1264,833,860,2957
11134,2020-01-16,(09111) Calle 19,1635,1159,1429,4223
11135,2020-04-08,(09122) Calle 72,571,398,345,1314
11136,2020-04-06,(06109) Centro Memoria,146,112,88,346
11137,2020-08-05,(07001) PERDOMO,768,450,527,1745
11138,2020-04-05,(09123) Calle 76,173,135,122,430
11139,2020-02-12,(07506) DESPENSA,1552,977,951,3480
11140,2020-03-19,(07506) DESPENSA,823,473,547,1843
11141,2020-02-22,(07506) DESPENSA,853,555,662,2070
11142,2020-07-25,(03003) 21 ANGELES,188,89,118,395
11143,2020-05-05,(10007) Las Nieves,309,200,222,731
11144,2020-05-30,(40001) Juan Pablo II,413,233,243,889
11145,2020-06-27,(10004) Policarpa,179,92,131,402
11146,2020-09-22,(05103) Marsella,530,307,349,1186
11147,2020-04-16,(02104) Calle 146,360,270,203,833
11148,2020-05-28,(03011) SUBA - CALLE 100,403,205,194,802
11149,2020-07-08,(04103) Las Ferias,378,196,183,757
11150,2020-10-06,(03009) Av. Suba- Calle 116,577,351,377,1305
11151,2020-05-21,(10007) Las Nieves,453,285,276,1014
11152,2020-06-08,(08002) Biblioteca,283,167,137,587
11153,2020-08-03,(12000) Puente Aranda,83,52,40,175
11154,2020-04-28,(07103) AV. CHILE,573,399,246,1218
11155,2020-05-27,(02102) Calle 161,218,137,157,512
11156,2020-08-31,(12004) Carrera 22,240,136,139,515
11157,2020-05-16,(07111) NQS - RICAURTE,597,418,273,1288
11158,2020-05-25,(07111) NQS - RICAURTE,172,142,130,444
11159,2020-04-25,(10009) Museo Nacional,154,119,103,376
11160,2020-01-03,(09003) Socorro,981,489,681,2151
11161,2020-05-01,(09003) Socorro,198,104,97,399
11162,2020-05-05,(04106) Carrera 47,220,114,117,451
11163,2020-05-08,(04106) Carrera 47,234,121,131,486
11164,2020-07-04,(08001) Parque el Tunal,423,239,257,919
11165,2020-08-11,(04002) Carrera 90,615,343,348,1306
11166,2020-01-26,(06106) Recinto Ferial,281,162,304,747
11167,2020-03-15,(09106) Nariño,325,194,407,926
11168,2020-07-22,(06002) Normandía,265,149,145,559
11169,2020-05-18,(04101) Minuto de Dios,257,157,175,589
11170,2020-06-17,(04101) Minuto de Dios,344,197,226,767
11171,2020-07-31,(06100) Av. Rojas,180,121,127,428
11172,2020-06-18,(06103) CAN,379,230,175,784
11173,2020-01-07,(09108) Hospital,147,94,186,427
11174,2020-05-12,(09108) Hospital,65,37,53,155
11175,2020-08-31,(09108) Hospital,46,43,67,156
11176,2020-07-04,(04103) Las Ferias,305,166,167,638
11177,2020-04-22,(06102) Salitre El Greco,141,89,81,311
11178,2020-08-11,(04000) Cabecera Calle 80 - intermunicipal,304,158,252,714
11179,2020-01-01,(04103) Las Ferias,106,57,194,357
11180,2020-07-12,(05105) Pradera,177,130,154,461
11181,2020-08-24,(07506) DESPENSA,411,227,243,881
11182,2020-10-03,(07006) General Santander - alimentacion,301,159,295,755
11183,2020-04-22,(09106) Nariño,212,131,143,486
11184,2020-04-17,(07010) Bosa,311,175,222,708
11185,2020-04-11,(07506) DESPENSA,155,86,79,320
11186,2020-03-28,(06107) Ciudad Universitaria,62,57,56,175
11187,2020-06-24,(07008) NQS - Calle 30 Sur,326,183,193,702
11188,2020-06-13,(06102) Salitre El Greco,176,108,98,382
11189,2020-09-15,(09101) Quiroga,580,279,453,1312
11190,2020-03-24,(04003) Avenida Ciudad de Cali,786,507,707,2000
11191,2020-05-01,(10001) Country Sur,303,149,207,659
11192,2020-08-31,(06101) El Tiempo,331,203,223,757
11193,2020-03-22,(09121) Las Flores,165,131,98,394
11194,2020-05-30,(07106) EL CAMPIN,243,152,141,536
11195,2020-06-12,(06107) Ciudad Universitaria,186,97,132,415
11196,2020-06-09,(09116) Avenida 39,294,194,190,678
11197,2020-05-08,(04105) Carrera 53,192,106,131,429
11198,2020-06-22,(07106) EL CAMPIN,139,97,104,340
11199,2020-04-14,(07007) NQS - Calle 38A Sur,175,105,103,383
11200,2020-04-23,(07007) NQS - Calle 38A Sur,189,116,101,406
11201,2020-03-22,(04106) Carrera 47,52,45,23,120
11202,2020-04-02,(09110) Avenida Jimenez,261,217,252,730
11203,2020-03-26,(03006) NIZA - CALLE 127,237,175,130,542
11204,2020-07-26,(40001) Juan Pablo II,142,60,115,317
11205,2020-10-04,(03004) GRATAMIRA,0,9,20,29
11206,2020-10-12,(03004) GRATAMIRA,0,10,22,32
11207,2020-03-30,(06104) Gobernación,129,120,89,338
11208,2020-04-10,(07104) Simon Bolivar,75,50,42,167
11209,2020-03-10,(12002) CDS - Carrera 32,246,48,67,361
11210,2020-04-26,(12004) Carrera 22,19,21,26,66
11211,2020-07-03,(04001) Quirigua,439,249,281,969
11212,2020-07-13,(06100) Av. Rojas,194,108,120,422
11213,2020-05-11,(06107) Ciudad Universitaria,145,87,90,322
11214,2020-05-19,(06106) Recinto Ferial,203,123,96,422
11215,2020-04-08,(09114) Calle 26,172,137,114,423
11216,2020-04-03,(09113) Calle 22,193,126,184,503
11217,2020-05-13,(12004) Carrera 22,153,93,72,318
11218,2020-06-28,(06102) Salitre El Greco,99,46,57,202
11219,2020-06-20,(06106) Recinto Ferial,204,145,121,470
11220,2020-04-28,(07200) Tygua-San José,124,70,78,272
11221,2020-04-10,(10009) Museo Nacional,61,36,42,139
11222,2020-08-07,(03005) SUBA - AV. BOYACA,116,68,89,273
11223,2020-09-25,(50002) Corral Calle 40 Sur,25,16,34,75
11224,2020-07-14,(50002) Corral Calle 40 Sur,13,10,13,36
11225,2020-04-04,(09105) Río Fucha,55,28,21,104
11226,2020-10-06,(03014) SAN MARTIN,0,23,42,65
11227,2020-04-29,(07108) Av. El Dorado,78,42,51,171
11228,2020-06-07,(10007) Las Nieves,77,60,86,223
11229,2020-08-05,(50006) Corral Carrera 77,3,2,4,9
11230,2020-07-31,(03014) SAN MARTIN,0,10,27,37
11231,2020-04-02,(09108) Hospital,35,29,42,106
11232,2020-03-22,(14005) Las Aguas,0,18,35,53
11233,2020-04-12,(10008) San Diego,57,33,23,113
11234,2020-03-22,(14004) Museo del Oro,0,19,35,54
11235,2020-01-15,(09002) Consuelo,1325,677,760,2762
11236,2020-06-02,(09002) Consuelo,441,236,214,891
11237,2020-02-21,(02502) Terminal,5121,3067,2915,11103
11238,2020-01-12,(03013) RIO NEGRO,231,127,301,659
11239,2020-03-16,(03013) RIO NEGRO,868,575,603,2046
11240,2020-02-24,(07111) NQS - RICAURTE,3244,2061,1787,7092
11241,2020-03-03,(07503) SAN MATEO,39405,22855,18032,80292
11242,2020-02-12,(14005) Las Aguas,3656,2218,1898,7772
11243,2020-01-29,(05000) Portal Américas,14586,8344,7550,30480
11244,2020-02-29,(09100) Calle 40 Sur,4436,2196,3414,10046
11245,2020-03-06,(09100) Calle 40 Sur,7419,4042,4311,15772
11246,2020-02-03,(06104) Gobernación,1419,825,645,2889
11247,2020-02-28,(09114) Calle 26,3135,2133,1952,7220
11248,2020-02-07,(07503) SAN MATEO,42227,23192,19119,84538
11249,2020-03-06,(07503) SAN MATEO,40655,21624,18523,80802
11250,2020-07-20,(04000) Cabecera Calle 80 - alimentacion,1021,563,735,2319
11251,2020-10-12,(04000) Cabecera Calle 80 - alimentacion,1379,709,1567,3655
11252,2020-08-31,(09001) Molinos,2582,1378,1782,5742
11253,2020-02-04,(03000) Portal Suba,9687,5783,5308,20778
11254,2020-05-21,(10001) Country Sur,912,413,510,1835
11255,2020-09-18,(40001) Juan Pablo II,577,363,440,1380
11256,2020-03-12,(09000) Cabecera Usme,207,1396,1250,2853
11257,2020-02-19,(02000) Cabecera Autopista Norte,11868,7240,6111,25219
11258,2020-02-23,(07002) MADELENA,860,380,797,2037
11259,2020-01-31,(09118) Marly,6166,4100,3844,14110
11260,2020-06-11,(07005) ALQUERIA,574,323,282,1179
11261,2020-03-09,(40003) Mirador del Paraiso,195,1218,811,2224
11262,2020-01-27,(05107) Américas - Cr.53,2503,1384,1283,5170
11263,2020-01-03,(04000) Cabecera Calle 80 - intermunicipal,935,598,997,2530
11264,2020-01-30,(04000) Cabecera Calle 80 - intermunicipal,2191,1511,1906,5608
11265,2020-03-05,(09104) Restrepo,5274,3129,4014,12417
11266,2020-01-07,(07505) LEON XIII,6132,3290,3215,12637
11267,2020-03-27,(07102) NQS - CALLE 75,135,112,97,344
11268,2020-07-26,(09118) Marly,434,269,279,982
11269,2020-03-07,(02302) Virrey,1347,1130,1369,3846
11270,2020-07-21,(09103) Olaya,789,488,418,1695
11271,2020-01-24,(14001) La Sabana,424,328,335,1087
11272,2020-05-20,(14001) La Sabana,141,100,73,314
11273,2020-04-24,(07111) NQS - RICAURTE,571,397,250,1218
11274,2020-07-25,(07111) NQS - RICAURTE,572,378,281,1231
11275,2020-09-04,(02000) Cabecera Autopista Norte - alimentacion,5179,2689,3297,11165
11276,2020-08-03,(07002) MADELENA,681,407,417,1505
11277,2020-09-04,(02104) Calle 146,934,545,737,2216
11278,2020-04-12,(09113) Calle 22,129,69,130,328
11279,2020-06-27,(09113) Calle 22,444,267,352,1063
11280,2020-04-14,(04105) Carrera 53,164,113,83,360
11281,2020-03-30,(50003) Corral Molinos,707,327,457,1491
11282,2020-02-16,(09110) Avenida Jimenez,1092,821,1093,3006
11283,2020-02-11,(05002) Tintal,11594,6858,6086,24538
11284,2020-07-16,(05002) Tintal,2169,1166,1246,4581
11285,2020-09-18,(02201) Prado,1024,660,750,2434
11286,2020-07-24,(04100) Carrera 77,1099,596,700,2395
11287,2020-06-30,(03000) Portal Suba,1395,847,986,3228
11288,2020-01-26,(05002) Tintal,2130,941,1911,4982
11289,2020-02-17,(10000) Portal 20 de Julio,9077,4347,3964,17388
11290,2020-03-02,(10000) Portal 20 de Julio,8827,4109,4058,16994
11291,2020-02-24,(09107) Hortúa,2418,1501,1497,5416
11292,2020-04-25,(05100) Banderas P. Central - alimentacion,1119,536,522,2177
11293,2020-08-06,(09000) Cabecera Usme - alimentacion,7994,4250,4656,16900
11294,2020-05-05,(02000) Cabecera Autopista Norte - intermunicipal,297,200,187,684
11295,2020-06-03,(03000) Portal Suba,1114,693,665,2472
11296,2020-06-11,(02000) Cabecera Autopista Norte - intermunicipal,503,329,350,1182
11297,2020-01-20,(09101) Quiroga,1506,895,1222,3623
11298,2020-05-26,(03000) Portal Suba - alimentacion,5434,3154,2994,11582
11299,2020-06-16,(02000) Cabecera Autopista Norte - alimentacion,4797,2812,2657,10266
11300,2020-03-18,(09107) Hortúa,1410,855,844,3109
11301,2020-03-11,(06108) Concejo de Bogotá,800,459,427,1686
11302,2020-04-01,(09004) Santa Lucía,1060,563,596,2219
11303,2020-01-25,(07001) PERDOMO,2629,1166,1802,5597
11304,2020-04-16,(09000) Cabecera Usme - alimentacion,4153,2417,2826,9396
11305,2020-06-02,(10002) Av. Primero de Mayo,1896,994,1088,3978
11306,2020-07-15,(08001) Parque el Tunal,347,213,172,732
11307,2020-01-28,(10007) Las Nieves,1928,1195,1137,4260
11308,2020-01-29,(06102) Salitre El Greco,1577,876,755,3208
11309,2020-05-12,(09107) Hortúa,490,321,278,1089
11310,2020-08-12,(09123) Calle 76,970,636,534,2140
11311,2020-02-26,(05101) Mandalay - Cr.73,1255,596,534,2385
11312,2020-04-04,(40003) Mirador del Paraiso,618,343,381,1342
11313,2020-02-04,(10009) Museo Nacional,4480,2279,1975,8734
11314,2020-03-31,(05000) Portal Américas,1201,779,960,2940
11315,2020-10-06,(03012) SUBA - CALLE 95,382,226,270,878
11316,2020-09-30,(10000) Portal 20 de Julio,2533,1216,1575,5324
11317,2020-01-11,(06000) Portal Eldorado,2243,1581,1825,5649
11318,2020-02-16,(07007) NQS - Calle 38A Sur,656,333,502,1491
11319,2020-06-09,(05101) Mandalay - Cr.73,90,55,51,196
11320,2020-01-12,(07104) Simon Bolivar,357,241,435,1033
11321,2020-03-04,(05005) Transversal 86,2851,1659,1320,5830
11322,2020-05-22,(05005) Transversal 86,283,156,153,592
11323,2020-05-04,(05105) Pradera,420,281,190,891
11324,2020-05-13,(05105) Pradera,470,274,159,903
11325,2020-08-24,(03009) Av. Suba- Calle 116,520,321,227,1068
11326,2020-06-01,(02205) Calle 106,312,209,172,693
11327,2020-08-29,(02205) Calle 106,186,158,206,550
11328,2020-05-19,(03000) Portal Suba - alimentacion,4904,2851,2514,10269
11329,2020-08-25,(04108) El Polo,467,305,232,1004
11330,2020-06-01,(07103) AV. CHILE,853,518,402,1773
11331,2020-08-29,(07113) SANTA ISABEL,297,157,259,713
11332,2020-02-09,(03011) SUBA - CALLE 100,432,246,486,1164
11333,2020-04-04,(09000) Cabecera Usme,581,308,381,1270
11334,2020-05-15,(02101) Toberín,1078,681,592,2351
11335,2020-02-29,(10005) Bicentenario - alimentacion,437,221,489,1147
11336,2020-04-29,(02000) Cabecera Autopista Norte,629,457,381,1467
11337,2020-07-04,(05001) Patio Bonito,0,713,1843,2556
11338,2020-05-10,(09110) Avenida Jimenez,143,109,129,381
11339,2020-07-11,(09117) Calle 45,533,329,418,1280
11340,2020-07-01,(06101) El Tiempo,382,228,189,799
11341,2020-03-30,(03011) SUBA - CALLE 100,283,188,130,601
11342,2020-03-25,(10001) Country Sur,543,242,355,1140
11343,2020-04-12,(05001) Patio Bonito,267,174,194,635
11344,2020-07-11,(04108) El Polo,360,219,247,826
11345,2020-09-18,(06106) Recinto Ferial,291,163,195,649
11346,2020-10-04,(04103) Las Ferias,119,62,122,303
11347,2020-05-15,(07106) EL CAMPIN,246,161,153,560
11348,2020-09-20,(05100) Banderas P. Central,249,128,294,671
11349,2020-02-03,(03009) Av. Suba- Calle 116,2590,1679,1435,5704
11350,2020-03-08,(06103) CAN,254,208,370,832
11351,2020-03-14,(06001) Modelia,913,584,873,2370
11352,2020-03-15,(02105) Calle 142,646,381,747,1774
11353,2020-10-08,(03006) NIZA - CALLE 127,562,351,408,1321
11354,2020-02-16,(06108) Concejo de Bogotá,128,72,186,386
11355,2020-05-08,(05107) Américas - Cr.53,354,240,171,765
11356,2020-08-24,(02103) Mazurén,187,108,139,434
11357,2020-03-22,(40002) Manitas,54,34,38,126
11358,2020-06-08,(09117) Calle 45,685,411,363,1459
11359,2020-09-15,(02304) Heroes,912,608,559,2079
11360,2020-09-11,(10002) Av. Primero de Mayo,2162,1039,1418,4619
11361,2020-06-11,(02001) Centro Comercial Santa Fe,452,275,283,1010
11362,2020-06-03,(09118) Marly,1385,902,634,2921
11363,2020-05-06,(09120) Calle 63,678,488,416,1582
11364,2020-07-29,(03011) SUBA - CALLE 100,490,226,217,933
11365,2020-08-21,(03011) SUBA - CALLE 100,511,231,234,976
11366,2020-05-22,(10009) Museo Nacional,421,260,229,910
11367,2020-03-01,(10004) Policarpa,253,90,265,608
11368,2020-08-31,(09117) Calle 45,660,399,467,1526
11369,2020-03-28,(05105) Pradera,267,189,131,587
11370,2020-09-30,(06111) Universidades,509,266,484,1259
11371,2020-06-03,(09115) Calle 34,640,396,346,1382
11372,2020-08-06,(09115) Calle 34,596,354,344,1294
11373,2020-07-22,(03006) NIZA - CALLE 127,455,243,204,902
11374,2020-01-07,(05102) Av. Américas - Av. Boyacá,926,550,658,2134
11375,2020-06-16,(07110) PALOQUEMAO,632,387,273,1292
11376,2020-08-14,(07110) PALOQUEMAO,635,385,261,1281
11377,2020-01-01,(03006) NIZA - CALLE 127,175,122,228,525
11378,2020-01-26,(10006) San Victorino,348,313,440,1101
11379,2020-10-06,(09107) Hortúa,647,394,535,1576
11380,2020-03-25,(06104) Gobernación,154,148,72,374
11381,2020-01-07,(09106) Nariño,1305,770,966,3041
11382,2020-03-01,(10001) Country Sur,838,357,1053,2248
11383,2020-04-17,(07105) MOVISTAR ARENA,164,100,74,338
11384,2020-02-05,(50002) Corral Calle 40 Sur,128,113,154,395
11385,2020-07-31,(09114) Calle 26,270,179,185,634
11386,2020-04-01,(02200) Alcalá,854,618,470,1942
11387,2020-05-01,(02200) Alcalá,505,386,291,1182
11388,2020-03-20,(07000) Portal Sur,773,484,427,1684
11389,2020-09-01,(03003) 21 ANGELES,319,173,192,684
11390,2020-05-04,(07110) PALOQUEMAO,530,354,204,1088
11391,2020-08-25,(40001) Juan Pablo II,528,330,336,1194
11392,2020-08-05,(06107) Ciudad Universitaria,144,101,104,349
11393,2020-06-25,(06102) Salitre El Greco,253,141,119,513
11394,2020-10-02,(06102) Salitre El Greco,293,171,196,660
11395,2020-03-19,(04103) Las Ferias,725,426,438,1589
11396,2020-07-07,(07009) SENA,689,420,468,1577
11397,2020-06-24,(04000) Cabecera Calle 80 - intermunicipal,302,187,287,776
11398,2020-05-06,(02102) Calle 161,127,90,83,300
11399,2020-06-15,(07111) NQS - RICAURTE,213,187,163,563
11400,2020-06-26,(09111) Calle 19,808,510,507,1825
11401,2020-07-19,(09120) Calle 63,263,168,192,623
11402,2020-03-24,(04106) Carrera 47,259,139,159,557
11403,2020-04-23,(10009) Museo Nacional,311,195,171,677
11404,2020-09-25,(04106) Carrera 47,374,181,244,799
11405,2020-10-12,(09107) Hortúa,245,147,264,656
11406,2020-07-26,(09003) Socorro,170,73,111,354
11407,2020-05-23,(04106) Carrera 47,229,114,107,450
11408,2020-05-09,(09002) Consuelo,222,105,166,493
11409,2020-09-19,(02000) Cabecera Autopista Norte - intermunicipal,459,259,482,1200
11410,2020-09-07,(09120) Calle 63,1144,760,854,2758
11411,2020-05-24,(02204) Pepe Sierra,194,143,106,443
11412,2020-05-17,(09004) Santa Lucía,596,281,361,1238
11413,2020-03-20,(07008) NQS - Calle 30 Sur,134,76,75,285
11414,2020-09-18,(12002) CDS - Carrera 32,213,137,101,451
11415,2020-08-05,(03003) 21 ANGELES,261,116,131,508
11416,2020-10-10,(09106) Nariño,377,191,398,966
11417,2020-05-27,(07006) General Santander,416,259,226,901
11418,2020-10-11,(03010) PUENTE LARGO,73,64,117,254
11419,2020-02-11,(09108) Hospital,278,159,215,652
11420,2020-07-11,(04000) Cabecera Calle 80 - intermunicipal,223,121,246,590
11421,2020-05-23,(04104) Avenida 68,379,205,223,807
11422,2020-10-03,(09111) Calle 19,640,423,576,1639
11423,2020-01-18,(04107) Escuela Militar,311,226,273,810
11424,2020-07-10,(07005) ALQUERIA,642,341,400,1383
11425,2020-07-07,(03011) SUBA - CALLE 100,577,273,278,1128
11426,2020-01-07,(09105) Río Fucha,447,287,401,1135
11427,2020-03-25,(07104) Simon Bolivar,183,147,133,463
11428,2020-07-28,(04103) Las Ferias,342,167,164,673
11429,2020-05-17,(09122) Calle 72,279,218,207,704
11430,2020-06-09,(09106) Nariño,387,215,267,869
11431,2020-08-25,(10004) Policarpa,248,103,149,500
11432,2020-09-05,(03005) SUBA - AV. BOYACA,368,216,319,903
11433,2020-03-20,(07006) General Santander - alimentacion,206,127,109,442
11434,2020-04-29,(07107) U. NACIONAL,223,149,99,471
11435,2020-05-07,(03010) PUENTE LARGO,228,156,129,513
11436,2020-05-14,(06101) El Tiempo,271,171,133,575
11437,2020-09-17,(10003) Ciudad Jardín,225,117,177,519
11438,2020-02-02,(07101) CASTELLANA,74,77,179,330
11439,2020-03-01,(09105) Río Fucha,108,71,190,369
11440,2020-05-19,(07007) NQS - Calle 38A Sur,252,168,181,601
11441,2020-04-10,(04100) Carrera 77,151,92,105,348
11442,2020-05-28,(04003) Avenida Ciudad de Cali,862,546,583,1991
11443,2020-04-11,(09114) Calle 26,66,53,51,170
11444,2020-06-15,(02104) Calle 146,271,174,195,640
11445,2020-03-22,(40001) Juan Pablo II,90,56,44,190
11446,2020-08-26,(09114) Calle 26,288,171,203,662
11447,2020-07-20,(10008) San Diego,80,47,52,179
11448,2020-04-16,(04003) Avenida Ciudad de Cali,530,317,355,1202
11449,2020-05-31,(04107) Escuela Militar,24,27,23,74
11450,2020-04-01,(10005) Bicentenario - alimentacion,135,68,88,291
11451,2020-06-15,(07003) SEVILLANA,143,73,91,307
11452,2020-10-02,(50006) Corral Carrera 77,5,3,10,18
11453,2020-08-23,(05005) Transversal 86,69,43,88,200
11454,2020-04-05,(09108) Hospital,19,13,16,48
11455,2020-09-03,(12000) Puente Aranda,76,42,67,185
11456,2020-03-28,(07102) NQS - CALLE 75,79,76,45,200
11457,2020-04-25,(07113) SANTA ISABEL,131,98,107,336
11458,2020-05-31,(10005) Bicentenario,14,10,15,39
11459,2020-06-28,(50006) Corral Carrera 77,1,1,0,2
11460,2020-03-04,(04000) Cabecera Calle 80 - alimentacion,24075,14507,15126,53708
11461,2020-06-04,(09002) Consuelo,450,242,247,939
11462,2020-01-18,(05000) Portal Américas - alimentacion,23539,11463,14619,49621
11463,2020-02-06,(03002) SUBA - TV- 91,4445,2597,2354,9396
11464,2020-03-12,(03002) SUBA - TV- 91,231,1048,710,1989
11465,2020-09-08,(07503) SAN MATEO,12194,6563,6063,24820
11466,2020-02-01,(02101) Toberín,5810,2686,4936,13432
11467,2020-02-24,(06104) Gobernación,1512,856,644,3012
11468,2020-01-21,(10000) Portal 20 de Julio - alimentacion,7708,3586,5594,16888
11469,2020-01-24,(07111) NQS - RICAURTE,3022,1878,1689,6589
11470,2020-02-14,(06107) Ciudad Universitaria,1544,938,985,3467
11471,2020-03-05,(09001) Molinos,7582,4468,5868,17918
11472,2020-01-15,(02000) Cabecera Autopista Norte - alimentacion,19658,10636,12020,42314
11473,2020-01-09,(14004) Museo del Oro,1811,1201,1215,4227
11474,2020-02-06,(50006) Corral Carrera 77,34,21,41,96
11475,2020-09-26,(09000) Cabecera Usme,1528,777,1446,3751
11476,2020-01-14,(05100) Banderas P. Central - alimentacion,12087,6571,7216,25874
11477,2020-01-13,(09118) Marly,4474,3102,3087,10663
11478,2020-01-16,(09118) Marly,5228,3520,3198,11946
11479,2020-01-09,(02205) Calle 106,1847,1216,1114,4177
11480,2020-03-11,(02205) Calle 106,2558,1654,1321,5533
11481,2020-01-14,(10005) Bicentenario - alimentacion,636,285,464,1385
11482,2020-09-04,(10005) Bicentenario - alimentacion,218,105,249,572
11483,2020-05-27,(07001) PERDOMO,776,432,449,1657
11484,2020-07-09,(07001) PERDOMO,978,555,562,2095
11485,2020-02-12,(09000) Cabecera Usme - alimentacion,27014,15209,15666,57889
11486,2020-01-30,(07505) LEON XIII,8341,4583,3741,16665
11487,2020-07-21,(02204) Pepe Sierra,768,528,396,1692
11488,2020-02-18,(06002) Normandía,2747,1591,1313,5651
11489,2020-09-23,(03000) Portal Suba - alimentacion,7490,4165,4893,16548
11490,2020-02-17,(12003) Ricaurte,1294,793,649,2736
11491,2020-04-14,(07102) NQS - CALLE 75,159,139,100,398
11492,2020-07-30,(07102) NQS - CALLE 75,431,260,237,928
11493,2020-08-15,(07102) NQS - CALLE 75,268,200,217,685
11494,2020-02-28,(03013) RIO NEGRO,1193,804,899,2896
11495,2020-04-29,(03013) RIO NEGRO,179,114,133,426
11496,2020-02-21,(02303) Calle 85,3307,2463,2013,7783
11497,2020-08-15,(05100) Banderas P. Central - alimentacion,2354,1113,1491,4958
11498,2020-05-11,(09103) Olaya,735,396,417,1548
11499,2020-06-14,(09103) Olaya,330,155,218,703
11500,2020-08-04,(09103) Olaya,935,500,496,1931
11501,2020-01-03,(07002) MADELENA,2319,1172,1431,4922
11502,2020-09-22,(07111) NQS - RICAURTE,1239,747,550,2536
11503,2020-09-17,(07002) MADELENA,974,556,650,2180
11504,2020-08-22,(02000) Cabecera Autopista Norte,947,536,669,2152
11505,2020-02-03,(07109) CAD,2882,1741,1502,6125
11506,2020-07-24,(08000) Portal Tunal - alimentacion,4573,2535,2654,9762
11507,2020-07-01,(50003) Corral Molinos,1630,856,1123,3609
11508,2020-06-16,(04000) Cabecera Calle 80,1069,670,773,2512
11509,2020-07-16,(07010) Bosa,642,307,378,1327
11510,2020-03-18,(09114) Calle 26,1376,975,882,3233
11511,2020-09-09,(02201) Prado,1019,661,691,2371
11512,2020-07-10,(06000) Portal Eldorado,960,654,529,2143
11513,2020-08-20,(06000) Portal Eldorado,919,583,475,1977
11514,2020-08-01,(12001) Carrera 43,248,132,158,538
11515,2020-09-09,(12001) Carrera 43,490,274,320,1084
11516,2020-03-17,(10002) Av. Primero de Mayo,5412,2697,3044,11153
11517,2020-03-07,(04104) Avenida 68,1745,977,1454,4176
11518,2020-02-18,(10005) Bicentenario - alimentacion,727,340,549,1616
11519,2020-05-31,(06105) Quinta Paredes,40,25,19,84
11520,2020-09-30,(02000) Cabecera Autopista Norte - intermunicipal,635,427,547,1609
11521,2020-08-05,(03000) Portal Suba,959,624,691,2274
11522,2020-05-26,(02000) Cabecera Autopista Norte - intermunicipal,471,340,371,1182
11523,2020-07-20,(09101) Quiroga,158,70,127,355
11524,2020-01-01,(03000) Portal Suba - alimentacion,2148,1043,2891,6082
11525,2020-01-30,(04108) El Polo,1932,1176,1130,4238
11526,2020-07-13,(10000) Portal 20 de Julio,1423,772,707,2902
11527,2020-06-06,(02303) Calle 85,402,313,247,962
11528,2020-02-20,(07000) Portal Sur,7899,4699,4035,16633
11529,2020-02-25,(07000) Portal Sur,8127,4812,4287,17226
11530,2020-03-03,(08002) Biblioteca,1019,633,652,2304
11531,2020-02-03,(07004) VENECIA,4600,2612,2576,9788
11532,2020-06-01,(07004) VENECIA,879,532,479,1890
11533,2020-07-20,(07503) SAN MATEO,2906,1683,1571,6160
11534,2020-02-17,(07008) NQS - Calle 30 Sur,1950,1097,1115,4162
11535,2020-03-15,(06108) Concejo de Bogotá,101,51,105,257
11536,2020-05-20,(04000) Cabecera Calle 80,851,546,561,1958
11537,2020-01-23,(06001) Modelia,2286,1432,1298,5016
11538,2020-01-10,(07110) PALOQUEMAO,1776,1029,923,3728
11539,2020-08-26,(09004) Santa Lucía,2398,1200,1371,4969
11540,2020-04-04,(09107) Hortúa,273,177,167,617
11541,2020-08-16,(09107) Hortúa,218,118,166,502
11542,2020-01-03,(02204) Pepe Sierra,2223,1512,1306,5041
11543,2020-03-05,(05101) Mandalay - Cr.73,1197,639,581,2417
11544,2020-05-15,(05101) Mandalay - Cr.73,90,43,44,177
11545,2020-06-25,(05002) Tintal,2632,1508,1435,5575
11546,2020-04-18,(05103) Marsella,124,68,69,261
11547,2020-01-22,(03011) SUBA - CALLE 100,2432,1216,1270,4918
11548,2020-09-27,(02300) Calle 100,208,231,420,859
11549,2020-07-15,(09119) Calle 57,415,261,296,972
11550,2020-01-21,(07007) NQS - Calle 38A Sur,1490,723,749,2962
11551,2020-03-10,(05105) Pradera,1023,294,289,1606
11552,2020-07-29,(02202) Calle 127,1049,735,482,2266
11553,2020-07-03,(08000) Portal Tunal,825,389,376,1590
11554,2020-06-24,(03009) Av. Suba- Calle 116,503,342,233,1078
11555,2020-08-04,(03009) Av. Suba- Calle 116,405,269,166,840
11556,2020-03-12,(14004) Museo del Oro,1748,102,383,2233
11557,2020-10-06,(04003) Avenida Ciudad de Cali,1217,663,1034,2914
11558,2020-01-20,(02202) Calle 127,5464,3608,2778,11850
11559,2020-03-19,(07106) EL CAMPIN,981,695,559,2235
11560,2020-09-10,(07106) EL CAMPIN,412,221,280,913
11561,2020-07-06,(06000) Portal Eldorado,1005,703,555,2263
11562,2020-06-21,(05103) Marsella,124,67,102,293
11563,2020-09-07,(08002) Biblioteca,326,175,217,718
11564,2020-09-23,(04000) Cabecera Calle 80,1245,802,1148,3195
11565,2020-01-24,(03010) PUENTE LARGO,1999,1278,1240,4517
11566,2020-03-09,(05101) Mandalay - Cr.73,55,300,147,502
11567,2020-04-28,(09100) Calle 40 Sur,1009,596,642,2247
11568,2020-06-27,(07104) Simon Bolivar,523,332,252,1107
11569,2020-06-17,(04103) Las Ferias,357,201,172,730
11570,2020-01-30,(09109) Tercer Milenio,1358,854,871,3083
11571,2020-04-30,(05001) Patio Bonito,1109,605,669,2383
11572,2020-07-09,(07002) MADELENA,879,524,490,1893
11573,2020-02-03,(03003) 21 ANGELES,1715,882,956,3553
11574,2020-10-11,(02104) Calle 146,303,169,338,810
11575,2020-03-17,(06000) Portal Eldorado,4146,2528,1723,8397
11576,2020-07-24,(02202) Calle 127,989,645,478,2112
11577,2020-08-09,(02202) Calle 127,349,256,222,827
11578,2020-09-01,(06101) El Tiempo,353,213,218,784
11579,2020-04-04,(03011) SUBA - CALLE 100,198,132,103,433
11580,2020-07-07,(09120) Calle 63,1208,795,764,2767
11581,2020-05-31,(10002) Av. Primero de Mayo,475,258,390,1123
11582,2020-08-01,(02304) Heroes,505,380,272,1157
11583,2020-03-21,(05001) Patio Bonito,525,292,319,1136
11584,2020-08-23,(02000) Cabecera Autopista Norte,371,222,314,907
11585,2020-04-01,(04108) El Polo,203,157,125,485
11586,2020-06-23,(02105) Calle 142,835,549,480,1864
11587,2020-09-24,(02001) Centro Comercial Santa Fe,595,379,489,1463
11588,2020-01-25,(06100) Av. Rojas,746,446,782,1974
11589,2020-01-25,(03013) RIO NEGRO,650,400,593,1643
11590,2020-06-13,(09104) Restrepo,1189,745,898,2832
11591,2020-09-03,(04106) Carrera 47,328,174,225,727
11592,2020-09-16,(04106) Carrera 47,374,161,230,765
11593,2020-09-05,(03006) NIZA - CALLE 127,380,239,274,893
11594,2020-10-11,(03002) SUBA - TV- 91,290,113,338,741
11595,2020-01-02,(07004) VENECIA,1983,1182,1383,4548
11596,2020-07-28,(02104) Calle 146,686,456,444,1586
11597,2020-05-25,(07103) AV. CHILE,219,167,144,530
11598,2020-09-01,(12007) Zona Industrial,387,220,146,753
11599,2020-08-15,(10005) Bicentenario,82,57,96,235
11600,2020-09-30,(10005) Bicentenario,138,74,123,335
11601,2020-10-01,(10005) Bicentenario,127,77,95,299
11602,2020-01-03,(07006) General Santander - alimentacion,699,441,592,1732
11603,2020-07-12,(05100) Banderas P. Central - alimentacion,1059,460,670,2189
11604,2020-09-22,(09107) Hortúa,649,399,512,1560
11605,2020-09-18,(04103) Las Ferias,384,221,221,826
11606,2020-09-14,(07106) EL CAMPIN,413,286,274,973
11607,2020-03-03,(09106) Nariño,2088,1300,1387,4775
11608,2020-09-06,(10008) San Diego,115,74,88,277
11609,2020-07-07,(10009) Museo Nacional,505,312,347,1164
11610,2020-02-04,(10004) Policarpa,900,471,621,1992
11611,2020-06-08,(05105) Pradera,523,324,237,1084
11612,2020-09-16,(06111) Universidades,443,238,459,1140
11613,2020-06-30,(12007) Zona Industrial,356,205,174,735
11614,2020-04-21,(40003) Mirador del Paraiso,744,503,527,1774
11615,2020-08-13,(09115) Calle 34,633,376,376,1385
11616,2020-05-12,(03006) NIZA - CALLE 127,303,190,176,669
11617,2020-01-06,(14005) Las Aguas,157,135,375,667
11618,2020-03-26,(04100) Carrera 77,569,357,321,1247
11619,2020-09-23,(04105) Carrera 53,339,179,203,721
11620,2020-03-01,(02303) Calle 85,471,421,590,1482
11621,2020-07-10,(06104) Gobernación,261,163,100,524
11622,2020-07-13,(06104) Gobernación,233,130,108,471
11623,2020-07-05,(02000) Cabecera Autopista Norte,411,278,363,1052
11624,2020-09-27,(03009) Av. Suba- Calle 116,135,109,177,421
11625,2020-03-15,(09104) Restrepo,935,566,1111,2612
11626,2020-07-08,(02200) Alcalá,1983,1276,1026,4285
11627,2020-07-02,(10007) Las Nieves,710,392,428,1530
11628,2020-08-30,(03001) LA CAMPIÑA,333,146,289,768
11629,2020-07-22,(06000) Portal Eldorado,826,568,422,1816
11630,2020-09-15,(04103) Las Ferias,375,198,214,787
11631,2020-07-28,(02200) Alcalá,1668,1140,852,3660
11632,2020-08-30,(09104) Restrepo,505,269,510,1284
11633,2020-10-12,(09104) Restrepo,558,331,733,1622
11634,2020-04-22,(02102) Calle 161,107,78,66,251
11635,2020-08-24,(06000) Portal Eldorado,889,526,451,1866
11636,2020-08-16,(10009) Museo Nacional,72,59,102,233
11637,2020-05-11,(07006) General Santander - alimentacion,265,136,162,563
11638,2020-03-29,(02201) Prado,143,100,58,301
11639,2020-10-11,(07009) SENA,223,111,350,684
11640,2020-09-05,(05101) Mandalay - Cr.73,114,67,87,268
11641,2020-09-22,(12002) CDS - Carrera 32,227,132,107,466
11642,2020-07-05,(03006) NIZA - CALLE 127,180,112,101,393
11643,2020-01-05,(40001) Juan Pablo II,395,180,299,874
11644,2020-03-20,(06002) Normandía,132,97,90,319
11645,2020-08-03,(07506) DESPENSA,419,226,220,865
11646,2020-04-14,(04102) Avenida Boyaca,131,91,106,328
11647,2020-06-30,(04102) Avenida Boyaca,380,230,242,852
11648,2020-07-28,(14004) Museo del Oro,275,146,177,598
11649,2020-08-09,(03001) LA CAMPIÑA,234,119,149,502
11650,2020-01-10,(09108) Hospital,171,89,158,418
11651,2020-06-03,(09108) Hospital,64,42,55,161
11652,2020-09-25,(07006) General Santander - alimentacion,414,240,343,997
11653,2020-08-16,(07009) SENA,171,103,150,424
11654,2020-03-23,(02103) Mazurén,30,25,32,87
11655,2020-04-10,(02502) Terminal,53,34,34,121
11656,2020-08-11,(07107) U. NACIONAL,329,180,165,674
11657,2020-05-27,(04104) Avenida 68,542,313,267,1122
11658,2020-04-08,(07009) SENA,287,164,171,622
11659,2020-03-26,(10007) Las Nieves,144,135,155,434
11660,2020-04-02,(10007) Las Nieves,169,128,162,459
11661,2020-03-23,(50003) Corral Molinos,314,155,204,673
11662,2020-08-07,(02001) Centro Comercial Santa Fe,155,82,135,372
11663,2020-07-21,(07008) NQS - Calle 30 Sur,264,145,161,570
11664,2020-05-25,(07006) General Santander - alimentacion,94,61,75,230
11665,2020-07-19,(02201) Prado,217,148,144,509
11666,2020-03-21,(03007) HUMEDAL CORDOBA,55,44,32,131
11667,2020-05-11,(07107) U. NACIONAL,278,166,147,591
11668,2020-05-22,(10004) Policarpa,192,98,119,409
11669,2020-07-03,(07006) General Santander,569,337,345,1251
11670,2020-07-22,(04001) Quirigua,353,211,235,799
11671,2020-03-21,(14004) Museo del Oro,0,31,80,111
11672,2020-04-28,(05100) Banderas P. Central,393,240,239,872
11673,2020-06-10,(03005) SUBA - AV. BOYACA,441,253,253,947
11674,2020-05-16,(03005) SUBA - AV. BOYACA,254,168,169,591
11675,2020-05-19,(09106) Nariño,312,191,171,674
11676,2020-06-05,(06101) El Tiempo,319,204,175,698
11677,2020-06-06,(04103) Las Ferias,268,144,157,569
11678,2020-08-17,(12004) Carrera 22,61,41,34,136
11679,2020-04-18,(05100) Banderas P. Central,195,122,128,445
11680,2020-08-04,(10003) Ciudad Jardín,208,99,166,473
11681,2020-05-14,(06100) Av. Rojas,175,96,100,371
11682,2020-06-12,(06100) Av. Rojas,228,129,132,489
11683,2020-06-08,(04103) Las Ferias,349,186,168,703
11684,2020-07-23,(10003) Ciudad Jardín,147,68,108,323
11685,2020-07-19,(03004) GRATAMIRA,12,3,6,21
11686,2020-05-12,(12007) Zona Industrial,254,166,85,505
11687,2020-04-15,(09106) Nariño,216,138,165,519
11688,2020-04-28,(06106) Recinto Ferial,166,113,84,363
11689,2020-08-20,(06107) Ciudad Universitaria,175,100,102,377
11690,2020-08-05,(04102) Avenida Boyaca,250,141,189,580
11691,2020-09-11,(07101) CASTELLANA,252,128,126,506
11692,2020-06-07,(12007) Zona Industrial,41,35,35,111
11693,2020-09-27,(06001) Modelia,91,50,130,271
11694,2020-03-21,(09114) Calle 26,86,68,74,228
11695,2020-07-19,(02000) Cabecera Autopista Norte - intermunicipal,98,51,82,231
11696,2020-04-27,(12004) Carrera 22,12,37,31,80
11697,2020-04-04,(10005) Bicentenario - alimentacion,106,48,73,227
11698,2020-04-09,(04002) Carrera 90,100,72,53,225
11699,2020-09-05,(03014) SAN MARTIN,0,13,38,51
11700,2020-05-03,(07006) General Santander,106,64,74,244
11701,2020-05-19,(03007) HUMEDAL CORDOBA,131,83,45,259
11702,2020-04-26,(05101) Mandalay - Cr.73,16,9,7,32
11703,2020-04-27,(12000) Puente Aranda,7,17,13,37
11704,2019-12-31,(10004) Policarpa,8,7,23,38
11705,2020-01-25,(04000) Cabecera Calle 80 - alimentacion,11941,5382,9516,26839
11706,2020-10-01,(04000) Cabecera Calle 80 - alimentacion,4964,2730,4028,11722
11707,2020-01-22,(07005) ALQUERIA,2360,1334,1331,5025
11708,2020-02-21,(07005) ALQUERIA,2678,1400,1334,5412
11709,2020-09-24,(09002) Consuelo,504,285,321,1110
11710,2020-01-02,(09118) Marly,2379,1676,1929,5984
11711,2020-02-22,(09118) Marly,3834,2520,3117,9471
11712,2020-07-18,(07504) TERREROS,3987,2062,1982,8031
11713,2020-01-31,(04106) Carrera 47,1470,786,871,3127
11714,2020-02-26,(03000) Portal Suba - alimentacion,29805,16874,16959,63638
11715,2020-04-30,(05000) Portal Américas - alimentacion,7217,3617,3328,14162
11716,2020-02-27,(07503) SAN MATEO,41270,23120,17823,82213
11717,2020-08-12,(07503) SAN MATEO,10865,6128,4914,21907
11718,2020-03-07,(50003) Corral Molinos,1947,1599,2954,6500
11719,2020-07-16,(07503) SAN MATEO,10294,5889,4799,20982
11720,2020-07-02,(05000) Portal Américas - alimentacion,11089,6016,5563,22668
11721,2020-02-29,(05005) Transversal 86,1482,561,983,3026
11722,2020-03-15,(05000) Portal Américas - alimentacion,7845,3188,5468,16501
11723,2020-06-26,(10001) Country Sur,1315,587,790,2692
11724,2020-03-07,(05100) Banderas P. Central - alimentacion,8759,3916,5766,18441
11725,2020-02-20,(02000) Cabecera Autopista Norte,11128,6865,5678,23671
11726,2020-02-26,(07009) SENA,3883,2230,1945,8058
11727,2020-02-14,(10002) Av. Primero de Mayo,8711,4260,4930,17901
11728,2020-04-26,(07001) PERDOMO,153,84,96,333
11729,2020-09-03,(07001) PERDOMO,983,578,741,2302
11730,2020-09-25,(07001) PERDOMO,1130,622,980,2732
11731,2020-01-02,(02000) Cabecera Autopista Norte,3557,2238,2572,8367
11732,2020-01-02,(40003) Mirador del Paraiso,2605,1351,1741,5697
11733,2020-07-09,(09109) Tercer Milenio,386,216,257,859
11734,2020-09-08,(09104) Restrepo,1675,925,1178,3778
11735,2020-07-30,(04100) Carrera 77,1271,719,779,2769
11736,2020-02-27,(07505) LEON XIII,8644,4789,3711,17144
11737,2020-04-24,(07505) LEON XIII,1277,817,615,2709
11738,2020-05-21,(07505) LEON XIII,1999,1228,858,4085
11739,2020-07-10,(07505) LEON XIII,3027,1633,1302,5962
11740,2020-07-28,(03000) Portal Suba - alimentacion,5906,3387,3314,12607
11741,2020-03-31,(09000) Cabecera Usme,814,412,534,1760
11742,2020-06-03,(09101) Quiroga,469,270,286,1025
11743,2020-02-18,(09116) Avenida 39,3463,2168,1686,7317
11744,2020-05-18,(07000) Portal Sur - alimentacion,6279,3503,2831,12613
11745,2020-03-09,(05100) Banderas P. Central - alimentacion,790,3933,2424,7147
11746,2020-07-14,(05100) Banderas P. Central - alimentacion,2664,1378,1314,5356
11747,2020-09-04,(05100) Banderas P. Central - alimentacion,3465,1802,2223,7490
11748,2020-10-09,(14001) La Sabana,167,95,146,408
11749,2020-07-28,(07002) MADELENA,765,414,524,1703
11750,2020-06-19,(02000) Cabecera Autopista Norte,1374,868,889,3131
11751,2020-05-05,(50003) Corral Molinos,1031,481,668,2180
11752,2020-09-08,(50003) Corral Molinos,1589,821,1173,3583
11753,2020-02-06,(05002) Tintal,10622,6402,5853,22877
11754,2020-09-27,(09114) Calle 26,76,56,124,256
11755,2020-02-10,(09111) Calle 19,2473,1459,1544,5476
11756,2020-03-16,(10006) San Victorino,1490,961,944,3395
11757,2020-07-07,(06000) Portal Eldorado,1018,690,522,2230
11758,2020-03-16,(10008) San Diego,1058,599,539,2196
11759,2020-03-03,(40003) Mirador del Paraiso,4634,2705,2613,9952
11760,2020-03-13,(04001) Quirigua,106,425,349,880
11761,2020-07-02,(06000) Portal Eldorado - alimentacion,4239,2154,2158,8551
11762,2020-01-18,(12001) Carrera 43,775,439,733,1947
11763,2020-05-03,(07000) Portal Sur - alimentacion,1722,874,677,3273
11764,2020-01-28,(07113) SANTA ISABEL,2005,1228,1353,4586
11765,2020-04-15,(02000) Cabecera Autopista Norte - intermunicipal,167,122,115,404
11766,2020-01-15,(02302) Virrey,3498,2256,1714,7468
11767,2020-02-24,(07106) EL CAMPIN,2182,1359,1140,4681
11768,2020-06-23,(09101) Quiroga,613,312,397,1322
11769,2020-05-06,(03000) Portal Suba - alimentacion,4042,2335,2034,8411
11770,2020-03-14,(09119) Calle 57,1483,961,1365,3809
11771,2020-02-04,(10010) San Bernardo,1839,1074,1459,4372
11772,2020-10-09,(02303) Calle 85,827,607,558,1992
11773,2020-01-08,(07000) Portal Sur,5876,3450,3481,12807
11774,2020-08-05,(07000) Portal Sur,1695,1026,1011,3732
11775,2020-01-06,(09116) Avenida 39,144,131,283,558
11776,2020-09-17,(09116) Avenida 39,399,242,295,936
11777,2020-03-03,(02104) Calle 146,9381,5985,5076,20442
11778,2020-03-31,(09107) Hortúa,444,301,219,964
11779,2020-01-27,(03000) Portal Suba,8695,5156,4950,18801
11780,2020-03-02,(07008) NQS - Calle 30 Sur,1885,1050,1152,4087
11781,2020-07-09,(02101) Toberín,1560,976,1002,3538
11782,2020-01-11,(02302) Virrey,1160,859,1040,3059
11783,2020-09-16,(06108) Concejo de Bogotá,155,92,119,366
11784,2020-09-24,(06108) Concejo de Bogotá,151,92,105,348
11785,2020-03-25,(09000) Cabecera Usme - alimentacion,4414,2060,2494,8968
11786,2020-02-08,(09113) Calle 22,1247,691,934,2872
11787,2020-05-01,(10002) Av. Primero de Mayo,585,284,423,1292
11788,2020-03-06,(03005) SUBA - AV. BOYACA,2592,1540,1645,5777
11789,2020-02-20,(10009) Museo Nacional,4630,2430,1833,8893
11790,2020-08-27,(09107) Hortúa,589,375,356,1320
11791,2020-05-18,(09123) Calle 76,775,532,440,1747
11792,2020-02-19,(04102) Avenida Boyaca,3237,1943,1603,6783
11793,2020-03-10,(06106) Recinto Ferial,551,193,242,986
11794,2020-06-21,(02201) Prado,274,170,208,652
11795,2020-01-20,(03011) SUBA - CALLE 100,2455,1203,1362,5020
11796,2020-02-08,(03011) SUBA - CALLE 100,1168,737,1047,2952
11797,2020-01-17,(03012) SUBA - CALLE 95,1246,818,866,2930
11798,2020-07-13,(03012) SUBA - CALLE 95,287,173,151,611
11799,2020-08-18,(50002) Corral Calle 40 Sur,26,13,24,63
11800,2020-01-09,(06000) Portal Eldorado,4953,2936,2267,10156
11801,2020-01-09,(10010) San Bernardo,1282,805,1071,3158
11802,2020-03-10,(05101) Mandalay - Cr.73,52,297,157,506
11803,2020-09-05,(07104) Simon Bolivar,446,301,312,1059
11804,2020-05-15,(09104) Restrepo,1111,661,833,2605
11805,2020-01-12,(03012) SUBA - CALLE 95,296,156,308,760
11806,2020-07-18,(05001) Patio Bonito,1226,632,759,2617
11807,2020-05-16,(05105) Pradera,310,223,162,695
11808,2020-07-15,(08000) Portal Tunal,548,213,198,959
11809,2020-09-01,(03009) Av. Suba- Calle 116,535,308,255,1098
11810,2020-03-07,(06111) Universidades,2102,1366,2006,5474
11811,2020-08-16,(06000) Portal Eldorado - alimentacion,1271,521,800,2592
11812,2020-03-10,(10009) Museo Nacional,2572,218,469,3259
11813,2020-03-18,(10009) Museo Nacional,2080,1255,950,4285
11814,2020-07-25,(07201) Guatoque -Veraguas,96,48,87,231
11815,2020-02-17,(06101) El Tiempo,3077,1690,1317,6084
11816,2020-04-18,(03007) HUMEDAL CORDOBA,70,50,35,155
11817,2020-05-10,(03007) HUMEDAL CORDOBA,30,27,9,66
11818,2020-07-27,(03007) HUMEDAL CORDOBA,141,102,78,321
11819,2020-01-27,(07108) Av. El Dorado,907,564,571,2042
11820,2020-05-11,(07000) Portal Sur,1339,828,722,2889
11821,2020-05-20,(07000) Portal Sur,1484,953,813,3250
11822,2020-01-18,(02204) Pepe Sierra,1905,1293,1498,4696
11823,2020-03-16,(04107) Escuela Militar,442,295,323,1060
11824,2020-08-25,(04003) Avenida Ciudad de Cali,933,507,681,2121
11825,2020-03-26,(05000) Portal Américas,1263,837,1001,3101
11826,2020-07-18,(05103) Marsella,273,134,159,566
11827,2020-10-09,(10009) Museo Nacional,549,390,572,1511
11828,2020-06-21,(09103) Olaya,378,169,238,785
11829,2020-07-11,(06101) El Tiempo,237,165,192,594
11830,2020-08-03,(06101) El Tiempo,266,157,189,612
11831,2020-08-04,(06101) El Tiempo,285,173,151,609
11832,2020-06-17,(02202) Calle 127,1199,829,584,2612
11833,2020-03-15,(04001) Quirigua,319,174,315,808
11834,2020-01-01,(07003) SEVILLANA,97,65,173,335
11835,2020-09-25,(07109) CAD,711,468,470,1649
11836,2020-07-06,(02105) Calle 142,839,543,537,1919
11837,2020-02-21,(07008) NQS - Calle 30 Sur,1936,972,1105,4013
11838,2020-09-27,(06100) Av. Rojas,40,46,88,174
11839,2020-07-04,(06000) Portal Eldorado,665,500,503,1668
11840,2020-08-04,(12003) Ricaurte,326,232,155,713
11841,2020-08-31,(12003) Ricaurte,395,254,193,842
11842,2020-06-03,(09104) Restrepo,1363,829,928,3120
11843,2020-05-11,(03010) PUENTE LARGO,275,175,124,574
11844,2020-08-21,(07200) Tygua-San José,232,123,180,535
11845,2020-07-10,(07106) EL CAMPIN,432,292,240,964
11846,2020-09-11,(09109) Tercer Milenio,344,208,246,798
11847,2020-06-13,(04003) Avenida Ciudad de Cali,742,424,550,1716
11848,2020-05-21,(09122) Calle 72,976,649,541,2166
11849,2020-10-06,(05107) Américas - Cr.53,498,296,377,1171
11850,2020-06-24,(02103) Mazurén,202,118,182,502
11851,2020-07-22,(07103) AV. CHILE,854,565,399,1818
11852,2020-01-17,(07201) Guatoque -Veraguas,858,445,597,1900
11853,2020-03-12,(06109) Centro Memoria,463,78,107,648
11854,2020-10-01,(09106) Nariño,490,301,406,1197
11855,2020-04-07,(02001) Centro Comercial Santa Fe,176,106,130,412
11856,2020-04-27,(10000) Portal 20 de Julio,1018,101,138,1257
11857,2020-04-29,(04100) Carrera 77,769,439,443,1651
11858,2020-03-15,(06105) Quinta Paredes,80,61,123,264
11859,2020-07-15,(09004) Santa Lucía,1683,920,897,3500
11860,2020-08-28,(07004) VENECIA,1052,589,589,2230
11861,2020-07-28,(10008) San Diego,281,159,164,604
11862,2020-08-24,(08002) Biblioteca,274,143,176,593
11863,2020-06-18,(10009) Museo Nacional,504,327,302,1133
11864,2020-03-18,(10004) Policarpa,544,256,334,1134
11865,2020-01-05,(05107) Américas - Cr.53,334,183,364,881
11866,2020-03-24,(05105) Pradera,566,390,306,1262
11867,2020-03-10,(07111) NQS - RICAURTE,1521,202,512,2235
11868,2020-06-08,(09115) Calle 34,647,431,353,1431
11869,2020-03-24,(02204) Pepe Sierra,671,551,434,1656
11870,2020-03-18,(05102) Av. Américas - Av. Boyacá,790,421,414,1625
11871,2020-05-07,(09107) Hortúa,450,299,252,1001
11872,2020-02-29,(06109) Centro Memoria,539,376,514,1429
11873,2020-08-19,(04105) Carrera 53,285,157,170,612
11874,2020-04-17,(02303) Calle 85,323,217,209,749
11875,2020-04-21,(02303) Calle 85,329,239,165,733
11876,2020-08-30,(06104) Gobernación,55,24,36,115
11877,2020-03-23,(02200) Alcalá,468,357,270,1095
11878,2020-05-29,(05105) Pradera,516,346,200,1062
11879,2020-09-28,(04102) Avenida Boyaca,464,244,351,1059
11880,2020-07-20,(04003) Avenida Ciudad de Cali,275,136,240,651
11881,2020-08-04,(03003) 21 ANGELES,254,142,137,533
11882,2020-04-30,(10006) San Victorino,226,156,177,559
11883,2020-06-17,(06102) Salitre El Greco,242,129,119,490
11884,2020-07-13,(05102) Av. Américas - Av. Boyacá,188,101,117,406
11885,2020-05-27,(09110) Avenida Jimenez,933,710,638,2281
11886,2020-10-12,(40002) Manitas,145,75,145,365
11887,2020-05-07,(07007) NQS - Calle 38A Sur,214,125,172,511
11888,2020-07-07,(02304) Heroes,939,638,547,2124
11889,2020-05-11,(08002) Biblioteca,227,121,113,461
11890,2020-06-24,(12000) Puente Aranda,90,47,43,180
11891,2020-07-17,(12000) Puente Aranda,87,54,40,181
11892,2020-05-03,(07001) PERDOMO,143,76,97,316
11893,2020-05-18,(07109) CAD,539,339,219,1097
11894,2020-10-07,(12004) Carrera 22,313,204,178,695
11895,2020-10-05,(06001) Modelia,424,263,291,978
11896,2020-01-10,(07006) General Santander - alimentacion,1122,635,808,2565
11897,2020-04-24,(07006) General Santander - alimentacion,209,133,108,450
11898,2020-04-24,(04106) Carrera 47,190,107,79,376
11899,2020-08-10,(04106) Carrera 47,263,138,153,554
11900,2020-07-25,(10009) Museo Nacional,178,128,177,483
11901,2020-09-06,(03013) RIO NEGRO,84,49,111,244
11902,2020-05-21,(07008) NQS - Calle 30 Sur,201,107,111,419
11903,2020-07-11,(07009) SENA,538,332,408,1278
11904,2020-04-28,(09120) Calle 63,696,465,425,1586
11905,2020-06-07,(02205) Calle 106,53,55,63,171
11906,2020-06-05,(04101) Minuto de Dios,304,175,217,696
11907,2020-09-05,(09106) Nariño,352,185,302,839
11908,2020-06-29,(02001) Centro Comercial Santa Fe,147,110,155,412
11909,2020-07-18,(04102) Avenida Boyaca,268,135,154,557
11910,2020-10-05,(03002) SUBA - TV- 91,935,541,731,2207
11911,2020-10-09,(12002) CDS - Carrera 32,181,131,113,425
11912,2020-08-12,(07006) General Santander,540,330,311,1181
11913,2020-05-15,(04102) Avenida Boyaca,231,116,155,502
11914,2020-07-29,(06100) Av. Rojas,189,113,124,426
11915,2020-06-14,(04102) Avenida Boyaca,92,62,90,244
11916,2020-08-08,(03010) PUENTE LARGO,152,112,129,393
11917,2020-06-12,(03010) PUENTE LARGO,368,208,205,781
11918,2020-05-05,(07010) Bosa,399,240,286,925
11919,2020-07-19,(07107) U. NACIONAL,119,67,67,253
11920,2020-04-13,(04103) Las Ferias,201,119,98,418
11921,2020-06-28,(10003) Ciudad Jardín,72,32,59,163
11922,2020-07-14,(07506) DESPENSA,475,246,215,936
11923,2020-05-01,(09105) Río Fucha,39,22,35,96
11924,2020-02-09,(06101) El Tiempo,326,247,470,1043
11925,2020-06-10,(07006) General Santander - alimentacion,357,218,231,806
11926,2020-09-08,(09106) Nariño,436,259,350,1045
11927,2020-03-22,(07102) NQS - CALLE 75,31,29,31,91
11928,2020-06-03,(07008) NQS - Calle 30 Sur,241,126,137,504
11929,2020-07-10,(07008) NQS - Calle 30 Sur,336,167,191,694
11930,2020-05-07,(05102) Av. Américas - Av. Boyacá,151,79,99,329
11931,2020-05-06,(06102) Salitre El Greco,147,80,71,298
11932,2020-07-16,(06102) Salitre El Greco,212,124,102,438
11933,2020-09-26,(06102) Salitre El Greco,201,122,169,492
11934,2020-04-07,(07006) General Santander - alimentacion,156,99,127,382
11935,2020-04-15,(07107) U. NACIONAL,222,152,119,493
11936,2020-09-03,(07107) U. NACIONAL,376,227,201,804
11937,2020-05-19,(02304) Heroes,687,474,337,1498
11938,2020-04-03,(04003) Avenida Ciudad de Cali,493,293,326,1112
11939,2020-05-01,(04001) Quirigua,103,71,57,231
11940,2020-08-22,(12007) Zona Industrial,245,157,139,541
11941,2020-06-02,(03002) SUBA - TV- 91,715,420,405,1540
11942,2020-06-15,(07008) NQS - Calle 30 Sur,98,47,73,218
11943,2020-05-10,(06101) El Tiempo,83,60,55,198
11944,2020-03-24,(07008) NQS - Calle 30 Sur,272,139,165,576
11945,2020-02-12,(03014) SAN MARTIN,252,165,184,601
11946,2020-08-09,(09117) Calle 45,193,115,178,486
11947,2020-04-17,(04105) Carrera 53,156,101,94,351
11948,2020-01-26,(07006) General Santander,648,288,615,1551
11949,2020-03-25,(07200) Tygua-San José,62,56,78,196
11950,2020-08-08,(09116) Avenida 39,196,119,180,495
11951,2020-06-30,(06100) Av. Rojas,237,143,156,536
11952,2020-09-21,(06100) Av. Rojas,201,140,130,471
11953,2020-03-30,(03006) NIZA - CALLE 127,234,195,145,574
11954,2020-04-27,(10008) San Diego,25,75,40,140
11955,2020-08-17,(12007) Zona Industrial,64,56,43,163
11956,2020-08-15,(05103) Marsella,325,157,221,703
11957,2020-10-12,(06109) Centro Memoria,61,60,103,224
11958,2020-03-29,(09003) Socorro,104,69,56,229
11959,2020-05-12,(04105) Carrera 53,224,128,122,474
11960,2020-04-16,(04102) Avenida Boyaca,150,85,99,334
11961,2020-04-10,(03002) SUBA - TV- 91,158,79,62,299
11962,2020-02-16,(09105) Río Fucha,128,97,221,446
11963,2020-05-03,(07003) SEVILLANA,62,33,35,130
11964,2020-04-16,(12007) Zona Industrial,228,154,104,486
11965,2020-10-12,(02204) Pepe Sierra,233,191,244,668
11966,2020-06-05,(10003) Ciudad Jardín,195,91,127,413
11967,2020-06-21,(10003) Ciudad Jardín,79,34,68,181
11968,2020-05-19,(03014) SAN MARTIN,32,9,26,67
11969,2020-03-20,(07104) Simon Bolivar,152,116,105,373
11970,2020-04-25,(03014) SAN MARTIN,9,4,11,24
11971,2020-07-20,(07006) General Santander - alimentacion,87,60,79,226
11972,2020-04-09,(09108) Hospital,18,12,17,47
11973,2020-05-09,(10005) Bicentenario,58,28,47,133
11974,2020-04-07,(50002) Corral Calle 40 Sur,13,3,9,25
11975,2020-08-27,(03014) SAN MARTIN,0,10,37,47
11976,2020-05-17,(07108) Av. El Dorado,28,16,27,71
11977,2020-05-31,(03014) SAN MARTIN,10,4,10,24
11978,2020-07-21,(09002) Consuelo,383,189,202,774
11979,2020-09-11,(02502) Terminal,443,297,406,1146
11980,2020-04-20,(09118) Marly,1046,717,455,2218
11981,2020-02-28,(09119) Calle 57,3793,2329,2195,8317
11982,2020-02-24,(04106) Carrera 47,1505,815,885,3205
11983,2020-01-10,(03000) Portal Suba - alimentacion,20728,10928,12605,44261
11984,2020-09-15,(07503) SAN MATEO,12111,6694,6270,25075
11985,2020-01-07,(07003) SEVILLANA,1328,800,811,2939
11986,2020-06-18,(10000) Portal 20 de Julio - alimentacion,4384,2003,2430,8817
11987,2020-06-27,(04101) Minuto de Dios,271,143,201,615
11988,2020-02-29,(05000) Portal Américas,9326,4108,6295,19729
11989,2020-05-18,(05000) Portal Américas,1911,1374,1534,4819
11990,2020-05-06,(05005) Transversal 86,257,129,131,517
11991,2020-09-23,(08000) Portal Tunal - alimentacion,7087,3918,4366,15371
11992,2020-02-27,(10001) Country Sur,5150,2376,2779,10305
11993,2020-10-11,(10001) Country Sur,437,162,450,1049
11994,2020-01-22,(09000) Cabecera Usme,5322,3273,3670,12265
11995,2020-02-02,(09000) Cabecera Usme,1294,675,1487,3456
11996,2020-07-01,(07503) SAN MATEO,11638,6937,6128,24703
11997,2020-02-18,(02204) Pepe Sierra,5187,3467,2403,11057
11998,2020-08-27,(02105) Calle 142,752,482,497,1731
11999,2020-01-10,(02205) Calle 106,1840,1188,1147,4175
12000,2020-09-14,(07001) PERDOMO,1001,599,672,2272
12001,2020-02-05,(02000) Cabecera Autopista Norte,11697,7349,6342,25388
12002,2020-05-30,(40003) Mirador del Paraiso,1438,819,861,3118
12003,2020-05-15,(09109) Tercer Milenio,277,166,167,610
12004,2020-07-02,(05107) Américas - Cr.53,431,235,266,932
12005,2020-01-02,(07505) LEON XIII,4066,2122,2184,8372
12006,2020-07-17,(07505) LEON XIII,2680,1387,1070,5137
12007,2020-09-04,(07505) LEON XIII,3044,1606,1431,6081
12008,2020-02-03,(04104) Avenida 68,3714,1939,1875,7528
12009,2020-03-26,(03000) Portal Suba - alimentacion,3336,1831,1604,6771
12010,2020-01-16,(03013) RIO NEGRO,1070,646,773,2489
12011,2020-03-10,(09116) Avenida 39,1614,170,408,2192
12012,2020-04-02,(02103) Mazurén,79,57,86,222
12013,2020-05-15,(07000) Portal Sur - alimentacion,6172,3394,2663,12229
12014,2020-07-15,(07000) Portal Sur - alimentacion,7100,4069,3346,14515
12015,2020-02-18,(14001) La Sabana,655,406,376,1437
12016,2020-05-08,(14001) La Sabana,104,82,77,263
12017,2020-10-06,(14001) La Sabana,158,104,128,390
12018,2020-09-24,(07111) NQS - RICAURTE,1239,786,601,2626
12019,2020-06-19,(07002) MADELENA,837,475,511,1823
12020,2020-09-01,(02000) Cabecera Autopista Norte,1388,878,897,3163
12021,2020-09-12,(09004) Santa Lucía,1162,1066,2483,4711
12022,2020-06-05,(04000) Cabecera Calle 80,980,594,704,2278
12023,2020-09-10,(04000) Cabecera Calle 80,999,604,906,2509
12024,2020-05-06,(08000) Portal Tunal - alimentacion,3826,2120,2103,8049
12025,2020-07-02,(09110) Avenida Jimenez,1476,986,955,3417
12026,2020-03-16,(04106) Carrera 47,1030,563,583,2176
12027,2020-02-08,(09114) Calle 26,684,614,1040,2338
12028,2020-06-13,(09001) Molinos,2021,1050,1457,4528
12029,2020-02-26,(10008) San Diego,1573,901,782,3256
12030,2020-06-05,(08000) Portal Tunal - alimentacion,6154,3324,3171,12649
12031,2020-06-21,(02000) Cabecera Autopista Norte - alimentacion,1894,898,1075,3867
12032,2020-02-22,(12001) Carrera 43,842,523,793,2158
12033,2020-03-01,(04104) Avenida 68,631,353,635,1619
12034,2020-05-15,(10005) Bicentenario - alimentacion,180,90,123,393
12035,2020-02-11,(06111) Universidades,6264,3781,2577,12622
12036,2020-03-07,(07106) EL CAMPIN,1210,861,1000,3071
12037,2020-03-02,(06100) Av. Rojas,2693,1504,1286,5483
12038,2020-01-16,(03007) HUMEDAL CORDOBA,788,486,443,1717
12039,2020-08-01,(10000) Portal 20 de Julio,1638,793,941,3372
12040,2020-07-29,(07112) COMUNEROS,703,398,411,1512
12041,2020-08-05,(02303) Calle 85,638,453,350,1441
12042,2020-06-18,(08001) Parque el Tunal,475,308,283,1066
12043,2020-01-31,(07008) NQS - Calle 30 Sur,1920,984,1095,3999
12044,2020-09-21,(02101) Toberín,1418,819,966,3203
12045,2020-09-21,(06108) Concejo de Bogotá,105,76,84,265
12046,2020-05-11,(07010) Bosa,494,278,332,1104
12047,2020-02-26,(02300) Calle 100,7181,4672,3832,15685
12048,2020-09-10,(02300) Calle 100,1039,622,792,2453
12049,2020-05-14,(07503) SAN MATEO,7851,4843,3659,16353
12050,2020-09-28,(03003) 21 ANGELES,394,199,252,845
12051,2020-02-29,(14004) Museo del Oro,811,787,1273,2871
12052,2020-03-18,(02105) Calle 142,2623,1581,1404,5608
12053,2020-05-17,(02201) Prado,212,136,153,501
12054,2020-09-05,(06002) Normandía,236,148,216,600
12055,2020-09-10,(40003) Mirador del Paraiso,1726,929,1119,3774
12056,2020-08-31,(09107) Hortúa,583,371,411,1365
12057,2020-05-23,(40003) Mirador del Paraiso,1322,763,771,2856
12058,2020-08-15,(03012) SUBA - CALLE 95,217,139,171,527
12059,2020-04-13,(09001) Molinos,1201,737,834,2772
12060,2020-07-01,(09119) Calle 57,630,415,389,1434
12061,2020-02-27,(07104) Simon Bolivar,2418,1518,1204,5140
12062,2020-04-25,(05005) Transversal 86,139,80,64,283
12063,2020-08-04,(05005) Transversal 86,289,168,209,666
12064,2020-08-31,(05005) Transversal 86,377,207,264,848
12065,2020-10-02,(05105) Pradera,672,433,389,1494
12066,2020-03-02,(09121) Las Flores,3349,2116,2018,7483
12067,2020-09-28,(04104) Avenida 68,750,365,464,1579
12068,2020-07-28,(08000) Portal Tunal,717,294,267,1278
12069,2020-04-04,(02205) Calle 106,125,96,74,295
12070,2020-02-07,(03006) NIZA - CALLE 127,2443,1476,1611,5530
12071,2020-07-29,(06000) Portal Eldorado - alimentacion,3374,1800,1773,6947
12072,2020-07-09,(04108) El Polo,509,314,249,1072
12073,2020-09-27,(07101) CASTELLANA,32,30,72,134
12074,2020-01-13,(07103) AV. CHILE,3016,1828,1631,6475
12075,2020-01-11,(06106) Recinto Ferial,594,357,471,1422
12076,2020-08-13,(07010) Bosa,641,297,383,1321
12077,2020-10-08,(07113) SANTA ISABEL,430,253,429,1112
12078,2020-09-10,(06000) Portal Eldorado - alimentacion,3659,1779,2111,7549
12079,2020-01-26,(03007) HUMEDAL CORDOBA,148,91,153,392
12080,2020-03-16,(07108) Av. El Dorado,654,407,398,1459
12081,2020-02-15,(07000) Portal Sur,4899,2494,3582,10975
12082,2020-02-09,(09115) Calle 34,525,361,761,1647
12083,2020-05-09,(10005) Bicentenario - alimentacion,121,57,107,285
12084,2020-08-25,(04107) Escuela Militar,145,83,89,317
12085,2020-02-12,(07109) CAD,2962,1798,1514,6274
12086,2020-02-12,(06001) Modelia,2799,1640,1251,5690
12087,2020-07-16,(09000) Cabecera Usme,1140,745,843,2728
12088,2020-01-09,(02000) Cabecera Autopista Norte - intermunicipal,3103,2045,2189,7337
12089,2020-05-05,(04003) Avenida Ciudad de Cali,660,404,445,1509
12090,2020-02-26,(07109) CAD,2850,1761,1488,6099
12091,2020-06-23,(03001) LA CAMPIÑA,1144,653,626,2423
12092,2020-09-18,(04104) Avenida 68,714,355,495,1564
12093,2020-07-29,(02104) Calle 146,707,446,428,1581
12094,2020-02-08,(09117) Calle 45,2617,1676,2231,6524
12095,2020-01-19,(12003) Ricaurte,136,115,190,441
12096,2020-02-23,(06100) Av. Rojas,193,142,301,636
12097,2020-05-25,(04100) Carrera 77,350,174,225,749
12098,2020-02-22,(04001) Quirigua,1118,566,890,2574
12099,2020-08-25,(07101) CASTELLANA,202,122,128,452
12100,2020-08-06,(04108) El Polo,355,221,202,778
12101,2020-07-17,(02302) Virrey,501,364,260,1125
12102,2020-01-01,(09122) Calle 72,422,296,743,1461
12103,2020-05-13,(03010) PUENTE LARGO,265,190,149,604
12104,2020-07-31,(07200) Tygua-San José,225,123,149,497
12105,2020-01-01,(02000) Cabecera Autopista Norte,462,268,711,1441
12106,2020-04-28,(10008) San Diego,169,102,115,386
12107,2020-01-25,(09110) Avenida Jimenez,3217,2235,2052,7504
12108,2020-01-03,(03013) RIO NEGRO,596,394,486,1476
12109,2020-04-04,(07005) ALQUERIA,182,107,89,378
12110,2020-09-04,(07007) NQS - Calle 38A Sur,431,257,318,1006
12111,2020-05-19,(05107) Américas - Cr.53,377,247,209,833
12112,2020-03-26,(09123) Calle 76,488,386,300,1174
12113,2020-05-31,(07103) AV. CHILE,177,132,157,466
12114,2020-06-28,(07103) AV. CHILE,197,130,205,532
12115,2020-09-10,(12007) Zona Industrial,380,216,188,784
12116,2020-07-11,(10005) Bicentenario,93,60,90,243
12117,2020-06-30,(40002) Manitas,461,306,286,1053
12118,2020-03-06,(07111) NQS - RICAURTE,2995,1962,1937,6894
12119,2020-01-21,(12002) CDS - Carrera 32,210,246,210,666
12120,2020-05-31,(02001) Centro Comercial Santa Fe,106,68,107,281
12121,2020-06-17,(05107) Américas - Cr.53,450,263,276,989
12122,2020-05-09,(02300) Calle 100,623,421,350,1394
12123,2020-01-29,(02102) Calle 161,1868,1108,1233,4209
12124,2020-01-30,(02102) Calle 161,1885,1146,1132,4163
12125,2020-04-19,(40003) Mirador del Paraiso,305,191,216,712
12126,2020-02-26,(07104) Simon Bolivar,2443,1541,1199,5183
12127,2020-05-25,(07102) NQS - CALLE 75,76,54,79,209
12128,2020-05-07,(09113) Calle 22,344,188,269,801
12129,2020-09-12,(09117) Calle 45,512,310,459,1281
12130,2020-01-18,(06105) Quinta Paredes,364,215,322,901
12131,2020-09-28,(09115) Calle 34,781,478,584,1843
12132,2020-05-06,(07107) U. NACIONAL,240,148,108,496
12133,2020-05-23,(03006) NIZA - CALLE 127,270,184,135,589
12134,2020-07-08,(07110) PALOQUEMAO,649,406,288,1343
12135,2020-06-20,(06000) Portal Eldorado - alimentacion,3140,1570,1723,6433
12136,2020-03-25,(05100) Banderas P. Central,358,213,270,841
12137,2020-03-10,(12004) Carrera 22,291,55,94,440
12138,2020-04-08,(10006) San Victorino,156,129,149,434
12139,2020-01-20,(09111) Calle 19,1855,1243,1492,4590
12140,2020-07-19,(10000) Portal 20 de Julio - alimentacion,1104,471,734,2309
12141,2020-01-31,(09111) Calle 19,2133,1313,1620,5066
12142,2020-06-15,(04105) Carrera 53,98,63,66,227
12143,2020-02-01,(50002) Corral Calle 40 Sur,55,42,80,177
12144,2020-08-18,(09114) Calle 26,302,174,209,685
12145,2020-03-26,(03000) Portal Suba,586,372,392,1350
12146,2020-05-02,(14004) Museo del Oro,0,37,71,108
12147,2020-08-26,(10007) Las Nieves,552,343,318,1213
12148,2020-09-01,(04103) Las Ferias,317,207,252,776
12149,2020-08-29,(05102) Av. Américas - Av. Boyacá,164,97,135,396
12150,2020-10-10,(09110) Avenida Jimenez,1344,934,976,3254
12151,2020-03-07,(10004) Policarpa,576,234,516,1326
12152,2020-07-27,(03005) SUBA - AV. BOYACA,396,249,242,887
12153,2020-09-12,(09107) Hortúa,444,234,374,1052
12154,2020-07-12,(02202) Calle 127,337,288,263,888
12155,2020-04-14,(08002) Biblioteca,166,86,99,351
12156,2020-06-01,(08002) Biblioteca,274,150,152,576
12157,2020-07-12,(12001) Carrera 43,82,50,89,221
12158,2020-09-05,(03011) SUBA - CALLE 100,361,220,299,880
12159,2020-09-18,(07506) DESPENSA,504,306,350,1160
12160,2020-09-29,(07506) DESPENSA,445,273,340,1058
12161,2020-04-18,(02102) Calle 161,66,57,35,158
12162,2020-02-28,(12004) Carrera 22,661,447,506,1614
12163,2020-07-10,(12004) Carrera 22,269,160,151,580
12164,2020-10-06,(12004) Carrera 22,273,177,193,643
12165,2020-08-04,(07107) U. NACIONAL,321,175,179,675
12166,2020-05-21,(09111) Calle 19,615,372,413,1400
12167,2020-05-16,(04100) Carrera 77,713,356,422,1491
12168,2020-03-22,(08000) Portal Tunal,163,96,86,345
12169,2020-04-09,(02201) Prado,177,121,83,381
12170,2020-05-04,(07112) COMUNEROS,514,308,266,1088
12171,2020-07-03,(12002) CDS - Carrera 32,168,94,95,357
12172,2020-08-08,(09105) Río Fucha,0,41,106,147
12173,2020-08-20,(09105) Río Fucha,0,61,100,161
12174,2020-04-11,(40001) Juan Pablo II,159,88,95,342
12175,2020-04-15,(06101) El Tiempo,207,145,104,456
12176,2020-08-18,(04102) Avenida Boyaca,354,200,188,742
12177,2020-04-03,(06002) Normandía,154,96,101,351
12178,2020-02-08,(09111) Calle 19,1476,984,1279,3739
12179,2020-04-07,(04003) Avenida Ciudad de Cali,466,284,381,1131
12180,2020-05-13,(06001) Modelia,343,230,187,760
12181,2020-07-09,(06107) Ciudad Universitaria,175,117,140,432
12182,2020-05-24,(07004) VENECIA,205,127,124,456
12183,2020-09-25,(09105) Río Fucha,0,95,186,281
12184,2020-08-30,(02105) Calle 142,206,122,216,544
12185,2020-07-01,(10008) San Diego,284,171,203,658
12186,2020-05-01,(06000) Portal Eldorado,348,213,176,737
12187,2020-08-26,(07506) DESPENSA,377,260,233,870
12188,2020-06-13,(09105) Río Fucha,99,38,93,230
12189,2020-06-14,(02303) Calle 85,151,111,112,374
12190,2020-05-07,(05100) Banderas P. Central,461,267,303,1031
12191,2020-05-30,(10004) Policarpa,166,79,112,357
12192,2020-04-04,(07006) General Santander - alimentacion,108,84,104,296
12193,2020-07-26,(10010) San Bernardo,211,84,147,442
12194,2020-08-09,(04104) Avenida 68,139,94,116,349
12195,2020-04-28,(08002) Biblioteca,212,112,85,409
12196,2020-07-15,(06111) Universidades,235,140,221,596
12197,2020-07-02,(02102) Calle 161,270,162,181,613
12198,2020-08-22,(09114) Calle 26,162,116,159,437
12199,2020-04-12,(09116) Avenida 39,67,55,40,162
12200,2020-09-19,(06101) El Tiempo,260,182,239,681
12201,2020-08-15,(07003) SEVILLANA,348,178,243,769
12202,2020-05-20,(07108) Av. El Dorado,110,68,60,238
12203,2020-09-21,(07113) SANTA ISABEL,352,186,231,769
12204,2020-10-04,(06102) Salitre El Greco,86,59,87,232
12205,2020-07-26,(07104) Simon Bolivar,112,88,80,280
12206,2020-06-07,(04102) Avenida Boyaca,80,45,84,209
12207,2020-04-02,(12003) Ricaurte,80,58,73,211
12208,2020-05-12,(09106) Nariño,299,168,211,678
12209,2020-06-23,(06107) Ciudad Universitaria,169,130,133,432
12210,2020-05-13,(06106) Recinto Ferial,196,124,100,420
12211,2020-10-12,(05107) Américas - Cr.53,95,93,159,347
12212,2020-08-30,(09114) Calle 26,65,54,107,226
12213,2020-08-15,(14004) Museo del Oro,140,122,180,442
12214,2020-07-20,(04000) Cabecera Calle 80 - intermunicipal,53,34,38,125
12215,2020-08-01,(09105) Río Fucha,0,46,100,146
12216,2020-01-05,(06105) Quinta Paredes,75,59,114,248
12217,2020-04-26,(12002) CDS - Carrera 32,37,44,21,102
12218,2020-04-23,(03014) SAN MARTIN,21,8,19,48
12219,2020-10-02,(03004) GRATAMIRA,0,24,60,84
12220,2020-04-11,(04108) El Polo,91,70,57,218
12221,2020-06-29,(03004) GRATAMIRA,17,7,13,37
12222,2020-06-06,(50006) Corral Carrera 77,2,2,3,7
12223,2020-05-03,(50002) Corral Calle 40 Sur,3,2,4,9
12224,2020-04-12,(50006) Corral Carrera 77,3,1,0,4
12225,2020-09-10,(04000) Cabecera Calle 80 - alimentacion,4103,2151,2858,9112
12226,2020-06-22,(07504) TERREROS,1703,956,965,3624
12227,2020-07-28,(07504) TERREROS,5797,3158,2523,11478
12228,2020-08-11,(07504) TERREROS,5763,3160,2734,11657
12229,2020-08-21,(07504) TERREROS,5810,3132,2836,11778
12230,2020-03-04,(08000) Portal Tunal - alimentacion,24450,13441,11881,49772
12231,2020-01-14,(03002) SUBA - TV- 91,3638,2140,2225,8003
12232,2020-02-05,(02101) Toberín,15450,9831,7869,33150
12233,2020-07-24,(07503) SAN MATEO,10128,5908,4546,20582
12234,2020-01-08,(07003) SEVILLANA,1406,814,849,3069
12235,2020-01-13,(06104) Gobernación,1106,655,574,2335
12236,2020-06-17,(10000) Portal 20 de Julio - alimentacion,4281,1990,2390,8661
12237,2020-01-14,(09000) Cabecera Usme - alimentacion,21804,11861,14782,48447
12238,2020-01-15,(09003) Socorro,1475,769,937,3181
12239,2020-09-11,(05000) Portal Américas - alimentacion,11676,5602,5798,23076
12240,2020-10-09,(05000) Portal Américas - alimentacion,12612,6537,8718,27867
12241,2020-05-09,(05000) Portal Américas - alimentacion,5940,2964,2611,11515
12242,2020-02-18,(05001) Patio Bonito,7365,4255,3814,15434
12243,2020-01-07,(08000) Portal Tunal - alimentacion,17149,8984,9838,35971
12244,2020-06-22,(08000) Portal Tunal - alimentacion,2251,1138,1227,4616
12245,2020-07-29,(04103) Las Ferias,336,166,170,672
12246,2020-01-28,(07002) MADELENA,4859,2743,2570,10172
12247,2020-10-03,(07002) MADELENA,845,339,759,1943
12248,2020-02-08,(07503) SAN MATEO,28271,13697,14499,56467
12249,2020-01-12,(09000) Cabecera Usme,1136,544,1275,2955
12250,2020-02-10,(09000) Cabecera Usme,5990,3639,4021,13650
12251,2020-02-07,(10003) Ciudad Jardín,1077,555,756,2388
12252,2020-01-21,(02200) Alcalá,10111,5676,4153,19940
12253,2020-03-18,(05100) Banderas P. Central,3309,1827,1687,6823
12254,2020-01-08,(07001) PERDOMO,3416,1923,2032,7371
12255,2020-01-03,(07113) SANTA ISABEL,884,539,762,2185
12256,2020-09-21,(09000) Cabecera Usme - alimentacion,7693,3488,4569,15750
12257,2020-06-05,(03000) Portal Suba - alimentacion,5744,3377,3048,12169
12258,2020-01-07,(02101) Toberín,9299,5676,5584,20559
12259,2020-08-18,(02204) Pepe Sierra,739,498,399,1636
12260,2020-07-21,(07102) NQS - CALLE 75,423,287,198,908
12261,2020-01-05,(03000) Portal Suba - alimentacion,4865,1994,4112,10971
12262,2020-02-17,(09103) Olaya,4357,2661,2512,9530
12263,2020-01-16,(07110) PALOQUEMAO,2085,1311,1118,4514
12264,2020-02-27,(03001) LA CAMPIÑA,6668,4082,4156,14906
12265,2020-09-16,(03001) LA CAMPIÑA,1346,744,868,2958
12266,2020-10-10,(03001) LA CAMPIÑA,953,443,812,2208
12267,2020-04-21,(09104) Restrepo,779,540,647,1966
12268,2020-03-11,(02303) Calle 85,3754,2519,1951,8224
12269,2020-01-02,(04105) Carrera 53,548,331,402,1281
12270,2020-06-29,(09001) Molinos,858,436,633,1927
12271,2020-03-09,(50003) Corral Molinos,12,885,940,1837
12272,2020-09-08,(05000) Portal Américas,3396,2042,2293,7731
12273,2020-09-10,(05000) Portal Américas,3404,1783,2057,7244
12274,2020-02-15,(09104) Restrepo,3411,1971,3274,8656
12275,2020-09-05,(09110) Avenida Jimenez,1362,990,851,3203
12276,2020-01-31,(10001) Country Sur,4922,2135,2716,9773
12277,2020-06-25,(04100) Carrera 77,1279,721,868,2868
12278,2020-05-13,(06000) Portal Eldorado,960,576,401,1937
12279,2020-03-05,(02000) Cabecera Autopista Norte - intermunicipal,4837,3336,3023,11196
12280,2020-06-11,(10005) Bicentenario - alimentacion,191,98,194,483
12281,2020-02-28,(03000) Portal Suba,9779,5195,5070,20044
12282,2020-02-24,(02000) Cabecera Autopista Norte - intermunicipal,5076,3540,3061,11677
12283,2020-09-17,(10002) Av. Primero de Mayo,2310,1206,1631,5147
12284,2020-01-21,(10000) Portal 20 de Julio,6825,2376,2737,11938
12285,2020-01-23,(09116) Avenida 39,2383,1587,1378,5348
12286,2020-07-01,(07112) COMUNEROS,807,504,513,1824
12287,2020-02-17,(06102) Salitre El Greco,1588,884,709,3181
12288,2020-09-13,(04100) Carrera 77,442,209,434,1085
12289,2020-09-04,(08001) Parque el Tunal,521,293,335,1149
12290,2020-10-07,(09116) Avenida 39,448,260,356,1064
12291,2020-04-13,(07505) LEON XIII,1175,726,563,2464
12292,2020-01-13,(06108) Concejo de Bogotá,699,354,438,1491
12293,2020-01-14,(06108) Concejo de Bogotá,707,377,411,1495
12294,2020-09-11,(06108) Concejo de Bogotá,134,80,87,301
12295,2020-06-20,(07010) Bosa,606,304,344,1254
12296,2020-04-17,(04000) Cabecera Calle 80,580,387,370,1337
12297,2020-03-05,(02202) Calle 127,5825,3859,2957,12641
12298,2020-03-12,(03001) LA CAMPIÑA,175,1698,1209,3082
12299,2020-07-06,(09107) Hortúa,651,353,372,1376
12300,2020-07-13,(40003) Mirador del Paraiso,894,637,554,2085
12301,2020-07-26,(05103) Marsella,83,42,61,186
12302,2020-10-05,(02103) Mazurén,254,199,279,732
12303,2020-02-27,(03012) SUBA - CALLE 95,1486,955,1012,3453
12304,2020-01-19,(10000) Portal 20 de Julio,2017,781,1625,4423
12305,2020-08-13,(50002) Corral Calle 40 Sur,23,13,24,60
12306,2020-01-31,(08000) Portal Tunal,2077,1132,1076,4285
12307,2020-02-08,(07104) Simon Bolivar,1421,936,981,3338
12308,2020-07-11,(05005) Transversal 86,0,148,417,565
12309,2020-10-01,(05005) Transversal 86,496,259,342,1097
12310,2020-10-07,(05005) Transversal 86,507,283,413,1203
12311,2020-01-29,(06109) Centro Memoria,1122,654,592,2368
12312,2020-05-11,(07007) NQS - Calle 38A Sur,252,152,160,564
12313,2020-03-04,(14004) Museo del Oro,4297,2639,2051,8987
12314,2020-02-08,(04003) Avenida Ciudad de Cali,3181,1543,2555,7279
12315,2020-06-30,(06000) Portal Eldorado - alimentacion,4185,2189,2140,8514
12316,2020-09-11,(07106) EL CAMPIN,444,275,264,983
12317,2020-01-24,(07103) AV. CHILE,3516,2087,1764,7367
12318,2020-09-23,(07103) AV. CHILE,1068,649,627,2344
12319,2020-02-24,(06102) Salitre El Greco,1591,907,706,3204
12320,2020-09-16,(03007) HUMEDAL CORDOBA,172,109,87,368
12321,2020-04-21,(10006) San Victorino,204,159,198,561
12322,2020-03-23,(03011) SUBA - CALLE 100,152,113,82,347
12323,2020-08-20,(09117) Calle 45,560,366,378,1304
12324,2020-06-25,(07000) Portal Sur,1927,1253,1114,4294
12325,2020-05-31,(02101) Toberín,242,173,250,665
12326,2020-06-02,(02101) Toberín,1324,851,807,2982
12327,2020-06-20,(09103) Olaya,840,434,503,1777
12328,2020-03-18,(06101) El Tiempo,1140,671,562,2373
12329,2020-08-15,(09115) Calle 34,398,282,377,1057
12330,2020-10-10,(02204) Pepe Sierra,583,409,512,1504
12331,2020-04-25,(09100) Calle 40 Sur,675,416,484,1575
12332,2020-04-30,(09100) Calle 40 Sur,1019,622,660,2301
12333,2020-08-12,(07104) Simon Bolivar,375,260,264,899
12334,2020-02-03,(04107) Escuela Militar,650,403,448,1501
12335,2020-06-24,(04107) Escuela Militar,134,95,89,318
12336,2020-07-09,(04107) Escuela Militar,141,88,110,339
12337,2020-08-14,(04107) Escuela Militar,100,69,59,228
12338,2020-10-01,(10009) Museo Nacional,565,361,472,1398
12339,2020-03-19,(09109) Tercer Milenio,796,502,471,1769
12340,2020-10-04,(09117) Calle 45,281,177,347,805
12341,2020-10-05,(03003) 21 ANGELES,412,210,282,904
12342,2020-02-07,(07004) VENECIA,4876,2656,2649,10181
12343,2020-10-01,(06101) El Tiempo,386,258,283,927
12344,2020-10-09,(06101) El Tiempo,383,247,321,951
12345,2020-01-11,(09001) Molinos,4631,2095,3639,10365
12346,2020-01-11,(04001) Quirigua,894,436,702,2032
12347,2020-08-01,(02205) Calle 106,137,132,143,412
12348,2020-09-15,(08000) Portal Tunal,812,326,369,1507
12349,2020-07-04,(09118) Marly,1115,745,717,2577
12350,2020-03-19,(07103) AV. CHILE,1911,1308,1037,4256
12351,2020-05-22,(06000) Portal Eldorado,994,642,457,2093
12352,2020-06-27,(06000) Portal Eldorado,705,517,484,1706
12353,2020-01-12,(09122) Calle 72,1015,722,1272,3009
12354,2020-01-23,(09122) Calle 72,6289,4098,3587,13974
12355,2020-07-02,(09122) Calle 72,1209,809,869,2887
12356,2020-09-14,(12003) Ricaurte,410,264,201,875
12357,2020-03-15,(04103) Las Ferias,222,139,227,588
12358,2020-09-16,(03013) RIO NEGRO,320,164,222,706
12359,2020-05-05,(07106) EL CAMPIN,207,131,131,469
12360,2020-02-15,(06001) Modelia,1044,651,942,2637
12361,2020-01-05,(08002) Biblioteca,188,77,180,445
12362,2020-04-12,(09109) Tercer Milenio,56,39,48,143
12363,2020-10-04,(07009) SENA,252,143,332,727
12364,2020-04-27,(05107) Américas - Cr.53,92,127,65,284
12365,2020-03-06,(12002) CDS - Carrera 32,561,365,365,1291
12366,2020-02-03,(08002) Biblioteca,1023,579,678,2280
12367,2020-09-10,(02304) Heroes,787,483,565,1835
12368,2020-08-20,(02104) Calle 146,680,432,447,1559
12369,2020-01-31,(08002) Biblioteca,980,466,679,2125
12370,2020-05-16,(02200) Alcalá,1085,722,586,2393
12371,2020-06-05,(02200) Alcalá,1712,1174,851,3737
12372,2020-04-26,(02202) Calle 127,306,229,155,690
12373,2020-02-15,(10004) Policarpa,603,244,497,1344
12374,2020-05-27,(05107) Américas - Cr.53,363,236,235,834
12375,2020-06-04,(06111) Universidades,0,117,374,491
12376,2020-06-07,(09115) Calle 34,144,120,140,404
12377,2020-06-18,(03006) NIZA - CALLE 127,480,283,245,1008
12378,2020-05-23,(07005) ALQUERIA,333,223,180,736
12379,2020-03-30,(02204) Pepe Sierra,385,333,262,980
12380,2020-05-08,(02204) Pepe Sierra,558,407,284,1249
12381,2020-03-12,(07000) Portal Sur,204,1935,1455,3594
12382,2020-08-25,(10003) Ciudad Jardín,196,92,119,407
12383,2020-07-30,(02105) Calle 142,720,449,496,1665
12384,2020-03-13,(09104) Restrepo,810,766,893,2469
12385,2020-04-16,(02101) Toberín,583,414,430,1427
12386,2020-04-16,(09118) Marly,999,701,439,2139
12387,2020-03-28,(06109) Centro Memoria,117,80,70,267
12388,2020-02-17,(07006) General Santander - alimentacion,1514,906,936,3356
12389,2020-04-24,(02302) Virrey,368,245,217,830
12390,2020-05-12,(07201) Guatoque -Veraguas,152,83,98,333
12391,2020-05-26,(07201) Guatoque -Veraguas,176,107,120,403
12392,2020-06-25,(07107) U. NACIONAL,346,217,187,750
12393,2020-04-21,(07105) MOVISTAR ARENA,166,112,82,360
12394,2020-09-03,(07105) MOVISTAR ARENA,274,162,153,589
12395,2020-04-21,(12007) Zona Industrial,244,163,105,512
12396,2020-07-05,(03000) Portal Suba,341,191,346,878
12397,2020-03-01,(12001) Carrera 43,172,125,318,615
12398,2020-04-04,(02104) Calle 146,253,200,141,594
12399,2020-04-19,(09119) Calle 57,102,76,77,255
12400,2020-03-17,(04103) Las Ferias,848,491,531,1870
12401,2020-09-08,(10004) Policarpa,259,125,191,575
12402,2020-08-15,(04105) Carrera 53,201,106,144,451
12403,2020-01-07,(50002) Corral Calle 40 Sur,83,44,99,226
12404,2020-04-25,(12000) Puente Aranda,35,19,22,76
12405,2020-09-19,(09121) Las Flores,504,337,518,1359
12406,2020-03-24,(02102) Calle 161,174,137,145,456
12407,2020-06-28,(10002) Av. Primero de Mayo,605,290,496,1391
12408,2020-05-12,(07004) VENECIA,743,450,398,1591
12409,2020-07-24,(06000) Portal Eldorado,779,497,356,1632
12410,2020-04-04,(09109) Tercer Milenio,107,74,86,267
12411,2020-05-09,(09003) Socorro,330,166,171,667
12412,2020-09-24,(04103) Las Ferias,385,205,236,826
12413,2020-08-07,(08001) Parque el Tunal,173,91,149,413
12414,2020-04-11,(07009) SENA,178,99,93,370
12415,2020-04-22,(10010) San Bernardo,411,234,253,898
12416,2020-04-17,(04102) Avenida Boyaca,136,91,91,318
12417,2020-09-26,(12002) CDS - Carrera 32,115,98,101,314
12418,2020-08-03,(03006) NIZA - CALLE 127,333,205,166,704
12419,2020-07-18,(06101) El Tiempo,199,134,142,475
12420,2020-04-17,(06103) CAN,303,206,160,669
12421,2020-06-21,(04000) Cabecera Calle 80 - intermunicipal,66,24,48,138
12422,2020-05-06,(04102) Avenida Boyaca,201,111,129,441
12423,2020-04-23,(09120) Calle 63,589,412,370,1371
12424,2020-09-03,(14004) Museo del Oro,346,233,292,871
12425,2020-07-14,(06001) Modelia,320,202,174,696
12426,2020-08-07,(02103) Mazurén,50,35,63,148
12427,2020-04-05,(06103) CAN,147,96,72,315
12428,2020-10-11,(05100) Banderas P. Central,245,117,304,666
12429,2020-06-22,(09122) Calle 72,342,261,306,909
12430,2020-04-24,(07107) U. NACIONAL,203,145,109,457
12431,2020-03-13,(07006) General Santander - alimentacion,71,226,242,539
12432,2020-05-21,(07506) DESPENSA,384,189,182,755
12433,2020-05-23,(02000) Cabecera Autopista Norte - intermunicipal,227,143,174,544
12434,2020-04-08,(09111) Calle 19,209,148,216,573
12435,2020-05-13,(09108) Hospital,59,41,41,141
12436,2020-04-25,(07006) General Santander - alimentacion,153,92,77,322
12437,2020-06-15,(09109) Tercer Milenio,112,92,123,327
12438,2020-05-17,(03011) SUBA - CALLE 100,112,79,65,256
12439,2020-05-27,(03004) GRATAMIRA,22,16,15,53
12440,2020-10-03,(06106) Recinto Ferial,234,147,201,582
12441,2020-05-18,(07008) NQS - Calle 30 Sur,199,119,107,425
12442,2020-04-18,(06103) CAN,191,151,103,445
12443,2020-05-10,(09116) Avenida 39,90,67,56,213
12444,2020-08-07,(09111) Calle 19,283,194,239,716
12445,2020-05-30,(03004) GRATAMIRA,27,15,10,52
12446,2020-05-17,(07102) NQS - CALLE 75,45,44,57,146
12447,2020-04-22,(06100) Av. Rojas,103,72,64,239
12448,2020-07-21,(05102) Av. Américas - Av. Boyacá,203,109,126,438
12449,2020-05-04,(12004) Carrera 22,121,79,78,278
12450,2020-02-23,(07200) Tygua-San José,150,116,245,511
12451,2020-03-27,(06106) Recinto Ferial,137,89,60,286
12452,2020-04-03,(06106) Recinto Ferial,118,89,79,286
12453,2020-03-30,(07105) MOVISTAR ARENA,114,104,103,321
12454,2020-07-21,(09105) Río Fucha,99,40,48,187
12455,2020-08-17,(04103) Las Ferias,117,57,75,249
12456,2020-08-16,(09113) Calle 22,195,104,183,482
12457,2020-09-15,(07101) CASTELLANA,268,126,142,536
12458,2020-06-02,(09105) Río Fucha,113,52,74,239
12459,2020-05-08,(14005) Las Aguas,0,53,137,190
12460,2020-05-14,(07101) CASTELLANA,145,94,90,329
12461,2020-04-26,(07201) Guatoque -Veraguas,11,10,28,49
12462,2020-04-13,(07200) Tygua-San José,98,58,87,243
12463,2020-08-23,(10004) Policarpa,81,32,68,181
12464,2020-10-01,(50002) Corral Calle 40 Sur,36,14,37,87
12465,2020-06-03,(50002) Corral Calle 40 Sur,16,9,20,45
12466,2020-04-30,(09108) Hospital,50,31,30,111
12467,2020-05-25,(07113) SANTA ISABEL,104,69,95,268
12468,2020-04-09,(09101) Quiroga,63,44,50,157
12469,2020-06-21,(06100) Av. Rojas,37,30,51,118
12470,2020-03-21,(05101) Mandalay - Cr.73,31,22,25,78
12471,2020-04-14,(09108) Hospital,28,15,29,72
12472,2020-04-10,(10008) San Diego,53,35,17,105
12473,2020-09-30,(03014) SAN MARTIN,0,16,54,70
12474,2020-06-28,(09105) Río Fucha,51,15,38,104
12475,2020-06-21,(07101) CASTELLANA,30,27,51,108
12476,2020-03-22,(03014) SAN MARTIN,11,5,7,23
12477,2020-06-10,(09002) Consuelo,490,247,270,1007
12478,2020-08-08,(09118) Marly,987,594,552,2133
12479,2020-01-10,(07504) TERREROS,14467,7879,8106,30452
12480,2020-09-21,(05000) Portal Américas - alimentacion,10153,4085,5222,19460
12481,2020-01-27,(07503) SAN MATEO,38588,22538,17138,78264
12482,2020-01-28,(07503) SAN MATEO,39215,22725,17258,79198
12483,2020-02-03,(07503) SAN MATEO,40433,23117,18299,81849
12484,2020-02-03,(14005) Las Aguas,3307,1970,1916,7193
12485,2020-02-04,(14005) Las Aguas,3427,1969,1971,7367
12486,2020-04-30,(05000) Portal Américas,1511,1042,1199,3752
12487,2020-01-16,(09100) Calle 40 Sur,6350,3356,3799,13505
12488,2020-02-12,(09114) Calle 26,3434,2228,1792,7454
12489,2020-02-04,(09001) Molinos,7638,4716,6054,18408
12490,2020-06-18,(07503) SAN MATEO,10584,6773,5789,23146
12491,2020-08-19,(07503) SAN MATEO,10585,5922,5011,21518
12492,2020-10-02,(05000) Portal Américas - alimentacion,12696,6752,8684,28132
12493,2020-09-28,(06107) Ciudad Universitaria,195,108,174,477
12494,2020-01-29,(09001) Molinos,7308,4402,5731,17441
12495,2020-03-08,(04100) Carrera 77,1360,609,1418,3387
12496,2020-01-07,(50006) Corral Carrera 77,25,21,47,93
12497,2020-02-01,(08000) Portal Tunal - alimentacion,15839,7565,9416,32820
12498,2020-05-02,(09100) Calle 40 Sur,732,447,452,1631
12499,2020-09-19,(09100) Calle 40 Sur,1562,822,1257,3641
12500,2020-03-02,(09000) Cabecera Usme,5792,3473,3937,13202
12501,2020-09-07,(40001) Juan Pablo II,569,349,382,1300
12502,2020-09-18,(09000) Cabecera Usme,2015,1190,1582,4787
12503,2020-01-27,(09115) Calle 34,4060,2572,2340,8972
12504,2020-02-29,(09115) Calle 34,1439,1073,1698,4210
12505,2020-09-12,(05100) Banderas P. Central - alimentacion,2694,1170,1798,5662
12506,2020-05-30,(09000) Cabecera Usme - alimentacion,6000,3121,3391,12512
12507,2020-05-14,(07001) PERDOMO,661,376,354,1391
12508,2020-09-04,(09000) Cabecera Usme - alimentacion,9590,4891,5947,20428
12509,2020-04-25,(09109) Tercer Milenio,143,109,114,366
12510,2020-01-07,(09104) Restrepo,3529,2171,3250,8950
12511,2020-03-02,(09104) Restrepo,5142,3179,4034,12355
12512,2020-02-03,(07505) LEON XIII,8303,4744,3903,16950
12513,2020-08-30,(07505) LEON XIII,842,412,506,1760
12514,2020-06-04,(09000) Cabecera Usme,1549,1021,1015,3585
12515,2020-02-17,(09117) Calle 45,6794,4326,3046,14166
12516,2020-01-25,(05001) Patio Bonito,4736,2347,2778,9861
12517,2020-04-15,(02000) Cabecera Autopista Norte - alimentacion,2747,1481,1298,5526
12518,2020-05-26,(04100) Carrera 77,1110,612,667,2389
12519,2020-07-13,(04100) Carrera 77,1083,625,692,2400
12520,2020-05-03,(07102) NQS - CALLE 75,48,42,27,117
12521,2020-03-18,(03013) RIO NEGRO,698,446,480,1624
12522,2020-01-22,(09110) Avenida Jimenez,4615,3037,2861,10513
12523,2020-06-13,(05000) Portal Américas - alimentacion,8247,4146,4134,16527
12524,2020-02-04,(02103) Mazurén,3557,2290,1925,7772
12525,2020-04-29,(09103) Olaya,609,353,325,1287
12526,2020-01-13,(14001) La Sabana,297,219,338,854
12527,2020-06-13,(07002) MADELENA,592,265,384,1241
12528,2020-02-26,(07107) U. NACIONAL,2227,1452,1239,4918
12529,2020-02-07,(04105) Carrera 53,1570,846,792,3208
12530,2020-04-28,(05000) Portal Américas,1448,1021,1138,3607
12531,2020-03-16,(05002) Tintal,7731,4535,4346,16612
12532,2020-01-31,(09120) Calle 63,5719,3775,3579,13073
12533,2020-07-03,(10006) San Victorino,777,357,371,1505
12534,2020-03-19,(03000) Portal Suba,3794,2148,2295,8237
12535,2020-09-24,(12001) Carrera 43,471,280,300,1051
12536,2020-05-30,(06105) Quinta Paredes,95,63,55,213
12537,2020-03-27,(09101) Quiroga,187,122,157,466
12538,2020-06-18,(02303) Calle 85,723,504,371,1598
12539,2020-06-23,(02303) Calle 85,821,539,410,1770
12540,2020-09-27,(07504) TERREROS,2064,874,1582,4520
12541,2020-03-24,(09107) Hortúa,638,459,387,1484
12542,2020-02-18,(05102) Av. Américas - Av. Boyacá,2053,1183,969,4205
12543,2020-01-24,(06103) CAN,2337,1412,1190,4939
12544,2020-01-20,(06108) Concejo de Bogotá,854,406,429,1689
12545,2020-08-08,(09113) Calle 22,370,203,269,842
12546,2020-06-23,(02201) Prado,978,628,588,2194
12547,2020-03-23,(03007) HUMEDAL CORDOBA,45,34,25,104
12548,2020-05-03,(50003) Corral Molinos,357,144,259,760
12549,2020-05-16,(50003) Corral Molinos,983,467,664,2114
12550,2020-01-31,(03011) SUBA - CALLE 100,2499,1246,1470,5215
12551,2020-07-17,(02300) Calle 100,1090,700,595,2385
12552,2020-01-20,(03012) SUBA - CALLE 95,1230,791,985,3006
12553,2020-01-04,(06000) Portal Eldorado,1849,1298,1400,4547
12554,2020-03-20,(10000) Portal 20 de Julio - alimentacion,1765,821,967,3553
12555,2020-06-03,(09001) Molinos,2146,1271,1465,4882
12556,2020-04-20,(05005) Transversal 86,211,118,97,426
12557,2020-09-30,(02202) Calle 127,1255,890,780,2925
12558,2020-03-16,(05105) Pradera,1954,1182,840,3976
12559,2020-06-27,(05105) Pradera,490,342,270,1102
12560,2020-07-02,(08000) Portal Tunal,852,359,306,1517
12561,2020-08-14,(03009) Av. Suba- Calle 116,450,293,243,986
12562,2020-02-15,(04003) Avenida Ciudad de Cali,3259,1496,2516,7271
12563,2020-02-24,(12007) Zona Industrial,1343,752,662,2757
12564,2020-01-27,(07101) CASTELLANA,940,563,598,2101
12565,2020-02-09,(06102) Salitre El Greco,273,167,242,682
12566,2020-09-09,(07106) EL CAMPIN,481,297,277,1055
12567,2020-02-02,(07113) SANTA ISABEL,463,245,590,1298
12568,2020-05-15,(07113) SANTA ISABEL,306,200,178,684
12569,2020-08-20,(07113) SANTA ISABEL,333,206,226,765
12570,2020-06-19,(06000) Portal Eldorado - alimentacion,4022,2066,2099,8187
12571,2020-02-02,(09119) Calle 57,628,353,820,1801
12572,2020-07-07,(03007) HUMEDAL CORDOBA,171,112,76,359
12573,2020-06-16,(10006) San Victorino,604,278,310,1192
12574,2020-08-25,(03001) LA CAMPIÑA,1077,607,636,2320
12575,2020-03-20,(09000) Cabecera Usme,749,457,416,1622
12576,2020-08-03,(02101) Toberín,1139,758,765,2662
12577,2020-06-27,(09103) Olaya,879,451,528,1858
12578,2020-03-29,(07110) PALOQUEMAO,106,86,66,258
12579,2020-07-15,(04107) Escuela Militar,130,79,79,288
12580,2020-08-07,(04003) Avenida Ciudad de Cali,331,187,265,783
12581,2020-08-25,(09109) Tercer Milenio,312,207,221,740
12582,2020-08-15,(05001) Patio Bonito,1616,789,1032,3437
12583,2020-06-15,(10000) Portal 20 de Julio - alimentacion,1651,696,986,3333
12584,2020-03-17,(04105) Carrera 53,795,474,451,1720
12585,2020-09-30,(06101) El Tiempo,398,279,282,959
12586,2020-03-01,(07002) MADELENA,898,354,842,2094
12587,2020-03-15,(09101) Quiroga,307,184,389,880
12588,2020-06-04,(02204) Pepe Sierra,699,483,390,1572
12589,2020-04-20,(02000) Cabecera Autopista Norte,567,386,369,1322
12590,2020-10-01,(02300) Calle 100,1276,895,1026,3197
12591,2020-02-04,(40001) Juan Pablo II,1721,985,1022,3728
12592,2020-02-15,(07109) CAD,1330,933,1156,3419
12593,2020-04-13,(03001) LA CAMPIÑA,544,318,291,1153
12594,2020-06-08,(07113) SANTA ISABEL,374,236,221,831
12595,2020-01-10,(06103) CAN,1610,1005,944,3559
12596,2020-10-04,(06100) Av. Rojas,38,43,105,186
12597,2020-09-26,(02302) Virrey,416,336,412,1164
12598,2020-08-22,(12003) Ricaurte,307,209,128,644
12599,2020-03-19,(06103) CAN,1012,609,512,2133
12600,2020-05-21,(04003) Avenida Ciudad de Cali,804,521,532,1857
12601,2020-03-22,(04104) Avenida 68,126,75,78,279
12602,2020-05-16,(03006) NIZA - CALLE 127,240,168,123,531
12603,2020-09-18,(03006) NIZA - CALLE 127,585,322,326,1233
12604,2020-01-16,(10005) Bicentenario,682,353,351,1386
12605,2020-05-02,(09118) Marly,804,535,379,1718
12606,2020-06-12,(02103) Mazurén,172,112,141,425
12607,2020-08-15,(12007) Zona Industrial,281,209,146,636
12608,2020-07-25,(04002) Carrera 90,485,259,253,997
12609,2020-09-14,(02001) Centro Comercial Santa Fe,532,333,420,1285
12610,2020-04-09,(05100) Banderas P. Central - alimentacion,563,265,235,1063
12611,2020-02-23,(04105) Carrera 53,314,171,313,798
12612,2020-05-12,(04100) Carrera 77,923,518,618,2059
12613,2020-06-12,(10006) San Victorino,551,267,339,1157
12614,2020-03-22,(07004) VENECIA,169,102,89,360
12615,2020-09-19,(10008) San Diego,230,159,228,617
12616,2020-04-04,(09120) Calle 63,406,295,252,953
12617,2020-09-15,(10009) Museo Nacional,537,306,385,1228
12618,2020-07-02,(05105) Pradera,614,306,284,1204
12619,2020-10-11,(05103) Marsella,147,78,188,413
12620,2020-06-03,(40001) Juan Pablo II,513,320,283,1116
12621,2020-06-06,(40001) Juan Pablo II,421,238,270,929
12622,2020-10-11,(09115) Calle 34,148,134,276,558
12623,2020-03-31,(02104) Calle 146,328,259,219,806
12624,2020-02-01,(05102) Av. Américas - Av. Boyacá,790,388,638,1816
12625,2020-07-10,(12002) CDS - Carrera 32,184,106,75,365
12626,2020-05-14,(06109) Centro Memoria,232,147,106,485
12627,2020-02-09,(10007) Las Nieves,206,224,431,861
12628,2020-04-17,(04100) Carrera 77,654,386,393,1433
12629,2020-06-12,(05102) Av. Américas - Av. Boyacá,203,110,114,427
12630,2020-05-01,(09103) Olaya,299,155,177,631
12631,2020-08-08,(06104) Gobernación,103,71,72,246
12632,2020-04-15,(03000) Portal Suba,484,371,414,1269
12633,2020-05-27,(07105) MOVISTAR ARENA,225,143,115,483
12634,2020-08-01,(07105) MOVISTAR ARENA,135,92,125,352
12635,2020-08-07,(04108) El Polo,121,75,85,281
12636,2020-04-07,(02200) Alcalá,859,623,468,1950
12637,2020-07-20,(06109) Centro Memoria,64,37,55,156
12638,2020-05-12,(09110) Avenida Jimenez,773,566,531,1870
12639,2020-09-27,(10000) Portal 20 de Julio - alimentacion,1618,669,1422,3709
12640,2020-10-01,(06102) Salitre El Greco,262,164,201,627
12641,2020-03-09,(05005) Transversal 86,63,773,456,1292
12642,2020-01-06,(06111) Universidades,296,194,496,986
12643,2020-07-16,(10007) Las Nieves,383,221,259,863
12644,2020-07-23,(12000) Puente Aranda,79,48,37,164
12645,2020-09-07,(12001) Carrera 43,478,260,277,1015
12646,2020-09-01,(09120) Calle 63,1100,710,774,2584
12647,2020-02-09,(07006) General Santander - alimentacion,278,185,331,794
12648,2020-01-04,(10004) Policarpa,334,151,292,777
12649,2020-03-31,(09002) Consuelo,219,104,126,449
12650,2020-08-28,(07200) Tygua-San José,241,124,166,531
12651,2020-02-24,(09105) Río Fucha,826,476,513,1815
12652,2020-03-15,(40001) Juan Pablo II,403,174,273,850
12653,2020-09-27,(02103) Mazurén,55,36,82,173
12654,2020-01-11,(14001) La Sabana,179,183,223,585
12655,2020-08-19,(07001) PERDOMO,843,515,512,1870
12656,2020-01-31,(12002) CDS - Carrera 32,565,347,318,1230
12657,2020-06-04,(12002) CDS - Carrera 32,179,138,69,386
12658,2020-01-05,(04000) Cabecera Calle 80 - intermunicipal,194,101,274,569
12659,2020-07-06,(07108) Av. El Dorado,163,93,98,354
12660,2020-09-13,(07004) VENECIA,331,160,302,793
12661,2020-07-24,(06002) Normandía,253,148,152,553
12662,2020-09-21,(04001) Quirigua,341,225,234,800
12663,2020-10-02,(09105) Río Fucha,0,77,199,276
12664,2020-05-12,(07010) Bosa,512,285,310,1107
12665,2020-09-26,(09111) Calle 19,649,443,563,1655
12666,2020-09-23,(02204) Pepe Sierra,884,634,529,2047
12667,2020-09-27,(02502) Terminal,104,90,209,403
12668,2020-06-03,(07006) General Santander - alimentacion,343,200,205,748
12669,2019-12-31,(05105) Pradera,26,12,35,73
12670,2020-03-15,(09105) Río Fucha,81,55,153,289
12671,2020-03-20,(09117) Calle 45,505,337,271,1113
12672,2020-09-21,(10008) San Diego,73,138,190,401
12673,2020-07-22,(04106) Carrera 47,301,149,162,612
12674,2020-10-03,(03005) SUBA - AV. BOYACA,421,231,422,1074
12675,2020-04-26,(09001) Molinos,450,281,325,1056
12676,2020-08-05,(10007) Las Nieves,636,371,340,1347
12677,2020-06-13,(02304) Heroes,478,384,307,1169
12678,2020-05-11,(09113) Calle 22,343,213,287,843
12679,2020-03-25,(09111) Calle 19,190,138,181,509
12680,2020-05-13,(09111) Calle 19,548,332,381,1261
12681,2020-06-14,(03003) 21 ANGELES,81,39,66,186
12682,2020-08-29,(09121) Las Flores,499,328,441,1268
12683,2020-10-10,(10003) Ciudad Jardín,207,85,212,504
12684,2020-04-01,(09105) Río Fucha,51,27,59,137
12685,2020-07-06,(05102) Av. Américas - Av. Boyacá,256,135,188,579
12686,2020-08-10,(07007) NQS - Calle 38A Sur,364,253,243,860
12687,2020-05-04,(08002) Biblioteca,225,108,102,435
12688,2020-04-17,(06104) Gobernación,150,113,67,330
12689,2020-02-24,(50006) Corral Carrera 77,28,18,43,89
12690,2020-07-25,(05101) Mandalay - Cr.73,60,31,37,128
12691,2020-06-15,(03005) SUBA - AV. BOYACA,110,77,96,283
12692,2020-06-28,(02304) Heroes,221,172,173,566
12693,2020-05-24,(04105) Carrera 53,66,39,48,153
12694,2020-07-13,(08002) Biblioteca,200,119,115,434
12695,2020-05-26,(04105) Carrera 53,256,135,137,528
12696,2020-03-15,(12001) Carrera 43,150,97,241,488
12697,2019-12-31,(04104) Avenida 68,36,20,29,85
12698,2020-03-23,(10006) San Victorino,57,49,47,153
12699,2020-04-16,(05101) Mandalay - Cr.73,63,33,25,121
12700,2020-09-13,(07010) Bosa,0,78,264,342
12701,2020-07-11,(06108) Concejo de Bogotá,80,57,70,207
12702,2020-03-21,(04107) Escuela Militar,31,21,19,71
12703,2020-07-26,(07101) CASTELLANA,27,21,28,76
12704,2020-04-15,(07106) EL CAMPIN,177,126,95,398
12705,2020-09-10,(50002) Corral Calle 40 Sur,15,15,19,49
12706,2020-08-17,(10005) Bicentenario - alimentacion,57,32,78,167
12707,2020-04-26,(07108) Av. El Dorado,26,17,18,61
12708,2020-07-12,(12000) Puente Aranda,7,8,10,25
12709,2020-04-23,(50006) Corral Carrera 77,7,0,9,16
12710,2020-04-07,(03004) GRATAMIRA,19,9,11,39
12711,2020-04-09,(50002) Corral Calle 40 Sur,3,1,2,6
12712,2020-05-31,(50002) Corral Calle 40 Sur,3,1,6,10
12713,2020-04-30,(07005) ALQUERIA,321,194,181,696
12714,2020-03-11,(09002) Consuelo,1315,701,817,2833
12715,2020-08-14,(09002) Consuelo,503,261,308,1072
12716,2020-03-19,(02502) Terminal,1537,938,1007,3482
12717,2020-08-31,(02502) Terminal,437,318,410,1165
12718,2020-01-27,(07504) TERREROS,16707,10502,8924,36133
12719,2020-09-25,(07504) TERREROS,7219,3632,4027,14878
12720,2020-08-03,(05000) Portal Américas - alimentacion,9241,4856,4671,18768
12721,2020-03-05,(03000) Portal Suba - alimentacion,28756,16673,16914,62343
12722,2020-02-17,(06000) Portal Eldorado - alimentacion,18927,10544,9585,39056
12723,2020-02-06,(09003) Socorro,1650,962,1081,3693
12724,2020-03-11,(09003) Socorro,1580,893,997,3470
12725,2020-01-15,(10000) Portal 20 de Julio - alimentacion,10175,4768,6701,21644
12726,2020-05-15,(05000) Portal Américas - alimentacion,8715,4461,3988,17164
12727,2020-02-02,(09001) Molinos,2015,887,2048,4950
12728,2020-02-01,(07111) NQS - RICAURTE,2087,1471,1401,4959
12729,2020-09-19,(05000) Portal Américas - alimentacion,9973,4900,6697,21570
12730,2020-07-02,(07503) SAN MATEO,11542,6968,6262,24772
12731,2020-01-04,(05000) Portal Américas,5043,2410,3678,11131
12732,2020-09-07,(07000) Portal Sur - alimentacion,8226,4756,4800,17782
12733,2020-01-17,(05005) Transversal 86,2310,1217,1198,4725
12734,2020-03-26,(09000) Cabecera Usme,783,427,494,1704
12735,2020-03-17,(09115) Calle 34,2437,1595,1385,5417
12736,2020-05-14,(09115) Calle 34,518,338,277,1133
12737,2020-01-30,(07009) SENA,3566,2044,2013,7623
12738,2020-02-07,(02105) Calle 142,7483,4110,4024,15617
12739,2020-02-21,(07002) MADELENA,5035,2645,2562,10242
12740,2020-02-28,(02105) Calle 142,7210,3948,3957,15115
12741,2020-06-30,(09104) Restrepo,1602,973,1216,3791
12742,2020-08-17,(09104) Restrepo,498,292,413,1203
12743,2020-09-17,(09104) Restrepo,1730,951,1334,4015
12744,2020-08-22,(04101) Minuto de Dios,198,126,203,527
12745,2020-05-23,(07505) LEON XIII,1457,885,705,3047
12746,2020-09-24,(07505) LEON XIII,3010,1525,1559,6094
12747,2020-10-05,(02101) Toberín,1862,1202,1561,4625
12748,2020-08-24,(02204) Pepe Sierra,672,505,373,1550
12749,2020-04-16,(09000) Cabecera Usme,841,514,626,1981
12750,2020-02-27,(09110) Avenida Jimenez,5060,3431,2894,11385
12751,2020-10-05,(10000) Portal 20 de Julio - alimentacion,4674,1954,3166,9794
12752,2020-01-14,(09101) Quiroga,1419,801,1164,3384
12753,2020-05-26,(09101) Quiroga,376,229,314,919
12754,2020-06-28,(05000) Portal Américas,699,459,625,1783
12755,2020-05-27,(04100) Carrera 77,1039,555,637,2231
12756,2020-04-11,(09118) Marly,600,441,256,1297
12757,2020-03-31,(09103) Olaya,439,244,243,926
12758,2020-09-12,(09103) Olaya,917,436,603,1956
12759,2020-06-25,(07000) Portal Sur - alimentacion,7966,4767,4168,16901
12760,2020-02-19,(06001) Modelia,2683,1570,1328,5581
12761,2020-02-05,(02303) Calle 85,3884,2584,1976,8444
12762,2020-02-24,(02303) Calle 85,3926,2549,2029,8504
12763,2020-02-21,(09119) Calle 57,3229,2218,2084,7531
12764,2020-07-29,(05100) Banderas P. Central - alimentacion,2547,1382,1430,5359
12765,2020-01-01,(09103) Olaya,385,188,465,1038
12766,2020-10-02,(09103) Olaya,1218,622,856,2696
12767,2020-09-12,(07000) Portal Sur - alimentacion,7061,3369,4387,14817
12768,2020-09-13,(07002) MADELENA,292,106,296,694
12769,2020-02-15,(02200) Alcalá,6551,3418,4525,14494
12770,2020-03-18,(07002) MADELENA,2344,1269,1167,4780
12771,2020-07-25,(09001) Molinos,1447,742,1042,3231
12772,2020-03-03,(07007) NQS - Calle 38A Sur,2214,1283,1237,4734
12773,2020-06-17,(50003) Corral Molinos,1487,771,1044,3302
12774,2020-04-21,(05000) Portal Américas,1296,950,986,3232
12775,2020-07-22,(02000) Cabecera Autopista Norte - alimentacion,4333,2328,2410,9071
12776,2020-07-04,(09110) Avenida Jimenez,1287,900,852,3039
12777,2020-10-04,(09110) Avenida Jimenez,472,404,499,1375
12778,2020-01-10,(04106) Carrera 47,1056,573,699,2328
12779,2020-01-16,(09120) Calle 63,3890,2855,3079,9824
12780,2020-09-08,(02000) Cabecera Autopista Norte - alimentacion,4866,2563,2981,10410
12781,2020-01-20,(07506) DESPENSA,1423,894,897,3214
12782,2020-02-25,(04002) Carrera 90,3740,2250,2072,8062
12783,2020-10-06,(10006) San Victorino,809,429,490,1728
12784,2020-02-25,(10000) Portal 20 de Julio,9177,4403,4074,17654
12785,2020-08-15,(02000) Cabecera Autopista Norte - alimentacion,3953,1889,2472,8314
12786,2020-02-07,(12001) Carrera 43,1731,1003,1110,3844
12787,2020-02-21,(12001) Carrera 43,1635,931,1091,3657
12788,2020-10-01,(12001) Carrera 43,527,300,338,1165
12789,2020-03-09,(07505) LEON XIII,370,2212,1312,3894
12790,2020-01-09,(07113) SANTA ISABEL,1466,880,1074,3420
12791,2020-01-16,(10000) Portal 20 de Julio,7834,3484,3775,15093
12792,2020-01-23,(02302) Virrey,3629,2387,1811,7827
12793,2020-04-30,(03000) Portal Suba,684,449,419,1552
12794,2020-02-10,(06100) Av. Rojas,2864,1622,1245,5731
12795,2020-08-27,(07112) COMUNEROS,800,456,430,1686
12796,2020-08-13,(07000) Portal Sur,1821,1134,1086,4041
12797,2020-04-22,(09004) Santa Lucía,1320,674,710,2704
12798,2020-03-02,(04003) Avenida Ciudad de Cali,5294,3268,3590,12152
12799,2020-01-30,(02300) Calle 100,7352,4499,3793,15644
12800,2020-09-15,(03003) 21 ANGELES,340,166,217,723
12801,2020-03-06,(02202) Calle 127,5680,3676,3075,12431
12802,2020-01-28,(02304) Heroes,4440,3055,2242,9737
12803,2020-01-16,(03005) SUBA - AV. BOYACA,2347,1309,1440,5096
12804,2020-05-25,(02300) Calle 100,359,264,214,837
12805,2020-02-03,(03012) SUBA - CALLE 95,1418,864,961,3243
12806,2020-03-13,(09103) Olaya,301,834,657,1792
12807,2020-01-19,(06000) Portal Eldorado,672,556,1014,2242
12808,2020-02-26,(08000) Portal Tunal,2296,1213,1029,4538
12809,2020-02-18,(14005) Las Aguas,3667,2195,1931,7793
12810,2020-03-23,(09104) Restrepo,293,206,242,741
12811,2020-03-28,(05005) Transversal 86,108,66,54,228
12812,2020-06-13,(05005) Transversal 86,263,110,178,551
12813,2020-07-03,(05005) Transversal 86,0,205,498,703
12814,2020-08-19,(02202) Calle 127,990,704,550,2244
12815,2020-07-16,(05105) Pradera,575,305,225,1105
12816,2020-04-29,(08000) Portal Tunal,475,224,185,884
12817,2020-03-05,(02205) Calle 106,2637,1676,1382,5695
12818,2020-01-29,(03006) NIZA - CALLE 127,2360,1497,1534,5391
12819,2020-10-08,(04003) Avenida Ciudad de Cali,940,676,1219,2835
12820,2020-07-05,(04108) El Polo,98,55,97,250
12821,2020-02-16,(02300) Calle 100,897,752,1247,2896
12822,2020-02-03,(07201) Guatoque -Veraguas,1056,504,622,2182
12823,2020-01-31,(03007) HUMEDAL CORDOBA,992,587,507,2086
12824,2020-03-28,(03007) HUMEDAL CORDOBA,65,45,41,151
12825,2020-01-22,(07108) Av. El Dorado,856,573,597,2026
12826,2020-02-21,(04105) Carrera 53,1530,778,806,3114
12827,2020-02-05,(05103) Marsella,3313,1895,1532,6740
12828,2020-04-02,(10000) Portal 20 de Julio,1132,518,526,2176
12829,2020-03-06,(06101) El Tiempo,2787,1660,1451,5898
12830,2020-02-08,(04103) Las Ferias,857,480,685,2022
12831,2020-02-17,(04103) Las Ferias,1588,966,889,3443
12832,2020-09-10,(07104) Simon Bolivar,543,263,351,1157
12833,2020-05-21,(10005) Bicentenario - alimentacion,200,108,133,441
12834,2020-07-22,(04107) Escuela Militar,111,57,76,244
12835,2020-08-04,(04107) Escuela Militar,85,49,68,202
12836,2020-09-08,(07004) VENECIA,1067,625,696,2388
12837,2020-07-30,(09000) Cabecera Usme,1567,1018,1158,3743
12838,2020-05-13,(04108) El Polo,373,238,186,797
12839,2020-06-14,(07505) LEON XIII,681,352,378,1411
12840,2020-05-10,(09000) Cabecera Usme,322,214,232,768
12841,2020-06-15,(07102) NQS - CALLE 75,98,79,93,270
12842,2020-08-15,(07002) MADELENA,556,276,417,1249
12843,2020-08-20,(09110) Avenida Jimenez,784,643,762,2189
12844,2020-06-21,(02202) Calle 127,347,280,233,860
12845,2020-02-16,(06101) El Tiempo,336,230,460,1026
12846,2020-03-21,(02205) Calle 106,115,94,81,290
12847,2020-05-24,(05001) Patio Bonito,383,229,257,869
12848,2020-01-19,(02105) Calle 142,881,446,1109,2436
12849,2020-05-04,(04108) El Polo,302,194,131,627
12850,2020-06-18,(07009) SENA,655,402,423,1480
12851,2020-08-13,(12003) Ricaurte,383,262,171,816
12852,2020-09-30,(12003) Ricaurte,447,313,242,1002
12853,2020-01-30,(03013) RIO NEGRO,1268,780,874,2922
12854,2020-04-19,(03010) PUENTE LARGO,94,66,45,205
12855,2020-04-30,(10010) San Bernardo,452,254,290,996
12856,2020-09-24,(03003) 21 ANGELES,376,184,238,798
12857,2020-09-24,(06001) Modelia,419,269,288,976
12858,2020-09-23,(06103) CAN,426,275,237,938
12859,2020-06-28,(04100) Carrera 77,415,207,277,899
12860,2020-04-13,(04104) Avenida 68,346,194,181,721
12861,2020-09-27,(06107) Ciudad Universitaria,53,38,93,184
12862,2020-08-20,(07007) NQS - Calle 38A Sur,329,216,270,815
12863,2020-02-07,(06109) Centro Memoria,1115,694,692,2501
12864,2020-04-03,(10005) Bicentenario,55,28,45,128
12865,2020-09-19,(10005) Bicentenario,77,51,103,231
12866,2020-01-04,(40002) Manitas,570,311,450,1331
12867,2020-05-18,(09106) Nariño,317,187,210,714
12868,2020-06-10,(02102) Calle 161,231,146,150,527
12869,2020-10-10,(09123) Calle 76,689,548,724,1961
12870,2020-07-23,(06002) Normandía,236,154,142,532
12871,2020-09-07,(02200) Alcalá,1899,1311,1139,4349
12872,2020-06-12,(03011) SUBA - CALLE 100,512,230,241,983
12873,2020-08-19,(03011) SUBA - CALLE 100,496,209,232,937
12874,2020-08-06,(10009) Museo Nacional,453,270,269,992
12875,2020-09-09,(09117) Calle 45,679,415,506,1600
12876,2020-07-29,(05107) Américas - Cr.53,339,202,177,718
12877,2020-06-17,(05105) Pradera,635,391,287,1313
12878,2020-08-22,(06111) Universidades,246,143,277,666
12879,2020-07-08,(07111) NQS - RICAURTE,1208,748,501,2457
12880,2020-05-14,(02204) Pepe Sierra,597,430,275,1302
12881,2020-01-11,(07001) PERDOMO,2135,972,1564,4671
12882,2020-09-18,(07110) PALOQUEMAO,726,410,405,1541
12883,2020-02-16,(07105) MOVISTAR ARENA,237,131,328,696
12884,2020-02-13,(12004) Carrera 22,740,435,470,1645
12885,2020-06-24,(07200) Tygua-San José,261,131,176,568
12886,2020-08-25,(02202) Calle 127,973,711,585,2269
12887,2020-01-05,(12007) Zona Industrial,104,94,142,340
12888,2020-01-01,(07111) NQS - RICAURTE,103,116,237,456
12889,2020-09-16,(07009) SENA,651,398,543,1592
12890,2020-06-20,(04105) Carrera 53,223,104,133,460
12891,2020-10-06,(50003) Corral Molinos,1570,852,1490,3912
12892,2020-05-17,(50003) Corral Molinos,403,172,305,880
12893,2020-03-13,(02302) Virrey,1430,93,390,1913
12894,2020-06-10,(09121) Las Flores,705,455,375,1535
12895,2020-06-23,(07003) SEVILLANA,493,291,264,1048
12896,2020-07-09,(07003) SEVILLANA,466,243,276,985
12897,2020-07-16,(07003) SEVILLANA,368,209,225,802
12898,2020-08-21,(07003) SEVILLANA,415,218,259,892
12899,2020-01-03,(07506) DESPENSA,817,475,630,1922
12900,2020-08-04,(02200) Alcalá,1458,1019,867,3344
12901,2020-07-08,(07107) U. NACIONAL,349,200,177,726
12902,2020-02-08,(07506) DESPENSA,976,578,769,2323
12903,2020-07-16,(04102) Avenida Boyaca,314,183,159,656
12904,2020-02-23,(12001) Carrera 43,173,123,254,550
12905,2020-08-17,(10007) Las Nieves,67,72,93,232
12906,2020-09-28,(06102) Salitre El Greco,265,154,160,579
12907,2020-09-16,(03011) SUBA - CALLE 100,650,290,317,1257
12908,2020-04-16,(04104) Avenida 68,329,203,183,715
12909,2020-08-22,(07001) PERDOMO,665,332,483,1480
12910,2020-03-25,(07007) NQS - Calle 38A Sur,192,118,113,423
12911,2020-07-29,(09122) Calle 72,1103,712,732,2547
12912,2020-08-05,(08002) Biblioteca,307,166,161,634
12913,2020-01-21,(50002) Corral Calle 40 Sur,90,66,78,234
12914,2020-02-19,(12000) Puente Aranda,302,178,218,698
12915,2020-03-02,(12000) Puente Aranda,285,169,175,629
12916,2020-06-25,(03005) SUBA - AV. BOYACA,481,283,284,1048
12917,2020-07-03,(07002) MADELENA,883,525,572,1980
12918,2020-05-16,(02103) Mazurén,80,60,71,211
12919,2020-09-29,(03013) RIO NEGRO,306,188,249,743
12920,2020-04-13,(10009) Museo Nacional,306,222,181,709
12921,2020-07-06,(03010) PUENTE LARGO,391,253,186,830
12922,2020-05-04,(07006) General Santander - alimentacion,222,129,124,475
12923,2020-05-14,(04106) Carrera 47,248,128,135,511
12924,2020-03-22,(14001) La Sabana,32,21,26,79
12925,2020-03-26,(14001) La Sabana,64,50,49,163
12926,2020-04-28,(02001) Centro Comercial Santa Fe,240,170,146,556
12927,2020-04-27,(40001) Juan Pablo II,195,24,33,252
12928,2020-03-09,(02102) Calle 161,169,479,303,951
12929,2020-06-01,(04105) Carrera 53,277,156,146,579
12930,2020-04-21,(04101) Minuto de Dios,160,89,107,356
12931,2020-07-30,(04001) Quirigua,402,253,231,886
12932,2020-10-07,(04001) Quirigua,453,303,368,1124
12933,2020-02-28,(09108) Hospital,240,149,200,589
12934,2020-03-27,(09108) Hospital,26,18,25,69
12935,2020-09-01,(05103) Marsella,396,227,233,856
12936,2020-06-01,(09113) Calle 22,397,250,294,941
12937,2020-04-15,(05005) Transversal 86,179,96,76,351
12938,2020-02-16,(12003) Ricaurte,148,108,205,461
12939,2020-08-17,(03000) Portal Suba,316,190,272,778
12940,2020-07-30,(12007) Zona Industrial,239,159,140,538
12941,2020-01-13,(10004) Policarpa,644,368,540,1552
12942,2020-05-09,(07107) U. NACIONAL,169,117,104,390
12943,2020-03-22,(04002) Carrera 90,100,58,46,204
12944,2020-06-22,(09109) Tercer Milenio,115,67,120,302
12945,2020-08-11,(06000) Portal Eldorado,866,553,430,1849
12946,2020-07-19,(09111) Calle 19,139,95,137,371
12947,2020-05-04,(06111) Universidades,0,93,250,343
12948,2020-03-12,(07102) NQS - CALLE 75,622,100,257,979
12949,2020-04-24,(05100) Banderas P. Central,348,218,217,783
12950,2020-04-11,(05103) Marsella,94,42,49,185
12951,2020-05-09,(10008) San Diego,142,99,87,328
12952,2020-03-01,(03004) GRATAMIRA,66,44,42,152
12953,2020-06-08,(12004) Carrera 22,212,102,118,432
12954,2020-04-22,(07506) DESPENSA,239,146,145,530
12955,2020-02-16,(03014) SAN MARTIN,34,24,68,126
12956,2020-06-25,(06106) Recinto Ferial,249,158,127,534
12957,2020-08-22,(03005) SUBA - AV. BOYACA,315,206,232,753
12958,2020-07-18,(06106) Recinto Ferial,165,104,107,376
12959,2020-06-14,(07008) NQS - Calle 30 Sur,86,51,63,200
12960,2020-04-24,(04107) Escuela Militar,65,43,49,157
12961,2020-06-13,(07101) CASTELLANA,119,90,107,316
12962,2020-04-05,(07008) NQS - Calle 30 Sur,53,29,26,108
12963,2020-04-12,(07008) NQS - Calle 30 Sur,52,34,32,118
12964,2020-09-30,(50002) Corral Calle 40 Sur,36,24,36,96
12965,2020-07-15,(03014) SAN MARTIN,23,14,21,58
12966,2020-09-13,(03014) SAN MARTIN,0,3,19,22
12967,2019-12-31,(04001) Quirigua,32,11,25,68
12968,2020-03-24,(50006) Corral Carrera 77,8,2,11,21
12969,2020-06-14,(50006) Corral Carrera 77,4,1,8,13
12970,2020-01-23,(04000) Cabecera Calle 80 - alimentacion,21449,12350,13490,47289
12971,2020-08-05,(04000) Cabecera Calle 80 - alimentacion,3154,1822,2069,7045
12972,2020-08-14,(04000) Cabecera Calle 80 - alimentacion,3606,1943,2376,7925
12973,2020-04-04,(07504) TERREROS,1711,1031,893,3635
12974,2020-01-08,(05000) Portal Américas - alimentacion,27846,14804,16105,58755
12975,2020-10-05,(06000) Portal Eldorado - alimentacion,4303,2249,2936,9488
12976,2020-02-01,(05000) Portal Américas,9086,4117,6350,19553
12977,2020-05-16,(05005) Transversal 86,194,99,99,392
12978,2020-03-05,(05005) Transversal 86,2767,1543,1391,5701
12979,2020-03-19,(08000) Portal Tunal - alimentacion,13947,7031,6924,27902
12980,2020-02-05,(05100) Banderas P. Central,8487,4911,3909,17307
12981,2020-06-28,(07503) SAN MATEO,3046,1700,1677,6423
12982,2020-02-22,(06000) Portal Eldorado - alimentacion,10857,5108,6946,22911
12983,2020-03-08,(06000) Portal Eldorado - alimentacion,4065,1731,3247,9043
12984,2020-04-29,(06000) Portal Eldorado - alimentacion,2670,1283,1147,5100
12985,2020-03-10,(02000) Cabecera Autopista Norte,1300,2770,1860,5930
12986,2020-02-07,(07009) SENA,3863,2138,2184,8185
12987,2020-02-21,(02105) Calle 142,7052,3797,3663,14512
12988,2020-02-22,(04000) Cabecera Calle 80,3799,1868,3574,9241
12989,2020-01-27,(02204) Pepe Sierra,4901,3207,2343,10451
12990,2020-02-19,(02204) Pepe Sierra,5187,3313,2508,11008
12991,2020-01-14,(07001) PERDOMO,4048,2285,2408,8741
12992,2020-01-16,(07001) PERDOMO,4198,2155,2438,8791
12993,2020-08-12,(07001) PERDOMO,832,487,535,1854
12994,2020-01-10,(09000) Cabecera Usme - alimentacion,20625,10549,13443,44617
12995,2020-02-17,(09104) Restrepo,5401,3401,3963,12765
12996,2020-03-06,(09104) Restrepo,5222,3043,4102,12367
12997,2020-01-18,(02101) Toberín,5235,2371,4573,12179
12998,2020-01-14,(09110) Avenida Jimenez,3753,2734,2556,9043
12999,2020-02-01,(09123) Calle 76,2063,1676,2134,5873
13000,2020-01-21,(12003) Ricaurte,570,605,451,1626
13001,2020-05-23,(09101) Quiroga,324,168,219,711
13002,2020-09-15,(05000) Portal Américas,3430,2064,2387,7881
13003,2020-07-25,(09104) Restrepo,938,536,692,2166
13004,2020-03-21,(03013) RIO NEGRO,83,61,32,176
13005,2020-01-18,(09103) Olaya,2153,1103,1647,4903
13006,2020-08-30,(07000) Portal Sur - alimentacion,2752,1285,1730,5767
13007,2020-01-20,(09116) Avenida 39,2389,1511,1388,5288
13008,2020-02-14,(02103) Mazurén,3492,1988,1854,7334
13009,2020-01-11,(09104) Restrepo,2848,1628,2488,6964
13010,2020-01-07,(02103) Mazurén,1956,1276,1292,4524
13011,2020-02-26,(02303) Calle 85,3816,2611,1999,8426
13012,2020-04-17,(07111) NQS - RICAURTE,530,362,222,1114
13013,2020-02-16,(02000) Cabecera Autopista Norte - alimentacion,6635,2631,5269,14535
13014,2020-09-19,(08000) Portal Tunal - alimentacion,5722,2786,4013,12521
13015,2020-08-12,(02000) Cabecera Autopista Norte,1177,737,728,2642
13016,2020-03-01,(02104) Calle 146,1281,549,1442,3272
13017,2020-03-13,(05000) Portal Américas,268,2854,2489,5611
13018,2020-03-05,(05107) Américas - Cr.53,2491,1316,1444,5251
13019,2020-07-10,(07112) COMUNEROS,878,509,492,1879
13020,2020-09-16,(03000) Portal Suba,1528,1002,1156,3686
13021,2020-09-21,(06000) Portal Eldorado,690,545,517,1752
13022,2020-02-06,(02000) Cabecera Autopista Norte - intermunicipal,5089,3458,3029,11576
13023,2020-01-28,(12001) Carrera 43,1648,937,1080,3665
13024,2020-07-08,(12001) Carrera 43,468,245,261,974
13025,2020-02-12,(06111) Universidades,6240,3829,2588,12657
13026,2020-02-20,(02105) Calle 142,6952,4209,3429,14590
13027,2020-04-08,(02000) Cabecera Autopista Norte - intermunicipal,137,86,97,320
13028,2020-08-05,(02000) Cabecera Autopista Norte - intermunicipal,485,305,325,1115
13029,2020-05-27,(03000) Portal Suba - alimentacion,5182,3105,2813,11100
13030,2020-03-06,(03007) HUMEDAL CORDOBA,1003,563,595,2161
13031,2020-04-23,(07112) COMUNEROS,453,280,256,989
13032,2020-07-13,(07112) COMUNEROS,755,449,384,1588
13033,2020-04-17,(07000) Portal Sur - alimentacion,4098,2287,1721,8106
13034,2020-07-07,(02303) Calle 85,773,508,372,1653
13035,2020-08-20,(07000) Portal Sur,1852,1141,1124,4117
13036,2020-03-06,(02001) Centro Comercial Santa Fe,4690,2781,2724,10195
13037,2020-08-13,(09004) Santa Lucía,2445,1179,1362,4986
13038,2020-01-09,(09105) Río Fucha,516,302,450,1268
13039,2020-01-04,(04003) Avenida Ciudad de Cali,1683,833,1393,3909
13040,2020-02-27,(05102) Av. Américas - Av. Boyacá,1960,1167,943,4070
13041,2020-01-17,(06108) Concejo de Bogotá,740,386,454,1580
13042,2020-01-24,(05103) Marsella,2698,1389,1466,5553
13043,2020-03-09,(08001) Parque el Tunal,76,436,328,840
13044,2020-01-24,(02304) Heroes,3879,2917,2203,8999
13045,2020-09-04,(06102) Salitre El Greco,265,147,164,576
13046,2020-10-07,(05101) Mandalay - Cr.73,166,94,132,392
13047,2020-08-25,(05002) Tintal,2305,1376,1375,5056
13048,2020-01-21,(02103) Mazurén,2482,1328,1135,4945
13049,2020-05-02,(02300) Calle 100,557,399,344,1300
13050,2020-07-10,(02300) Calle 100,1340,853,703,2896
13051,2020-06-10,(10000) Portal 20 de Julio,2189,1135,1009,4333
13052,2020-07-19,(10000) Portal 20 de Julio,565,272,375,1212
13053,2020-02-08,(07006) General Santander,1633,809,1201,3643
13054,2020-06-25,(04104) Avenida 68,650,315,323,1288
13055,2020-01-05,(07104) Simon Bolivar,300,180,334,814
13056,2020-02-02,(07104) Simon Bolivar,412,256,514,1182
13057,2020-05-11,(05005) Transversal 86,259,132,148,539
13058,2020-05-25,(05005) Transversal 86,94,36,61,191
13059,2020-05-21,(10008) San Diego,210,121,146,477
13060,2020-01-22,(07106) EL CAMPIN,1953,1235,1141,4329
13061,2020-09-08,(07007) NQS - Calle 38A Sur,375,240,329,944
13062,2020-01-17,(09121) Las Flores,2774,1746,1864,6384
13063,2020-06-12,(08000) Portal Tunal,784,323,289,1396
13064,2020-04-02,(02205) Calle 106,178,144,122,444
13065,2020-07-22,(02205) Calle 106,337,213,174,724
13066,2020-02-11,(12000) Puente Aranda,303,174,234,711
13067,2020-01-21,(04000) Cabecera Calle 80,4900,2679,2969,10548
13068,2020-02-07,(07101) CASTELLANA,932,615,661,2208
13069,2020-02-23,(07113) SANTA ISABEL,453,236,523,1212
13070,2020-09-27,(06111) Universidades,145,70,214,429
13071,2020-06-16,(04104) Avenida 68,650,333,324,1307
13072,2020-03-06,(05101) Mandalay - Cr.73,1157,616,606,2379
13073,2020-03-22,(10000) Portal 20 de Julio,459,215,205,879
13074,2020-03-25,(06101) El Tiempo,271,197,136,604
13075,2020-04-12,(05100) Banderas P. Central - alimentacion,461,223,196,880
13076,2020-03-25,(02202) Calle 127,763,536,336,1635
13077,2020-04-02,(02304) Heroes,391,326,261,978
13078,2020-07-14,(09100) Calle 40 Sur,1152,677,730,2559
13079,2020-09-05,(09100) Calle 40 Sur,1545,829,1240,3614
13080,2020-04-26,(05000) Portal Américas,439,314,378,1131
13081,2020-09-24,(04003) Avenida Ciudad de Cali,1173,634,901,2708
13082,2020-01-15,(07004) VENECIA,4047,2304,2397,8748
13083,2020-07-31,(09000) Cabecera Usme,1557,913,1126,3596
13084,2020-09-18,(04003) Avenida Ciudad de Cali,1168,629,930,2727
13085,2020-04-28,(03013) RIO NEGRO,167,110,103,380
13086,2020-04-08,(03000) Portal Suba - alimentacion,3184,1744,1783,6711
13087,2020-08-07,(03000) Portal Suba,355,216,322,893
13088,2020-04-06,(02104) Calle 146,359,281,257,897
13089,2020-03-02,(02202) Calle 127,5809,3721,2906,12436
13090,2020-03-27,(10002) Av. Primero de Mayo,1074,599,612,2285
13091,2020-03-11,(04000) Cabecera Calle 80 - intermunicipal,2165,1505,1927,5597
13092,2020-06-22,(02205) Calle 106,87,82,68,237
13093,2020-03-15,(07003) SEVILLANA,294,141,269,704
13094,2020-04-23,(04108) El Polo,255,168,117,540
13095,2020-10-11,(02105) Calle 142,221,140,335,696
13096,2020-09-27,(02001) Centro Comercial Santa Fe,159,86,216,461
13097,2020-07-27,(06000) Portal Eldorado,815,526,484,1825
13098,2020-01-05,(09122) Calle 72,768,567,1034,2369
13099,2020-08-11,(12003) Ricaurte,367,245,182,794
13100,2020-05-07,(07106) EL CAMPIN,199,131,131,461
13101,2020-05-29,(09104) Restrepo,1270,768,956,2994
13102,2020-03-23,(07106) EL CAMPIN,62,48,41,151
13103,2020-06-07,(06001) Modelia,85,53,72,210
13104,2020-07-02,(06103) CAN,391,238,179,808
13105,2020-04-30,(02105) Calle 142,491,294,248,1033
13106,2020-07-15,(09109) Tercer Milenio,199,116,160,475
13107,2020-04-10,(07005) ALQUERIA,87,49,45,181
13108,2020-04-27,(09002) Consuelo,201,26,33,260
13109,2020-03-19,(10010) San Bernardo,939,541,793,2273
13110,2020-04-25,(10010) San Bernardo,330,165,218,713
13111,2020-03-10,(04000) Cabecera Calle 80 - intermunicipal,34,541,605,1180
13112,2020-01-12,(06107) Ciudad Universitaria,149,95,282,526
13113,2020-03-22,(05000) Portal Américas,495,333,368,1196
13114,2020-02-05,(07105) MOVISTAR ARENA,1387,846,726,2959
13115,2020-02-12,(07105) MOVISTAR ARENA,1389,873,784,3046
13116,2020-09-15,(10005) Bicentenario,98,66,91,255
13117,2020-03-09,(12002) CDS - Carrera 32,259,45,63,367
13118,2020-03-11,(09106) Nariño,1872,1183,1377,4432
13119,2020-01-03,(06108) Concejo de Bogotá,366,212,230,808
13120,2020-10-08,(02001) Centro Comercial Santa Fe,645,379,611,1635
13121,2020-06-11,(02104) Calle 146,715,473,468,1656
13122,2020-07-31,(10009) Museo Nacional,438,253,283,974
13123,2020-02-28,(40001) Juan Pablo II,1666,972,935,3573
13124,2020-09-24,(05102) Av. Américas - Av. Boyacá,275,171,234,680
13125,2020-05-24,(10010) San Bernardo,202,100,145,447
13126,2020-02-03,(10004) Policarpa,886,426,555,1867
13127,2020-02-20,(10004) Policarpa,876,457,505,1838
13128,2020-08-18,(09003) Socorro,534,279,317,1130
13129,2020-02-23,(08002) Biblioteca,231,115,231,577
13130,2020-07-11,(12007) Zona Industrial,281,185,143,609
13131,2020-06-27,(40001) Juan Pablo II,488,273,336,1097
13132,2020-07-29,(09115) Calle 34,625,393,344,1362
13133,2020-08-19,(09115) Calle 34,582,361,394,1337
13134,2020-08-13,(02204) Pepe Sierra,725,496,390,1611
13135,2020-09-21,(03013) RIO NEGRO,253,145,182,580
13136,2020-04-24,(02000) Cabecera Autopista Norte,593,422,360,1375
13137,2020-01-10,(12004) Carrera 22,509,342,381,1232
13138,2020-03-26,(09106) Nariño,163,101,127,391
13139,2020-04-14,(07004) VENECIA,493,306,239,1038
13140,2020-06-20,(07006) General Santander,416,253,242,911
13141,2020-08-20,(04105) Carrera 53,279,144,159,582
13142,2020-02-09,(07506) DESPENSA,310,180,332,822
13143,2020-09-06,(02101) Toberín,317,216,526,1059
13144,2020-05-16,(02303) Calle 85,339,250,200,789
13145,2020-08-26,(09110) Avenida Jimenez,915,716,767,2398
13146,2020-09-28,(05103) Marsella,512,288,372,1172
13147,2020-08-06,(06102) Salitre El Greco,224,118,117,459
13148,2020-09-30,(06102) Salitre El Greco,263,163,187,613
13149,2020-09-22,(40002) Manitas,456,279,315,1050
13150,2020-04-09,(12003) Ricaurte,46,34,26,106
13151,2020-08-19,(07007) NQS - Calle 38A Sur,317,223,251,791
13152,2020-06-10,(07109) CAD,663,408,293,1364
13153,2020-04-13,(03006) NIZA - CALLE 127,247,167,113,527
13154,2020-10-03,(07506) DESPENSA,357,231,354,942
13155,2020-06-29,(07111) NQS - RICAURTE,236,208,168,612
13156,2020-05-21,(07107) U. NACIONAL,277,167,130,574
13157,2020-03-15,(09002) Consuelo,346,138,266,750
13158,2020-09-04,(10004) Policarpa,289,137,218,644
13159,2020-07-08,(06002) Normandía,323,182,192,697
13160,2020-08-22,(07008) NQS - Calle 30 Sur,226,106,168,500
13161,2020-08-16,(07103) AV. CHILE,189,123,190,502
13162,2020-08-24,(09119) Calle 57,357,272,310,939
13163,2020-10-05,(12002) CDS - Carrera 32,235,155,99,489
13164,2020-03-25,(40001) Juan Pablo II,248,138,145,531
13165,2020-10-09,(04105) Carrera 53,340,174,270,784
13166,2020-04-27,(04101) Minuto de Dios,103,37,29,169
13167,2020-04-02,(04000) Cabecera Calle 80 - intermunicipal,87,57,96,240
13168,2020-05-10,(07106) EL CAMPIN,71,64,54,189
13169,2020-09-22,(07006) General Santander - alimentacion,404,231,332,967
13170,2020-01-26,(04103) Las Ferias,322,158,306,786
13171,2020-08-09,(02103) Mazurén,22,22,38,82
13172,2020-01-05,(03004) GRATAMIRA,35,14,38,87
13173,2020-01-04,(04107) Escuela Militar,136,103,164,403
13174,2020-06-15,(07101) CASTELLANA,30,28,23,81
13175,2020-06-16,(07506) DESPENSA,517,278,284,1079
13176,2020-08-04,(07506) DESPENSA,408,224,233,865
13177,2020-08-31,(07006) General Santander - alimentacion,381,211,255,847
13178,2020-04-17,(09110) Avenida Jimenez,310,256,340,906
13179,2020-05-20,(06105) Quinta Paredes,105,76,50,231
13180,2020-07-27,(06105) Quinta Paredes,138,82,66,286
13181,2020-04-01,(09110) Avenida Jimenez,253,224,286,763
13182,2020-03-17,(09105) Río Fucha,428,255,321,1004
13183,2020-06-11,(04106) Carrera 47,317,160,144,621
13184,2020-05-17,(04002) Carrera 90,151,79,110,340
13185,2020-03-08,(07001) PERDOMO,923,390,891,2204
13186,2020-08-21,(10004) Policarpa,213,101,149,463
13187,2020-08-22,(07006) General Santander - alimentacion,261,140,202,603
13188,2020-06-02,(06102) Salitre El Greco,198,111,113,422
13189,2020-03-30,(02303) Calle 85,345,281,218,844
13190,2020-06-14,(12001) Carrera 43,55,41,63,159
13191,2020-05-24,(04000) Cabecera Calle 80 - intermunicipal,33,23,37,93
13192,2020-04-19,(06000) Portal Eldorado,186,131,114,431
13193,2020-04-15,(07007) NQS - Calle 38A Sur,180,104,99,383
13194,2020-04-08,(09105) Río Fucha,69,38,68,175
13195,2020-05-08,(02201) Prado,564,350,317,1231
13196,2020-04-16,(10003) Ciudad Jardín,114,51,57,222
13197,2020-05-03,(05105) Pradera,99,79,67,245
13198,2020-03-25,(03007) HUMEDAL CORDOBA,69,60,44,173
13199,2020-04-22,(07201) Guatoque -Veraguas,88,74,67,229
13200,2020-03-24,(10003) Ciudad Jardín,154,97,119,370
13201,2020-07-20,(10002) Av. Primero de Mayo,521,239,357,1117
13202,2020-04-01,(05103) Marsella,172,94,105,371
13203,2020-04-25,(06103) CAN,216,143,90,449
13204,2020-06-17,(06107) Ciudad Universitaria,193,129,147,469
13205,2020-01-01,(07107) U. NACIONAL,92,87,190,369
13206,2020-06-07,(14004) Museo del Oro,0,18,51,69
13207,2020-04-27,(04107) Escuela Militar,14,31,18,63
13208,2019-12-31,(08001) Parque el Tunal,20,8,36,64
13209,2020-03-28,(07008) NQS - Calle 30 Sur,92,45,52,189
13210,2020-06-15,(05102) Av. Américas - Av. Boyacá,91,41,28,160
13211,2020-07-10,(50006) Corral Carrera 77,6,3,3,12
13212,2020-08-18,(03014) SAN MARTIN,0,16,27,43
13213,2020-05-31,(50006) Corral Carrera 77,1,0,0,1
13214,2020-08-01,(04000) Cabecera Calle 80 - alimentacion,2065,1167,1514,4746
13215,2020-01-16,(07005) ALQUERIA,2140,1122,1262,4524
13216,2020-06-17,(09002) Consuelo,496,267,298,1061
13217,2020-05-04,(07504) TERREROS,3306,1996,1663,6965
13218,2020-08-15,(07504) TERREROS,4808,2349,2620,9777
13219,2020-01-12,(04106) Carrera 47,327,172,325,824
13220,2020-07-27,(07505) LEON XIII,2504,1422,1076,5002
13221,2020-08-18,(06000) Portal Eldorado - alimentacion,3602,1796,1940,7338
13222,2020-01-15,(09100) Calle 40 Sur,6348,3422,3837,13607
13223,2020-01-07,(06104) Gobernación,868,507,483,1858
13224,2020-06-16,(06104) Gobernación,261,171,124,556
13225,2020-01-10,(09114) Calle 26,2017,1386,1367,4770
13226,2020-01-01,(04000) Cabecera Calle 80 - alimentacion,1417,744,2382,4543
13227,2020-02-15,(09001) Molinos,5873,2684,4547,13104
13228,2020-06-26,(06107) Ciudad Universitaria,193,128,119,440
13229,2020-02-24,(09001) Molinos,6852,4770,6208,17830
13230,2020-03-18,(05001) Patio Bonito,4665,2365,2184,9214
13231,2020-01-10,(14004) Museo del Oro,1809,1257,1228,4294
13232,2020-01-07,(05100) Banderas P. Central,4548,2689,2616,9853
13233,2020-10-09,(05100) Banderas P. Central,1158,611,954,2723
13234,2020-03-12,(06000) Portal Eldorado - alimentacion,1804,3410,2411,7625
13235,2020-03-19,(07000) Portal Sur - alimentacion,16640,8848,8142,33630
13236,2020-07-10,(02105) Calle 142,839,523,542,1904
13237,2020-03-19,(02205) Calle 106,927,723,598,2248
13238,2020-09-05,(10005) Bicentenario - alimentacion,189,76,232,497
13239,2020-09-09,(10005) Bicentenario - alimentacion,253,103,223,579
13240,2020-03-05,(07001) PERDOMO,4580,2634,2692,9906
13241,2020-08-11,(07001) PERDOMO,865,513,554,1932
13242,2020-01-06,(40003) Mirador del Paraiso,1578,738,1133,3449
13243,2020-08-20,(40003) Mirador del Paraiso,1574,972,982,3528
13244,2020-02-18,(09109) Tercer Milenio,1423,885,889,3197
13245,2020-01-21,(06104) Gobernación,855,582,443,1880
13246,2020-07-16,(09104) Restrepo,1143,677,804,2624
13247,2020-01-03,(07505) LEON XIII,4754,2457,2525,9736
13248,2020-06-06,(07505) LEON XIII,1921,1052,916,3889
13249,2020-07-25,(07505) LEON XIII,1803,920,774,3497
13250,2020-09-17,(03000) Portal Suba - alimentacion,7134,4000,4571,15705
13251,2020-03-19,(02204) Pepe Sierra,2037,1387,1027,4451
13252,2020-02-26,(10006) San Victorino,2375,1306,1251,4932
13253,2020-01-31,(06002) Normandía,2460,1386,1414,5260
13254,2020-04-06,(03000) Portal Suba - alimentacion,3324,1799,1758,6881
13255,2020-01-04,(09123) Calle 76,1139,904,1151,3194
13256,2020-01-25,(07110) PALOQUEMAO,1255,815,839,2909
13257,2020-08-09,(07102) NQS - CALLE 75,51,39,59,149
13258,2020-09-14,(07102) NQS - CALLE 75,482,321,268,1071
13259,2020-01-21,(03001) LA CAMPIÑA,1617,1716,2438,5771
13260,2020-02-28,(06001) Modelia,2553,1476,1380,5409
13261,2020-01-17,(07106) EL CAMPIN,1828,1139,1078,4045
13262,2020-03-04,(02103) Mazurén,3478,2144,1883,7505
13263,2020-01-09,(02001) Centro Comercial Santa Fe,3260,1902,2035,7197
13264,2020-08-11,(07000) Portal Sur - alimentacion,7573,4235,3859,15667
13265,2020-10-09,(07000) Portal Sur - alimentacion,9613,4911,6095,20619
13266,2020-07-13,(05100) Banderas P. Central - alimentacion,2632,1389,1343,5364
13267,2020-06-11,(07002) MADELENA,749,433,428,1610
13268,2020-08-22,(02104) Calle 146,508,325,352,1185
13269,2020-01-05,(04102) Avenida Boyaca,497,257,389,1143
13270,2020-01-09,(02201) Prado,3768,2370,2259,8397
13271,2020-10-08,(04105) Carrera 53,326,172,238,736
13272,2020-07-24,(09001) Molinos,1866,1022,1237,4125
13273,2020-04-02,(50003) Corral Molinos,816,330,548,1694
13274,2020-07-07,(50003) Corral Molinos,1650,899,1170,3719
13275,2020-02-09,(04000) Cabecera Calle 80,1304,644,1560,3508
13276,2020-09-30,(07010) Bosa,0,396,1010,1406
13277,2020-01-06,(07112) COMUNEROS,618,346,635,1599
13278,2020-06-13,(04100) Carrera 77,950,520,635,2105
13279,2020-01-25,(12001) Carrera 43,734,481,745,1960
13280,2020-08-22,(07000) Portal Sur - alimentacion,6084,3092,3382,12558
13281,2020-10-01,(03000) Portal Suba,1687,1053,1322,4062
13282,2020-02-27,(02000) Cabecera Autopista Norte - intermunicipal,5017,3395,3013,11425
13283,2020-01-27,(06100) Av. Rojas,2531,1453,1196,5180
13284,2020-01-30,(06100) Av. Rojas,2618,1466,1209,5293
13285,2020-02-02,(04106) Carrera 47,390,175,357,922
13286,2020-05-16,(07112) COMUNEROS,448,269,258,975
13287,2020-03-04,(04002) Carrera 90,3751,2251,2005,8007
13288,2020-02-10,(02300) Calle 100,7297,4676,3982,15955
13289,2020-08-08,(09003) Socorro,468,211,286,965
13290,2020-01-28,(07008) NQS - Calle 30 Sur,1886,1034,1071,3991
13291,2020-03-31,(06108) Concejo de Bogotá,73,72,68,213
13292,2020-09-17,(06108) Concejo de Bogotá,148,71,97,316
13293,2020-10-01,(14004) Museo del Oro,443,268,361,1072
13294,2020-04-26,(09000) Cabecera Usme - alimentacion,1899,946,948,3793
13295,2020-08-23,(05105) Pradera,124,91,109,324
13296,2020-06-27,(05103) Marsella,359,184,231,774
13297,2020-07-05,(02300) Calle 100,244,231,252,727
13298,2020-03-07,(03012) SUBA - CALLE 95,777,514,776,2067
13299,2020-01-28,(10010) San Bernardo,1789,994,1432,4215
13300,2020-02-16,(07104) Simon Bolivar,429,285,469,1183
13301,2020-07-20,(05005) Transversal 86,55,41,75,171
13302,2020-02-02,(02104) Calle 146,1263,550,1369,3182
13303,2020-01-31,(09121) Las Flores,2898,1919,2122,6939
13304,2020-07-14,(08000) Portal Tunal,539,196,182,917
13305,2020-06-06,(02205) Calle 106,181,126,142,449
13306,2020-07-01,(02205) Calle 106,368,233,248,849
13307,2020-07-06,(02205) Calle 106,403,243,227,873
13308,2020-01-23,(04003) Avenida Ciudad de Cali,5235,2901,3230,11366
13309,2020-03-10,(12007) Zona Industrial,617,63,152,832
13310,2020-02-22,(02304) Heroes,1809,1470,1527,4806
13311,2020-07-01,(07113) SANTA ISABEL,392,249,312,953
13312,2020-09-26,(07113) SANTA ISABEL,334,175,378,887
13313,2020-03-19,(06000) Portal Eldorado,3239,2050,1528,6817
13314,2020-09-10,(05103) Marsella,437,249,265,951
13315,2020-02-22,(04102) Avenida Boyaca,1556,805,1102,3463
13316,2020-07-28,(10006) San Victorino,693,332,318,1343
13317,2020-09-02,(04104) Avenida 68,687,352,377,1416
13318,2020-08-26,(08002) Biblioteca,306,173,177,656
13319,2020-08-20,(05101) Mandalay - Cr.73,115,63,70,248
13320,2020-03-15,(07110) PALOQUEMAO,317,246,345,908
13321,2020-01-30,(07104) Simon Bolivar,2350,1473,1185,5008
13322,2020-07-03,(07104) Simon Bolivar,629,385,281,1295
13323,2020-07-08,(10005) Bicentenario - alimentacion,234,107,211,552
13324,2020-01-10,(04003) Avenida Ciudad de Cali,4175,2188,2715,9078
13325,2019-12-31,(04000) Cabecera Calle 80 - alimentacion,261,139,271,671
13326,2020-09-27,(04003) Avenida Ciudad de Cali,361,195,443,999
13327,2020-05-29,(04108) El Polo,427,260,183,870
13328,2020-07-02,(05103) Marsella,436,248,220,904
13329,2020-07-16,(06000) Portal Eldorado,823,544,435,1802
13330,2020-03-16,(07004) VENECIA,3211,1825,1716,6752
13331,2020-01-05,(10000) Portal 20 de Julio - alimentacion,3118,1107,2566,6791
13332,2020-06-16,(04105) Carrera 53,295,157,159,611
13333,2020-06-20,(03002) SUBA - TV- 91,570,323,388,1281
13334,2020-02-23,(02202) Calle 127,1007,709,907,2623
13335,2020-09-26,(02202) Calle 127,884,629,709,2222
13336,2020-08-27,(07101) CASTELLANA,204,117,121,442
13337,2020-08-31,(07109) CAD,662,392,329,1383
13338,2020-06-13,(12003) Ricaurte,277,215,153,645
13339,2020-09-21,(12003) Ricaurte,190,270,183,643
13340,2020-02-25,(07106) EL CAMPIN,2107,1432,1197,4736
13341,2020-08-14,(10010) San Bernardo,578,317,419,1314
13342,2020-03-26,(03009) Av. Suba- Calle 116,365,252,188,805
13343,2020-01-03,(07003) SEVILLANA,962,535,662,2159
13344,2020-07-01,(06103) CAN,419,231,199,849
13345,2020-09-26,(03006) NIZA - CALLE 127,415,241,313,969
13346,2020-01-21,(06107) Ciudad Universitaria,833,507,517,1857
13347,2020-10-01,(12007) Zona Industrial,422,251,243,916
13348,2020-01-14,(40002) Manitas,1037,630,738,2405
13349,2020-05-30,(04100) Carrera 77,785,425,566,1776
13350,2020-09-29,(07006) General Santander,610,384,453,1447
13351,2020-05-18,(09110) Avenida Jimenez,881,600,604,2085
13352,2020-09-25,(06101) El Tiempo,386,251,252,889
13353,2020-07-16,(09113) Calle 22,274,170,249,693
13354,2020-10-06,(08002) Biblioteca,344,203,242,789
13355,2020-01-19,(02103) Mazurén,272,146,435,853
13356,2020-05-17,(09101) Quiroga,87,59,86,232
13357,2020-05-18,(09120) Calle 63,867,603,514,1984
13358,2020-05-19,(09120) Calle 63,872,619,491,1982
13359,2020-08-29,(03011) SUBA - CALLE 100,324,200,272,796
13360,2020-08-27,(09003) Socorro,573,331,311,1215
13361,2020-04-07,(05105) Pradera,362,258,149,769
13362,2020-06-01,(07111) NQS - RICAURTE,1052,689,419,2160
13363,2020-05-16,(07000) Portal Sur,1035,630,614,2279
13364,2020-06-19,(07110) PALOQUEMAO,690,406,306,1402
13365,2020-05-24,(09111) Calle 19,185,125,186,496
13366,2020-03-16,(14005) Las Aguas,1471,967,1016,3454
13367,2020-09-04,(09122) Calle 72,1281,888,927,3096
13368,2020-04-30,(09111) Calle 19,351,222,252,825
13369,2020-03-31,(10000) Portal 20 de Julio,1116,538,511,2165
13370,2020-09-07,(05103) Marsella,432,236,257,925
13371,2020-08-31,(02202) Calle 127,1058,788,607,2453
13372,2020-08-07,(07111) NQS - RICAURTE,348,246,199,793
13373,2020-08-15,(07111) NQS - RICAURTE,919,566,472,1957
13374,2020-04-19,(07105) MOVISTAR ARENA,44,35,28,107
13375,2020-07-31,(07003) SEVILLANA,376,189,209,774
13376,2020-10-10,(07002) MADELENA,796,327,707,1830
13377,2020-06-17,(07107) U. NACIONAL,344,197,184,725
13378,2020-07-03,(03003) 21 ANGELES,379,178,229,786
13379,2020-09-13,(07105) MOVISTAR ARENA,59,38,72,169
13380,2020-06-08,(10006) San Victorino,533,251,303,1087
13381,2020-05-31,(40001) Juan Pablo II,135,73,128,336
13382,2020-07-05,(10004) Policarpa,90,36,81,207
13383,2020-08-16,(06107) Ciudad Universitaria,36,27,39,102
13384,2020-07-22,(07110) PALOQUEMAO,525,358,236,1119
13385,2020-07-30,(04103) Las Ferias,355,190,181,726
13386,2020-04-22,(05102) Av. Américas - Av. Boyacá,128,79,78,285
13387,2020-07-15,(40001) Juan Pablo II,338,207,248,793
13388,2020-05-26,(09110) Avenida Jimenez,992,737,666,2395
13389,2020-06-18,(07007) NQS - Calle 38A Sur,416,242,269,927
13390,2020-05-13,(09122) Calle 72,892,617,510,2019
13391,2020-03-28,(07006) General Santander - alimentacion,123,89,97,309
13392,2020-02-03,(12000) Puente Aranda,296,180,198,674
13393,2020-07-09,(12000) Puente Aranda,98,47,42,187
13394,2020-04-01,(07103) AV. CHILE,389,289,244,922
13395,2020-07-26,(09000) Cabecera Usme,369,199,322,890
13396,2020-10-07,(07506) DESPENSA,485,290,367,1142
13397,2020-01-29,(04102) Avenida Boyaca,2951,1738,1605,6294
13398,2020-08-28,(09113) Calle 22,407,228,322,957
13399,2020-09-17,(10004) Policarpa,276,129,225,630
13400,2020-04-01,(06111) Universidades,0,68,224,292
13401,2020-05-10,(02302) Virrey,158,106,92,356
13402,2020-07-06,(02000) Cabecera Autopista Norte - intermunicipal,639,392,454,1485
13403,2020-05-03,(14001) La Sabana,43,34,31,108
13404,2020-02-22,(12002) CDS - Carrera 32,284,208,280,772
13405,2020-07-13,(06109) Centro Memoria,207,96,119,422
13406,2020-06-25,(07108) Av. El Dorado,158,99,106,363
13407,2020-04-17,(04000) Cabecera Calle 80 - intermunicipal,126,78,116,320
13408,2020-01-06,(14004) Museo del Oro,0,82,252,334
13409,2020-03-23,(07109) CAD,212,157,122,491
13410,2020-07-13,(14004) Museo del Oro,269,147,164,580
13411,2020-05-06,(09108) Hospital,59,31,43,133
13412,2020-06-04,(06101) El Tiempo,328,201,156,685
13413,2020-05-22,(04103) Las Ferias,299,163,155,617
13414,2020-05-28,(06100) Av. Rojas,194,109,110,413
13415,2020-08-02,(07506) DESPENSA,100,65,79,244
13416,2020-03-27,(07112) COMUNEROS,369,245,204,818
13417,2020-09-21,(07006) General Santander - alimentacion,355,176,280,811
13418,2020-06-27,(04106) Carrera 47,260,124,180,564
13419,2020-06-05,(07006) General Santander - alimentacion,363,218,214,795
13420,2020-08-26,(03007) HUMEDAL CORDOBA,137,102,72,311
13421,2020-08-27,(09101) Quiroga,474,254,377,1105
13422,2020-05-22,(09111) Calle 19,661,387,467,1515
13423,2020-05-22,(03004) GRATAMIRA,22,14,14,50
13424,2020-09-27,(04002) Carrera 90,267,110,264,641
13425,2020-05-21,(09106) Nariño,350,209,205,764
13426,2020-06-21,(09106) Nariño,128,84,113,325
13427,2020-07-26,(03004) GRATAMIRA,10,3,11,24
13428,2020-03-21,(07004) VENECIA,331,183,172,686
13429,2020-04-06,(07506) DESPENSA,205,103,146,454
13430,2020-04-03,(07007) NQS - Calle 38A Sur,151,104,97,352
13431,2020-08-14,(06103) CAN,350,216,183,749
13432,2020-01-01,(12001) Carrera 43,34,46,162,242
13433,2020-07-25,(04107) Escuela Militar,91,64,70,225
13434,2020-07-19,(03002) SUBA - TV- 91,189,89,126,404
13435,2020-01-04,(07108) Av. El Dorado,166,128,236,530
13436,2020-03-26,(06106) Recinto Ferial,129,89,70,288
13437,2020-04-16,(06104) Gobernación,147,110,54,311
13438,2020-08-03,(06102) Salitre El Greco,231,126,129,486
13439,2020-09-13,(09106) Nariño,159,73,183,415
13440,2020-05-17,(14005) Las Aguas,0,18,52,70
13441,2020-05-17,(06101) El Tiempo,79,63,68,210
13442,2020-08-09,(04102) Avenida Boyaca,79,48,81,208
13443,2020-05-21,(07101) CASTELLANA,139,98,74,311
13444,2020-05-17,(07201) Guatoque -Veraguas,14,21,34,69
13445,2020-05-24,(02102) Calle 161,52,38,43,133
13446,2020-04-09,(05101) Mandalay - Cr.73,23,9,3,35
13447,2020-09-11,(03014) SAN MARTIN,0,19,35,54
13448,2019-12-31,(07010) Bosa,14,21,54,89
13449,2020-05-05,(10005) Bicentenario,77,37,76,190
13450,2020-06-21,(10005) Bicentenario,29,16,35,80
13451,2020-09-15,(03014) SAN MARTIN,0,12,43,55
13452,2020-04-18,(50002) Corral Calle 40 Sur,6,4,8,18
13453,2020-08-04,(04000) Cabecera Calle 80 - alimentacion,3127,1771,2078,6976
13454,2020-02-05,(07005) ALQUERIA,2743,1546,1428,5717
13455,2020-02-24,(07005) ALQUERIA,2728,1505,1378,5611
13456,2020-03-19,(07005) ALQUERIA,1279,703,698,2680
13457,2020-02-08,(09002) Consuelo,1003,473,798,2274
13458,2020-09-28,(02502) Terminal,555,393,503,1451
13459,2020-02-07,(09118) Marly,7854,5118,4305,17277
13460,2020-03-04,(09118) Marly,8108,5232,4147,17487
13461,2020-10-02,(03013) RIO NEGRO,320,204,276,800
13462,2020-02-06,(07504) TERREROS,17218,10488,9246,36952
13463,2020-02-19,(02303) Calle 85,3922,2618,1986,8526
13464,2020-02-20,(02200) Alcalá,14484,8941,6109,29534
13465,2020-01-13,(08001) Parque el Tunal,1366,793,894,3053
13466,2020-01-02,(50003) Corral Molinos,1904,1090,1907,4901
13467,2020-03-14,(04101) Minuto de Dios,1335,743,1158,3236
13468,2020-02-22,(07503) SAN MATEO,27590,13492,14017,55099
13469,2020-09-29,(07503) SAN MATEO,13764,6919,7147,27830
13470,2020-02-27,(06107) Ciudad Universitaria,1534,916,885,3335
13471,2020-01-23,(07010) Bosa,2152,1260,1379,4791
13472,2020-01-28,(07010) Bosa,2177,1315,1366,4858
13473,2020-01-20,(07000) Portal Sur - alimentacion,26114,14846,13626,54586
13474,2020-02-06,(03009) Av. Suba- Calle 116,2532,1687,1473,5692
13475,2020-01-13,(09100) Calle 40 Sur,6085,3405,3709,13199
13476,2020-03-03,(02102) Calle 161,1916,1161,1164,4241
13477,2020-01-21,(09000) Cabecera Usme,4706,2354,2767,9827
13478,2020-02-28,(05100) Banderas P. Central - alimentacion,15996,8643,9281,33920
13479,2020-01-18,(07002) MADELENA,2359,1041,1707,5107
13480,2020-02-10,(07001) PERDOMO,4839,2914,2576,10329
13481,2020-02-27,(09120) Calle 63,7416,4783,3753,15952
13482,2020-08-29,(04101) Minuto de Dios,176,131,260,567
13483,2020-07-11,(07505) LEON XIII,2421,1184,1167,4772
13484,2020-02-04,(09110) Avenida Jimenez,5056,3372,3028,11456
13485,2020-02-18,(09110) Avenida Jimenez,5174,3529,2891,11594
13486,2020-06-03,(03002) SUBA - TV- 91,673,406,388,1467
13487,2020-08-25,(04100) Carrera 77,1151,666,728,2545
13488,2020-07-29,(07102) NQS - CALLE 75,385,254,191,830
13489,2020-04-15,(03013) RIO NEGRO,161,97,92,350
13490,2020-02-13,(06001) Modelia,2701,1584,1310,5595
13491,2020-01-24,(07106) EL CAMPIN,1935,1253,1139,4327
13492,2020-02-19,(02103) Mazurén,3594,2206,1909,7709
13493,2020-05-22,(09103) Olaya,830,487,433,1750
13494,2020-06-26,(14001) La Sabana,172,121,95,388
13495,2020-01-27,(07107) U. NACIONAL,2416,1484,1347,5247
13496,2020-01-24,(02001) Centro Comercial Santa Fe,4578,2592,2624,9794
13497,2020-02-04,(04105) Carrera 53,1511,846,730,3087
13498,2020-03-03,(04105) Carrera 53,1488,821,805,3114
13499,2020-06-26,(04105) Carrera 53,291,158,132,581
13500,2020-09-10,(09004) Santa Lucía,1227,1280,2632,5139
13501,2020-08-16,(08000) Portal Tunal - alimentacion,1944,876,1286,4106
13502,2020-10-07,(08000) Portal Tunal - alimentacion,6978,3769,5007,15754
13503,2020-09-26,(09110) Avenida Jimenez,1333,961,931,3225
13504,2020-01-02,(04106) Carrera 47,592,338,467,1397
13505,2020-03-14,(10001) Country Sur,2550,1102,2076,5728
13506,2020-09-20,(50003) Corral Molinos,581,255,553,1389
13507,2020-03-26,(10006) San Victorino,147,133,130,410
13508,2020-06-21,(06105) Quinta Paredes,34,19,38,91
13509,2020-03-30,(02000) Cabecera Autopista Norte - intermunicipal,137,92,101,330
13510,2020-05-01,(10000) Portal 20 de Julio - alimentacion,1451,668,947,3066
13511,2020-02-05,(09119) Calle 57,3851,2426,2177,8454
13512,2020-01-27,(06111) Universidades,5252,3224,2459,10935
13513,2020-01-15,(10002) Av. Primero de Mayo,7221,3548,4407,15176
13514,2020-08-31,(10000) Portal 20 de Julio,2207,1104,1211,4522
13515,2020-01-17,(03007) HUMEDAL CORDOBA,813,480,504,1797
13516,2020-06-23,(10000) Portal 20 de Julio,2399,1205,1153,4757
13517,2020-01-11,(02300) Calle 100,2193,1599,2191,5983
13518,2020-08-12,(07004) VENECIA,934,572,565,2071
13519,2020-03-06,(09105) Río Fucha,764,393,534,1691
13520,2020-08-19,(09116) Avenida 39,311,190,218,719
13521,2020-01-30,(05102) Av. Américas - Av. Boyacá,1814,1079,945,3838
13522,2020-09-10,(02101) Toberín,1465,836,1084,3385
13523,2020-04-02,(06108) Concejo de Bogotá,92,72,65,229
13524,2020-03-09,(09003) Socorro,129,426,294,849
13525,2020-09-10,(02201) Prado,897,563,625,2085
13526,2020-08-23,(02201) Prado,223,146,206,575
13527,2020-07-07,(09123) Calle 76,1156,796,654,2606
13528,2020-10-06,(09123) Calle 76,1214,839,832,2885
13529,2020-09-14,(05101) Mandalay - Cr.73,147,88,88,323
13530,2020-08-09,(05103) Marsella,98,56,87,241
13531,2020-02-29,(03007) HUMEDAL CORDOBA,480,261,333,1074
13532,2020-09-01,(02300) Calle 100,1222,831,752,2805
13533,2020-01-14,(03012) SUBA - CALLE 95,1270,790,869,2929
13534,2020-04-22,(09001) Molinos,1280,723,908,2911
13535,2020-05-22,(09119) Calle 57,458,309,313,1080
13536,2020-01-14,(06000) Portal Eldorado,5611,3294,2588,11493
13537,2020-03-13,(10008) San Diego,683,54,152,889
13538,2020-08-10,(10008) San Diego,307,159,160,626
13539,2020-03-06,(04105) Carrera 53,1443,795,836,3074
13540,2020-09-12,(03009) Av. Suba- Calle 116,352,251,256,859
13541,2020-02-11,(03006) NIZA - CALLE 127,2450,1638,1557,5645
13542,2020-01-17,(09115) Calle 34,3431,2367,2256,8054
13543,2020-07-04,(07201) Guatoque -Veraguas,147,110,126,383
13544,2020-04-18,(06000) Portal Eldorado - alimentacion,1638,798,713,3149
13545,2020-06-09,(07113) SANTA ISABEL,382,237,252,871
13546,2020-02-23,(06000) Portal Eldorado,753,601,974,2328
13547,2020-03-09,(06000) Portal Eldorado,2738,633,764,4135
13548,2020-03-16,(03007) HUMEDAL CORDOBA,550,348,286,1184
13549,2020-01-09,(06101) El Tiempo,1975,1073,1032,4080
13550,2020-01-22,(07102) NQS - CALLE 75,1430,943,917,3290
13551,2020-06-04,(04107) Escuela Militar,126,81,69,276
13552,2020-01-14,(06001) Modelia,1935,1200,1176,4311
13553,2020-10-07,(09109) Tercer Milenio,407,263,303,973
13554,2020-09-25,(04002) Carrera 90,901,434,567,1902
13555,2020-04-10,(07109) CAD,163,107,65,335
13556,2020-03-16,(06101) El Tiempo,1741,958,806,3505
13557,2020-01-29,(07002) MADELENA,4805,2755,2521,10081
13558,2020-10-07,(06002) Normandía,375,244,312,931
13559,2020-10-08,(06104) Gobernación,300,179,200,679
13560,2020-04-18,(05001) Patio Bonito,653,374,377,1404
13561,2020-02-23,(09116) Avenida 39,233,180,424,837
13562,2020-08-10,(09116) Avenida 39,334,185,242,761
13563,2020-06-28,(07113) SANTA ISABEL,133,69,105,307
13564,2020-04-01,(02302) Virrey,333,239,195,767
13565,2020-05-21,(06000) Portal Eldorado - alimentacion,3371,1704,1564,6639
13566,2020-09-09,(03013) RIO NEGRO,297,181,201,679
13567,2020-10-03,(09104) Restrepo,1354,797,1459,3610
13568,2020-07-31,(03010) PUENTE LARGO,228,176,170,574
13569,2020-05-01,(10010) San Bernardo,247,121,175,543
13570,2020-04-19,(02105) Calle 142,134,120,80,334
13571,2020-05-31,(09116) Avenida 39,90,62,73,225
13572,2020-01-04,(05102) Av. Américas - Av. Boyacá,374,171,314,859
13573,2020-08-11,(07103) AV. CHILE,706,442,424,1572
13574,2020-09-13,(03002) SUBA - TV- 91,275,128,262,665
13575,2020-08-30,(10010) San Bernardo,233,125,238,596
13576,2020-02-28,(04000) Cabecera Calle 80 - intermunicipal,2393,1548,2223,6164
13577,2020-08-02,(10005) Bicentenario,25,12,29,66
13578,2020-02-01,(40002) Manitas,959,481,697,2137
13579,2020-10-05,(02304) Heroes,1012,705,733,2450
13580,2020-06-01,(02304) Heroes,696,528,420,1644
13581,2020-05-03,(05100) Banderas P. Central - alimentacion,616,259,260,1135
13582,2020-04-02,(09114) Calle 26,155,137,115,407
13583,2020-01-23,(07006) General Santander,2675,1572,1434,5681
13584,2020-06-08,(02102) Calle 161,231,142,157,530
13585,2020-07-09,(02102) Calle 161,266,155,184,605
13586,2020-08-27,(09123) Calle 76,1028,686,569,2283
13587,2020-08-11,(02104) Calle 146,641,408,425,1474
13588,2020-09-23,(10008) San Diego,338,201,216,755
13589,2020-09-26,(10008) San Diego,238,161,227,626
13590,2020-02-26,(10005) Bicentenario,732,427,405,1564
13591,2020-09-27,(09120) Calle 63,392,294,484,1170
13592,2020-06-24,(05105) Pradera,605,384,281,1270
13593,2020-03-30,(03012) SUBA - CALLE 95,169,140,122,431
13594,2020-07-27,(07111) NQS - RICAURTE,975,604,424,2003
13595,2020-07-22,(02200) Alcalá,1655,1057,853,3565
13596,2020-07-16,(07006) General Santander,495,301,261,1057
13597,2020-08-04,(07006) General Santander,470,300,252,1022
13598,2020-04-28,(09111) Calle 19,350,209,245,804
13599,2020-06-08,(07201) Guatoque -Veraguas,185,99,122,406
13600,2020-02-20,(07104) Simon Bolivar,2383,1439,1139,4961
13601,2020-07-10,(07200) Tygua-San José,272,125,168,565
13602,2020-06-03,(07004) VENECIA,910,554,475,1939
13603,2020-01-05,(03001) LA CAMPIÑA,857,383,809,2049
13604,2020-04-07,(09123) Calle 76,456,374,295,1125
13605,2020-08-14,(06104) Gobernación,253,148,105,506
13606,2020-05-25,(07201) Guatoque -Veraguas,25,28,38,91
13607,2020-06-01,(07201) Guatoque -Veraguas,176,124,113,413
13608,2020-07-15,(07201) Guatoque -Veraguas,128,64,95,287
13609,2020-08-10,(07105) MOVISTAR ARENA,185,123,133,441
13610,2020-07-23,(07107) U. NACIONAL,310,173,168,651
13611,2020-01-03,(09107) Hortúa,1176,692,866,2734
13612,2020-04-17,(07113) SANTA ISABEL,203,148,141,492
13613,2020-07-09,(14004) Museo del Oro,342,197,241,780
13614,2020-03-13,(07004) VENECIA,428,776,624,1828
13615,2020-07-26,(40002) Manitas,112,51,76,239
13616,2020-03-21,(09119) Calle 57,174,122,103,399
13617,2020-07-17,(04103) Las Ferias,312,162,166,640
13618,2020-09-30,(04103) Las Ferias,395,207,267,869
13619,2020-07-31,(10007) Las Nieves,623,364,335,1322
13620,2020-05-16,(08002) Biblioteca,183,87,111,381
13621,2020-03-22,(12000) Puente Aranda,11,8,11,30
13622,2020-04-19,(12000) Puente Aranda,12,11,8,31
13623,2020-07-29,(07109) CAD,545,342,254,1141
13624,2020-09-26,(02102) Calle 161,220,115,177,512
13625,2020-06-12,(06106) Recinto Ferial,267,139,111,517
13626,2020-01-02,(10004) Policarpa,380,201,340,921
13627,2020-05-23,(02201) Prado,590,390,341,1321
13628,2020-04-12,(07009) SENA,104,58,57,219
13629,2020-05-17,(14001) La Sabana,41,26,25,92
13630,2020-04-16,(02103) Mazurén,97,67,72,236
13631,2020-04-21,(02001) Centro Comercial Santa Fe,221,158,158,537
13632,2020-08-31,(07108) Av. El Dorado,157,94,99,350
13633,2020-08-06,(06002) Normandía,257,166,167,590
13634,2020-07-16,(07506) DESPENSA,456,236,230,922
13635,2020-04-16,(04000) Cabecera Calle 80 - intermunicipal,138,75,104,317
13636,2020-05-29,(04000) Cabecera Calle 80 - intermunicipal,258,145,244,647
13637,2020-08-13,(14004) Museo del Oro,334,180,202,716
13638,2020-08-19,(09119) Calle 57,427,297,323,1047
13639,2020-03-12,(09108) Hospital,38,48,46,132
13640,2020-03-18,(09108) Hospital,140,95,111,346
13641,2020-04-20,(06101) El Tiempo,210,156,123,489
13642,2020-07-23,(07009) SENA,472,306,295,1073
13643,2020-04-16,(03012) SUBA - CALLE 95,190,127,106,423
13644,2020-09-21,(09003) Socorro,535,237,296,1068
13645,2020-01-14,(03004) GRATAMIRA,241,116,147,504
13646,2020-02-21,(03004) GRATAMIRA,290,153,148,591
13647,2020-05-18,(09003) Socorro,473,273,285,1031
13648,2020-10-01,(07009) SENA,735,395,652,1782
13649,2020-04-08,(10007) Las Nieves,170,155,159,484
13650,2020-06-16,(04106) Carrera 47,326,171,175,672
13651,2020-01-26,(09121) Las Flores,574,369,721,1664
13652,2020-05-04,(10005) Bicentenario,65,36,49,150
13653,2020-04-30,(04003) Avenida Ciudad de Cali,650,402,454,1506
13654,2020-03-26,(10004) Policarpa,120,75,71,266
13655,2020-07-24,(10004) Policarpa,194,95,127,416
13656,2020-09-25,(07101) CASTELLANA,277,145,179,601
13657,2020-08-16,(04001) Quirigua,104,54,87,245
13658,2020-08-28,(06101) El Tiempo,328,205,192,725
13659,2020-07-16,(03005) SUBA - AV. BOYACA,393,222,200,815
13660,2020-09-23,(06107) Ciudad Universitaria,222,132,156,510
13661,2020-08-29,(07109) CAD,412,281,285,978
13662,2020-05-30,(07008) NQS - Calle 30 Sur,189,95,116,400
13663,2020-04-02,(09106) Nariño,172,115,155,442
13664,2020-05-31,(09106) Nariño,132,84,90,306
13665,2020-04-25,(04002) Carrera 90,258,149,123,530
13666,2020-09-14,(03005) SUBA - AV. BOYACA,515,306,343,1164
13667,2020-07-12,(04106) Carrera 47,126,66,79,271
13668,2020-05-04,(06106) Recinto Ferial,169,95,81,345
13669,2020-08-17,(06103) CAN,139,94,81,314
13670,2020-08-21,(06103) CAN,323,192,193,708
13671,2020-09-17,(07101) CASTELLANA,252,134,167,553
13672,2020-03-26,(05103) Marsella,186,98,84,368
13673,2020-04-14,(06103) CAN,308,242,160,710
13674,2020-05-31,(40002) Manitas,107,54,82,243
13675,2020-04-18,(12003) Ricaurte,77,67,48,192
13676,2020-05-15,(10003) Ciudad Jardín,151,81,106,338
13677,2020-02-09,(12000) Puente Aranda,32,31,53,116
13678,2020-01-01,(06105) Quinta Paredes,44,29,73,146
13679,2020-05-28,(50002) Corral Calle 40 Sur,18,6,14,38
13680,2020-04-06,(10003) Ciudad Jardín,109,56,66,231
13681,2020-07-28,(07113) SANTA ISABEL,330,207,239,776
13682,2020-04-25,(06106) Recinto Ferial,125,77,55,257
13683,2020-07-03,(03014) SAN MARTIN,34,15,36,85
13684,2020-09-18,(09105) Río Fucha,0,81,162,243
13685,2020-06-06,(07108) Av. El Dorado,80,50,87,217
13686,2020-05-10,(05101) Mandalay - Cr.73,17,8,5,30
13687,2020-06-28,(07107) U. NACIONAL,90,71,71,232
13688,2020-06-27,(12000) Puente Aranda,52,39,54,145
13689,2020-04-10,(06104) Gobernación,46,40,35,121
13690,2020-03-29,(09106) Nariño,61,49,40,150
13691,2020-04-05,(07104) Simon Bolivar,60,39,51,150
13692,2020-08-06,(03004) GRATAMIRA,0,13,19,32
13693,2020-04-10,(10005) Bicentenario,21,8,12,41
13694,2019-12-31,(06107) Ciudad Universitaria,7,8,16,31
13695,2020-08-03,(50006) Corral Carrera 77,1,2,3,6
13696,2020-04-19,(50002) Corral Calle 40 Sur,4,0,1,5
13697,2020-04-15,(04000) Cabecera Calle 80 - alimentacion,1882,1097,1115,4094
13698,2020-04-17,(04000) Cabecera Calle 80 - alimentacion,1966,1122,1185,4273
13699,2020-03-16,(02502) Terminal,2970,1887,1665,6522
13700,2020-03-30,(09118) Marly,1059,725,481,2265
13701,2020-07-06,(07504) TERREROS,6435,3674,3047,13156
13702,2020-07-24,(05000) Portal Américas - alimentacion,8425,4492,3877,16794
13703,2020-03-17,(05000) Portal Américas - alimentacion,25491,13941,13528,52960
13704,2020-02-19,(02200) Alcalá,15216,9495,6757,31468
13705,2020-02-10,(06000) Portal Eldorado - alimentacion,17623,10717,10687,39027
13706,2020-06-20,(05000) Portal Américas,1930,1333,1687,4950
13707,2020-02-21,(03010) PUENTE LARGO,2045,1276,1176,4497
13708,2020-01-31,(08001) Parque el Tunal,1624,851,1005,3480
13709,2020-03-24,(50003) Corral Molinos,1194,509,918,2621
13710,2020-03-07,(05000) Portal Américas - alimentacion,24856,12362,15898,53116
13711,2020-07-10,(06107) Ciudad Universitaria,172,114,133,419
13712,2020-02-11,(07000) Portal Sur - alimentacion,30216,17700,14561,62477
13713,2020-09-01,(09000) Cabecera Usme,1790,1114,1286,4190
13714,2020-02-12,(02204) Pepe Sierra,4921,3427,2670,11018
13715,2020-02-07,(09000) Cabecera Usme - alimentacion,23787,14070,15891,53748
13716,2020-07-23,(07001) PERDOMO,690,393,435,1518
13717,2020-06-22,(40003) Mirador del Paraiso,688,412,501,1601
13718,2020-02-04,(04000) Cabecera Calle 80 - intermunicipal,2396,1666,2124,6186
13719,2020-02-02,(04101) Minuto de Dios,429,230,635,1294
13720,2020-06-15,(07504) TERREROS,1531,845,1047,3423
13721,2020-01-12,(02204) Pepe Sierra,562,436,660,1658
13722,2020-02-13,(06002) Normandía,2729,1559,1378,5666
13723,2020-04-30,(02000) Cabecera Autopista Norte - alimentacion,3119,1771,1529,6419
13724,2020-01-14,(12003) Ricaurte,1090,725,568,2383
13725,2020-02-01,(07000) Portal Sur - alimentacion,18916,9312,11766,39994
13726,2020-02-28,(07102) NQS - CALLE 75,1488,981,962,3431
13727,2020-03-05,(03013) RIO NEGRO,1185,825,853,2863
13728,2020-09-01,(06000) Portal Eldorado - alimentacion,3972,1963,2138,8073
13729,2020-02-21,(07106) EL CAMPIN,2160,1304,1187,4651
13730,2020-04-24,(09104) Restrepo,816,562,629,2007
13731,2020-05-12,(02103) Mazurén,131,93,123,347
13732,2020-01-30,(09119) Calle 57,3496,2154,2004,7654
13733,2020-07-30,(09103) Olaya,1043,561,564,2168
13734,2020-02-21,(14001) La Sabana,543,384,398,1325
13735,2020-05-07,(14001) La Sabana,119,96,81,296
13736,2020-07-06,(14001) La Sabana,166,85,117,368
13737,2020-08-14,(02000) Cabecera Autopista Norte,1216,772,742,2730
13738,2020-01-18,(02104) Calle 146,3005,1305,2612,6922
13739,2020-02-22,(09113) Calle 22,1217,692,955,2864
13740,2020-06-12,(02204) Pepe Sierra,792,524,408,1724
13741,2020-04-06,(08000) Portal Tunal - alimentacion,3381,1728,1944,7053
13742,2020-04-25,(05000) Portal Américas,976,653,761,2390
13743,2020-06-29,(05000) Portal Américas,836,536,707,2079
13744,2020-07-19,(05000) Portal Américas,605,345,490,1440
13745,2020-08-08,(05000) Portal Américas,1729,975,1497,4201
13746,2020-08-04,(02000) Cabecera Autopista Norte - alimentacion,4211,2332,2365,8908
13747,2020-03-02,(06106) Recinto Ferial,1525,943,816,3284
13748,2020-01-11,(10001) Country Sur,2370,978,1768,5116
13749,2020-06-06,(04002) Carrera 90,480,233,284,997
13750,2020-02-27,(40003) Mirador del Paraiso,4788,2650,2543,9981
13751,2020-04-26,(07000) Portal Sur - alimentacion,1628,909,671,3208
13752,2020-05-09,(07000) Portal Sur - alimentacion,4043,2180,1800,8023
13753,2020-01-23,(10002) Av. Primero de Mayo,7704,3865,4396,15965
13754,2020-01-25,(02201) Prado,2765,1478,1921,6164
13755,2020-01-17,(40001) Juan Pablo II,1450,817,917,3184
13756,2020-03-19,(08001) Parque el Tunal,1043,546,576,2165
13757,2020-09-29,(10000) Portal 20 de Julio,2537,1188,1598,5323
13758,2020-04-01,(07000) Portal Sur - alimentacion,3874,1949,1678,7501
13759,2020-06-26,(02303) Calle 85,798,529,385,1712
13760,2020-07-11,(09004) Santa Lucía,2307,1137,1360,4804
13761,2020-02-15,(07008) NQS - Calle 30 Sur,1249,546,855,2650
13762,2020-01-20,(05102) Av. Américas - Av. Boyacá,1552,928,870,3350
13763,2020-02-24,(02302) Virrey,3897,2605,1952,8454
13764,2020-05-09,(06108) Concejo de Bogotá,102,48,52,202
13765,2020-08-11,(06108) Concejo de Bogotá,139,62,71,272
13766,2020-02-13,(10001) Country Sur,5388,2396,2709,10493
13767,2020-04-30,(02000) Cabecera Autopista Norte,722,469,430,1621
13768,2020-01-31,(02304) Heroes,4215,3072,2353,9640
13769,2020-03-02,(05100) Banderas P. Central,8038,4775,3574,16387
13770,2020-06-14,(40003) Mirador del Paraiso,588,308,402,1298
13771,2020-04-22,(09107) Hortúa,451,278,208,937
13772,2020-05-04,(09123) Calle 76,587,452,378,1417
13773,2020-06-05,(09123) Calle 76,935,687,490,2112
13774,2020-05-19,(05002) Tintal,1839,981,914,3734
13775,2020-01-27,(05105) Pradera,2409,1439,1151,4999
13776,2020-01-27,(02103) Mazurén,3230,2184,1740,7154
13777,2020-04-23,(02300) Calle 100,771,552,357,1680
13778,2020-10-11,(02300) Calle 100,202,239,375,816
13779,2020-07-10,(03012) SUBA - CALLE 95,337,223,189,749
13780,2020-04-03,(09001) Molinos,1209,629,836,2674
13781,2020-02-21,(07006) General Santander,2881,1553,1495,5929
13782,2020-03-27,(05005) Transversal 86,186,84,91,361
13783,2020-08-21,(05005) Transversal 86,342,177,257,776
13784,2020-09-04,(02202) Calle 127,1208,860,713,2781
13785,2020-02-23,(07009) SENA,848,440,811,2099
13786,2020-02-14,(08000) Portal Tunal,2304,1220,1064,4588
13787,2020-05-06,(08000) Portal Tunal,510,238,174,922
13788,2020-02-12,(03009) Av. Suba- Calle 116,2675,1635,1445,5755
13789,2020-05-22,(03009) Av. Suba- Calle 116,433,287,201,921
13790,2020-06-19,(02205) Calle 106,386,247,222,855
13791,2020-03-05,(04108) El Polo,1917,1198,1170,4285
13792,2020-02-24,(07001) PERDOMO,4661,2835,2595,10091
13793,2020-08-05,(07106) EL CAMPIN,322,214,178,714
13794,2020-08-18,(07113) SANTA ISABEL,352,218,255,825
13795,2020-10-09,(07113) SANTA ISABEL,466,255,492,1213
13796,2020-03-07,(03001) LA CAMPIÑA,3517,1419,2560,7496
13797,2020-05-07,(08002) Biblioteca,201,113,103,417
13798,2020-01-09,(03005) SUBA - AV. BOYACA,1874,1104,1127,4105
13799,2020-04-11,(05000) Portal Américas - alimentacion,3677,1993,1473,7143
13800,2020-07-23,(07000) Portal Sur,1466,960,888,3314
13801,2020-07-26,(02101) Toberín,211,142,206,559
13802,2020-06-24,(05103) Marsella,451,236,257,944
13803,2020-06-25,(09100) Calle 40 Sur,1905,1110,1117,4132
13804,2020-07-06,(07104) Simon Bolivar,608,363,317,1288
13805,2020-05-19,(05103) Marsella,299,169,159,627
13806,2020-06-11,(05103) Marsella,341,186,197,724
13807,2020-05-04,(03007) HUMEDAL CORDOBA,95,71,40,206
13808,2020-08-07,(09101) Quiroga,260,110,190,560
13809,2020-04-28,(02202) Calle 127,688,502,311,1501
13810,2020-03-23,(02205) Calle 106,71,77,65,213
13811,2020-08-04,(05001) Patio Bonito,1593,869,927,3389
13812,2020-02-14,(07004) VENECIA,4850,2734,2491,10075
13813,2020-06-19,(02105) Calle 142,826,482,517,1825
13814,2020-09-12,(02001) Centro Comercial Santa Fe,388,212,367,967
13815,2020-08-22,(09104) Restrepo,1205,663,900,2768
13816,2020-09-11,(03010) PUENTE LARGO,355,205,229,789
13817,2020-04-05,(02302) Virrey,159,101,96,356
13818,2020-04-23,(02105) Calle 142,417,288,221,926
13819,2020-06-11,(02105) Calle 142,736,460,427,1623
13820,2020-03-20,(08000) Portal Tunal - alimentacion,3084,1580,1231,5895
13821,2020-06-21,(09002) Consuelo,148,64,110,322
13822,2020-06-15,(07103) AV. CHILE,231,151,182,564
13823,2020-04-10,(40002) Manitas,54,17,40,111
13824,2020-09-07,(09106) Nariño,430,249,331,1010
13825,2020-05-30,(07112) COMUNEROS,553,324,310,1187
13826,2020-04-02,(09001) Molinos,1227,627,890,2744
13827,2020-03-21,(05100) Banderas P. Central - alimentacion,956,448,406,1810
13828,2020-05-03,(09004) Santa Lucía,491,249,286,1026
13829,2020-01-26,(02103) Mazurén,293,143,451,887
13830,2020-09-21,(08000) Portal Tunal,699,269,302,1270
13831,2020-06-29,(03000) Portal Suba - alimentacion,2169,1169,1411,4749
13832,2020-08-18,(10009) Museo Nacional,447,247,283,977
13833,2020-09-11,(10009) Museo Nacional,548,325,385,1258
13834,2020-07-08,(09003) Socorro,637,347,333,1317
13835,2020-02-01,(06105) Quinta Paredes,423,218,367,1008
13836,2020-09-05,(03013) RIO NEGRO,227,126,203,556
13837,2020-04-14,(09004) Santa Lucía,1156,622,683,2461
13838,2020-05-07,(02101) Toberín,919,582,601,2102
13839,2020-06-04,(07200) Tygua-San José,217,111,136,464
13840,2020-10-02,(07200) Tygua-San José,286,156,218,660
13841,2020-01-08,(09106) Nariño,1330,790,1090,3210
13842,2020-08-26,(02200) Alcalá,1684,1137,885,3706
13843,2020-07-17,(06104) Gobernación,212,124,85,421
13844,2020-01-01,(02202) Calle 127,461,296,473,1230
13845,2020-03-31,(04100) Carrera 77,545,320,320,1185
13846,2020-07-02,(05102) Av. Américas - Av. Boyacá,222,135,161,518
13847,2020-05-13,(03000) Portal Suba,895,541,574,2010
13848,2020-01-14,(07105) MOVISTAR ARENA,1212,726,640,2578
13849,2020-04-07,(09121) Las Flores,380,271,242,893
13850,2020-08-19,(07003) SEVILLANA,399,209,234,842
13851,2020-06-19,(07506) DESPENSA,556,281,302,1139
13852,2020-03-05,(09105) Río Fucha,808,437,487,1732
13853,2020-04-30,(12007) Zona Industrial,238,157,104,499
13854,2020-05-02,(07000) Portal Sur,754,433,431,1618
13855,2020-04-15,(02303) Calle 85,316,244,179,739
13856,2020-04-27,(02303) Calle 85,62,195,92,349
13857,2020-07-17,(06109) Centro Memoria,213,120,116,449
13858,2020-08-13,(03003) 21 ANGELES,290,147,169,606
13859,2020-04-30,(09119) Calle 57,323,201,210,734
13860,2020-09-06,(06107) Ciudad Universitaria,43,34,77,154
13861,2020-06-27,(04104) Avenida 68,528,273,332,1133
13862,2020-10-03,(40002) Manitas,371,209,366,946
13863,2020-05-14,(10007) Las Nieves,400,262,268,930
13864,2020-01-01,(12003) Ricaurte,29,27,111,167
13865,2020-03-05,(12000) Puente Aranda,271,172,207,650
13866,2020-06-19,(07109) CAD,678,444,356,1478
13867,2020-03-20,(07002) MADELENA,400,246,184,830
13868,2020-10-03,(10003) Ciudad Jardín,213,95,212,520
13869,2020-07-08,(09111) Calle 19,789,509,491,1789
13870,2020-06-06,(06001) Modelia,255,170,135,560
13871,2019-12-31,(08000) Portal Tunal - alimentacion,244,186,323,753
13872,2020-08-13,(10004) Policarpa,259,118,155,532
13873,2020-09-18,(07008) NQS - Calle 30 Sur,416,221,297,934
13874,2020-08-12,(07200) Tygua-San José,217,125,147,489
13875,2020-06-14,(50003) Corral Molinos,473,192,352,1017
13876,2020-06-14,(09117) Calle 45,246,129,162,537
13877,2020-05-24,(04108) El Polo,75,47,64,186
13878,2020-08-09,(04108) El Polo,72,47,65,184
13879,2020-04-15,(02001) Centro Comercial Santa Fe,189,113,140,442
13880,2020-08-30,(07000) Portal Sur,515,260,537,1312
13881,2020-08-04,(06002) Normandía,246,157,180,583
13882,2020-04-12,(04000) Cabecera Calle 80 - intermunicipal,17,13,17,47
13883,2020-08-19,(14004) Museo del Oro,204,128,171,503
13884,2020-09-10,(07009) SENA,562,280,419,1261
13885,2020-02-09,(07008) NQS - Calle 30 Sur,446,194,431,1071
13886,2020-03-30,(04103) Las Ferias,169,115,99,383
13887,2020-10-06,(07105) MOVISTAR ARENA,295,179,214,688
13888,2020-07-24,(07200) Tygua-San José,146,96,110,352
13889,2020-07-20,(07108) Av. El Dorado,42,29,34,105
13890,2020-04-15,(09111) Calle 19,307,204,251,762
13891,2020-01-01,(04000) Cabecera Calle 80 - intermunicipal,79,57,182,318
13892,2020-07-20,(03011) SUBA - CALLE 100,162,84,89,335
13893,2020-07-23,(40002) Manitas,288,173,192,653
13894,2020-08-25,(07006) General Santander - alimentacion,356,193,228,777
13895,2020-05-06,(09113) Calle 22,270,178,213,661
13896,2020-08-26,(09121) Las Flores,671,388,430,1489
13897,2020-06-09,(05102) Av. Américas - Av. Boyacá,196,108,115,419
13898,2020-05-17,(07006) General Santander - alimentacion,52,51,74,177
13899,2020-05-26,(07006) General Santander - alimentacion,336,196,163,695
13900,2020-01-26,(04102) Avenida Boyaca,572,311,517,1400
13901,2020-05-17,(02303) Calle 85,147,96,96,339
13902,2020-10-12,(09109) Tercer Milenio,123,78,150,351
13903,2020-05-19,(07008) NQS - Calle 30 Sur,212,111,87,410
13904,2020-07-18,(03004) GRATAMIRA,25,4,11,40
13905,2020-05-01,(09000) Cabecera Usme,460,283,320,1063
13906,2020-05-17,(03002) SUBA - TV- 91,178,97,111,386
13907,2020-06-05,(40002) Manitas,375,230,222,827
13908,2020-07-23,(05102) Av. Américas - Av. Boyacá,156,87,85,328
13909,2020-05-01,(06101) El Tiempo,111,76,59,246
13910,2020-08-30,(05107) Américas - Cr.53,81,74,113,268
13911,2020-08-11,(03004) GRATAMIRA,0,15,26,41
13912,2020-08-01,(04103) Las Ferias,209,121,141,471
13913,2020-04-09,(06103) CAN,158,129,62,349
13914,2020-04-23,(06103) CAN,288,193,114,595
13915,2020-04-29,(06102) Salitre El Greco,164,87,58,309
13916,2020-07-15,(07006) General Santander - alimentacion,290,157,167,614
13917,2020-04-14,(07008) NQS - Calle 30 Sur,163,79,78,320
13918,2020-07-01,(08002) Biblioteca,335,183,223,741
13919,2020-03-23,(06111) Universidades,0,29,99,128
13920,2020-08-12,(10003) Ciudad Jardín,216,98,151,465
13921,2020-04-24,(06104) Gobernación,151,105,69,325
13922,2020-10-07,(07101) CASTELLANA,289,146,209,644
13923,2020-09-12,(07200) Tygua-San José,195,111,123,429
13924,2020-09-18,(14005) Las Aguas,269,156,290,715
13925,2020-03-20,(09111) Calle 19,153,103,137,393
13926,2020-10-12,(04105) Carrera 53,86,62,124,272
13927,2020-08-18,(06103) CAN,335,197,165,697
13928,2020-05-18,(06106) Recinto Ferial,205,135,107,447
13929,2020-08-09,(40002) Manitas,128,64,94,286
13930,2020-04-23,(06105) Quinta Paredes,58,51,24,133
13931,2020-05-06,(06105) Quinta Paredes,76,63,48,187
13932,2020-09-23,(50002) Corral Calle 40 Sur,29,12,34,75
13933,2020-04-13,(05102) Av. Américas - Av. Boyacá,127,79,67,273
13934,2020-06-18,(03014) SAN MARTIN,35,14,33,82
13935,2019-12-31,(09115) Calle 34,25,22,32,79
13936,2020-03-28,(04103) Las Ferias,133,102,76,311
13937,2020-06-24,(03014) SAN MARTIN,31,6,29,66
13938,2020-03-28,(50006) Corral Carrera 77,6,2,4,12
13939,2020-04-24,(03004) GRATAMIRA,17,13,12,42
13940,2020-02-25,(07005) ALQUERIA,2695,1522,1476,5693
13941,2020-02-03,(09002) Consuelo,1529,811,898,3238
13942,2020-06-23,(09002) Consuelo,513,255,272,1040
13943,2020-03-06,(02502) Terminal,5003,3005,3199,11207
13944,2020-10-08,(02502) Terminal,526,376,568,1470
13945,2020-08-21,(09118) Marly,1286,833,697,2816
13946,2020-08-23,(09118) Marly,443,271,330,1044
13947,2020-03-10,(07504) TERREROS,424,5478,3475,9377
13948,2020-08-24,(07504) TERREROS,5573,2924,2449,10946
13949,2020-08-29,(07504) TERREROS,4895,2398,2893,10186
13950,2020-05-15,(09119) Calle 57,427,290,267,984
13951,2020-02-08,(02303) Calle 85,1542,1130,1318,3990
13952,2020-03-05,(09122) Calle 72,8200,5273,4456,17929
13953,2020-07-09,(07503) SAN MATEO,11874,6927,5713,24514
13954,2020-01-13,(06000) Portal Eldorado - alimentacion,14401,7485,8245,30131
13955,2020-02-06,(05000) Portal Américas,14346,8458,7931,30735
13956,2020-05-20,(05000) Portal Américas - alimentacion,9066,4645,4244,17955
13957,2020-08-01,(05000) Portal Américas - alimentacion,7204,3478,3868,14550
13958,2020-01-22,(07010) Bosa,2078,1301,1446,4825
13959,2020-01-27,(04103) Las Ferias,1488,825,819,3132
13960,2020-08-31,(07000) Portal Sur - alimentacion,8017,4533,4332,16882
13961,2020-01-17,(03009) Av. Suba- Calle 116,2182,1424,1419,5025
13962,2020-01-27,(05100) Banderas P. Central,7456,4507,3661,15624
13963,2020-02-21,(02000) Cabecera Autopista Norte,11351,6329,6073,23753
13964,2020-03-26,(06000) Portal Eldorado - alimentacion,2308,1046,892,4246
13965,2020-05-27,(07005) ALQUERIA,468,296,243,1007
13966,2020-02-29,(02000) Cabecera Autopista Norte,5020,2529,4130,11679
13967,2020-02-04,(09104) Restrepo,5469,3327,4101,12897
13968,2020-08-25,(09104) Restrepo,1566,838,1077,3481
13969,2020-04-23,(07505) LEON XIII,1256,806,563,2625
13970,2020-07-04,(07505) LEON XIII,2425,1196,1162,4783
13971,2020-08-11,(07505) LEON XIII,2598,1381,1159,5138
13972,2020-02-05,(05002) Tintal,11396,6745,6201,24342
13973,2020-02-22,(09123) Calle 76,2301,1808,2204,6313
13974,2020-02-17,(07102) NQS - CALLE 75,1567,972,981,3520
13975,2020-10-12,(03001) LA CAMPIÑA,367,187,381,935
13976,2020-09-30,(05100) Banderas P. Central - alimentacion,3687,1959,2365,8011
13977,2020-09-14,(07002) MADELENA,857,550,576,1983
13978,2020-09-19,(07106) EL CAMPIN,363,229,312,904
13979,2020-04-04,(09113) Calle 22,167,93,147,407
13980,2020-02-07,(02000) Cabecera Autopista Norte - intermunicipal,5161,3304,3228,11693
13981,2020-05-21,(50003) Corral Molinos,1274,631,817,2722
13982,2020-05-04,(04000) Cabecera Calle 80,696,455,437,1588
13983,2020-02-19,(02000) Cabecera Autopista Norte - alimentacion,24650,14444,13481,52575
13984,2020-10-01,(09110) Avenida Jimenez,1538,1090,1079,3707
13985,2020-09-04,(10006) San Victorino,751,364,422,1537
13986,2020-03-03,(03000) Portal Suba,9792,5633,5260,20685
13987,2020-09-29,(40003) Mirador del Paraiso,1835,1046,1292,4173
13988,2020-01-20,(04001) Quirigua,1770,1070,1115,3955
13989,2020-02-13,(07113) SANTA ISABEL,2114,1284,1419,4817
13990,2020-01-20,(06101) El Tiempo,2658,1482,1313,5453
13991,2020-08-19,(03000) Portal Suba,1172,689,832,2693
13992,2020-07-31,(02000) Cabecera Autopista Norte - intermunicipal,526,330,356,1212
13993,2020-07-13,(09101) Quiroga,312,193,236,741
13994,2020-02-22,(08001) Parque el Tunal,1090,559,766,2415
13995,2020-08-31,(02000) Cabecera Autopista Norte - alimentacion,4593,2457,2766,9816
13996,2020-06-13,(09108) Hospital,66,42,62,170
13997,2020-07-28,(10000) Portal 20 de Julio,2168,1088,1035,4291
13998,2020-07-27,(07112) COMUNEROS,685,380,356,1421
13999,2020-07-20,(07000) Portal Sur - alimentacion,2537,1257,1194,4988
14000,2020-03-01,(07000) Portal Sur,1416,639,1449,3504
14001,2020-03-06,(06108) Concejo de Bogotá,800,441,526,1767
14002,2020-08-11,(09000) Cabecera Usme - alimentacion,8219,4351,4792,17362
14003,2020-01-18,(03003) 21 ANGELES,833,313,576,1722
14004,2020-08-31,(02201) Prado,893,610,557,2060
14005,2020-01-22,(07001) PERDOMO,4363,2585,2569,9517
14006,2020-01-31,(05103) Marsella,2916,1561,1522,5999
14007,2020-07-04,(02101) Toberín,1037,620,857,2514
14008,2020-06-17,(03001) LA CAMPIÑA,1074,639,594,2307
14009,2020-06-17,(05100) Banderas P. Central,703,442,462,1607
14010,2020-08-04,(09004) Santa Lucía,2368,1158,1312,4838
14011,2020-01-13,(10009) Museo Nacional,3408,1745,1656,6809
14012,2020-07-27,(09107) Hortúa,533,337,319,1189
14013,2020-06-06,(09123) Calle 76,586,452,424,1462
14014,2020-02-15,(05105) Pradera,1574,1036,978,3588
14015,2020-01-23,(03011) SUBA - CALLE 100,2419,1240,1399,5058
14016,2020-08-10,(03012) SUBA - CALLE 95,252,156,179,587
14017,2020-08-26,(50002) Corral Calle 40 Sur,22,10,27,59
14018,2020-09-29,(04106) Carrera 47,367,181,262,810
14019,2020-05-24,(05005) Transversal 86,81,33,48,162
14020,2020-06-10,(05005) Transversal 86,313,163,169,645
14021,2020-06-27,(09001) Molinos,2120,1066,1582,4768
14022,2020-01-09,(02202) Calle 127,3960,2683,2206,8849
14023,2020-09-18,(02202) Calle 127,1225,845,760,2830
14024,2020-09-29,(02202) Calle 127,1183,879,830,2892
14025,2020-09-05,(05105) Pradera,487,329,344,1160
14026,2020-09-21,(05105) Pradera,255,325,270,850
14027,2020-08-21,(06109) Centro Memoria,252,144,136,532
14028,2020-04-02,(07007) NQS - Calle 38A Sur,151,110,78,339
14029,2020-07-18,(08000) Portal Tunal,468,191,186,845
14030,2020-07-27,(03009) Av. Suba- Calle 116,485,318,236,1039
14031,2020-03-06,(04108) El Polo,1911,1176,1305,4392
14032,2020-01-04,(07009) SENA,1285,621,887,2793
14033,2020-05-29,(07010) Bosa,620,337,366,1323
14034,2020-03-10,(03010) PUENTE LARGO,686,262,358,1306
14035,2020-03-11,(14005) Las Aguas,3171,2042,1824,7037
14036,2020-03-23,(02304) Heroes,253,180,112,545
14037,2020-06-11,(09100) Calle 40 Sur,1650,1068,1041,3759
14038,2020-02-01,(07109) CAD,1387,892,1184,3463
14039,2020-01-10,(40003) Mirador del Paraiso,3952,2139,2223,8314
14040,2020-02-26,(06105) Quinta Paredes,1010,636,488,2134
14041,2020-03-16,(06105) Quinta Paredes,643,351,290,1284
14042,2020-09-28,(09117) Calle 45,744,474,599,1817
14043,2020-04-11,(40003) Mirador del Paraiso,495,287,315,1097
14044,2020-10-09,(03002) SUBA - TV- 91,995,508,741,2244
14045,2020-08-23,(06101) El Tiempo,96,68,83,247
14046,2020-03-01,(04001) Quirigua,403,192,460,1055
14047,2020-03-31,(03011) SUBA - CALLE 100,280,159,162,601
14048,2020-07-16,(04001) Quirigua,330,202,217,749
14049,2020-08-03,(04001) Quirigua,278,186,187,651
14050,2020-02-27,(06104) Gobernación,1418,809,644,2871
14051,2020-03-22,(09001) Molinos,393,247,297,937
14052,2020-02-20,(07101) CASTELLANA,932,568,542,2042
14053,2020-06-07,(06100) Av. Rojas,32,20,34,86
14054,2020-06-18,(05100) Banderas P. Central - alimentacion,2829,1624,1713,6166
14055,2020-06-02,(06000) Portal Eldorado,985,643,423,2051
14056,2020-07-09,(02302) Virrey,708,492,374,1574
14057,2020-07-31,(02302) Virrey,578,404,321,1303
14058,2020-02-08,(09104) Restrepo,3412,2087,3300,8799
14059,2020-06-26,(10010) San Bernardo,655,365,458,1478
14060,2020-06-08,(05100) Banderas P. Central,515,323,385,1223
14061,2020-01-28,(07001) PERDOMO,4609,2746,2518,9873
14062,2020-06-23,(06103) CAN,421,253,207,881
14063,2020-04-13,(09109) Tercer Milenio,148,115,111,374
14064,2020-05-03,(09109) Tercer Milenio,78,52,71,201
14065,2020-04-28,(06107) Ciudad Universitaria,113,72,85,270
14066,2020-08-06,(03006) NIZA - CALLE 127,358,212,232,802
14067,2020-06-17,(09104) Restrepo,1462,939,1106,3507
14068,2020-03-17,(04000) Cabecera Calle 80 - intermunicipal,810,627,1121,2558
14069,2020-07-14,(02103) Mazurén,180,104,147,431
14070,2020-07-17,(02103) Mazurén,179,109,125,413
14071,2020-04-17,(06102) Salitre El Greco,144,82,85,311
14072,2020-08-09,(10005) Bicentenario,25,12,23,60
14073,2020-09-03,(40002) Manitas,459,268,290,1017
14074,2020-02-08,(06101) El Tiempo,957,699,1040,2696
14075,2020-08-31,(04105) Carrera 53,311,154,168,633
14076,2020-01-23,(02102) Calle 161,1738,1010,1048,3796
14077,2020-07-28,(09118) Marly,1357,894,681,2932
14078,2020-02-05,(08002) Biblioteca,1047,614,687,2348
14079,2020-02-23,(09101) Quiroga,407,193,486,1086
14080,2020-07-14,(02200) Alcalá,1617,1095,812,3524
14081,2020-09-28,(03011) SUBA - CALLE 100,649,318,328,1295
14082,2020-08-14,(10009) Museo Nacional,511,308,294,1113
14083,2020-03-30,(09003) Socorro,254,115,153,522
14084,2020-06-20,(05105) Pradera,483,306,254,1043
14085,2020-03-09,(08002) Biblioteca,88,229,199,516
14086,2020-05-20,(08002) Biblioteca,249,136,149,534
14087,2020-07-09,(40001) Juan Pablo II,585,347,316,1248
14088,2020-03-24,(09115) Calle 34,684,491,483,1658
14089,2020-09-22,(02202) Calle 127,1173,839,751,2763
14090,2020-05-20,(09122) Calle 72,949,663,551,2163
14091,2020-07-17,(09122) Calle 72,997,653,573,2223
14092,2020-08-21,(09122) Calle 72,1088,715,674,2477
14093,2020-08-23,(09000) Cabecera Usme,399,209,375,983
14094,2020-03-20,(02303) Calle 85,318,213,154,685
14095,2020-07-29,(06104) Gobernación,234,127,102,463
14096,2020-06-17,(02302) Virrey,685,430,374,1489
14097,2020-05-05,(07201) Guatoque -Veraguas,125,86,85,296
14098,2020-07-22,(07105) MOVISTAR ARENA,248,139,121,508
14099,2020-04-21,(07009) SENA,336,218,210,764
14100,2020-05-27,(05105) Pradera,530,341,208,1079
14101,2020-06-05,(07107) U. NACIONAL,309,196,154,659
14102,2020-06-16,(07107) U. NACIONAL,340,198,187,725
14103,2020-07-07,(07107) U. NACIONAL,354,212,209,775
14104,2020-07-09,(06109) Centro Memoria,295,171,154,620
14105,2020-09-19,(10007) Las Nieves,520,381,451,1352
14106,2020-08-03,(07113) SANTA ISABEL,311,191,207,709
14107,2020-09-14,(10007) Las Nieves,671,386,391,1448
14108,2020-07-01,(05102) Av. Américas - Av. Boyacá,249,143,173,565
14109,2020-09-03,(05102) Av. Américas - Av. Boyacá,271,140,194,605
14110,2020-07-14,(09114) Calle 26,251,162,160,573
14111,2020-03-14,(07006) General Santander - alimentacion,824,422,641,1887
14112,2020-04-22,(12000) Puente Aranda,44,30,29,103
14113,2020-06-07,(12000) Puente Aranda,8,8,12,28
14114,2020-07-18,(12000) Puente Aranda,51,34,28,113
14115,2020-05-05,(03005) SUBA - AV. BOYACA,262,149,169,580
14116,2020-06-25,(06105) Quinta Paredes,142,91,69,302
14117,2020-08-21,(02102) Calle 161,212,124,155,491
14118,2020-06-16,(12004) Carrera 22,270,130,143,543
14119,2020-03-23,(10007) Las Nieves,41,41,40,122
14120,2020-07-06,(06001) Modelia,404,245,203,852
14121,2020-05-12,(03013) RIO NEGRO,217,152,117,486
14122,2020-01-12,(10009) Museo Nacional,308,248,501,1057
14123,2020-04-01,(10009) Museo Nacional,310,217,193,720
14124,2020-05-11,(09003) Socorro,432,250,254,936
14125,2020-03-31,(09119) Calle 57,216,177,164,557
14126,2020-10-10,(07104) Simon Bolivar,418,295,365,1078
14127,2020-08-14,(07200) Tygua-San José,233,119,159,511
14128,2020-04-22,(03010) PUENTE LARGO,200,163,88,451
14129,2020-03-24,(07003) SEVILLANA,343,214,205,762
14130,2020-09-30,(09120) Calle 63,1252,885,978,3115
14131,2020-08-17,(09100) Calle 40 Sur,568,295,464,1327
14132,2020-08-05,(07108) Av. El Dorado,131,75,55,261
14133,2020-08-10,(06002) Normandía,248,166,175,589
14134,2020-06-10,(09108) Hospital,78,47,64,189
14135,2020-04-05,(09104) Restrepo,259,189,183,631
14136,2020-03-22,(03012) SUBA - CALLE 95,55,30,33,118
14137,2020-04-25,(04103) Las Ferias,162,109,94,365
14138,2020-03-22,(07000) Portal Sur,327,183,174,684
14139,2020-06-05,(06105) Quinta Paredes,126,82,65,273
14140,2020-05-21,(07006) General Santander - alimentacion,279,166,163,608
14141,2020-05-04,(07003) SEVILLANA,303,180,143,626
14142,2020-06-20,(03005) SUBA - AV. BOYACA,348,232,218,798
14143,2020-07-26,(02303) Calle 85,145,101,76,322
14144,2020-03-26,(09114) Calle 26,164,151,129,444
14145,2020-03-25,(10004) Policarpa,119,78,92,289
14146,2020-07-26,(06000) Portal Eldorado,159,142,167,468
14147,2020-03-08,(12002) CDS - Carrera 32,61,77,90,228
14148,2020-04-27,(05100) Banderas P. Central,240,40,60,340
14149,2020-07-26,(10006) San Victorino,80,55,74,209
14150,2020-08-20,(03004) GRATAMIRA,0,11,33,44
14151,2020-08-07,(12004) Carrera 22,87,64,66,217
14152,2020-02-14,(03014) SAN MARTIN,250,161,175,586
14153,2020-07-28,(07006) General Santander - alimentacion,356,209,268,833
14154,2020-09-22,(06105) Quinta Paredes,164,111,117,392
14155,2020-07-20,(02103) Mazurén,37,23,41,101
14156,2020-08-02,(02502) Terminal,57,53,91,201
14157,2020-09-10,(06105) Quinta Paredes,134,84,90,308
14158,2020-10-03,(05102) Av. Américas - Av. Boyacá,222,105,207,534
14159,2020-09-28,(12000) Puente Aranda,94,55,64,213
14160,2020-05-24,(04002) Carrera 90,157,86,98,341
14161,2020-07-11,(14005) Las Aguas,145,91,192,428
14162,2020-07-20,(10005) Bicentenario - alimentacion,65,36,51,152
14163,2020-06-25,(06100) Av. Rojas,236,148,159,543
14164,2020-10-08,(07108) Av. El Dorado,193,121,158,472
14165,2020-05-08,(40002) Manitas,247,135,145,527
14166,2020-06-07,(07006) General Santander,152,79,108,339
14167,2020-07-24,(05102) Av. Américas - Av. Boyacá,171,91,109,371
14168,2020-03-26,(07101) CASTELLANA,42,70,84,196
14169,2020-07-15,(07101) CASTELLANA,184,93,111,388
14170,2020-06-28,(04102) Avenida Boyaca,138,77,96,311
14171,2020-10-11,(14005) Las Aguas,70,59,168,297
14172,2020-03-31,(06105) Quinta Paredes,57,51,44,152
14173,2020-04-11,(07201) Guatoque -Veraguas,30,23,38,91
14174,2020-05-21,(50002) Corral Calle 40 Sur,17,6,12,35
14175,2020-07-15,(06100) Av. Rojas,201,116,105,422
14176,2020-04-05,(03013) RIO NEGRO,47,26,29,102
14177,2020-06-28,(03010) PUENTE LARGO,84,57,58,199
14178,2020-04-30,(05101) Mandalay - Cr.73,72,37,27,136
14179,2020-05-17,(06106) Recinto Ferial,54,29,44,127
14180,2020-09-09,(12000) Puente Aranda,95,46,44,185
14181,2020-04-26,(07113) SANTA ISABEL,80,47,58,185
14182,2020-02-24,(04000) Cabecera Calle 80 - alimentacion,24074,15067,14317,53458
14183,2020-10-07,(07005) ALQUERIA,672,373,513,1558
14184,2020-02-29,(02502) Terminal,1745,1008,1902,4655
14185,2020-02-15,(09118) Marly,3758,2577,3110,9445
14186,2020-07-15,(10000) Portal 20 de Julio - alimentacion,2802,1310,1679,5791
14187,2020-03-02,(07503) SAN MATEO,37923,22331,17705,77959
14188,2020-10-09,(05000) Portal Américas,4080,2138,2994,9212
14189,2020-02-11,(10000) Portal 20 de Julio - alimentacion,11741,5771,7436,24948
14190,2020-03-14,(09000) Cabecera Usme - alimentacion,16428,7814,11410,35652
14191,2020-06-08,(04101) Minuto de Dios,301,189,216,706
14192,2020-09-26,(05000) Portal Américas - alimentacion,9675,4671,6746,21092
14193,2020-04-08,(04000) Cabecera Calle 80 - alimentacion,1871,967,1117,3955
14194,2020-09-29,(06107) Ciudad Universitaria,195,143,164,502
14195,2020-02-20,(05001) Patio Bonito,7051,4080,3537,14668
14196,2020-02-20,(07000) Portal Sur - alimentacion,28733,16761,13549,59043
14197,2020-02-21,(07103) AV. CHILE,3684,2328,1866,7878
14198,2020-02-19,(02102) Calle 161,2000,1206,1158,4364
14199,2020-01-05,(09115) Calle 34,344,261,474,1079
14200,2020-02-15,(04000) Cabecera Calle 80,3927,1905,3625,9457
14201,2020-01-17,(07002) MADELENA,4279,2308,2530,9117
14202,2020-06-06,(07001) PERDOMO,617,282,418,1317
14203,2020-09-20,(07001) PERDOMO,341,150,330,821
14204,2020-02-07,(09120) Calle 63,6922,4485,3971,15378
14205,2020-09-02,(09000) Cabecera Usme - alimentacion,9135,4852,5353,19340
14206,2020-02-27,(09104) Restrepo,5396,3176,3897,12469
14207,2020-06-11,(07505) LEON XIII,2622,1427,1169,5218
14208,2020-06-01,(03000) Portal Suba - alimentacion,5601,3274,3080,11955
14209,2020-02-06,(07112) COMUNEROS,3749,2285,2283,8317
14210,2020-05-02,(09101) Quiroga,211,114,144,469
14211,2020-06-11,(09101) Quiroga,585,266,320,1171
14212,2020-06-10,(07102) NQS - CALLE 75,417,255,204,876
14213,2020-01-31,(50003) Corral Molinos,3148,2164,3553,8865
14214,2020-02-04,(50003) Corral Molinos,3485,2209,3575,9269
14215,2020-07-17,(09103) Olaya,772,471,426,1669
14216,2020-01-08,(04102) Avenida Boyaca,1903,1138,1200,4241
14217,2020-04-05,(09113) Calle 22,117,63,93,273
14218,2020-05-14,(09113) Calle 22,379,213,258,850
14219,2020-02-24,(50003) Corral Molinos,3523,2207,3297,9027
14220,2020-08-25,(50003) Corral Molinos,1465,752,1016,3233
14221,2020-06-19,(05000) Portal Américas,2714,1820,2142,6676
14222,2020-10-05,(09110) Avenida Jimenez,1552,1127,1154,3833
14223,2020-02-09,(07504) TERREROS,4577,1951,3314,9842
14224,2020-03-08,(10006) San Victorino,271,260,420,951
14225,2020-02-10,(10000) Portal 20 de Julio,9208,4393,3993,17594
14226,2020-02-19,(12001) Carrera 43,1832,985,1128,3945
14227,2020-01-03,(10002) Av. Primero de Mayo,4550,2178,3221,9949
14228,2020-06-26,(06105) Quinta Paredes,144,89,81,314
14229,2020-06-17,(06101) El Tiempo,360,233,192,785
14230,2020-06-04,(03000) Portal Suba,1091,671,713,2475
14231,2020-09-09,(03000) Portal Suba,1471,957,1021,3449
14232,2020-03-17,(09101) Quiroga,979,643,768,2390
14233,2020-01-23,(10006) San Victorino,2086,1108,1195,4389
14234,2020-02-10,(04108) El Polo,1985,1247,1174,4406
14235,2020-03-08,(40003) Mirador del Paraiso,1679,766,1193,3638
14236,2020-06-01,(09003) Socorro,545,303,298,1146
14237,2020-09-24,(08001) Parque el Tunal,516,279,333,1128
14238,2020-01-23,(03000) Portal Suba,8294,4794,4986,18074
14239,2020-06-10,(02101) Toberín,1356,866,811,3033
14240,2020-01-28,(06103) CAN,2557,1522,1102,5181
14241,2020-01-15,(06108) Concejo de Bogotá,731,383,450,1564
14242,2020-04-21,(06108) Concejo de Bogotá,103,80,60,243
14243,2020-02-11,(02202) Calle 127,6140,4147,2967,13254
14244,2020-07-15,(02101) Toberín,1308,794,801,2903
14245,2020-10-03,(02000) Cabecera Autopista Norte - alimentacion,4628,2037,3457,10122
14246,2020-07-26,(09107) Hortúa,160,94,130,384
14247,2020-02-06,(05101) Mandalay - Cr.73,1161,633,551,2345
14248,2020-07-23,(10006) San Victorino,402,225,226,853
14249,2020-09-30,(02103) Mazurén,261,167,267,695
14250,2020-05-15,(10000) Portal 20 de Julio,1886,955,892,3733
14251,2020-07-31,(50002) Corral Calle 40 Sur,23,14,26,63
14252,2020-08-21,(50002) Corral Calle 40 Sur,21,12,30,63
14253,2020-02-06,(07006) General Santander,2821,1676,1620,6117
14254,2020-01-17,(07104) Simon Bolivar,2029,1244,1246,4519
14255,2020-08-21,(07104) Simon Bolivar,595,382,264,1241
14256,2020-09-25,(07104) Simon Bolivar,628,401,406,1435
14257,2020-05-23,(07006) General Santander,301,175,157,633
14258,2020-06-28,(09104) Restrepo,492,274,371,1137
14259,2020-08-05,(10008) San Diego,291,180,159,630
14260,2020-08-13,(10008) San Diego,318,155,168,641
14261,2020-03-23,(08000) Portal Tunal,184,107,87,378
14262,2020-07-01,(06109) Centro Memoria,287,167,143,597
14263,2020-09-14,(02205) Calle 106,408,287,239,934
14264,2020-10-07,(02205) Calle 106,461,290,340,1091
14265,2020-07-05,(03000) Portal Suba - alimentacion,1942,988,1508,4438
14266,2020-07-03,(05002) Tintal,0,1062,2855,3917
14267,2020-06-19,(09118) Marly,1488,983,826,3297
14268,2020-06-04,(04108) El Polo,436,264,200,900
14269,2020-07-14,(04108) El Polo,418,254,197,869
14270,2020-01-02,(02202) Calle 127,2247,1552,1435,5234
14271,2020-01-22,(07101) CASTELLANA,913,522,579,2014
14272,2020-01-07,(05001) Patio Bonito,4544,2692,2957,10193
14273,2020-09-05,(06000) Portal Eldorado - alimentacion,3256,1512,2332,7100
14274,2020-08-02,(07113) SANTA ISABEL,98,47,106,251
14275,2020-03-19,(02200) Alcalá,5046,3135,2557,10738
14276,2020-03-01,(02001) Centro Comercial Santa Fe,599,351,898,1848
14277,2020-05-11,(04104) Avenida 68,459,256,237,952
14278,2020-07-31,(04104) Avenida 68,488,237,290,1015
14279,2020-09-25,(08002) Biblioteca,332,189,233,754
14280,2020-07-07,(07000) Portal Sur,1950,1236,1189,4375
14281,2020-01-01,(02101) Toberín,512,318,1003,1833
14282,2020-01-24,(06105) Quinta Paredes,985,558,526,2069
14283,2020-01-16,(04101) Minuto de Dios,2079,1197,1552,4828
14284,2020-05-19,(07110) PALOQUEMAO,627,365,231,1223
14285,2020-07-16,(09100) Calle 40 Sur,1184,682,816,2682
14286,2020-05-21,(07104) Simon Bolivar,521,345,229,1095
14287,2020-04-29,(10005) Bicentenario - alimentacion,145,72,110,327
14288,2020-06-12,(10005) Bicentenario - alimentacion,224,107,173,504
14289,2020-04-18,(03006) NIZA - CALLE 127,184,134,82,400
14290,2020-02-12,(09121) Las Flores,3551,2225,2159,7935
14291,2020-01-19,(09109) Tercer Milenio,352,167,389,908
14292,2020-10-05,(09109) Tercer Milenio,365,250,292,907
14293,2020-09-28,(03001) LA CAMPIÑA,1401,796,971,3168
14294,2020-09-10,(02104) Calle 146,828,467,614,1909
14295,2020-05-18,(02202) Calle 127,938,683,464,2085
14296,2020-07-10,(09120) Calle 63,1225,765,770,2760
14297,2020-01-08,(40001) Juan Pablo II,1278,716,801,2795
14298,2020-08-16,(05001) Patio Bonito,516,250,364,1130
14299,2020-05-24,(07109) CAD,173,107,85,365
14300,2020-08-25,(07109) CAD,638,388,298,1324
14301,2020-08-27,(07109) CAD,621,374,281,1276
14302,2020-05-28,(09002) Consuelo,458,215,238,911
14303,2020-08-09,(09002) Consuelo,141,64,116,321
14304,2020-01-04,(02001) Centro Comercial Santa Fe,967,500,917,2384
14305,2020-01-18,(09120) Calle 63,2380,1762,2353,6495
14306,2020-07-24,(09120) Calle 63,825,578,533,1936
14307,2020-03-28,(02302) Virrey,272,199,149,620
14308,2020-01-12,(07007) NQS - Calle 38A Sur,545,291,396,1232
14309,2020-02-22,(09122) Calle 72,3351,2315,3164,8830
14310,2020-10-12,(12003) Ricaurte,59,64,69,192
14311,2020-05-04,(07106) EL CAMPIN,211,163,112,486
14312,2020-03-07,(03010) PUENTE LARGO,909,603,902,2414
14313,2020-01-04,(10010) San Bernardo,645,389,665,1699
14314,2020-03-18,(10010) San Bernardo,917,632,745,2294
14315,2020-03-13,(03009) Av. Suba- Calle 116,758,144,303,1205
14316,2020-07-20,(02105) Calle 142,181,148,149,478
14317,2020-09-04,(14004) Museo del Oro,379,251,309,939
14318,2020-04-13,(09000) Cabecera Usme,824,527,572,1923
14319,2020-07-25,(07103) AV. CHILE,577,321,318,1216
14320,2020-07-29,(07103) AV. CHILE,878,498,422,1798
14321,2020-06-11,(09122) Calle 72,1098,778,590,2466
14322,2020-02-22,(07201) Guatoque -Veraguas,497,263,500,1260
14323,2020-07-10,(10005) Bicentenario,118,67,83,268
14324,2020-05-12,(05100) Banderas P. Central,491,276,316,1083
14325,2020-01-18,(02102) Calle 161,677,337,675,1689
14326,2020-02-18,(10004) Policarpa,962,447,568,1977
14327,2020-02-09,(40001) Juan Pablo II,511,210,430,1151
14328,2020-09-15,(09115) Calle 34,735,441,470,1646
14329,2020-06-27,(07002) MADELENA,653,321,410,1384
14330,2020-03-03,(07200) Tygua-San José,856,482,613,1951
14331,2020-03-15,(07111) NQS - RICAURTE,409,352,475,1236
14332,2020-07-07,(06100) Av. Rojas,246,148,156,550
14333,2020-09-08,(09123) Calle 76,1101,760,650,2511
14334,2020-05-24,(06109) Centro Memoria,74,45,42,161
14335,2020-06-19,(07111) NQS - RICAURTE,1231,753,469,2453
14336,2020-02-27,(07006) General Santander - alimentacion,1515,882,978,3375
14337,2020-05-13,(02302) Virrey,478,335,212,1025
14338,2020-07-23,(07105) MOVISTAR ARENA,252,129,117,498
14339,2020-05-28,(09121) Las Flores,638,427,346,1411
14340,2020-07-17,(09121) Las Flores,529,364,340,1233
14341,2020-01-29,(07506) DESPENSA,1690,947,944,3581
14342,2020-07-12,(07001) PERDOMO,265,132,223,620
14343,2020-07-05,(09123) Calle 76,213,165,216,594
14344,2020-09-01,(09113) Calle 22,419,239,343,1001
14345,2020-09-03,(04102) Avenida Boyaca,435,259,301,995
14346,2020-04-14,(07113) SANTA ISABEL,197,125,128,450
14347,2020-06-02,(07110) PALOQUEMAO,640,391,250,1281
14348,2020-09-19,(03005) SUBA - AV. BOYACA,373,230,333,936
14349,2020-05-04,(04104) Avenida 68,420,241,210,871
14350,2020-04-27,(10007) Las Nieves,31,129,68,228
14351,2020-09-20,(02000) Cabecera Autopista Norte,516,311,522,1349
14352,2020-07-13,(09001) Molinos,1587,971,1056,3614
14353,2020-09-11,(10004) Policarpa,273,106,199,578
14354,2020-08-18,(02103) Mazurén,182,126,157,465
14355,2020-09-15,(09114) Calle 26,367,213,281,861
14356,2020-06-22,(10009) Museo Nacional,88,57,99,244
14357,2020-04-04,(09002) Consuelo,163,73,77,313
14358,2020-09-27,(08000) Portal Tunal,251,154,200,605
14359,2020-06-16,(02502) Terminal,464,315,330,1109
14360,2020-03-31,(14001) La Sabana,68,56,57,181
14361,2020-08-03,(07006) General Santander,436,279,255,970
14362,2020-08-29,(07108) Av. El Dorado,89,61,85,235
14363,2020-10-03,(07009) SENA,618,321,613,1552
14364,2020-05-11,(04101) Minuto de Dios,226,142,155,523
14365,2020-03-23,(07000) Portal Sur,363,206,242,811
14366,2020-08-04,(09117) Calle 45,625,399,380,1404
14367,2020-05-08,(03006) NIZA - CALLE 127,295,171,156,622
14368,2020-04-18,(03012) SUBA - CALLE 95,138,77,67,282
14369,2020-06-22,(09002) Consuelo,159,65,103,327
14370,2020-01-18,(09108) Hospital,135,68,158,361
14371,2020-07-12,(09002) Consuelo,190,100,159,449
14372,2020-06-06,(05100) Banderas P. Central,351,180,326,857
14373,2020-04-04,(07107) U. NACIONAL,114,88,73,275
14374,2020-06-29,(06102) Salitre El Greco,107,60,63,230
14375,2020-04-10,(10001) Country Sur,201,86,104,391
14376,2020-06-16,(12007) Zona Industrial,326,222,160,708
14377,2020-04-09,(02105) Calle 142,144,128,86,358
14378,2020-07-17,(07007) NQS - Calle 38A Sur,390,219,244,853
14379,2020-06-09,(06103) CAN,343,219,145,707
14380,2020-06-03,(09105) Río Fucha,122,54,101,277
14381,2020-05-08,(09105) Río Fucha,82,57,69,208
14382,2020-08-16,(40001) Juan Pablo II,159,80,135,374
14383,2020-04-26,(06101) El Tiempo,77,68,36,181
14384,2020-05-23,(09106) Nariño,277,155,177,609
14385,2020-03-15,(07102) NQS - CALLE 75,152,138,195,485
14386,2020-06-19,(06107) Ciudad Universitaria,179,118,134,431
14387,2020-03-17,(50002) Corral Calle 40 Sur,72,44,74,190
14388,2020-09-19,(05103) Marsella,386,196,281,863
14389,2020-05-17,(05107) Américas - Cr.53,65,65,55,185
14390,2020-05-17,(10003) Ciudad Jardín,52,18,39,109
14391,2020-04-02,(05101) Mandalay - Cr.73,45,25,20,90
14392,2020-10-11,(06109) Centro Memoria,76,47,97,220
14393,2020-08-22,(09106) Nariño,280,147,236,663
14394,2020-05-19,(09105) Río Fucha,94,50,89,233
14395,2020-08-09,(06002) Normandía,58,51,69,178
14396,2020-04-04,(07104) Simon Bolivar,140,105,88,333
14397,2020-08-23,(09114) Calle 26,48,45,65,158
14398,2020-08-11,(07106) EL CAMPIN,363,227,205,795
14399,2020-05-03,(12003) Ricaurte,36,37,40,113
14400,2020-03-25,(12003) Ricaurte,81,87,60,228
14401,2019-12-31,(03001) LA CAMPIÑA,41,33,71,145
14402,2020-05-31,(08002) Biblioteca,91,49,49,189
14403,2020-09-20,(05101) Mandalay - Cr.73,27,19,34,80
14404,2020-08-16,(07007) NQS - Calle 38A Sur,125,85,95,305
14405,2020-04-26,(07009) SENA,103,69,62,234
14406,2020-07-20,(09108) Hospital,30,24,17,71
14407,2020-05-08,(10005) Bicentenario,73,38,43,154
14408,2020-07-25,(12000) Puente Aranda,53,33,34,120
14409,2020-03-25,(50006) Corral Carrera 77,4,3,3,10
14410,2020-04-20,(03004) GRATAMIRA,22,12,9,43
14411,2020-08-07,(50006) Corral Carrera 77,2,2,0,4
14412,2020-05-26,(07005) ALQUERIA,505,289,274,1068
14413,2020-02-22,(09002) Consuelo,1007,469,715,2191
14414,2020-06-13,(09002) Consuelo,371,181,254,806
14415,2020-09-26,(09002) Consuelo,399,204,357,960
14416,2020-02-04,(07504) TERREROS,17371,10779,9383,37533
14417,2020-04-02,(07504) TERREROS,2308,1332,1361,5001
14418,2020-08-04,(07504) TERREROS,5559,3045,2565,11169
14419,2020-01-20,(03000) Portal Suba - alimentacion,24758,14344,15123,54225
14420,2020-02-21,(14005) Las Aguas,2764,1998,2070,6832
14421,2020-01-28,(09100) Calle 40 Sur,7189,3979,4072,15240
14422,2020-02-18,(06104) Gobernación,1533,884,675,3092
14423,2020-02-12,(08001) Parque el Tunal,1779,1013,1026,3818
14424,2020-01-24,(09121) Las Flores,2903,1838,1945,6686
14425,2020-10-09,(06107) Ciudad Universitaria,218,142,223,583
14426,2020-08-10,(09001) Molinos,2363,1310,1625,5298
14427,2020-08-13,(09001) Molinos,2408,1268,1620,5296
14428,2020-10-05,(07503) SAN MATEO,13609,6943,7635,28187
14429,2020-02-07,(07002) MADELENA,5289,2869,2810,10968
14430,2020-01-15,(05100) Banderas P. Central,6198,3605,3394,13197
14431,2020-02-03,(05100) Banderas P. Central,8033,4901,3861,16795
14432,2020-05-20,(09100) Calle 40 Sur,1420,859,805,3084
14433,2020-07-28,(40001) Juan Pablo II,513,308,321,1142
14434,2020-02-24,(07009) SENA,3778,2228,2069,8075
14435,2020-02-26,(06102) Salitre El Greco,1546,874,739,3159
14436,2020-02-10,(07113) SANTA ISABEL,2159,1346,1394,4899
14437,2020-07-04,(09104) Restrepo,1254,805,1004,3063
14438,2020-10-02,(09104) Restrepo,1736,982,1738,4456
14439,2020-07-06,(04101) Minuto de Dios,346,225,316,887
14440,2020-09-11,(04101) Minuto de Dios,337,203,267,807
14441,2020-10-05,(04101) Minuto de Dios,389,234,342,965
14442,2020-08-14,(07505) LEON XIII,2755,1478,1245,5478
14443,2020-01-17,(09123) Calle 76,4064,2895,2792,9751
14444,2020-03-17,(07111) NQS - RICAURTE,2527,1616,1053,5196
14445,2020-02-03,(06106) Recinto Ferial,1615,871,857,3343
14446,2020-08-30,(07102) NQS - CALLE 75,90,73,109,272
14447,2020-01-10,(09118) Marly,3885,2719,2947,9551
14448,2020-06-14,(09118) Marly,488,282,304,1074
14449,2020-02-19,(09103) Olaya,4452,2598,2366,9416
14450,2020-02-23,(08000) Portal Tunal - alimentacion,5566,2522,3875,11963
14451,2020-05-13,(09103) Olaya,783,433,414,1630
14452,2020-05-28,(07111) NQS - RICAURTE,1016,628,357,2001
14453,2020-08-14,(07111) NQS - RICAURTE,1115,656,484,2255
14454,2020-01-28,(04102) Avenida Boyaca,2908,1767,1599,6274
14455,2020-01-22,(09113) Calle 22,1360,834,1068,3262
14456,2020-02-11,(02201) Prado,6283,4006,3134,13423
14457,2020-01-08,(04105) Carrera 53,937,511,563,2011
14458,2020-02-26,(09114) Calle 26,2761,2251,2053,7065
14459,2020-07-07,(02000) Cabecera Autopista Norte - alimentacion,5191,2851,2976,11018
14460,2020-07-01,(09110) Avenida Jimenez,1476,970,887,3333
14461,2020-08-28,(09110) Avenida Jimenez,1369,979,827,3175
14462,2020-03-02,(05107) Américas - Cr.53,2478,1444,1405,5327
14463,2020-02-08,(02201) Prado,3076,1628,2218,6922
14464,2020-04-06,(04002) Carrera 90,323,163,191,677
14465,2020-09-14,(10001) Country Sur,1309,615,789,2713
14466,2020-01-19,(06109) Centro Memoria,203,123,271,597
14467,2020-05-27,(12001) Carrera 43,374,212,182,768
14468,2020-02-02,(09110) Avenida Jimenez,1107,904,1086,3097
14469,2020-01-10,(02302) Virrey,2927,1980,1577,6484
14470,2020-08-20,(04108) El Polo,491,289,217,997
14471,2020-10-12,(04108) El Polo,111,79,179,369
14472,2020-04-24,(07000) Portal Sur - alimentacion,4438,2408,1792,8638
14473,2020-08-06,(02303) Calle 85,648,424,376,1448
14474,2020-08-08,(02303) Calle 85,365,277,263,905
14475,2020-03-14,(09004) Santa Lucía,4922,2307,3261,10490
14476,2020-03-19,(09004) Santa Lucía,4666,2409,2590,9665
14477,2020-08-09,(09004) Santa Lucía,799,313,595,1707
14478,2020-02-03,(10007) Las Nieves,2090,1226,1226,4542
14479,2020-03-07,(07108) Av. El Dorado,404,310,421,1135
14480,2020-10-04,(09000) Cabecera Usme - alimentacion,2963,1263,2594,6820
14481,2020-03-16,(06103) CAN,1670,1022,681,3373
14482,2020-03-16,(09003) Socorro,1267,716,780,2763
14483,2020-03-17,(09003) Socorro,1183,626,677,2486
14484,2020-01-20,(03003) 21 ANGELES,1559,781,873,3213
14485,2020-04-06,(03003) 21 ANGELES,168,94,76,338
14486,2020-06-17,(10002) Av. Primero de Mayo,2164,1163,1311,4638
14487,2020-04-23,(02000) Cabecera Autopista Norte,579,418,400,1397
14488,2020-01-04,(10000) Portal 20 de Julio,3400,1436,2235,7071
14489,2020-05-15,(09107) Hortúa,524,322,279,1125
14490,2020-02-12,(03011) SUBA - CALLE 100,2801,1430,1545,5776
14491,2020-06-19,(03012) SUBA - CALLE 95,338,193,196,727
14492,2020-01-17,(50002) Corral Calle 40 Sur,114,52,116,282
14493,2020-06-04,(07104) Simon Bolivar,558,366,241,1165
14494,2020-08-06,(05005) Transversal 86,293,165,212,670
14495,2020-10-03,(05005) Transversal 86,375,151,325,851
14496,2020-05-16,(02202) Calle 127,703,535,362,1600
14497,2020-01-25,(02104) Calle 146,3233,1414,2619,7266
14498,2020-01-23,(08000) Portal Tunal,1986,1097,1001,4084
14499,2020-02-06,(08000) Portal Tunal,2232,1245,1085,4562
14500,2020-08-11,(03009) Av. Suba- Calle 116,429,284,207,920
14501,2020-09-24,(03009) Av. Suba- Calle 116,547,367,297,1211
14502,2020-06-28,(09000) Cabecera Usme - alimentacion,2600,1258,1609,5467
14503,2020-09-17,(04101) Minuto de Dios,374,235,316,925
14504,2020-03-04,(04003) Avenida Ciudad de Cali,5435,3241,3567,12243
14505,2020-09-08,(04003) Avenida Ciudad de Cali,1082,603,801,2486
14506,2020-08-08,(09101) Quiroga,362,169,290,821
14507,2020-05-12,(03000) Portal Suba,892,552,557,2001
14508,2020-02-25,(04108) El Polo,2030,1248,1079,4357
14509,2020-05-22,(07113) SANTA ISABEL,326,212,220,758
14510,2020-09-08,(04104) Avenida 68,689,321,418,1428
14511,2020-07-14,(10006) San Victorino,395,216,231,842
14512,2020-03-19,(03011) SUBA - CALLE 100,1162,627,558,2347
14513,2020-01-03,(03010) PUENTE LARGO,923,565,628,2116
14514,2020-01-11,(03006) NIZA - CALLE 127,977,616,727,2320
14515,2020-03-05,(05103) Marsella,3068,1752,1436,6256
14516,2020-04-18,(02304) Heroes,270,221,175,666
14517,2020-09-25,(10005) Bicentenario - alimentacion,219,123,233,575
14518,2020-08-25,(09121) Las Flores,627,407,376,1410
14519,2020-04-17,(05005) Transversal 86,202,107,122,431
14520,2020-05-07,(04108) El Polo,303,212,147,662
14521,2020-10-05,(09106) Nariño,479,292,432,1203
14522,2020-10-06,(09109) Tercer Milenio,367,250,285,902
14523,2020-07-09,(10000) Portal 20 de Julio - alimentacion,4421,2032,2484,8937
14524,2020-05-04,(02202) Calle 127,783,566,411,1760
14525,2020-09-03,(06104) Gobernación,269,150,137,556
14526,2020-01-04,(03001) LA CAMPIÑA,1660,766,1229,3655
14527,2020-01-17,(07103) AV. CHILE,3231,1960,1846,7037
14528,2020-02-09,(04108) El Polo,294,189,432,915
14529,2020-04-21,(04108) El Polo,239,168,150,557
14530,2020-05-06,(04108) El Polo,302,203,146,651
14531,2020-06-10,(06000) Portal Eldorado,983,637,443,2063
14532,2020-01-18,(10010) San Bernardo,879,542,955,2376
14533,2019-12-31,(02104) Calle 146,47,20,35,102
14534,2020-04-05,(02105) Calle 142,97,116,79,292
14535,2020-07-27,(02105) Calle 142,695,457,428,1580
14536,2020-01-08,(05005) Transversal 86,1758,941,969,3668
14537,2020-04-07,(05102) Av. Américas - Av. Boyacá,112,59,65,236
14538,2020-03-07,(03006) NIZA - CALLE 127,1167,802,982,2951
14539,2020-07-01,(06108) Concejo de Bogotá,149,82,92,323
14540,2020-09-07,(03002) SUBA - TV- 91,813,522,537,1872
14541,2020-04-21,(05107) Américas - Cr.53,332,197,194,723
14542,2020-08-24,(05107) Américas - Cr.53,370,203,230,803
14543,2020-09-11,(05107) Américas - Cr.53,366,239,295,900
14544,2020-08-04,(04000) Cabecera Calle 80 - intermunicipal,312,160,282,754
14545,2020-10-12,(02104) Calle 146,305,166,347,818
14546,2020-05-11,(07103) AV. CHILE,700,459,333,1492
14547,2020-10-10,(07103) AV. CHILE,608,402,596,1606
14548,2020-01-09,(03001) LA CAMPIÑA,4872,2596,2732,10200
14549,2020-01-29,(07105) MOVISTAR ARENA,1321,803,714,2838
14550,2020-02-24,(07105) MOVISTAR ARENA,1372,839,709,2920
14551,2020-01-02,(10005) Bicentenario,298,161,186,645
14552,2020-07-15,(10005) Bicentenario,90,41,59,190
14553,2020-08-26,(40002) Manitas,377,234,265,876
14554,2020-04-19,(05100) Banderas P. Central - alimentacion,478,253,216,947
14555,2020-04-24,(10000) Portal 20 de Julio,1280,652,607,2539
14556,2020-09-13,(02102) Calle 161,67,46,79,192
14557,2020-02-03,(06103) CAN,2683,1565,1095,5343
14558,2020-10-02,(07003) SEVILLANA,562,297,374,1233
14559,2020-10-02,(07006) General Santander,678,364,490,1532
14560,2020-08-01,(02104) Calle 146,442,294,318,1054
14561,2020-02-02,(07004) VENECIA,1033,522,978,2533
14562,2020-06-16,(05100) Banderas P. Central,681,439,469,1589
14563,2020-03-22,(09120) Calle 63,254,161,135,550
14564,2020-07-08,(05105) Pradera,608,346,281,1235
14565,2020-09-06,(05105) Pradera,193,151,195,539
14566,2020-10-02,(09115) Calle 34,737,465,652,1854
14567,2020-05-05,(07107) U. NACIONAL,232,136,118,486
14568,2020-03-16,(03006) NIZA - CALLE 127,1509,962,887,3358
14569,2020-01-09,(05102) Av. Américas - Av. Boyacá,1052,611,672,2335
14570,2020-04-03,(02201) Prado,397,284,205,886
14571,2020-06-02,(04003) Avenida Ciudad de Cali,921,541,603,2065
14572,2020-05-13,(06104) Gobernación,214,126,98,438
14573,2020-06-08,(09114) Calle 26,300,209,179,688
14574,2020-07-05,(09114) Calle 26,66,48,88,202
14575,2020-05-20,(07201) Guatoque -Veraguas,144,104,104,352
14576,2020-05-05,(09121) Las Flores,490,329,286,1105
14577,2020-02-25,(07506) DESPENSA,1732,993,922,3647
14578,2020-10-10,(09114) Calle 26,180,160,315,655
14579,2020-05-15,(03003) 21 ANGELES,282,133,128,543
14580,2020-09-09,(10003) Ciudad Jardín,221,113,157,491
14581,2020-01-21,(04103) Las Ferias,977,580,519,2076
14582,2020-08-03,(03011) SUBA - CALLE 100,403,192,194,789
14583,2020-07-15,(04103) Las Ferias,298,147,159,604
14584,2020-05-07,(10004) Policarpa,170,80,135,385
14585,2020-06-28,(07007) NQS - Calle 38A Sur,190,97,125,412
14586,2020-05-08,(08002) Biblioteca,223,127,112,462
14587,2020-10-09,(07506) DESPENSA,405,300,367,1072
14588,2020-10-01,(02102) Calle 161,307,170,245,722
14589,2020-07-14,(09111) Calle 19,387,265,351,1003
14590,2020-08-18,(09111) Calle 19,640,384,414,1438
14591,2020-04-29,(07005) ALQUERIA,334,211,209,754
14592,2020-08-19,(10009) Museo Nacional,429,224,244,897
14593,2020-05-17,(09003) Socorro,172,88,117,377
14594,2020-05-31,(04106) Carrera 47,109,54,58,221
14595,2020-09-21,(06001) Modelia,328,225,185,738
14596,2020-05-10,(09004) Santa Lucía,495,244,311,1050
14597,2020-07-19,(07008) NQS - Calle 30 Sur,86,39,72,197
14598,2020-09-23,(07108) Av. El Dorado,192,123,142,457
14599,2020-07-29,(06002) Normandía,271,183,154,608
14600,2020-06-29,(09119) Calle 57,192,125,162,479
14601,2020-07-07,(09108) Hospital,70,50,72,192
14602,2020-03-28,(03012) SUBA - CALLE 95,112,77,75,264
14603,2020-07-20,(07006) General Santander,160,74,114,348
14604,2020-03-25,(07106) EL CAMPIN,135,131,98,364
14605,2020-04-30,(09003) Socorro,329,188,210,727
14606,2020-07-25,(40002) Manitas,242,135,170,547
14607,2020-08-30,(03011) SUBA - CALLE 100,149,88,117,354
14608,2020-07-29,(09113) Calle 22,408,224,273,905
14609,2020-06-27,(09108) Hospital,60,36,48,144
14610,2020-04-09,(08000) Portal Tunal,199,91,80,370
14611,2020-08-02,(09110) Avenida Jimenez,360,284,313,957
14612,2020-09-06,(06102) Salitre El Greco,104,58,85,247
14613,2020-07-30,(04101) Minuto de Dios,311,200,255,766
14614,2020-05-30,(07506) DESPENSA,346,173,198,717
14615,2020-05-10,(05105) Pradera,89,74,60,223
14616,2020-04-22,(04001) Quirigua,211,124,100,435
14617,2020-06-18,(12007) Zona Industrial,379,240,159,778
14618,2020-04-23,(09121) Las Flores,393,286,246,925
14619,2020-08-31,(10003) Ciudad Jardín,197,95,143,435
14620,2020-04-26,(04102) Avenida Boyaca,56,43,36,135
14621,2020-09-29,(09106) Nariño,493,304,408,1205
14622,2020-09-01,(09116) Avenida 39,417,237,261,915
14623,2020-08-12,(03004) GRATAMIRA,0,18,30,48
14624,2020-05-14,(07200) Tygua-San José,187,90,105,382
14625,2020-06-10,(10003) Ciudad Jardín,191,101,112,404
14626,2020-05-10,(03009) Av. Suba- Calle 116,134,91,73,298
14627,2020-08-23,(14005) Las Aguas,40,39,90,169
14628,2020-03-16,(03014) SAN MARTIN,140,93,123,356
14629,2020-01-26,(50006) Corral Carrera 77,10,6,17,33
14630,2020-09-27,(04108) El Polo,115,80,116,311
14631,2020-06-06,(04001) Quirigua,290,154,168,612
14632,2020-06-15,(07006) General Santander,187,97,93,377
14633,2020-08-03,(07101) CASTELLANA,178,89,79,346
14634,2020-07-07,(09105) Río Fucha,130,53,107,290
14635,2020-09-06,(40002) Manitas,141,59,135,335
14636,2020-04-17,(09105) Río Fucha,80,47,57,184
14637,2020-06-07,(10004) Policarpa,78,47,79,204
14638,2020-10-11,(03003) 21 ANGELES,109,43,128,280
14639,2020-04-08,(14005) Las Aguas,0,33,92,125
14640,2020-05-03,(04107) Escuela Militar,20,15,18,53
14641,2020-08-01,(14005) Las Aguas,109,75,156,340
14642,2020-04-19,(09117) Calle 45,207,128,92,427
14643,2019-12-31,(02000) Cabecera Autopista Norte,71,43,91,205
14644,2020-04-23,(10003) Ciudad Jardín,99,69,60,228
14645,2020-08-14,(09105) Río Fucha,0,63,139,202
14646,2020-03-20,(07101) CASTELLANA,74,63,54,191
14647,2020-04-25,(04108) El Polo,167,101,107,375
14648,2020-08-30,(14001) La Sabana,50,39,49,138
14649,2020-08-09,(07007) NQS - Calle 38A Sur,160,101,92,353
14650,2020-04-09,(07106) EL CAMPIN,59,48,31,138
14651,2020-05-22,(10005) Bicentenario,105,61,67,233
14652,2020-07-26,(04000) Cabecera Calle 80 - intermunicipal,55,37,66,158
14653,2020-04-20,(03014) SAN MARTIN,15,7,26,48
14654,2020-05-20,(03014) SAN MARTIN,31,12,25,68
14655,2020-04-10,(07105) MOVISTAR ARENA,40,22,25,87
14656,2020-02-01,(50006) Corral Carrera 77,16,16,29,61
14657,2020-09-06,(12000) Puente Aranda,12,18,18,48
14658,2020-06-02,(50002) Corral Calle 40 Sur,16,6,18,40
14659,2020-07-20,(14005) Las Aguas,53,30,69,152
14660,2020-07-28,(04000) Cabecera Calle 80 - alimentacion,3874,2182,2445,8501
14661,2020-02-17,(02502) Terminal,5449,3614,2908,11971
14662,2020-08-14,(02502) Terminal,377,266,325,968
14663,2020-05-07,(09119) Calle 57,365,248,262,875
14664,2020-04-02,(05000) Portal Américas - alimentacion,6029,2656,2450,11135
14665,2020-05-29,(05000) Portal Américas - alimentacion,9942,5104,4705,19751
14666,2020-01-03,(09122) Calle 72,2989,2051,2254,7294
14667,2020-01-31,(09122) Calle 72,6642,4340,4114,15096
14668,2020-01-25,(06104) Gobernación,338,269,411,1018
14669,2020-03-11,(03010) PUENTE LARGO,1955,1399,1157,4511
14670,2020-08-09,(09003) Socorro,204,91,146,441
14671,2020-01-23,(50003) Corral Molinos,3270,2048,3257,8575
14672,2020-01-23,(04002) Carrera 90,3363,2009,1904,7276
14673,2020-10-03,(07111) NQS - RICAURTE,905,637,642,2184
14674,2020-06-05,(07503) SAN MATEO,10095,6139,5128,21362
14675,2020-04-22,(05000) Portal Américas - alimentacion,6513,3360,2787,12660
14676,2020-03-25,(04000) Cabecera Calle 80 - alimentacion,1998,1163,1018,4179
14677,2020-02-19,(07010) Bosa,2318,1270,1432,5020
14678,2020-03-02,(07010) Bosa,2176,1206,1347,4729
14679,2020-10-04,(07112) COMUNEROS,274,143,336,753
14680,2020-01-13,(14004) Museo del Oro,2348,1573,1485,5406
14681,2020-03-02,(05005) Transversal 86,2767,1640,1295,5702
14682,2020-01-13,(09000) Cabecera Usme - alimentacion,21886,11805,14217,47908
14683,2020-02-17,(07002) MADELENA,5081,3055,2502,10638
14684,2020-08-20,(05100) Banderas P. Central,730,399,427,1556
14685,2020-02-23,(07000) Portal Sur - alimentacion,7437,3221,4507,15165
14686,2020-05-28,(05100) Banderas P. Central,615,317,412,1344
14687,2020-09-18,(07001) PERDOMO,1186,654,880,2720
14688,2020-09-26,(07001) PERDOMO,816,392,734,1942
14689,2020-02-11,(07113) SANTA ISABEL,2171,1337,1359,4867
14690,2020-02-29,(40003) Mirador del Paraiso,4034,1986,2592,8612
14691,2020-06-10,(09104) Restrepo,1418,887,967,3272
14692,2020-05-08,(07505) LEON XIII,1612,987,792,3391
14693,2020-09-03,(03000) Portal Suba - alimentacion,6759,3762,4144,14665
14694,2020-02-16,(07504) TERREROS,4721,2013,3373,10107
14695,2020-01-23,(04104) Avenida 68,3347,1729,1681,6757
14696,2020-01-09,(09123) Calle 76,3438,2317,2195,7950
14697,2020-02-11,(09123) Calle 76,6091,3916,3189,13196
14698,2020-02-13,(09123) Calle 76,5943,3934,3127,13004
14699,2020-08-01,(02000) Cabecera Autopista Norte - alimentacion,3281,1684,1856,6821
14700,2020-02-21,(03005) SUBA - AV. BOYACA,2556,1516,1573,5645
14701,2020-09-09,(07102) NQS - CALLE 75,476,318,247,1041
14702,2020-01-08,(03013) RIO NEGRO,903,533,632,2068
14703,2020-06-11,(03013) RIO NEGRO,264,171,154,589
14704,2020-02-18,(09103) Olaya,4505,2751,2435,9691
14705,2020-02-09,(08000) Portal Tunal - alimentacion,5859,2730,4185,12774
14706,2020-01-14,(03001) LA CAMPIÑA,5647,3190,3353,12190
14707,2020-07-04,(50003) Corral Molinos,1415,699,1015,3129
14708,2020-07-28,(07000) Portal Sur - alimentacion,6753,3947,3355,14055
14709,2020-01-20,(09103) Olaya,3607,2146,2284,8037
14710,2020-06-11,(09103) Olaya,945,537,508,1990
14711,2020-01-29,(14001) La Sabana,445,341,364,1150
14712,2020-06-18,(14001) La Sabana,161,106,79,346
14713,2020-03-14,(07112) COMUNEROS,2084,1157,1513,4754
14714,2020-03-19,(02000) Cabecera Autopista Norte,3797,2201,2367,8365
14715,2020-05-09,(09113) Calle 22,300,169,282,751
14716,2020-01-02,(02201) Prado,2092,1325,1437,4854
14717,2020-08-11,(08000) Portal Tunal - alimentacion,6022,3356,3327,12705
14718,2020-05-07,(50003) Corral Molinos,941,522,676,2139
14719,2020-10-02,(05000) Portal Américas,4174,2145,3036,9355
14720,2020-10-07,(07010) Bosa,0,405,982,1387
14721,2020-02-28,(05002) Tintal,11553,6114,6001,23668
14722,2020-01-15,(09120) Calle 63,3793,2778,3008,9579
14723,2020-05-22,(05002) Tintal,1853,991,994,3838
14724,2020-03-11,(12001) Carrera 43,1531,983,1097,3611
14725,2020-08-28,(05002) Tintal,2585,1494,1643,5722
14726,2020-04-29,(02000) Cabecera Autopista Norte - intermunicipal,232,168,175,575
14727,2020-01-02,(07106) EL CAMPIN,826,545,637,2008
14728,2020-06-12,(06101) El Tiempo,337,219,172,728
14729,2020-09-01,(02000) Cabecera Autopista Norte - intermunicipal,550,359,449,1358
14730,2020-08-31,(09000) Cabecera Usme - alimentacion,8556,4500,5046,18102
14731,2020-05-07,(03000) Portal Suba - alimentacion,3962,2347,2110,8419
14732,2020-02-19,(10010) San Bernardo,1853,1108,1302,4263
14733,2020-02-29,(06100) Av. Rojas,829,557,864,2250
14734,2020-01-24,(06111) Universidades,4736,3063,2477,10276
14735,2020-02-25,(09108) Hospital,243,153,244,640
14736,2020-01-26,(04106) Carrera 47,371,197,329,897
14737,2020-09-28,(07112) COMUNEROS,877,510,669,2056
14738,2020-05-31,(07004) VENECIA,226,128,152,506
14739,2020-09-09,(09004) Santa Lucía,1470,1453,2693,5616
14740,2020-09-11,(09004) Santa Lucía,1224,1387,2622,5233
14741,2020-09-17,(07108) Av. El Dorado,172,100,139,411
14742,2020-01-25,(10004) Policarpa,533,247,436,1216
14743,2020-09-06,(07504) TERREROS,1975,888,1434,4297
14744,2020-07-11,(09116) Avenida 39,194,163,173,530
14745,2020-07-27,(02101) Toberín,1302,874,857,3033
14746,2020-01-30,(09123) Calle 76,5242,3521,2915,11678
14747,2020-01-08,(03000) Portal Suba,5953,3600,3811,13364
14748,2020-04-01,(07001) PERDOMO,423,242,305,970
14749,2020-09-03,(02000) Cabecera Autopista Norte - alimentacion,5011,2710,3177,10898
14750,2020-04-07,(14004) Museo del Oro,0,55,106,161
14751,2020-04-30,(02201) Prado,530,318,296,1144
14752,2020-06-02,(02000) Cabecera Autopista Norte,1143,726,703,2572
14753,2020-02-27,(06001) Modelia,2602,1555,1236,5393
14754,2020-07-07,(09107) Hortúa,669,370,378,1417
14755,2020-07-29,(09107) Hortúa,563,362,346,1271
14756,2020-09-18,(02300) Calle 100,1331,930,926,3187
14757,2020-06-03,(10000) Portal 20 de Julio,2163,1073,946,4182
14758,2020-06-05,(10000) Portal 20 de Julio,2172,1093,1036,4301
14759,2020-07-22,(50002) Corral Calle 40 Sur,14,5,21,40
14760,2020-03-23,(10000) Portal 20 de Julio - alimentacion,1197,491,625,2313
14761,2020-05-17,(08000) Portal Tunal,183,110,93,386
14762,2020-09-22,(07006) General Santander,606,371,421,1398
14763,2020-10-09,(02302) Virrey,764,539,587,1890
14764,2020-04-24,(05005) Transversal 86,221,119,99,439
14765,2020-06-20,(09001) Molinos,2149,1099,1569,4817
14766,2020-07-22,(05107) Américas - Cr.53,392,236,258,886
14767,2020-02-28,(03009) Av. Suba- Calle 116,2530,1597,1507,5634
14768,2020-09-16,(03009) Av. Suba- Calle 116,565,330,311,1206
14769,2020-05-07,(02205) Calle 106,222,162,131,515
14770,2020-05-08,(02205) Calle 106,229,158,124,511
14771,2020-08-14,(04003) Avenida Ciudad de Cali,851,487,736,2074
14772,2020-07-15,(09101) Quiroga,360,222,263,845
14773,2020-08-21,(02304) Heroes,673,477,427,1577
14774,2020-03-15,(07113) SANTA ISABEL,315,218,409,942
14775,2020-08-13,(02200) Alcalá,1607,1069,939,3615
14776,2020-04-03,(03007) HUMEDAL CORDOBA,77,43,38,158
14777,2020-08-19,(03007) HUMEDAL CORDOBA,140,90,81,311
14778,2020-05-13,(04104) Avenida 68,472,242,254,968
14779,2020-10-01,(04100) Carrera 77,1478,847,1227,3552
14780,2020-01-31,(09117) Calle 45,5379,3688,3132,12199
14781,2020-02-20,(03005) SUBA - AV. BOYACA,2696,1576,1412,5684
14782,2020-02-11,(05101) Mandalay - Cr.73,1248,692,588,2528
14783,2020-02-18,(06101) El Tiempo,2966,1795,1459,6220
14784,2020-02-21,(06105) Quinta Paredes,1025,601,458,2084
14785,2020-07-03,(02101) Toberín,1593,977,1080,3650
14786,2020-07-14,(10003) Ciudad Jardín,134,60,102,296
14787,2020-03-18,(04101) Minuto de Dios,1103,632,763,2498
14788,2020-09-08,(10005) Bicentenario - alimentacion,227,109,201,537
14789,2020-02-13,(04107) Escuela Militar,690,431,466,1587
14790,2020-08-10,(09121) Las Flores,587,398,431,1416
14791,2020-04-28,(02304) Heroes,488,356,275,1119
14792,2020-06-26,(04103) Las Ferias,389,229,169,787
14793,2020-08-26,(05001) Patio Bonito,1808,965,1005,3778
14794,2020-07-14,(06101) El Tiempo,329,162,136,627
14795,2020-07-27,(04105) Carrera 53,267,157,163,587
14796,2020-02-26,(06101) El Tiempo,2949,1692,1458,6099
14797,2020-07-04,(08000) Portal Tunal - alimentacion,5568,2910,3300,11778
14798,2020-04-05,(08000) Portal Tunal - alimentacion,1353,676,731,2760
14799,2020-03-07,(06106) Recinto Ferial,784,440,649,1873
14800,2020-01-06,(04101) Minuto de Dios,299,167,368,834
14801,2020-04-25,(06100) Av. Rojas,69,47,52,168
14802,2020-05-09,(02302) Virrey,303,214,159,676
14803,2020-06-25,(02302) Virrey,694,483,377,1554
14804,2020-09-08,(02302) Virrey,686,509,410,1605
14805,2020-03-18,(12007) Zona Industrial,919,568,355,1842
14806,2020-03-05,(09113) Calle 22,1583,908,1048,3539
14807,2020-04-11,(03013) RIO NEGRO,64,45,40,149
14808,2020-08-10,(07103) AV. CHILE,696,448,424,1568
14809,2020-03-08,(05107) Américas - Cr.53,384,256,489,1129
14810,2020-04-14,(10010) San Bernardo,397,250,236,883
14811,2020-08-06,(10005) Bicentenario,103,45,83,231
14812,2020-10-04,(10005) Bicentenario,24,23,57,104
14813,2020-08-24,(40002) Manitas,359,206,248,813
14814,2020-09-05,(40002) Manitas,369,190,293,852
14815,2020-06-09,(09117) Calle 45,707,419,394,1520
14816,2020-02-21,(12002) CDS - Carrera 32,595,377,311,1283
14817,2020-04-15,(06108) Concejo de Bogotá,105,65,63,233
14818,2020-07-03,(02001) Centro Comercial Santa Fe,548,337,398,1283
14819,2020-09-03,(02001) Centro Comercial Santa Fe,518,314,394,1226
14820,2020-03-25,(02300) Calle 100,832,652,515,1999
14821,2020-06-12,(02102) Calle 161,245,148,132,525
14822,2020-01-26,(05100) Banderas P. Central - alimentacion,3024,1188,2321,6533
14823,2020-02-15,(07104) Simon Bolivar,1496,976,987,3459
14824,2020-09-10,(10008) San Diego,277,128,198,603
14825,2020-06-06,(02200) Alcalá,1279,861,680,2820
14826,2020-04-06,(02202) Calle 127,662,488,324,1474
14827,2020-06-19,(03002) SUBA - TV- 91,768,473,497,1738
14828,2020-05-23,(09004) Santa Lucía,1724,839,937,3500
14829,2020-06-13,(40001) Juan Pablo II,474,259,278,1011
14830,2020-04-28,(02104) Calle 146,463,303,292,1058
14831,2020-03-08,(04108) El Polo,320,201,406,927
14832,2020-04-07,(07006) General Santander,247,155,150,552
14833,2020-01-16,(14005) Las Aguas,1841,1192,1493,4526
14834,2020-04-06,(07200) Tygua-San José,79,55,85,219
14835,2020-07-16,(09106) Nariño,327,191,247,765
14836,2020-09-24,(07005) ALQUERIA,619,353,446,1418
14837,2020-07-29,(03012) SUBA - CALLE 95,320,173,169,662
14838,2020-06-25,(09122) Calle 72,1224,857,753,2834
14839,2020-09-09,(06109) Centro Memoria,281,159,181,621
14840,2020-07-21,(07001) PERDOMO,749,415,451,1615
14841,2019-12-31,(04003) Avenida Ciudad de Cali,41,31,80,152
14842,2020-08-16,(09100) Calle 40 Sur,529,276,475,1280
14843,2020-05-07,(07105) MOVISTAR ARENA,170,123,100,393
14844,2020-04-24,(07105) MOVISTAR ARENA,163,104,95,362
14845,2020-05-26,(07003) SEVILLANA,409,224,189,822
14846,2020-01-25,(07506) DESPENSA,1045,552,732,2329
14847,2020-05-28,(02502) Terminal,365,270,252,887
14848,2020-09-10,(40001) Juan Pablo II,573,324,397,1294
14849,2020-10-10,(09119) Calle 57,480,337,494,1311
14850,2020-08-11,(06107) Ciudad Universitaria,170,111,116,397
14851,2020-05-14,(04103) Las Ferias,267,154,128,549
14852,2020-09-07,(04103) Las Ferias,360,204,210,774
14853,2020-08-07,(05102) Av. Américas - Av. Boyacá,95,52,64,211
14854,2020-08-13,(05102) Av. Américas - Av. Boyacá,236,130,145,511
14855,2020-06-08,(10004) Policarpa,251,118,144,513
14856,2020-09-01,(10004) Policarpa,228,107,154,489
14857,2020-07-24,(09004) Santa Lucía,1814,966,1027,3807
14858,2020-07-20,(09003) Socorro,182,94,94,370
14859,2020-04-29,(10004) Policarpa,161,80,116,357
14860,2020-07-29,(02300) Calle 100,1129,693,580,2402
14861,2020-07-08,(04102) Avenida Boyaca,395,230,247,872
14862,2020-04-18,(40001) Juan Pablo II,212,113,137,462
14863,2020-07-12,(09122) Calle 72,382,257,364,1003
14864,2020-06-23,(06002) Normandía,333,201,218,752
14865,2020-09-03,(06002) Normandía,316,206,202,724
14866,2020-10-05,(04001) Quirigua,423,277,373,1073
14867,2020-04-21,(09120) Calle 63,562,402,358,1322
14868,2020-08-11,(06001) Modelia,326,206,186,718
14869,2020-04-27,(03012) SUBA - CALLE 95,30,82,38,150
14870,2020-01-05,(09121) Las Flores,444,261,536,1241
14871,2020-03-28,(07010) Bosa,181,126,163,470
14872,2020-05-31,(09117) Calle 45,221,127,158,506
14873,2020-08-14,(40002) Manitas,402,223,281,906
14874,2020-04-10,(07001) PERDOMO,122,70,65,257
14875,2020-06-07,(02303) Calle 85,175,99,93,367
14876,2020-03-22,(02303) Calle 85,160,103,102,365
14877,2020-09-17,(07200) Tygua-San José,258,139,176,573
14878,2020-07-08,(07006) General Santander,606,361,331,1298
14879,2020-05-19,(06103) CAN,336,217,159,712
14880,2020-04-04,(12003) Ricaurte,69,55,48,172
14881,2020-04-25,(02204) Pepe Sierra,309,238,161,708
14882,2020-09-20,(05105) Pradera,179,135,148,462
14883,2020-04-14,(03004) GRATAMIRA,24,18,9,51
14884,2020-08-17,(07104) Simon Bolivar,164,113,128,405
14885,2020-05-25,(09110) Avenida Jimenez,200,173,227,600
14886,2020-06-20,(12004) Carrera 22,202,121,131,454
14887,2020-04-13,(07007) NQS - Calle 38A Sur,169,114,100,383
14888,2020-09-25,(10003) Ciudad Jardín,254,110,216,580
14889,2020-04-08,(05100) Banderas P. Central,296,173,216,685
14890,2020-03-26,(07113) SANTA ISABEL,180,122,117,419
14891,2020-09-29,(06105) Quinta Paredes,163,105,106,374
14892,2020-06-07,(08001) Parque el Tunal,127,52,69,248
14893,2020-07-29,(06108) Concejo de Bogotá,135,74,88,297
14894,2020-01-13,(03014) SAN MARTIN,212,133,160,505
14895,2020-10-04,(02103) Mazurén,47,34,109,190
14896,2019-12-31,(04101) Minuto de Dios,16,13,26,55
14897,2020-06-25,(14005) Las Aguas,180,110,202,492
14898,2020-09-04,(06100) Av. Rojas,274,162,160,596
14899,2020-03-30,(10003) Ciudad Jardín,82,50,52,184
14900,2020-04-20,(10005) Bicentenario,58,36,34,128
14901,2020-08-31,(14005) Las Aguas,182,123,226,531
14902,2020-07-20,(10003) Ciudad Jardín,51,22,46,119
14903,2020-05-12,(50002) Corral Calle 40 Sur,14,7,11,32
14904,2020-05-15,(50002) Corral Calle 40 Sur,18,9,17,44
14905,2020-03-28,(03004) GRATAMIRA,18,11,5,34
14906,2020-03-26,(07105) MOVISTAR ARENA,134,119,95,348
14907,2020-06-09,(03014) SAN MARTIN,27,12,25,64
14908,2020-04-14,(03010) PUENTE LARGO,197,139,119,455
14909,2020-06-26,(10005) Bicentenario,124,53,99,276
14910,2020-09-15,(12000) Puente Aranda,93,43,54,190
14911,2020-04-18,(50006) Corral Carrera 77,3,4,3,10
14912,2020-06-23,(50006) Corral Carrera 77,8,3,7,18
14913,2019-12-31,(07003) SEVILLANA,10,11,28,49
14914,2020-03-30,(03004) GRATAMIRA,16,17,9,42
14915,2020-04-11,(50002) Corral Calle 40 Sur,2,1,4,7
14916,2020-08-23,(04000) Cabecera Calle 80 - alimentacion,1036,532,959,2527
14917,2020-09-02,(04000) Cabecera Calle 80 - alimentacion,4463,2614,3081,10158
14918,2020-09-18,(04000) Cabecera Calle 80 - alimentacion,4987,2722,3775,11484
14919,2020-03-02,(07005) ALQUERIA,2552,1452,1503,5507
14920,2020-03-17,(09118) Marly,3727,2479,2097,8303
14921,2020-08-12,(09118) Marly,1415,899,692,3006
14922,2020-03-18,(03002) SUBA - TV- 91,2077,1155,1200,4432
14923,2020-01-13,(03010) PUENTE LARGO,1749,1068,1072,3889
14924,2020-01-31,(02000) Cabecera Autopista Norte - alimentacion,22719,12378,13328,48425
14925,2020-01-24,(09000) Cabecera Usme - alimentacion,24866,12876,14848,52590
14926,2020-01-09,(09003) Socorro,1297,692,811,2800
14927,2020-01-13,(07010) Bosa,1882,1125,1374,4381
14928,2020-02-12,(07000) Portal Sur - alimentacion,30352,17572,14393,62317
14929,2020-02-16,(10001) Country Sur,849,345,1033,2227
14930,2020-08-22,(09000) Cabecera Usme,1257,686,1071,3014
14931,2020-01-22,(02204) Pepe Sierra,4800,3126,2357,10283
14932,2020-03-06,(10005) Bicentenario - alimentacion,685,338,551,1574
14933,2020-06-08,(09000) Cabecera Usme - alimentacion,8142,4551,4627,17320
14934,2020-01-31,(05107) Américas - Cr.53,2393,1365,1444,5202
14935,2020-02-17,(04000) Cabecera Calle 80 - intermunicipal,2432,1725,2130,6287
14936,2020-01-16,(09104) Restrepo,4695,2720,3704,11119
14937,2020-02-28,(09104) Restrepo,5330,3216,3981,12527
14938,2020-02-12,(04101) Minuto de Dios,3772,2255,1846,7873
14939,2020-05-16,(04101) Minuto de Dios,171,86,113,370
14940,2020-01-29,(04100) Carrera 77,6546,3798,3813,14157
14941,2020-02-18,(04100) Carrera 77,6972,4352,3958,15282
14942,2020-09-26,(07505) LEON XIII,2519,1143,1465,5127
14943,2020-07-20,(02204) Pepe Sierra,229,186,136,551
14944,2020-03-14,(10006) San Victorino,991,772,922,2685
14945,2020-01-22,(07110) PALOQUEMAO,2335,1355,1022,4712
14946,2020-01-26,(07110) PALOQUEMAO,379,308,435,1122
14947,2020-02-21,(06106) Recinto Ferial,1396,834,819,3049
14948,2020-02-10,(04100) Carrera 77,6964,4382,4033,15379
14949,2020-08-06,(07102) NQS - CALLE 75,311,199,197,707
14950,2020-08-17,(07102) NQS - CALLE 75,103,77,65,245
14951,2020-03-14,(03013) RIO NEGRO,614,363,571,1548
14952,2020-05-25,(09118) Marly,502,358,260,1120
14953,2020-04-30,(02302) Virrey,423,288,241,952
14954,2020-06-08,(07000) Portal Sur - alimentacion,7467,4195,3459,15121
14955,2020-02-23,(02103) Mazurén,252,142,396,790
14956,2020-10-07,(09103) Olaya,1216,630,907,2753
14957,2020-08-18,(14001) La Sabana,172,106,100,378
14958,2020-02-23,(07106) EL CAMPIN,432,298,411,1141
14959,2020-01-13,(02000) Cabecera Autopista Norte - intermunicipal,3647,2485,2531,8663
14960,2020-01-21,(04105) Carrera 53,880,532,497,1909
14961,2020-09-15,(08000) Portal Tunal - alimentacion,6363,3637,4195,14195
14962,2020-01-15,(50003) Corral Molinos,2706,1988,3308,8002
14963,2020-06-25,(50003) Corral Molinos,1592,870,1091,3553
14964,2020-01-27,(04000) Cabecera Calle 80,6977,4382,4709,16068
14965,2020-02-10,(04000) Cabecera Calle 80,7755,4932,5071,17758
14966,2020-04-24,(04000) Cabecera Calle 80,564,372,379,1315
14967,2020-01-05,(07010) Bosa,332,206,411,949
14968,2020-08-26,(07010) Bosa,622,292,371,1285
14969,2020-09-16,(08000) Portal Tunal - alimentacion,6789,3867,4442,15098
14970,2020-07-02,(07112) COMUNEROS,863,490,485,1838
14971,2020-02-16,(09114) Calle 26,244,195,454,893
14972,2020-06-05,(04002) Carrera 90,679,354,380,1413
14973,2020-05-30,(07000) Portal Sur - alimentacion,5595,2939,2646,11180
14974,2020-02-18,(40003) Mirador del Paraiso,5049,2804,2697,10550
14975,2020-03-24,(06000) Portal Eldorado - alimentacion,3939,1798,1949,7686
14976,2020-03-06,(02205) Calle 106,2559,1630,1486,5675
14977,2020-07-29,(06105) Quinta Paredes,127,86,76,289
14978,2020-04-17,(08000) Portal Tunal - alimentacion,3447,1801,1837,7085
14979,2020-04-29,(08000) Portal Tunal - alimentacion,3860,2013,1943,7816
14980,2020-07-26,(09004) Santa Lucía,615,260,386,1261
14981,2020-02-26,(10004) Policarpa,958,464,591,2013
14982,2020-05-15,(08001) Parque el Tunal,364,192,215,771
14983,2020-06-26,(08001) Parque el Tunal,529,292,285,1106
14984,2020-09-10,(09116) Avenida 39,382,227,245,854
14985,2020-01-02,(02302) Virrey,1677,1052,991,3720
14986,2020-08-15,(06108) Concejo de Bogotá,108,58,81,247
14987,2020-08-31,(06108) Concejo de Bogotá,131,82,72,285
14988,2020-01-30,(03005) SUBA - AV. BOYACA,2734,1613,1552,5899
14989,2020-08-30,(40003) Mirador del Paraiso,653,331,546,1530
14990,2020-07-01,(09107) Hortúa,636,368,405,1409
14991,2020-09-14,(09123) Calle 76,1044,712,689,2445
14992,2020-01-13,(05101) Mandalay - Cr.73,882,481,427,1790
14993,2020-05-24,(05002) Tintal,529,255,285,1069
14994,2020-09-24,(02103) Mazurén,259,175,247,681
14995,2020-03-22,(06000) Portal Eldorado - alimentacion,1008,383,334,1725
14996,2020-01-27,(03012) SUBA - CALLE 95,1301,800,974,3075
14997,2020-02-01,(10000) Portal 20 de Julio,5418,2324,3562,11304
14998,2020-10-01,(10000) Portal 20 de Julio,2543,1203,1661,5407
14999,2020-01-26,(08000) Portal Tunal,548,356,382,1286
15000,2020-10-09,(05001) Patio Bonito,2356,1206,1629,5191
15001,2020-09-16,(05105) Pradera,656,389,367,1412
15002,2020-10-08,(02205) Calle 106,456,305,349,1110
15003,2020-08-27,(09118) Marly,1311,868,763,2942
15004,2020-04-29,(04003) Avenida Ciudad de Cali,634,373,439,1446
15005,2020-05-19,(04108) El Polo,385,256,192,833
15006,2020-03-11,(07103) AV. CHILE,3462,2160,1810,7432
15007,2020-09-16,(07010) Bosa,0,374,961,1335
15008,2020-09-23,(06000) Portal Eldorado,960,698,685,2343
15009,2020-01-16,(10006) San Victorino,1703,1009,1147,3859
15010,2020-08-14,(10006) San Victorino,667,344,355,1366
15011,2020-08-13,(04000) Cabecera Calle 80 - alimentacion,3395,1950,2278,7623
15012,2020-01-05,(09117) Calle 45,469,339,671,1479
15013,2020-01-23,(05103) Marsella,2686,1500,1374,5560
15014,2020-03-29,(09100) Calle 40 Sur,255,156,156,567
15015,2020-07-08,(07104) Simon Bolivar,606,396,286,1288
15016,2020-07-06,(04107) Escuela Militar,140,95,82,317
15017,2020-05-26,(02303) Calle 85,628,441,342,1411
15018,2020-08-14,(04002) Carrera 90,647,352,373,1372
15019,2020-09-07,(05001) Patio Bonito,2006,1038,1238,4282
15020,2020-03-11,(07109) CAD,2665,1687,1502,5854
15021,2020-08-26,(06101) El Tiempo,357,205,188,750
15022,2020-09-05,(04104) Avenida 68,483,260,377,1120
15023,2020-10-01,(04104) Avenida 68,743,367,538,1648
15024,2020-09-25,(03002) SUBA - TV- 91,988,543,696,2227
15025,2020-03-14,(06100) Av. Rojas,730,458,735,1923
15026,2020-01-18,(04001) Quirigua,1024,483,845,2352
15027,2020-10-09,(06104) Gobernación,292,211,193,696
15028,2020-07-04,(04002) Carrera 90,593,308,352,1253
15029,2020-07-28,(02302) Virrey,609,428,305,1342
15030,2020-03-12,(12003) Ricaurte,677,33,138,848
15031,2020-05-30,(12003) Ricaurte,235,188,143,566
15032,2020-05-08,(07106) EL CAMPIN,233,137,139,509
15033,2020-05-01,(03010) PUENTE LARGO,105,76,52,233
15034,2020-08-08,(10010) San Bernardo,406,195,325,926
15035,2020-04-10,(03009) Av. Suba- Calle 116,134,97,74,305
15036,2020-06-10,(03009) Av. Suba- Calle 116,489,311,209,1009
15037,2020-08-14,(04106) Carrera 47,271,151,155,577
15038,2020-10-10,(07009) SENA,587,327,573,1487
15039,2020-09-27,(02105) Calle 142,202,157,304,663
15040,2020-01-11,(08002) Biblioteca,524,255,405,1184
15041,2020-02-15,(06106) Recinto Ferial,842,482,653,1977
15042,2020-03-03,(09109) Tercer Milenio,1352,841,883,3076
15043,2020-07-17,(09109) Tercer Milenio,221,132,170,523
15044,2020-10-04,(09116) Avenida 39,89,71,164,324
15045,2020-09-15,(07010) Bosa,0,356,948,1304
15046,2020-09-20,(03006) NIZA - CALLE 127,187,128,137,452
15047,2020-09-27,(03006) NIZA - CALLE 127,179,112,164,455
15048,2020-03-10,(50003) Corral Molinos,99,870,921,1890
15049,2020-05-23,(07103) AV. CHILE,518,319,270,1107
15050,2020-09-17,(07103) AV. CHILE,1002,612,552,2166
15051,2020-08-14,(10005) Bicentenario,100,63,91,254
15052,2020-09-29,(10005) Bicentenario,113,70,93,276
15053,2020-02-10,(40002) Manitas,1320,795,769,2884
15054,2020-08-29,(40002) Manitas,335,197,280,812
15055,2020-09-01,(06109) Centro Memoria,274,148,150,572
15056,2020-08-27,(09106) Nariño,407,244,303,954
15057,2020-03-14,(07003) SEVILLANA,991,515,801,2307
15058,2020-05-21,(02001) Centro Comercial Santa Fe,341,206,213,760
15059,2020-07-25,(07004) VENECIA,605,346,376,1327
15060,2020-06-19,(10008) San Diego,301,158,192,651
15061,2020-09-12,(10010) San Bernardo,498,246,412,1156
15062,2020-05-26,(10009) Museo Nacional,467,289,278,1034
15063,2020-06-12,(10009) Museo Nacional,499,303,282,1084
15064,2020-10-08,(10009) Museo Nacional,596,383,482,1461
15065,2020-03-02,(10004) Policarpa,873,434,542,1849
15066,2020-05-21,(09004) Santa Lucía,2076,1110,1055,4241
15067,2020-04-01,(02104) Calle 146,371,280,206,857
15068,2020-09-19,(07110) PALOQUEMAO,483,333,392,1208
15069,2020-03-27,(07006) General Santander,235,133,110,478
15070,2020-06-29,(02304) Heroes,244,175,173,592
15071,2020-02-27,(09111) Calle 19,2418,1370,1606,5394
15072,2020-06-15,(03012) SUBA - CALLE 95,93,66,78,237
15073,2020-05-02,(09122) Calle 72,517,355,287,1159
15074,2020-06-22,(07000) Portal Sur,554,310,395,1259
15075,2020-06-29,(07000) Portal Sur,598,313,420,1331
15076,2020-08-15,(06109) Centro Memoria,166,110,141,417
15077,2020-09-04,(09111) Calle 19,808,490,532,1830
15078,2020-04-12,(09103) Olaya,174,101,104,379
15079,2020-06-02,(06104) Gobernación,245,142,95,482
15080,2020-05-31,(07105) MOVISTAR ARENA,54,30,44,128
15081,2020-06-21,(07105) MOVISTAR ARENA,69,41,57,167
15082,2020-02-15,(07506) DESPENSA,1188,557,762,2507
15083,2020-06-17,(14005) Las Aguas,144,114,205,463
15084,2020-06-26,(14005) Las Aguas,192,140,221,553
15085,2020-07-25,(14005) Las Aguas,115,65,134,314
15086,2020-05-20,(09114) Calle 26,238,178,147,563
15087,2020-04-18,(02303) Calle 85,230,184,140,554
15088,2020-08-30,(06109) Centro Memoria,71,48,67,186
15089,2020-06-12,(07000) Portal Sur,1803,1142,1087,4032
15090,2020-10-11,(04003) Avenida Ciudad de Cali,331,175,436,942
15091,2020-08-27,(09121) Las Flores,684,415,455,1554
15092,2020-03-08,(10003) Ciudad Jardín,191,104,257,552
15093,2020-04-24,(02104) Calle 146,414,291,254,959
15094,2020-05-31,(06107) Ciudad Universitaria,47,35,38,120
15095,2020-08-18,(03011) SUBA - CALLE 100,501,217,224,942
15096,2020-07-08,(05102) Av. Américas - Av. Boyacá,238,134,186,558
15097,2020-08-06,(05102) Av. Américas - Av. Boyacá,213,108,136,457
15098,2020-06-20,(10007) Las Nieves,473,313,327,1113
15099,2020-04-17,(12000) Puente Aranda,49,28,19,96
15100,2020-08-20,(12000) Puente Aranda,84,46,38,168
15101,2020-03-10,(07109) CAD,1261,213,422,1896
15102,2020-06-18,(12004) Carrera 22,255,139,132,526
15103,2020-05-05,(07111) NQS - RICAURTE,691,459,295,1445
15104,2020-08-14,(02102) Calle 161,226,132,198,556
15105,2020-09-15,(06001) Modelia,376,254,251,881
15106,2020-08-28,(09114) Calle 26,320,185,237,742
15107,2020-08-17,(10009) Museo Nacional,79,50,82,211
15108,2020-07-21,(03013) RIO NEGRO,256,148,175,579
15109,2020-07-31,(02201) Prado,668,455,402,1525
15110,2020-07-22,(09115) Calle 34,540,354,293,1187
15111,2020-06-01,(07006) General Santander,452,303,269,1024
15112,2020-08-06,(09106) Nariño,359,204,287,850
15113,2020-04-01,(06002) Normandía,139,92,111,342
15114,2020-08-08,(05107) Américas - Cr.53,249,159,184,592
15115,2020-07-04,(09111) Calle 19,647,442,502,1591
15116,2020-04-19,(07109) CAD,188,131,68,387
15117,2020-07-21,(03001) LA CAMPIÑA,999,622,556,2177
15118,2020-08-22,(02204) Pepe Sierra,515,374,358,1247
15119,2020-07-19,(09117) Calle 45,219,125,140,484
15120,2020-05-31,(03012) SUBA - CALLE 95,67,56,69,192
15121,2020-04-11,(02502) Terminal,64,57,65,186
15122,2020-01-26,(03004) GRATAMIRA,64,29,64,157
15123,2020-08-29,(09111) Calle 19,604,398,478,1480
15124,2020-06-21,(03011) SUBA - CALLE 100,138,91,84,313
15125,2020-08-30,(04002) Carrera 90,235,106,181,522
15126,2020-05-07,(05101) Mandalay - Cr.73,76,49,43,168
15127,2020-03-31,(10008) San Diego,148,94,101,343
15128,2020-09-06,(06109) Centro Memoria,85,57,93,235
15129,2020-05-14,(09108) Hospital,64,41,55,160
15130,2020-04-11,(07107) U. NACIONAL,139,88,59,286
15131,2020-06-07,(02304) Heroes,157,144,138,439
15132,2020-04-18,(06102) Salitre El Greco,107,74,72,253
15133,2020-10-12,(02303) Calle 85,204,159,223,586
15134,2020-07-26,(10005) Bicentenario,19,16,18,53
15135,2020-07-08,(10004) Policarpa,285,132,158,575
15136,2020-06-01,(03004) GRATAMIRA,27,16,18,61
15137,2020-08-06,(04106) Carrera 47,238,111,164,513
15138,2020-08-01,(03009) Av. Suba- Calle 116,267,178,148,593
15139,2020-08-10,(10003) Ciudad Jardín,210,98,150,458
15140,2020-10-11,(06111) Universidades,157,82,274,513
15141,2020-08-13,(06103) CAN,343,202,174,719
15142,2020-03-12,(50002) Corral Calle 40 Sur,10,29,46,85
15143,2020-05-29,(14005) Las Aguas,0,57,195,252
15144,2020-06-25,(07106) EL CAMPIN,417,257,233,907
15145,2020-05-11,(09114) Calle 26,207,149,144,500
15146,2020-08-02,(09111) Calle 19,175,117,213,505
15147,2020-06-29,(12002) CDS - Carrera 32,43,46,26,115
15148,2020-09-22,(06103) CAN,411,264,224,899
15149,2020-08-22,(10005) Bicentenario - alimentacion,158,77,164,399
15150,2020-05-16,(05103) Marsella,173,81,104,358
15151,2020-07-25,(08002) Biblioteca,181,99,108,388
15152,2020-07-26,(05102) Av. Américas - Av. Boyacá,43,22,35,100
15153,2020-06-15,(04001) Quirigua,152,83,97,332
15154,2020-03-31,(07101) CASTELLANA,52,47,69,168
15155,2020-03-28,(04102) Avenida Boyaca,75,44,57,176
15156,2020-03-22,(09106) Nariño,68,44,50,162
15157,2020-07-20,(07008) NQS - Calle 30 Sur,88,51,63,202
15158,2020-01-01,(09003) Socorro,176,71,204,451
15159,2020-09-05,(07108) Av. El Dorado,106,75,102,283
15160,2020-09-09,(50006) Corral Carrera 77,4,2,11,17
15161,2020-03-03,(50006) Corral Carrera 77,29,24,34,87
15162,2020-08-23,(06106) Recinto Ferial,56,37,38,131
15163,2019-12-31,(10005) Bicentenario - alimentacion,3,7,20,30
15164,2019-12-31,(06100) Av. Rojas,15,10,22,47
15165,2020-05-25,(50002) Corral Calle 40 Sur,9,2,4,15
15166,2020-03-11,(04000) Cabecera Calle 80 - alimentacion,21975,13486,14223,49684
15167,2020-03-15,(04000) Cabecera Calle 80 - alimentacion,3532,1672,3390,8594
15168,2020-02-25,(09002) Consuelo,1504,874,852,3230
15169,2020-06-20,(09002) Consuelo,371,177,265,813
15170,2020-10-08,(09002) Consuelo,532,282,410,1224
15171,2020-08-03,(07504) TERREROS,5449,2970,2601,11020
15172,2020-01-30,(10000) Portal 20 de Julio - alimentacion,10810,5366,7292,23468
15173,2020-05-11,(02303) Calle 85,480,348,275,1103
15174,2020-09-29,(03000) Portal Suba - alimentacion,7407,3966,4939,16312
15175,2020-01-22,(03002) SUBA - TV- 91,4093,2380,2310,8783
15176,2020-02-05,(07503) SAN MATEO,42118,23616,18212,83946
15177,2020-09-25,(07503) SAN MATEO,14290,6980,7492,28762
15178,2020-03-19,(05000) Portal Américas,8188,4022,4500,16710
15179,2020-05-04,(05000) Portal Américas,1518,1118,1251,3887
15180,2020-08-19,(05000) Portal Américas,2645,1664,1874,6183
15181,2020-05-07,(09003) Socorro,402,207,210,819
15182,2020-03-02,(02000) Cabecera Autopista Norte - alimentacion,23194,13776,13326,50296
15183,2020-06-02,(09000) Cabecera Usme - alimentacion,7573,4405,4521,16499
15184,2020-09-28,(09000) Cabecera Usme - alimentacion,9556,4794,6122,20472
15185,2020-09-02,(04002) Carrera 90,763,454,490,1707
15186,2020-02-05,(09001) Molinos,7731,4609,6206,18546
15187,2020-01-27,(02000) Cabecera Autopista Norte - alimentacion,22168,12722,12719,47609
15188,2020-01-03,(05100) Banderas P. Central,2909,1594,1866,6369
15189,2020-06-26,(09100) Calle 40 Sur,1938,1136,1253,4327
15190,2020-02-22,(09000) Cabecera Usme,3849,1982,3157,8988
15191,2020-10-09,(09000) Cabecera Usme,2005,1116,1733,4854
15192,2020-02-08,(05100) Banderas P. Central - alimentacion,8727,4050,6089,18866
15193,2020-04-24,(06000) Portal Eldorado - alimentacion,2477,1231,1015,4723
15194,2020-02-28,(02204) Pepe Sierra,4919,3155,2452,10526
15195,2020-09-30,(10005) Bicentenario - alimentacion,221,110,212,543
15196,2020-03-04,(09120) Calle 63,7240,4674,3823,15737
15197,2020-01-21,(07113) SANTA ISABEL,1458,755,807,3020
15198,2020-03-20,(07504) TERREROS,2131,1438,1127,4696
15199,2020-02-18,(07111) NQS - RICAURTE,3306,2121,1834,7261
15200,2020-03-26,(07102) NQS - CALLE 75,145,112,113,370
15201,2020-04-03,(07102) NQS - CALLE 75,154,128,118,400
15202,2020-07-15,(03013) RIO NEGRO,276,147,149,572
15203,2020-02-10,(03001) LA CAMPIÑA,6664,4303,4115,15082
15204,2020-08-08,(50003) Corral Molinos,1157,539,805,2501
15205,2020-07-06,(07000) Portal Sur - alimentacion,8378,4919,4232,17529
15206,2020-03-10,(14001) La Sabana,307,32,76,415
15207,2020-04-15,(14001) La Sabana,75,54,81,210
15208,2020-03-16,(02000) Cabecera Autopista Norte - alimentacion,15472,8698,8640,32810
15209,2020-01-10,(07002) MADELENA,3576,1876,2137,7589
15210,2020-02-12,(07112) COMUNEROS,3999,2446,2379,8824
15211,2020-02-07,(10007) Las Nieves,2028,1286,1293,4607
15212,2020-07-12,(09110) Avenida Jimenez,625,523,514,1662
15213,2020-08-14,(10001) Country Sur,1236,558,743,2537
15214,2020-09-25,(10001) Country Sur,1509,682,1013,3204
15215,2020-01-13,(06109) Centro Memoria,945,508,577,2030
15216,2020-03-24,(06000) Portal Eldorado,1174,1028,740,2942
15217,2020-06-25,(06000) Portal Eldorado,1013,692,514,2219
15218,2020-01-21,(40003) Mirador del Paraiso,3787,2057,2073,7917
15219,2020-01-10,(05002) Tintal,8613,4596,4890,18099
15220,2020-08-02,(06000) Portal Eldorado - alimentacion,988,496,678,2162
15221,2020-02-01,(12001) Carrera 43,761,491,879,2131
15222,2020-02-11,(12001) Carrera 43,1794,1027,1135,3956
15223,2020-05-01,(05100) Banderas P. Central - alimentacion,821,371,371,1563
15224,2020-02-13,(02304) Heroes,4902,3413,2368,10683
15225,2020-08-26,(02000) Cabecera Autopista Norte - intermunicipal,479,301,341,1121
15226,2020-08-31,(09101) Quiroga,466,256,400,1122
15227,2020-09-22,(09101) Quiroga,578,300,463,1341
15228,2020-04-20,(03000) Portal Suba - alimentacion,3434,1995,1787,7216
15229,2020-04-07,(10000) Portal 20 de Julio - alimentacion,2641,969,1338,4948
15230,2020-10-12,(02000) Cabecera Autopista Norte - alimentacion,2028,886,1827,4741
15231,2020-05-18,(07112) COMUNEROS,618,360,367,1345
15232,2020-07-02,(02303) Calle 85,773,506,389,1668
15233,2020-09-24,(04002) Carrera 90,856,464,526,1846
15234,2020-06-06,(09004) Santa Lucía,1985,919,1083,3987
15235,2020-03-14,(40003) Mirador del Paraiso,3489,1739,2240,7468
15236,2020-06-26,(04100) Carrera 77,1388,768,900,3056
15237,2020-03-27,(07503) SAN MATEO,5679,2977,2863,11519
15238,2020-04-07,(07503) SAN MATEO,5087,2965,2476,10528
15239,2020-08-24,(08001) Parque el Tunal,391,198,226,815
15240,2020-09-23,(09116) Avenida 39,440,275,311,1026
15241,2020-03-14,(07008) NQS - Calle 30 Sur,999,436,694,2129
15242,2020-04-24,(14004) Museo del Oro,0,45,112,157
15243,2020-09-30,(14004) Museo del Oro,426,277,326,1029
15244,2020-05-29,(02201) Prado,811,559,427,1797
15245,2020-06-11,(02201) Prado,859,580,450,1889
15246,2020-07-16,(09107) Hortúa,517,324,299,1140
15247,2020-09-12,(09123) Calle 76,703,502,628,1833
15248,2020-05-02,(10000) Portal 20 de Julio,1035,490,556,2081
15249,2020-05-09,(10000) Portal 20 de Julio,1210,596,667,2473
15250,2020-02-29,(03011) SUBA - CALLE 100,1192,716,1145,3053
15251,2020-02-16,(05100) Banderas P. Central,859,336,897,2092
15252,2020-06-03,(05005) Transversal 86,285,164,172,621
15253,2020-07-03,(02202) Calle 127,1252,799,650,2701
15254,2020-01-24,(09106) Nariño,1847,1060,1304,4211
15255,2020-08-31,(03009) Av. Suba- Calle 116,538,332,253,1123
15256,2020-02-20,(09113) Calle 22,1525,907,991,3423
15257,2020-01-08,(04108) El Polo,1300,873,865,3038
15258,2020-03-26,(08000) Portal Tunal - alimentacion,3250,1650,1627,6527
15259,2020-01-25,(12007) Zona Industrial,645,445,465,1555
15260,2020-01-16,(07000) Portal Sur,7028,3866,4130,15024
15261,2020-05-23,(06000) Portal Eldorado - alimentacion,2514,1185,1234,4933
15262,2020-06-27,(07106) EL CAMPIN,304,216,189,709
15263,2020-06-19,(07113) SANTA ISABEL,423,272,315,1010
15264,2020-05-06,(03007) HUMEDAL CORDOBA,87,59,35,181
15265,2020-02-25,(03005) SUBA - AV. BOYACA,2884,1683,1622,6189
15266,2020-04-05,(09000) Cabecera Usme,302,169,195,666
15267,2020-04-25,(02101) Toberín,414,288,317,1019
15268,2020-04-28,(02101) Toberín,728,521,453,1702
15269,2020-01-08,(06101) El Tiempo,1887,1046,1013,3946
15270,2020-07-15,(07104) Simon Bolivar,578,345,225,1148
15271,2020-08-15,(07104) Simon Bolivar,413,289,289,991
15272,2020-06-18,(10005) Bicentenario - alimentacion,224,122,160,506
15273,2020-06-04,(07109) CAD,617,382,242,1241
15274,2020-06-26,(07004) VENECIA,1070,616,614,2300
15275,2020-02-01,(02105) Calle 142,2892,1343,2330,6565
15276,2020-08-18,(03001) LA CAMPIÑA,989,599,583,2171
15277,2020-03-20,(40003) Mirador del Paraiso,548,342,290,1180
15278,2020-04-03,(03002) SUBA - TV- 91,418,249,250,917
15279,2020-01-16,(04000) Cabecera Calle 80 - intermunicipal,1697,1174,1776,4647
15280,2020-05-29,(09121) Las Flores,645,421,371,1437
15281,2020-04-25,(05002) Tintal,1000,545,469,2014
15282,2020-04-21,(05001) Patio Bonito,969,538,587,2094
15283,2020-08-29,(09116) Avenida 39,204,153,208,565
15284,2020-01-31,(07004) VENECIA,4596,2515,2593,9704
15285,2020-09-20,(06106) Recinto Ferial,95,60,116,271
15286,2020-06-27,(02001) Centro Comercial Santa Fe,397,242,300,939
15287,2020-05-05,(07009) SENA,427,226,261,914
15288,2020-05-28,(07009) SENA,574,369,353,1296
15289,2020-03-23,(06100) Av. Rojas,52,31,19,102
15290,2020-04-25,(02302) Virrey,264,194,175,633
15291,2020-03-22,(07009) SENA,121,78,63,262
15292,2020-05-06,(10010) San Bernardo,474,256,292,1022
15293,2020-09-11,(06103) CAN,349,201,195,745
15294,2020-06-19,(09004) Santa Lucía,2727,1452,1362,5541
15295,2020-02-03,(09109) Tercer Milenio,1360,869,847,3076
15296,2020-07-20,(07007) NQS - Calle 38A Sur,176,102,115,393
15297,2020-01-05,(02300) Calle 100,675,584,951,2210
15298,2020-02-24,(04000) Cabecera Calle 80 - intermunicipal,2485,1713,2149,6347
15299,2020-08-15,(04000) Cabecera Calle 80 - intermunicipal,224,100,207,531
15300,2020-07-19,(02104) Calle 146,212,149,135,496
15301,2020-09-08,(12007) Zona Industrial,407,231,199,837
15302,2020-03-05,(07105) MOVISTAR ARENA,1284,809,721,2814
15303,2020-05-03,(40002) Manitas,89,60,71,220
15304,2020-10-03,(02304) Heroes,615,469,584,1668
15305,2020-01-16,(07006) General Santander - alimentacion,1246,733,868,2847
15306,2020-09-11,(02102) Calle 161,273,140,184,597
15307,2020-01-08,(06105) Quinta Paredes,631,368,384,1383
15308,2020-06-04,(02200) Alcalá,1655,1132,834,3621
15309,2020-06-01,(09120) Calle 63,991,652,619,2262
15310,2020-06-10,(10009) Museo Nacional,487,305,241,1033
15311,2020-08-07,(07002) MADELENA,285,146,202,633
15312,2020-09-04,(07101) CASTELLANA,234,136,146,516
15313,2020-07-12,(09123) Calle 76,264,214,257,735
15314,2020-01-10,(07008) NQS - Calle 30 Sur,1405,711,857,2973
15315,2020-08-16,(09111) Calle 19,170,136,173,479
15316,2020-05-12,(06104) Gobernación,196,142,80,418
15317,2020-04-30,(07105) MOVISTAR ARENA,164,97,88,349
15318,2020-10-08,(50003) Corral Molinos,1554,791,1509,3854
15319,2020-05-25,(09114) Calle 26,57,40,38,135
15320,2020-06-12,(07201) Guatoque -Veraguas,209,107,127,443
15321,2020-01-03,(07107) U. NACIONAL,536,450,596,1582
15322,2020-07-17,(07003) SEVILLANA,371,218,228,817
15323,2020-09-17,(07107) U. NACIONAL,401,228,238,867
15324,2020-09-14,(04102) Avenida Boyaca,351,204,267,822
15325,2020-09-27,(09119) Calle 57,202,132,255,589
15326,2020-09-27,(10007) Las Nieves,138,106,186,430
15327,2020-06-19,(04108) El Polo,511,307,257,1075
15328,2020-04-16,(40003) Mirador del Paraiso,1013,524,719,2256
15329,2020-01-10,(50002) Corral Calle 40 Sur,99,38,100,237
15330,2020-04-20,(07109) CAD,434,310,193,937
15331,2020-05-15,(07506) DESPENSA,373,194,186,753
15332,2020-05-28,(02102) Calle 161,203,128,115,446
15333,2020-09-25,(02102) Calle 161,316,164,244,724
15334,2020-02-03,(09111) Calle 19,2357,1409,1614,5380
15335,2020-05-19,(04107) Escuela Militar,104,76,62,242
15336,2020-09-22,(06001) Modelia,411,261,271,943
15337,2020-05-16,(09003) Socorro,416,200,226,842
15338,2020-07-13,(10009) Museo Nacional,362,237,238,837
15339,2020-05-13,(06002) Normandía,250,135,147,532
15340,2020-02-22,(40001) Juan Pablo II,1187,631,763,2581
15341,2020-05-17,(09001) Molinos,577,287,458,1322
15342,2020-04-05,(02200) Alcalá,354,259,186,799
15343,2020-07-20,(02502) Terminal,101,66,84,251
15344,2020-06-03,(09114) Calle 26,271,187,166,624
15345,2020-01-06,(14001) La Sabana,69,49,86,204
15346,2020-06-04,(07108) Av. El Dorado,125,85,80,290
15347,2020-08-08,(07108) Av. El Dorado,82,57,56,195
15348,2020-05-07,(06002) Normandía,206,115,123,444
15349,2020-03-23,(07506) DESPENSA,85,49,70,204
15350,2020-10-05,(03010) PUENTE LARGO,408,248,299,955
15351,2020-01-26,(09109) Tercer Milenio,340,177,410,927
15352,2020-02-26,(09108) Hospital,226,148,199,573
15353,2020-01-23,(09105) Río Fucha,723,404,471,1598
15354,2020-05-17,(02502) Terminal,45,45,68,158
15355,2020-05-07,(04003) Avenida Ciudad de Cali,693,412,445,1550
15356,2020-06-07,(09117) Calle 45,245,129,173,547
15357,2020-09-03,(09106) Nariño,474,241,336,1051
15358,2020-06-05,(02000) Cabecera Autopista Norte - intermunicipal,514,342,319,1175
15359,2020-03-22,(05100) Banderas P. Central,119,49,76,244
15360,2020-04-20,(05102) Av. Américas - Av. Boyacá,137,81,70,288
15361,2020-07-16,(06103) CAN,340,220,154,714
15362,2020-09-26,(07107) U. NACIONAL,285,195,285,765
15363,2020-06-28,(05107) Américas - Cr.53,93,81,101,275
15364,2020-04-27,(10009) Museo Nacional,42,137,66,245
15365,2020-05-30,(04000) Cabecera Calle 80 - intermunicipal,136,81,128,345
15366,2020-01-12,(07506) DESPENSA,337,172,342,851
15367,2020-04-29,(09111) Calle 19,403,233,301,937
15368,2020-09-07,(06101) El Tiempo,364,222,222,808
15369,2020-05-02,(06103) CAN,215,134,106,455
15370,2020-04-20,(02105) Calle 142,421,273,217,911
15371,2020-04-27,(06002) Normandía,70,48,32,150
15372,2020-04-13,(04003) Avenida Ciudad de Cali,508,340,379,1227
15373,2020-01-06,(03007) HUMEDAL CORDOBA,109,68,108,285
15374,2019-12-31,(09109) Tercer Milenio,28,13,24,65
15375,2020-06-01,(07506) DESPENSA,465,255,277,997
15376,2020-08-05,(10003) Ciudad Jardín,182,82,154,418
15377,2020-04-03,(09101) Quiroga,202,108,168,478
15378,2020-07-27,(06100) Av. Rojas,204,116,130,450
15379,2020-04-19,(03003) 21 ANGELES,47,25,22,94
15380,2020-03-15,(08002) Biblioteca,175,85,188,448
15381,2020-07-27,(06106) Recinto Ferial,212,133,118,463
15382,2020-05-15,(04105) Carrera 53,223,136,119,478
15383,2020-05-04,(40002) Manitas,232,122,162,516
15384,2020-07-22,(07108) Av. El Dorado,148,86,73,307
15385,2020-05-01,(06105) Quinta Paredes,31,26,21,78
15386,2020-08-04,(09105) Río Fucha,0,56,132,188
15387,2020-05-02,(04001) Quirigua,145,93,67,305
15388,2020-10-11,(07506) DESPENSA,98,73,151,322
15389,2020-04-04,(07201) Guatoque -Veraguas,38,33,41,112
15390,2020-08-27,(06108) Concejo de Bogotá,137,70,77,284
15391,2020-04-28,(02102) Calle 161,128,85,80,293
15392,2020-03-23,(07108) Av. El Dorado,30,24,25,79
15393,2020-05-31,(05101) Mandalay - Cr.73,24,12,11,47
15394,2020-03-21,(09105) Río Fucha,29,23,22,74
15395,2020-04-17,(10005) Bicentenario,44,28,44,116
15396,2020-04-17,(03014) SAN MARTIN,14,8,15,37
15397,2020-06-14,(02102) Calle 161,56,37,64,157
15398,2020-07-16,(03004) GRATAMIRA,28,9,12,49
15399,2020-06-22,(50006) Corral Carrera 77,3,1,1,5
15400,2020-01-03,(50004) Corral Avenida Ciudad de Cali,0,0,1,1
15401,2020-02-19,(04000) Cabecera Calle 80 - alimentacion,25347,15043,14755,55145
15402,2020-07-27,(04000) Cabecera Calle 80 - alimentacion,3810,2223,2415,8448
15403,2020-09-02,(07005) ALQUERIA,597,355,328,1280
15404,2020-06-06,(09002) Consuelo,339,155,226,720
15405,2020-07-22,(02502) Terminal,374,273,269,916
15406,2020-07-31,(09118) Marly,1365,883,721,2969
15407,2020-09-29,(07504) TERREROS,6982,3667,3724,14373
15408,2020-06-10,(03000) Portal Suba - alimentacion,5827,3376,3097,12300
15409,2020-02-27,(02101) Toberín,14906,9253,7398,31557
15410,2020-02-11,(09100) Calle 40 Sur,7727,4532,4298,16557
15411,2020-07-30,(09003) Socorro,593,332,334,1259
15412,2020-02-01,(08001) Parque el Tunal,1092,516,783,2391
15413,2020-02-07,(09001) Molinos,6987,4390,5993,17370
15414,2020-01-07,(06107) Ciudad Universitaria,538,373,574,1485
15415,2020-06-19,(08000) Portal Tunal - alimentacion,6574,3668,3602,13844
15416,2020-01-29,(07000) Portal Sur - alimentacion,28034,16265,13968,58267
15417,2020-09-08,(05100) Banderas P. Central,964,537,668,2169
15418,2020-02-21,(10001) Country Sur,5075,2043,2708,9826
15419,2020-09-30,(09100) Calle 40 Sur,1905,1112,1462,4479
15420,2020-09-29,(09000) Cabecera Usme,1981,1177,1452,4610
15421,2020-02-19,(07002) MADELENA,5260,3046,2725,11031
15422,2020-08-01,(05100) Banderas P. Central,411,193,322,926
15423,2020-08-25,(10005) Bicentenario - alimentacion,184,99,210,493
15424,2020-06-03,(09000) Cabecera Usme - alimentacion,6309,4316,5011,15636
15425,2020-09-14,(09104) Restrepo,1658,966,1205,3829
15426,2020-09-16,(09104) Restrepo,1720,931,1345,3996
15427,2020-09-29,(02204) Pepe Sierra,875,622,590,2087
15428,2020-10-09,(07102) NQS - CALLE 75,478,339,380,1197
15429,2020-02-25,(03001) LA CAMPIÑA,6697,4163,4251,15111
15430,2020-07-16,(03001) LA CAMPIÑA,934,566,524,2024
15431,2020-01-30,(02103) Mazurén,3401,2048,1858,7307
15432,2020-07-31,(14001) La Sabana,146,99,79,324
15433,2020-09-21,(14001) La Sabana,60,70,86,216
15434,2020-06-04,(07002) MADELENA,698,430,387,1515
15435,2020-10-09,(08000) Portal Tunal - alimentacion,7040,3862,5345,16247
15436,2020-01-28,(07112) COMUNEROS,3748,2306,2215,8269
15437,2020-03-08,(07112) COMUNEROS,837,405,902,2144
15438,2020-03-19,(09113) Calle 22,959,529,656,2144
15439,2020-02-08,(02001) Centro Comercial Santa Fe,2158,982,1880,5020
15440,2020-05-14,(04105) Carrera 53,229,110,104,443
15441,2020-01-25,(07109) CAD,1295,858,1071,3224
15442,2020-02-28,(50003) Corral Molinos,2775,2343,3918,9036
15443,2020-04-08,(50003) Corral Molinos,766,335,553,1654
15444,2020-01-29,(04000) Cabecera Calle 80,7227,4314,4828,16369
15445,2020-01-31,(04000) Cabecera Calle 80,7275,4104,4962,16341
15446,2020-10-07,(04000) Cabecera Calle 80,1319,790,1233,3342
15447,2020-08-11,(07010) Bosa,643,309,379,1331
15448,2020-06-26,(09110) Avenida Jimenez,1431,1073,897,3401
15449,2020-01-09,(09114) Calle 26,2006,1380,1346,4732
15450,2020-02-17,(04002) Carrera 90,3786,2328,1981,8095
15451,2020-03-17,(09111) Calle 19,1627,1027,1129,3783
15452,2020-06-04,(09111) Calle 19,693,425,460,1578
15453,2020-01-08,(10000) Portal 20 de Julio - alimentacion,8557,4109,6363,19029
15454,2020-09-17,(02101) Toberín,1663,986,1235,3884
15455,2020-06-16,(12001) Carrera 43,417,272,262,951
15456,2020-05-31,(07000) Portal Sur - alimentacion,2115,1065,1089,4269
15457,2020-01-04,(10002) Av. Primero de Mayo,2974,1400,2389,6763
15458,2020-09-04,(10002) Av. Primero de Mayo,2369,1224,1626,5219
15459,2020-01-21,(10006) San Victorino,664,790,1048,2502
15460,2020-05-20,(02000) Cabecera Autopista Norte - intermunicipal,399,270,295,964
15461,2020-06-17,(02000) Cabecera Autopista Norte - intermunicipal,566,402,379,1347
15462,2020-07-30,(09000) Cabecera Usme - alimentacion,8113,4317,4407,16837
15463,2020-03-16,(09101) Quiroga,1190,752,853,2795
15464,2020-03-30,(08001) Parque el Tunal,225,135,116,476
15465,2020-02-18,(09115) Calle 34,4671,2981,2516,10168
15466,2020-08-06,(10000) Portal 20 de Julio,2139,1052,1086,4277
15467,2020-09-03,(07000) Portal Sur,2169,1332,1361,4862
15468,2020-02-29,(10007) Las Nieves,1039,850,1047,2936
15469,2020-04-21,(07503) SAN MATEO,5365,3531,2436,11332
15470,2020-01-21,(09123) Calle 76,3494,2472,2149,8115
15471,2020-09-04,(04000) Cabecera Calle 80,1211,694,1102,3007
15472,2020-04-06,(10001) Country Sur,533,246,387,1166
15473,2020-08-28,(09100) Calle 40 Sur,1735,1011,1272,4018
15474,2020-07-09,(02201) Prado,931,620,490,2041
15475,2020-01-29,(02304) Heroes,4514,3144,2171,9829
15476,2020-02-14,(04003) Avenida Ciudad de Cali,5772,3152,3564,12488
15477,2020-06-09,(09107) Hortúa,623,347,330,1300
15478,2020-08-06,(09123) Calle 76,928,619,599,2146
15479,2020-02-13,(05105) Pradera,2680,1633,1247,5560
15480,2020-08-12,(02300) Calle 100,1126,710,638,2474
15481,2020-10-02,(02300) Calle 100,1346,950,1026,3322
15482,2020-09-26,(09119) Calle 57,497,329,472,1298
15483,2020-07-19,(50002) Corral Calle 40 Sur,5,3,4,12
15484,2020-01-13,(06000) Portal Eldorado,5460,3224,2585,11269
15485,2020-01-22,(10010) San Bernardo,1693,917,1269,3879
15486,2020-01-18,(07104) Simon Bolivar,1279,846,931,3056
15487,2020-05-19,(05005) Transversal 86,302,158,168,628
15488,2020-08-23,(02202) Calle 127,312,275,246,833
15489,2020-08-05,(05105) Pradera,470,285,284,1039
15490,2020-03-22,(10008) San Diego,47,22,42,111
15491,2020-03-16,(07009) SENA,2427,1390,1364,5181
15492,2020-03-07,(08000) Portal Tunal,1355,847,922,3124
15493,2020-04-01,(08000) Portal Tunal,371,206,185,762
15494,2020-03-04,(02205) Calle 106,2708,1691,1399,5798
15495,2020-02-10,(04101) Minuto de Dios,3602,2175,1861,7638
15496,2020-03-10,(04003) Avenida Ciudad de Cali,241,1584,1193,3018
15497,2020-02-21,(04108) El Polo,1744,1155,1282,4181
15498,2020-01-10,(07201) Guatoque -Veraguas,737,365,528,1630
15499,2020-07-08,(02304) Heroes,952,646,478,2076
15500,2020-09-11,(07113) SANTA ISABEL,388,232,291,911
15501,2020-05-26,(03007) HUMEDAL CORDOBA,140,96,58,294
15502,2020-07-31,(03007) HUMEDAL CORDOBA,100,73,49,222
15503,2020-10-08,(03007) HUMEDAL CORDOBA,153,110,109,372
15504,2020-07-07,(04104) Avenida 68,675,359,372,1406
15505,2020-09-08,(08002) Biblioteca,325,185,201,711
15506,2020-09-04,(04100) Carrera 77,1424,769,1039,3232
15507,2020-09-10,(09117) Calle 45,637,401,419,1457
15508,2020-01-26,(03006) NIZA - CALLE 127,508,322,452,1282
15509,2020-03-03,(06105) Quinta Paredes,1075,632,501,2208
15510,2020-02-28,(04103) Las Ferias,1539,877,857,3273
15511,2020-02-06,(14005) Las Aguas,3420,2125,1969,7514
15512,2020-09-22,(14005) Las Aguas,267,149,281,697
15513,2020-04-15,(09100) Calle 40 Sur,877,501,562,1940
15514,2020-09-03,(07104) Simon Bolivar,605,381,324,1310
15515,2020-08-04,(10005) Bicentenario - alimentacion,194,84,165,443
15516,2020-08-14,(10005) Bicentenario - alimentacion,191,99,191,481
15517,2020-07-23,(04107) Escuela Militar,117,66,56,239
15518,2020-09-07,(04107) Escuela Militar,164,107,88,359
15519,2020-05-20,(09000) Cabecera Usme,1373,857,918,3148
15520,2020-04-30,(02304) Heroes,493,362,283,1138
15521,2020-05-07,(09106) Nariño,272,168,192,632
15522,2020-05-06,(09118) Marly,1154,774,515,2443
15523,2020-03-11,(06105) Quinta Paredes,934,572,492,1998
15524,2020-07-08,(09117) Calle 45,799,482,455,1736
15525,2020-04-05,(40003) Mirador del Paraiso,297,155,234,686
15526,2020-01-04,(04001) Quirigua,592,286,491,1369
15527,2020-03-02,(07003) SEVILLANA,2088,1192,1103,4383
15528,2020-07-09,(02204) Pepe Sierra,864,608,436,1908
15529,2020-07-05,(02205) Calle 106,63,55,73,191
15530,2020-08-17,(02205) Calle 106,0,51,109,160
15531,2020-08-20,(09120) Calle 63,940,611,689,2240
15532,2020-05-20,(07009) SENA,531,298,292,1121
15533,2020-01-23,(04101) Minuto de Dios,2451,1476,1553,5480
15534,2020-08-28,(02302) Virrey,691,461,379,1531
15535,2020-02-10,(12003) Ricaurte,1335,791,650,2776
15536,2020-05-07,(12003) Ricaurte,250,185,142,577
15537,2020-08-06,(12003) Ricaurte,360,234,180,774
15538,2020-10-10,(03012) SUBA - CALLE 95,219,143,246,608
15539,2020-07-21,(06103) CAN,338,213,150,701
15540,2020-07-18,(09004) Santa Lucía,1481,694,923,3098
15541,2020-06-14,(05002) Tintal,579,291,381,1251
15542,2020-06-21,(03006) NIZA - CALLE 127,169,106,88,363
15543,2020-08-29,(03006) NIZA - CALLE 127,392,234,213,839
15544,2020-04-25,(05107) Américas - Cr.53,247,166,99,512
15545,2020-08-13,(02103) Mazurén,135,104,166,405
15546,2020-06-12,(07103) AV. CHILE,920,550,451,1921
15547,2020-08-31,(07103) AV. CHILE,911,565,515,1991
15548,2020-03-05,(10005) Bicentenario,806,424,362,1592
15549,2020-06-10,(40002) Manitas,366,218,244,828
15550,2020-10-10,(02304) Heroes,564,477,584,1625
15551,2020-02-09,(02103) Mazurén,316,163,474,953
15552,2020-01-13,(07006) General Santander,2273,1363,1451,5087
15553,2020-05-27,(07003) SEVILLANA,404,210,195,809
15554,2020-09-08,(10008) San Diego,294,172,185,651
15555,2020-06-03,(03011) SUBA - CALLE 100,462,218,212,892
15556,2020-02-10,(10004) Policarpa,939,458,594,1991
15557,2020-08-05,(05107) Américas - Cr.53,323,204,213,740
15558,2020-01-03,(06105) Quinta Paredes,358,231,248,837
15559,2020-09-23,(09115) Calle 34,750,466,569,1785
15560,2020-05-26,(03006) NIZA - CALLE 127,371,248,218,837
15561,2020-02-20,(03004) GRATAMIRA,295,171,132,598
15562,2020-06-09,(07005) ALQUERIA,564,319,263,1146
15563,2020-03-01,(07105) MOVISTAR ARENA,210,161,312,683
15564,2020-09-07,(10003) Ciudad Jardín,206,105,174,485
15565,2020-07-15,(09106) Nariño,365,197,259,821
15566,2020-03-08,(02304) Heroes,506,454,670,1630
15567,2020-05-01,(06104) Gobernación,61,46,27,134
15568,2020-07-04,(07105) MOVISTAR ARENA,194,122,137,453
15569,2020-07-21,(02200) Alcalá,1663,1134,813,3610
15570,2020-06-19,(07107) U. NACIONAL,362,203,212,777
15571,2020-08-24,(10007) Las Nieves,528,313,277,1118
15572,2020-05-01,(02104) Calle 146,223,155,119,497
15573,2020-10-08,(04103) Las Ferias,387,209,279,875
15574,2020-08-19,(07106) EL CAMPIN,317,222,208,747
15575,2020-07-27,(40002) Manitas,366,215,227,808
15576,2020-08-20,(08002) Biblioteca,291,158,195,644
15577,2020-02-27,(50002) Corral Calle 40 Sur,137,89,153,379
15578,2020-09-08,(07506) DESPENSA,461,276,281,1018
15579,2020-05-02,(07002) MADELENA,258,154,166,578
15580,2020-08-20,(09111) Calle 19,674,387,378,1439
15581,2020-09-07,(09111) Calle 19,730,431,485,1646
15582,2020-02-02,(07003) SEVILLANA,377,182,391,950
15583,2020-07-15,(10009) Museo Nacional,364,214,200,778
15584,2020-09-22,(03013) RIO NEGRO,324,166,241,731
15585,2020-04-29,(07006) General Santander - alimentacion,217,124,114,455
15586,2020-08-12,(10004) Policarpa,245,100,135,480
15587,2020-04-27,(02200) Alcalá,349,403,177,929
15588,2020-04-11,(05001) Patio Bonito,493,333,288,1114
15589,2020-06-03,(09120) Calle 63,973,637,615,2225
15590,2020-08-17,(02502) Terminal,76,70,102,248
15591,2020-01-01,(50003) Corral Molinos,175,222,679,1076
15592,2020-04-09,(14001) La Sabana,43,28,15,86
15593,2020-05-03,(09115) Calle 34,130,90,84,304
15594,2020-07-06,(07008) NQS - Calle 30 Sur,344,206,223,773
15595,2020-10-02,(12002) CDS - Carrera 32,209,141,111,461
15596,2020-05-30,(09105) Río Fucha,98,50,68,216
15597,2020-07-23,(06101) El Tiempo,292,168,159,619
15598,2020-01-12,(04102) Avenida Boyaca,562,310,452,1324
15599,2020-04-29,(04101) Minuto de Dios,182,123,137,442
15600,2020-03-31,(04000) Cabecera Calle 80 - intermunicipal,73,65,89,227
15601,2020-05-14,(06001) Modelia,344,211,156,711
15602,2020-05-23,(06101) El Tiempo,180,114,130,424
15603,2020-08-27,(09122) Calle 72,1196,789,756,2741
15604,2020-08-02,(03012) SUBA - CALLE 95,66,50,53,169
15605,2020-05-23,(09121) Las Flores,395,270,283,948
15606,2020-09-20,(09111) Calle 19,204,166,284,654
15607,2020-01-30,(09105) Río Fucha,738,443,520,1701
15608,2020-10-04,(05105) Pradera,173,149,180,502
15609,2020-06-08,(07008) NQS - Calle 30 Sur,270,162,156,588
15610,2020-09-15,(06102) Salitre El Greco,223,138,135,496
15611,2020-09-20,(09121) Las Flores,197,140,242,579
15612,2020-04-24,(06103) CAN,303,199,137,639
15613,2020-05-17,(09000) Cabecera Usme,338,213,303,854
15614,2020-01-12,(14004) Museo del Oro,0,116,333,449
15615,2020-05-25,(07008) NQS - Calle 30 Sur,77,45,45,167
15616,2020-07-08,(07106) EL CAMPIN,398,272,228,898
15617,2020-04-02,(10006) San Victorino,156,133,154,443
15618,2020-04-20,(04106) Carrera 47,187,97,111,395
15619,2020-04-05,(04002) Carrera 90,87,60,32,179
15620,2020-08-31,(09106) Nariño,405,236,319,960
15621,2020-08-04,(03004) GRATAMIRA,0,17,26,43
15622,2020-06-03,(07506) DESPENSA,475,264,217,956
15623,2020-05-10,(07009) SENA,132,72,82,286
15624,2020-04-27,(07007) NQS - Calle 38A Sur,80,48,34,162
15625,2020-09-06,(07007) NQS - Calle 38A Sur,197,128,135,460
15626,2020-06-16,(07006) General Santander - alimentacion,380,240,230,850
15627,2020-05-10,(04000) Cabecera Calle 80,178,112,128,418
15628,2020-04-10,(07002) MADELENA,86,37,55,178
15629,2020-04-09,(09114) Calle 26,60,36,33,129
15630,2020-07-14,(04102) Avenida Boyaca,315,185,197,697
15631,2020-09-20,(03004) GRATAMIRA,0,6,21,27
15632,2020-08-23,(04107) Escuela Militar,33,24,43,100
15633,2020-04-21,(04107) Escuela Militar,66,40,37,143
15634,2020-05-02,(04107) Escuela Militar,42,27,36,105
15635,2020-05-05,(07113) SANTA ISABEL,268,160,193,621
15636,2020-10-04,(06106) Recinto Ferial,81,54,103,238
15637,2020-08-08,(06103) CAN,201,150,118,469
15638,2020-04-06,(12003) Ricaurte,82,84,75,241
15639,2020-06-09,(06107) Ciudad Universitaria,163,112,117,392
15640,2020-08-30,(02205) Calle 106,48,55,70,173
15641,2020-04-10,(06111) Universidades,0,25,48,73
15642,2020-03-29,(06001) Modelia,65,53,41,159
15643,2020-04-23,(14005) Las Aguas,0,36,107,143
15644,2020-05-27,(14005) Las Aguas,0,60,187,247
15645,2020-04-19,(03001) LA CAMPIÑA,173,96,81,350
15646,2020-05-14,(12007) Zona Industrial,245,152,113,510
15647,2020-04-10,(09111) Calle 19,79,60,72,211
15648,2020-10-10,(50002) Corral Calle 40 Sur,14,6,33,53
15649,2020-05-24,(03010) PUENTE LARGO,78,66,45,189
15650,2020-07-18,(50006) Corral Carrera 77,4,3,4,11
15651,2020-04-11,(10005) Bicentenario,36,16,16,68
15652,2020-09-22,(03004) GRATAMIRA,0,17,38,55
15653,2020-09-28,(03014) SAN MARTIN,0,18,42,60
15654,2020-07-28,(50006) Corral Carrera 77,5,2,3,10
15655,2020-04-10,(12003) Ricaurte,22,21,12,55
15656,2020-06-14,(50002) Corral Calle 40 Sur,7,1,8,16
15657,2020-05-28,(07005) ALQUERIA,483,282,232,997
15658,2020-03-11,(02502) Terminal,4860,3099,2783,10742
15659,2020-06-03,(02502) Terminal,375,252,292,919
15660,2020-02-10,(03013) RIO NEGRO,1277,826,854,2957
15661,2020-02-25,(07504) TERREROS,17640,10992,9303,37935
15662,2020-02-16,(08000) Portal Tunal - alimentacion,5867,2622,4197,12686
15663,2020-02-01,(07503) SAN MATEO,27347,13315,14759,55421
15664,2020-08-29,(07503) SAN MATEO,9235,4808,4950,18993
15665,2020-02-24,(02200) Alcalá,14931,9442,6700,31073
15666,2020-01-30,(06000) Portal Eldorado - alimentacion,17537,9367,9273,36177
15667,2020-02-24,(08001) Parque el Tunal,1728,1009,967,3704
15668,2020-03-27,(09001) Molinos,1067,595,752,2414
15669,2020-08-01,(10000) Portal 20 de Julio - alimentacion,3200,1411,2060,6671
15670,2020-01-09,(07112) COMUNEROS,2653,1596,1730,5979
15671,2020-02-19,(02201) Prado,6176,3856,3088,13120
15672,2020-01-23,(07000) Portal Sur - alimentacion,26954,15178,13666,55798
15673,2020-01-28,(07000) Portal Sur - alimentacion,27771,16106,14063,57940
15674,2020-02-28,(07112) COMUNEROS,3900,2233,2450,8583
15675,2020-01-30,(03009) Av. Suba- Calle 116,2579,1636,1380,5595
15676,2020-01-16,(40001) Juan Pablo II,1473,811,932,3216
15677,2020-01-10,(09115) Calle 34,2840,2010,1968,6818
15678,2020-01-07,(09113) Calle 22,1054,630,870,2554
15679,2020-02-12,(07009) SENA,4000,2367,1999,8366
15680,2020-02-22,(07009) SENA,2333,1223,1621,5177
15681,2020-10-02,(10005) Bicentenario - alimentacion,223,111,266,600
15682,2020-09-22,(04100) Carrera 77,1444,791,1134,3369
15683,2020-01-08,(07505) LEON XIII,6462,3473,3119,13054
15684,2020-02-20,(09110) Avenida Jimenez,4981,3300,2735,11016
15685,2020-08-11,(02000) Cabecera Autopista Norte - alimentacion,4409,2413,2501,9323
15686,2020-07-14,(07102) NQS - CALLE 75,429,262,185,876
15687,2020-07-24,(07102) NQS - CALLE 75,398,248,188,834
15688,2020-01-20,(03013) RIO NEGRO,1118,721,801,2640
15689,2020-03-28,(09118) Marly,756,540,342,1638
15690,2020-06-10,(09118) Marly,1442,919,713,3074
15691,2020-08-26,(06000) Portal Eldorado - alimentacion,3730,1819,1898,7447
15692,2020-03-02,(09116) Avenida 39,3254,2012,1686,6952
15693,2020-01-30,(02001) Centro Comercial Santa Fe,4782,2902,2649,10333
15694,2020-08-25,(14001) La Sabana,168,105,95,368
15695,2020-10-07,(07002) MADELENA,1043,602,786,2431
15696,2020-10-03,(09113) Calle 22,415,226,396,1037
15697,2020-06-22,(03003) 21 ANGELES,96,58,60,214
15698,2020-08-09,(05000) Portal Américas,677,407,608,1692
15699,2020-06-10,(04000) Cabecera Calle 80,995,627,662,2284
15700,2020-09-28,(07010) Bosa,0,367,929,1296
15701,2020-01-23,(07506) DESPENSA,1609,892,933,3434
15702,2020-01-28,(10001) Country Sur,5016,2227,2475,9718
15703,2020-02-08,(10001) Country Sur,3016,1260,2181,6457
15704,2020-04-24,(10001) Country Sur,606,279,369,1254
15705,2020-02-07,(40003) Mirador del Paraiso,4939,2775,2675,10389
15706,2020-08-13,(03000) Portal Suba - alimentacion,5183,3030,3101,11314
15707,2020-07-24,(12001) Carrera 43,376,216,166,758
15708,2020-01-21,(02001) Centro Comercial Santa Fe,3469,1912,1679,7060
15709,2020-03-10,(02205) Calle 106,1144,236,296,1676
15710,2020-06-09,(03000) Portal Suba - alimentacion,5753,3299,3140,12192
15711,2020-08-27,(02000) Cabecera Autopista Norte - intermunicipal,502,332,371,1205
15712,2020-03-10,(09119) Calle 57,1594,367,516,2477
15713,2020-02-04,(09115) Calle 34,4590,2767,2413,9770
15714,2020-04-25,(07112) COMUNEROS,327,199,220,746
15715,2020-01-17,(04002) Carrera 90,3260,1737,1918,6915
15716,2020-05-13,(06000) Portal Eldorado - alimentacion,3130,1558,1442,6130
15717,2020-04-15,(04100) Carrera 77,643,374,416,1433
15718,2020-08-02,(07504) TERREROS,1498,743,902,3143
15719,2020-04-27,(07503) SAN MATEO,4488,627,744,5859
15720,2020-05-20,(07503) SAN MATEO,8575,5314,3934,17823
15721,2020-06-10,(08001) Parque el Tunal,469,273,236,978
15722,2020-05-12,(06108) Concejo de Bogotá,125,63,79,267
15723,2020-09-25,(03003) 21 ANGELES,410,200,263,873
15724,2020-09-23,(14004) Museo del Oro,418,271,318,1007
15725,2020-04-25,(02000) Cabecera Autopista Norte,436,290,273,999
15726,2020-03-02,(03005) SUBA - AV. BOYACA,2745,1593,1580,5918
15727,2020-10-01,(09123) Calle 76,1128,767,792,2687
15728,2020-10-01,(02103) Mazurén,255,171,288,714
15729,2020-01-18,(03007) HUMEDAL CORDOBA,374,230,291,895
15730,2020-07-02,(02300) Calle 100,1291,823,716,2830
15731,2020-04-16,(09001) Molinos,1248,743,903,2894
15732,2020-08-20,(04106) Carrera 47,306,162,144,612
15733,2020-03-10,(04105) Carrera 53,335,236,211,782
15734,2020-07-16,(06109) Centro Memoria,216,114,90,420
15735,2020-01-14,(09121) Las Flores,2777,1735,1646,6158
15736,2020-07-17,(05107) Américas - Cr.53,390,231,250,871
15737,2020-06-18,(02205) Calle 106,352,238,202,792
15738,2020-01-12,(10002) Av. Primero de Mayo,1400,665,1530,3595
15739,2020-01-26,(10002) Av. Primero de Mayo,1563,721,1630,3914
15740,2020-02-01,(12000) Puente Aranda,178,102,188,468
15741,2020-01-23,(03006) NIZA - CALLE 127,2236,1446,1504,5186
15742,2020-02-22,(07113) SANTA ISABEL,1282,681,1089,3052
15743,2020-01-13,(09101) Quiroga,1293,823,1133,3249
15744,2020-05-05,(09101) Quiroga,323,189,245,757
15745,2020-09-04,(09101) Quiroga,629,306,456,1391
15746,2020-03-08,(05100) Banderas P. Central - alimentacion,3073,1170,2296,6539
15747,2020-01-28,(10009) Museo Nacional,4309,2205,1859,8373
15748,2020-02-06,(10009) Museo Nacional,4410,2442,2024,8876
15749,2020-03-09,(07201) Guatoque -Veraguas,239,154,168,561
15750,2020-08-08,(07106) EL CAMPIN,245,167,165,577
15751,2020-02-08,(06000) Portal Eldorado,2693,1953,2362,7008
15752,2020-03-15,(03003) 21 ANGELES,270,101,232,603
15753,2020-09-02,(08002) Biblioteca,322,186,223,731
15754,2020-10-06,(02101) Toberín,1994,1197,1594,4785
15755,2020-02-28,(06101) El Tiempo,2916,1628,1344,5888
15756,2020-10-08,(10003) Ciudad Jardín,255,136,232,623
15757,2020-03-10,(09004) Santa Lucía,429,2033,1469,3931
15758,2020-02-17,(07109) CAD,2857,1738,1462,6057
15759,2020-02-18,(07109) CAD,2910,1734,1516,6160
15760,2020-02-07,(04107) Escuela Militar,645,400,458,1503
15761,2020-01-17,(05103) Marsella,2441,1321,1304,5066
15762,2020-06-25,(05103) Marsella,442,239,233,914
15763,2020-03-08,(02200) Alcalá,2060,1113,2177,5350
15764,2020-07-10,(03002) SUBA - TV- 91,865,487,563,1915
15765,2020-09-02,(06104) Gobernación,267,161,148,576
15766,2020-08-19,(06106) Recinto Ferial,229,144,114,487
15767,2020-08-29,(02001) Centro Comercial Santa Fe,332,215,333,880
15768,2020-03-06,(04101) Minuto de Dios,3435,1996,2029,7460
15769,2020-02-16,(06100) Av. Rojas,223,156,349,728
15770,2020-06-24,(07009) SENA,689,398,418,1505
15771,2020-05-26,(12003) Ricaurte,323,229,178,730
15772,2020-06-19,(03010) PUENTE LARGO,368,228,198,794
15773,2020-05-03,(03010) PUENTE LARGO,76,60,45,181
15774,2020-03-15,(03009) Av. Suba- Calle 116,300,216,326,842
15775,2020-07-04,(10010) San Bernardo,504,245,394,1143
15776,2020-05-06,(09109) Tercer Milenio,218,138,135,491
15777,2020-05-13,(05107) Américas - Cr.53,377,224,220,821
15778,2020-07-30,(07103) AV. CHILE,914,559,425,1898
15779,2020-05-13,(02001) Centro Comercial Santa Fe,332,207,217,756
15780,2020-06-30,(02001) Centro Comercial Santa Fe,547,341,344,1232
15781,2020-08-11,(02001) Centro Comercial Santa Fe,443,250,314,1007
15782,2020-06-10,(05100) Banderas P. Central - alimentacion,2225,1129,1454,4808
15783,2020-04-21,(06002) Normandía,198,119,106,423
15784,2020-03-14,(07107) U. NACIONAL,821,624,798,2243
15785,2020-05-29,(03011) SUBA - CALLE 100,412,220,221,853
15786,2020-03-26,(05105) Pradera,384,270,139,793
15787,2020-06-02,(05105) Pradera,501,321,223,1045
15788,2020-08-29,(06111) Universidades,295,164,325,784
15789,2020-06-10,(40001) Juan Pablo II,566,334,342,1242
15790,2020-03-16,(05102) Av. Américas - Av. Boyacá,1047,630,613,2290
15791,2020-01-12,(04108) El Polo,253,160,375,788
15792,2020-04-14,(02200) Alcalá,910,641,489,2040
15793,2020-09-13,(07101) CASTELLANA,28,27,54,109
15794,2020-03-14,(14005) Las Aguas,883,624,1119,2626
15795,2020-07-09,(07200) Tygua-San José,259,133,175,567
15796,2020-03-29,(09123) Calle 76,178,134,99,411
15797,2020-01-01,(03012) SUBA - CALLE 95,79,56,160,295
15798,2020-07-30,(03012) SUBA - CALLE 95,330,193,198,721
15799,2020-02-03,(12002) CDS - Carrera 32,552,365,352,1269
15800,2020-06-10,(12002) CDS - Carrera 32,193,142,72,407
15801,2020-04-04,(10000) Portal 20 de Julio,877,407,391,1675
15802,2020-09-21,(04003) Avenida Ciudad de Cali,948,496,670,2114
15803,2020-06-25,(06109) Centro Memoria,279,168,147,594
15804,2020-07-14,(02303) Calle 85,551,377,288,1216
15805,2020-06-11,(06104) Gobernación,259,145,111,515
15806,2020-07-23,(07201) Guatoque -Veraguas,129,62,86,277
15807,2020-06-09,(09121) Las Flores,685,442,376,1503
15808,2020-05-09,(07003) SEVILLANA,239,128,133,500
15809,2020-02-09,(04003) Avenida Ciudad de Cali,1014,496,1107,2617
15810,2020-06-03,(09113) Calle 22,405,223,289,917
15811,2020-05-19,(03003) 21 ANGELES,275,148,119,542
15812,2020-06-20,(07004) VENECIA,777,418,470,1665
15813,2020-01-01,(09101) Quiroga,149,81,260,490
15814,2020-05-16,(04001) Quirigua,215,116,138,469
15815,2020-09-26,(08000) Portal Tunal,590,305,389,1284
15816,2020-05-08,(05005) Transversal 86,263,139,111,513
15817,2020-05-01,(04104) Avenida 68,183,121,106,410
15818,2020-01-08,(10004) Policarpa,564,319,528,1411
15819,2020-03-10,(10004) Policarpa,112,173,151,436
15820,2020-01-06,(10007) Las Nieves,138,140,271,549
15821,2020-09-30,(07007) NQS - Calle 38A Sur,489,297,380,1166
15822,2020-03-08,(05100) Banderas P. Central,840,354,957,2151
15823,2020-06-17,(03005) SUBA - AV. BOYACA,455,262,286,1003
15824,2020-05-27,(06002) Normandía,283,162,158,603
15825,2020-06-10,(03013) RIO NEGRO,275,161,167,603
15826,2020-08-20,(07005) ALQUERIA,500,291,302,1093
15827,2020-09-18,(04106) Carrera 47,384,196,237,817
15828,2020-03-21,(02201) Prado,312,222,155,689
15829,2020-07-07,(06002) Normandía,320,194,239,753
15830,2020-08-06,(02300) Calle 100,1089,722,578,2389
15831,2020-05-24,(09110) Avenida Jimenez,194,162,221,577
15832,2020-07-01,(12002) CDS - Carrera 32,184,98,116,398
15833,2020-10-08,(12002) CDS - Carrera 32,227,141,112,480
15834,2020-07-28,(07006) General Santander,475,284,265,1024
15835,2020-04-11,(03002) SUBA - TV- 91,242,148,147,537
15836,2020-08-01,(04105) Carrera 53,150,85,108,343
15837,2020-08-09,(07108) Av. El Dorado,32,19,29,80
15838,2020-04-16,(06002) Normandía,159,102,83,344
15839,2020-05-10,(03003) 21 ANGELES,62,33,39,134
15840,2020-04-20,(06100) Av. Rojas,92,85,65,242
15841,2020-04-13,(09108) Hospital,34,23,31,88
15842,2020-09-06,(09105) Río Fucha,0,30,72,102
15843,2020-03-24,(07010) Bosa,435,249,393,1077
15844,2020-04-10,(07006) General Santander,79,61,42,182
15845,2020-05-03,(03009) Av. Suba- Calle 116,129,91,62,282
15846,2020-01-08,(07006) General Santander - alimentacion,1060,582,732,2374
15847,2020-08-04,(05105) Pradera,446,282,256,984
15848,2020-04-20,(04104) Avenida 68,332,202,175,709
15849,2020-03-01,(07102) NQS - CALLE 75,227,176,350,753
15850,2020-07-11,(07006) General Santander,447,255,287,989
15851,2020-10-05,(07006) General Santander - alimentacion,405,243,366,1014
15852,2020-03-28,(07009) SENA,176,110,122,408
15853,2020-07-11,(06105) Quinta Paredes,118,67,69,254
15854,2020-07-21,(06105) Quinta Paredes,133,68,59,260
15855,2020-03-26,(07104) Simon Bolivar,153,134,106,393
15856,2020-09-03,(07006) General Santander - alimentacion,408,232,315,955
15857,2020-01-18,(05101) Mandalay - Cr.73,391,195,304,890
15858,2020-07-11,(02102) Calle 161,179,114,142,435
15859,2020-03-23,(04106) Carrera 47,88,49,37,174
15860,2020-06-04,(02304) Heroes,742,549,387,1678
15861,2020-03-26,(05107) Américas - Cr.53,283,245,157,685
15862,2020-05-06,(12007) Zona Industrial,226,141,110,477
15863,2020-04-24,(10004) Policarpa,130,59,95,284
15864,2020-06-07,(04000) Cabecera Calle 80 - intermunicipal,45,23,51,119
15865,2020-03-30,(09111) Calle 19,201,141,193,535
15866,2020-07-30,(03004) GRATAMIRA,27,14,15,56
15867,2020-03-31,(03006) NIZA - CALLE 127,244,191,145,580
15868,2020-04-13,(07004) VENECIA,487,307,257,1051
15869,2020-05-18,(06103) CAN,344,213,161,718
15870,2020-03-22,(10006) San Victorino,63,43,40,146
15871,2020-06-10,(06101) El Tiempo,326,219,178,723
15872,2020-06-12,(09106) Nariño,401,247,282,930
15873,2020-03-14,(07108) Av. El Dorado,358,267,386,1011
15874,2020-03-27,(04106) Carrera 47,163,102,80,345
15875,2020-01-30,(03014) SAN MARTIN,264,162,173,599
15876,2020-04-19,(09114) Calle 26,41,36,37,114
15877,2020-04-04,(05103) Marsella,113,65,74,252
15878,2020-04-10,(03003) 21 ANGELES,42,29,25,96
15879,2020-04-25,(03003) 21 ANGELES,125,43,69,237
15880,2020-04-30,(07201) Guatoque -Veraguas,106,69,75,250
15881,2020-05-11,(10003) Ciudad Jardín,146,75,102,323
15882,2020-06-06,(07200) Tygua-San José,171,99,126,396
15883,2020-05-04,(05100) Banderas P. Central,433,246,281,960
15884,2020-08-10,(03005) SUBA - AV. BOYACA,340,202,223,765
15885,2020-06-09,(07108) Av. El Dorado,116,79,68,263
15886,2020-04-01,(07105) MOVISTAR ARENA,141,90,84,315
15887,2020-06-05,(09105) Río Fucha,131,51,70,252
15888,2020-10-06,(09105) Río Fucha,0,78,194,272
15889,2020-01-09,(12000) Puente Aranda,183,104,156,443
15890,2020-05-02,(03003) 21 ANGELES,126,54,72,252
15891,2020-03-23,(06107) Ciudad Universitaria,48,26,30,104
15892,2020-08-01,(07101) CASTELLANA,106,62,74,242
15893,2020-07-11,(09105) Río Fucha,102,50,79,231
15894,2020-05-24,(06105) Quinta Paredes,29,25,27,81
15895,2020-04-10,(09106) Nariño,67,43,24,134
15896,2020-03-23,(06105) Quinta Paredes,27,24,23,74
15897,2020-05-19,(07101) CASTELLANA,150,90,83,323
15898,2020-06-28,(06001) Modelia,94,59,103,256
15899,2020-04-13,(07003) SEVILLANA,216,113,111,440
15900,2020-07-04,(03014) SAN MARTIN,25,8,33,66
15901,2019-12-31,(10008) San Diego,27,8,26,61
15902,2020-10-12,(50002) Corral Calle 40 Sur,9,5,15,29
15903,2020-01-07,(04000) Cabecera Calle 80 - alimentacion,14934,8541,10866,34341
15904,2020-06-13,(04000) Cabecera Calle 80 - alimentacion,2938,1513,1901,6352
15905,2020-07-20,(09002) Consuelo,124,58,76,258
15906,2020-08-31,(09118) Marly,1420,881,843,3144
15907,2020-09-30,(09119) Calle 57,651,469,574,1694
15908,2020-01-28,(09000) Cabecera Usme - alimentacion,25167,13871,15004,54042
15909,2020-09-15,(09001) Molinos,2709,1414,2129,6252
15910,2020-09-22,(09001) Molinos,2849,1461,2084,6394
15911,2020-01-14,(04103) Las Ferias,1315,723,779,2817
15912,2020-01-27,(02000) Cabecera Autopista Norte - intermunicipal,4759,3234,2834,10827
15913,2020-02-23,(07112) COMUNEROS,856,449,843,2148
15914,2020-01-27,(07103) AV. CHILE,3563,2223,1805,7591
15915,2020-02-07,(07103) AV. CHILE,3693,2299,1995,7987
15916,2020-09-28,(09000) Cabecera Usme,1897,1206,1477,4580
15917,2020-05-19,(06000) Portal Eldorado - alimentacion,3468,1768,1545,6781
15918,2020-02-21,(09113) Calle 22,1437,875,1107,3419
15919,2020-01-11,(07009) SENA,1718,877,1264,3859
15920,2020-01-29,(07009) SENA,3577,2060,2001,7638
15921,2020-09-29,(07009) SENA,758,438,658,1854
15922,2020-01-28,(10003) Ciudad Jardín,1008,549,735,2292
15923,2020-02-19,(02205) Calle 106,2800,1757,1398,5955
15924,2020-03-19,(09000) Cabecera Usme - alimentacion,16293,8291,9498,34082
15925,2020-03-27,(07001) PERDOMO,409,246,251,906
15926,2020-09-05,(07001) PERDOMO,804,394,661,1859
15927,2020-01-16,(09001) Molinos,6616,3760,5597,15973
15928,2020-09-13,(04101) Minuto de Dios,81,42,143,266
15929,2020-01-20,(04100) Carrera 77,5829,3429,3772,13030
15930,2020-08-04,(07505) LEON XIII,2523,1275,1099,4897
15931,2020-02-07,(05103) Marsella,3269,1837,1648,6754
15932,2020-10-09,(05002) Tintal,2960,1708,2117,6785
15933,2020-02-13,(09117) Calle 45,6807,4309,3111,14227
15934,2020-08-05,(08000) Portal Tunal - alimentacion,5861,3174,3292,12327
15935,2020-01-11,(03013) RIO NEGRO,541,344,520,1405
15936,2020-07-12,(09000) Cabecera Usme - alimentacion,3350,1483,2199,7032
15937,2020-03-14,(09110) Avenida Jimenez,3071,2177,2027,7275
15938,2020-03-03,(07110) PALOQUEMAO,2734,1614,1217,5565
15939,2020-05-18,(02103) Mazurén,148,102,104,354
15940,2020-10-03,(05100) Banderas P. Central - alimentacion,2924,1266,2307,6497
15941,2020-01-18,(07106) EL CAMPIN,1133,728,850,2711
15942,2020-08-03,(08000) Portal Tunal - alimentacion,5764,3193,3130,12087
15943,2020-01-16,(07107) U. NACIONAL,1059,1294,1732,4085
15944,2020-10-07,(04105) Carrera 53,332,174,211,717
15945,2020-02-01,(10002) Av. Primero de Mayo,4669,2189,3922,10780
15946,2020-03-11,(04000) Cabecera Calle 80,6772,4213,4885,15870
15947,2020-08-28,(07010) Bosa,676,319,420,1415
15948,2020-01-03,(09123) Calle 76,2092,1516,1590,5198
15949,2020-01-16,(40003) Mirador del Paraiso,4255,2320,2428,9003
15950,2020-08-25,(12001) Carrera 43,422,223,228,873
15951,2020-01-16,(10002) Av. Primero de Mayo,7163,3534,4296,14993
15952,2020-01-10,(10005) Bicentenario - alimentacion,533,259,478,1270
15953,2020-03-17,(02304) Heroes,2638,1932,1456,6026
15954,2020-07-07,(09101) Quiroga,625,314,398,1337
15955,2020-08-09,(07112) COMUNEROS,196,129,158,483
15956,2020-04-15,(07000) Portal Sur - alimentacion,4041,2194,1682,7917
15957,2020-08-27,(10002) Av. Primero de Mayo,2085,1054,1354,4493
15958,2020-10-09,(08001) Parque el Tunal,574,302,443,1319
15959,2020-02-15,(09116) Avenida 39,859,669,1058,2586
15960,2020-02-10,(06103) CAN,2703,1597,1110,5410
15961,2020-03-06,(14004) Museo del Oro,3630,2425,2183,8238
15962,2020-06-28,(02000) Cabecera Autopista Norte - alimentacion,1875,838,1126,3839
15963,2020-05-05,(09107) Hortúa,450,299,242,991
15964,2020-01-16,(05105) Pradera,2158,1321,1093,4572
15965,2020-02-14,(03011) SUBA - CALLE 100,2586,1412,1572,5570
15966,2020-08-18,(02300) Calle 100,1073,730,648,2451
15967,2020-02-11,(03012) SUBA - CALLE 95,1513,945,1022,3480
15968,2020-06-04,(10000) Portal 20 de Julio,2120,1040,977,4137
15969,2020-01-16,(10010) San Bernardo,1478,923,1231,3632
15970,2020-01-24,(07104) Simon Bolivar,2218,1389,1232,4839
15971,2020-07-29,(07104) Simon Bolivar,561,321,258,1140
15972,2020-01-06,(09001) Molinos,1568,716,1596,3880
15973,2020-03-25,(05005) Transversal 86,201,111,101,413
15974,2020-05-14,(05005) Transversal 86,262,141,123,526
15975,2020-07-17,(02202) Calle 127,1067,717,529,2313
15976,2020-08-17,(05105) Pradera,143,102,92,337
15977,2020-09-23,(05105) Pradera,687,424,352,1463
15978,2020-07-03,(03012) SUBA - CALLE 95,331,206,225,762
15979,2020-01-11,(03009) Av. Suba- Calle 116,925,654,782,2361
15980,2020-01-27,(10008) San Diego,1393,765,721,2879
15981,2020-03-19,(02300) Calle 100,2973,2012,1753,6738
15982,2020-10-10,(05001) Patio Bonito,1874,845,1298,4017
15983,2020-05-25,(07505) LEON XIII,667,378,296,1341
15984,2020-06-07,(06000) Portal Eldorado - alimentacion,1175,496,725,2396
15985,2020-06-18,(06000) Portal Eldorado - alimentacion,3905,2051,1931,7887
15986,2020-09-02,(07113) SANTA ISABEL,393,240,308,941
15987,2020-04-13,(03007) HUMEDAL CORDOBA,79,52,46,177
15988,2020-09-26,(03007) HUMEDAL CORDOBA,122,79,111,312
15989,2020-06-26,(04104) Avenida 68,687,366,408,1461
15990,2020-08-25,(05101) Mandalay - Cr.73,120,81,57,258
15991,2020-09-26,(14005) Las Aguas,171,127,282,580
15992,2020-08-24,(09100) Calle 40 Sur,1446,798,904,3148
15993,2020-08-05,(10005) Bicentenario - alimentacion,181,88,183,452
15994,2020-09-03,(04107) Escuela Militar,160,98,90,348
15995,2020-09-11,(04107) Escuela Militar,152,96,96,344
15996,2020-07-18,(09121) Las Flores,400,238,274,912
15997,2020-04-28,(02000) Cabecera Autopista Norte,614,450,382,1446
15998,2020-09-05,(02000) Cabecera Autopista Norte - intermunicipal,409,256,407,1072
15999,2020-07-22,(06101) El Tiempo,319,182,144,645
16000,2020-09-21,(09110) Avenida Jimenez,610,644,617,1871
16001,2020-02-27,(04000) Cabecera Calle 80 - intermunicipal,2372,1692,2160,6224
16002,2020-08-02,(05001) Patio Bonito,517,256,380,1153
16003,2020-03-24,(03001) LA CAMPIÑA,944,512,612,2068
16004,2020-09-25,(40001) Juan Pablo II,635,357,486,1478
16005,2020-02-23,(02302) Virrey,341,315,492,1148
16006,2020-07-11,(02302) Virrey,466,321,324,1111
16007,2020-09-12,(02302) Virrey,417,356,357,1130
16008,2020-05-18,(07106) EL CAMPIN,254,154,167,575
16009,2020-02-16,(03010) PUENTE LARGO,286,186,395,867
16010,2020-04-12,(03010) PUENTE LARGO,84,71,28,183
16011,2020-05-22,(10010) San Bernardo,568,281,347,1196
16012,2020-01-06,(03012) SUBA - CALLE 95,169,102,224,495
16013,2020-10-03,(02105) Calle 142,701,382,629,1712
16014,2020-07-09,(03002) SUBA - TV- 91,747,496,541,1784
16015,2020-08-18,(07007) NQS - Calle 38A Sur,318,205,220,743
16016,2020-03-12,(04000) Cabecera Calle 80 - intermunicipal,28,443,520,991
16017,2020-06-03,(05100) Banderas P. Central - alimentacion,1779,1068,1259,4106
16018,2020-06-17,(05100) Banderas P. Central - alimentacion,2851,1623,1678,6152
16019,2020-04-05,(10005) Bicentenario,19,14,16,49
16020,2020-03-19,(12002) CDS - Carrera 32,392,261,189,842
16021,2020-10-06,(09106) Nariño,458,278,448,1184
16022,2020-07-27,(02001) Centro Comercial Santa Fe,455,295,305,1055
16023,2020-06-15,(09120) Calle 63,374,269,315,958
16024,2020-07-09,(05107) Américas - Cr.53,451,257,262,970
16025,2020-06-30,(09003) Socorro,642,339,354,1335
16026,2020-01-05,(05105) Pradera,338,262,375,975
16027,2020-04-16,(09004) Santa Lucía,1189,647,652,2488
16028,2020-09-09,(03002) SUBA - TV- 91,896,515,589,2000
16029,2020-05-27,(02204) Pepe Sierra,679,495,351,1525
16030,2020-06-16,(09110) Avenida Jimenez,1152,867,833,2852
16031,2020-02-21,(07105) MOVISTAR ARENA,1336,788,723,2847
16032,2020-06-16,(09111) Calle 19,728,470,468,1666
16033,2020-05-16,(02101) Toberín,647,419,461,1527
16034,2020-02-20,(09111) Calle 19,2304,1357,1452,5113
16035,2020-06-01,(04003) Avenida Ciudad de Cali,997,582,634,2213
16036,2020-06-23,(04003) Avenida Ciudad de Cali,1064,646,709,2419
16037,2020-07-20,(02200) Alcalá,537,387,308,1232
16038,2020-07-18,(07111) NQS - RICAURTE,654,448,341,1443
16039,2020-06-13,(04105) Carrera 53,209,116,158,483
16040,2020-09-08,(06104) Gobernación,290,152,145,587
16041,2020-06-10,(04003) Avenida Ciudad de Cali,992,598,637,2227
16042,2020-09-09,(07105) MOVISTAR ARENA,266,143,134,543
16043,2020-06-04,(07107) U. NACIONAL,297,178,137,612
16044,2020-02-16,(40001) Juan Pablo II,463,214,381,1058
16045,2020-03-15,(10004) Policarpa,200,95,201,496
16046,2020-04-21,(02104) Calle 146,380,266,231,877
16047,2020-09-25,(03011) SUBA - CALLE 100,644,299,366,1309
16048,2020-06-13,(05102) Av. Américas - Av. Boyacá,154,79,87,320
16049,2020-08-13,(09110) Avenida Jimenez,1425,987,763,3175
16050,2020-05-04,(09114) Calle 26,194,143,138,475
16051,2020-06-19,(12000) Puente Aranda,93,44,52,189
16052,2020-07-26,(12000) Puente Aranda,12,14,17,43
16053,2020-04-07,(02102) Calle 161,82,59,61,202
16054,2020-08-05,(02102) Calle 161,216,138,144,498
16055,2020-01-19,(04102) Avenida Boyaca,577,288,529,1394
16056,2020-05-14,(07111) NQS - RICAURTE,846,534,312,1692
16057,2020-04-02,(09120) Calle 63,501,373,332,1206
16058,2020-03-24,(07106) EL CAMPIN,254,214,219,687
16059,2020-08-15,(07009) SENA,483,307,395,1185
16060,2020-05-17,(07111) NQS - RICAURTE,136,106,107,349
16061,2020-06-21,(02304) Heroes,221,167,190,578
16062,2020-04-10,(02201) Prado,148,95,68,311
16063,2020-05-18,(08001) Parque el Tunal,384,232,230,846
16064,2020-03-20,(07109) CAD,433,297,155,885
16065,2020-09-04,(07200) Tygua-San José,264,153,199,616
16066,2020-05-18,(09113) Calle 22,383,231,288,902
16067,2020-02-13,(12002) CDS - Carrera 32,652,371,332,1355
16068,2020-06-18,(07008) NQS - Calle 30 Sur,296,158,147,601
16069,2020-09-27,(07006) General Santander - alimentacion,74,56,118,248
16070,2020-08-24,(07006) General Santander,508,307,305,1120
16071,2020-04-08,(06101) El Tiempo,222,160,120,502
16072,2020-04-28,(09117) Calle 45,496,317,249,1062
16073,2020-07-27,(07005) ALQUERIA,454,279,322,1055
16074,2020-08-21,(10008) San Diego,240,135,187,562
16075,2020-09-10,(04106) Carrera 47,312,144,187,643
16076,2020-08-14,(07010) Bosa,653,329,439,1421
16077,2020-09-01,(06104) Gobernación,290,160,137,587
16078,2020-05-23,(14004) Museo del Oro,0,54,129,183
16079,2020-07-10,(12007) Zona Industrial,386,232,174,792
16080,2020-03-27,(07006) General Santander - alimentacion,166,93,132,391
16081,2020-08-13,(07107) U. NACIONAL,321,179,190,690
16082,2020-03-21,(07006) General Santander - alimentacion,129,79,85,293
16083,2020-05-05,(07003) SEVILLANA,306,184,178,668
16084,2020-05-06,(07003) SEVILLANA,323,176,135,634
16085,2020-04-13,(12007) Zona Industrial,190,132,80,402
16086,2020-08-17,(09120) Calle 63,270,197,270,737
16087,2020-03-31,(04003) Avenida Ciudad de Cali,494,312,306,1112
16088,2020-05-02,(12007) Zona Industrial,115,81,63,259
16089,2020-04-27,(03010) PUENTE LARGO,54,106,51,211
16090,2020-08-19,(06105) Quinta Paredes,124,84,68,276
16091,2020-09-11,(06105) Quinta Paredes,129,83,80,292
16092,2020-07-24,(03004) GRATAMIRA,23,12,13,48
16093,2020-05-29,(10005) Bicentenario,105,46,65,216
16094,2020-06-14,(07010) Bosa,176,96,145,417
16095,2020-06-17,(09105) Río Fucha,126,70,105,301
16096,2020-08-22,(04107) Escuela Militar,98,64,63,225
16097,2020-03-21,(10003) Ciudad Jardín,65,37,33,135
16098,2020-07-11,(07006) General Santander - alimentacion,298,172,216,686
16099,2020-06-22,(04106) Carrera 47,132,69,73,274
16100,2020-06-15,(09106) Nariño,147,79,121,347
16101,2020-02-23,(12002) CDS - Carrera 32,63,68,79,210
16102,2020-03-25,(05103) Marsella,192,113,119,424
16103,2020-08-31,(06106) Recinto Ferial,229,143,125,497
16104,2020-07-15,(07108) Av. El Dorado,143,91,81,315
16105,2020-03-27,(07002) MADELENA,351,192,197,740
16106,2020-03-22,(06001) Modelia,72,55,52,179
16107,2020-09-05,(02103) Mazurén,155,96,187,438
16108,2020-04-14,(10005) Bicentenario,52,35,43,130
16109,2020-04-12,(04107) Escuela Militar,17,14,11,42
16110,2020-08-09,(06105) Quinta Paredes,33,26,25,84
16111,2020-07-27,(09105) Río Fucha,81,46,59,186
16112,2020-04-02,(08002) Biblioteca,181,101,92,374
16113,2020-05-24,(04101) Minuto de Dios,76,38,57,171
16114,2020-04-04,(09115) Calle 34,200,140,120,460
16115,2020-04-24,(06105) Quinta Paredes,81,61,43,185
16116,2020-04-20,(06104) Gobernación,140,115,64,319
16117,2020-09-06,(06108) Concejo de Bogotá,37,28,42,107
16118,2020-06-23,(03014) SAN MARTIN,35,9,28,72
16119,2020-04-19,(07101) CASTELLANA,12,22,28,62
16120,2020-08-18,(50006) Corral Carrera 77,4,1,4,9
16121,2020-05-17,(10006) San Victorino,58,56,67,181
16122,2020-03-29,(09108) Hospital,12,7,9,28
16123,2020-06-21,(09108) Hospital,25,20,24,69
16124,2020-03-11,(50006) Corral Carrera 77,25,18,31,74
16125,2020-04-29,(50002) Corral Calle 40 Sur,10,6,10,26
16126,2019-12-31,(50002) Corral Calle 40 Sur,0,1,0,1
16127,2020-08-09,(50006) Corral Carrera 77,1,0,0,1
16128,2020-07-18,(04000) Cabecera Calle 80 - alimentacion,2591,1329,1767,5687
16129,2020-02-04,(07005) ALQUERIA,2703,1523,1401,5627
16130,2020-02-16,(09002) Consuelo,420,160,365,945
16131,2020-03-24,(09118) Marly,1538,1090,865,3493
16132,2020-02-11,(07504) TERREROS,18138,11038,9370,38546
16133,2020-01-30,(04106) Carrera 47,1511,849,787,3147
16134,2020-02-19,(02101) Toberín,15164,9746,7706,32616
16135,2020-03-19,(07503) SAN MATEO,22880,12780,10364,46024
16136,2020-02-14,(05000) Portal Américas,15555,8505,8039,32099
16137,2020-02-14,(09100) Calle 40 Sur,7786,4293,4313,16392
16138,2020-02-04,(06104) Gobernación,1464,855,690,3009
16139,2020-03-04,(10000) Portal 20 de Julio - alimentacion,9476,5826,8411,23713
16140,2020-06-20,(10000) Portal 20 de Julio - alimentacion,3606,1705,2375,7686
16141,2020-03-07,(04101) Minuto de Dios,1554,847,1312,3713
16142,2020-02-06,(04002) Carrera 90,3682,2184,2112,7978
16143,2020-02-16,(09003) Socorro,523,215,417,1155
16144,2020-05-28,(10000) Portal 20 de Julio - alimentacion,3741,1700,2066,7507
16145,2020-03-12,(06107) Ciudad Universitaria,492,147,191,830
16146,2020-03-09,(05001) Patio Bonito,270,1961,1208,3439
16147,2020-02-19,(04103) Las Ferias,1614,942,866,3422
16148,2020-02-24,(02201) Prado,5965,3735,2918,12618
16149,2020-08-24,(07000) Portal Sur - alimentacion,7424,4021,3594,15039
16150,2020-03-12,(40001) Juan Pablo II,54,401,293,748
16151,2020-01-07,(09000) Cabecera Usme,4081,2401,3244,9726
16152,2020-04-27,(06000) Portal Eldorado - alimentacion,1447,342,270,2059
16153,2020-01-31,(07009) SENA,3549,2001,2010,7560
16154,2020-03-18,(02200) Alcalá,5722,3595,2709,12026
16155,2020-01-21,(02000) Cabecera Autopista Norte,7488,4147,3764,15399
16156,2020-05-02,(09109) Tercer Milenio,135,91,106,332
16157,2020-04-18,(07505) LEON XIII,856,532,381,1769
16158,2020-01-02,(02204) Pepe Sierra,2035,1376,1137,4548
16159,2020-10-03,(09123) Calle 76,723,570,811,2104
16160,2020-09-10,(05000) Portal Américas - alimentacion,11212,5655,6185,23052
16161,2020-01-15,(02304) Heroes,3722,2703,2098,8523
16162,2020-02-25,(02302) Virrey,3885,2672,1894,8451
16163,2020-03-12,(07503) SAN MATEO,1432,9378,5590,16400
16164,2020-01-30,(50003) Corral Molinos,3417,2066,3277,8760
16165,2020-06-30,(05100) Banderas P. Central - alimentacion,2918,1702,1932,6552
16166,2020-08-28,(09103) Olaya,1065,575,627,2267
16167,2020-09-23,(02000) Cabecera Autopista Norte - alimentacion,5461,2863,3442,11766
16168,2020-08-27,(09113) Calle 22,390,230,316,936
16169,2020-05-27,(03003) 21 ANGELES,285,138,139,562
16170,2020-09-14,(09004) Santa Lucía,1202,1331,2713,5246
16171,2020-07-28,(08000) Portal Tunal - alimentacion,5937,3277,3187,12401
16172,2020-07-31,(50003) Corral Molinos,1383,722,975,3080
16173,2020-09-01,(09110) Avenida Jimenez,1022,737,724,2483
16174,2020-06-24,(07112) COMUNEROS,818,488,488,1794
16175,2020-01-27,(09120) Calle 63,5374,3595,3324,12293
16176,2020-05-30,(02000) Cabecera Autopista Norte - intermunicipal,270,180,235,685
16177,2020-02-27,(07506) DESPENSA,1645,953,869,3467
16178,2020-03-11,(10001) Country Sur,4844,2143,2565,9552
16179,2020-08-27,(10001) Country Sur,1215,550,702,2467
16180,2020-02-19,(04002) Carrera 90,3873,2360,1957,8190
16181,2020-01-06,(06109) Centro Memoria,154,85,175,414
16182,2020-10-02,(10006) San Victorino,766,484,506,1756
16183,2020-02-19,(06000) Portal Eldorado,7025,3938,2864,13827
16184,2020-02-20,(06000) Portal Eldorado,6654,3845,2691,13190
16185,2020-06-04,(40003) Mirador del Paraiso,1603,1033,943,3579
16186,2020-10-10,(40003) Mirador del Paraiso,1547,812,1249,3608
16187,2020-01-29,(12001) Carrera 43,1707,968,1054,3729
16188,2020-01-11,(07000) Portal Sur - alimentacion,16261,7894,9231,33386
16189,2020-01-22,(04104) Avenida 68,3291,1731,1750,6772
16190,2020-02-28,(09107) Hortúa,2476,1425,1574,5475
16191,2020-01-09,(10005) Bicentenario - alimentacion,510,237,447,1194
16192,2020-05-23,(08000) Portal Tunal - alimentacion,4261,2242,2231,8734
16193,2020-05-14,(07010) Bosa,535,300,313,1148
16194,2020-02-24,(04108) El Polo,1962,1214,1214,4390
16195,2020-05-05,(07112) COMUNEROS,551,316,296,1163
16196,2020-07-06,(02303) Calle 85,774,503,436,1713
16197,2020-08-15,(09116) Avenida 39,206,140,210,556
16198,2020-06-04,(07004) VENECIA,899,525,467,1891
16199,2020-02-07,(07008) NQS - Calle 30 Sur,1978,1026,1159,4163
16200,2020-08-29,(08001) Parque el Tunal,382,188,284,854
16201,2020-08-13,(09000) Cabecera Usme - alimentacion,8234,4344,4635,17213
16202,2020-04-30,(10001) Country Sur,693,284,411,1388
16203,2020-07-30,(10001) Country Sur,1206,549,662,2417
16204,2020-03-19,(02304) Heroes,1908,1471,1167,4546
16205,2020-06-21,(09107) Hortúa,207,133,134,474
16206,2020-05-16,(05101) Mandalay - Cr.73,54,34,24,112
16207,2020-02-10,(07006) General Santander,2968,1715,1592,6275
16208,2020-03-08,(05005) Transversal 86,485,139,410,1034
16209,2020-06-08,(05005) Transversal 86,302,161,202,665
16210,2020-06-16,(05005) Transversal 86,363,197,241,801
16211,2020-07-09,(05001) Patio Bonito,1516,1032,1174,3722
16212,2020-08-22,(02205) Calle 106,179,142,159,480
16213,2020-03-05,(03006) NIZA - CALLE 127,2390,1550,1595,5535
16214,2020-08-10,(09101) Quiroga,523,285,369,1177
16215,2020-07-27,(04108) El Polo,469,272,221,962
16216,2020-03-20,(02202) Calle 127,720,500,300,1520
16217,2020-01-24,(06000) Portal Eldorado,6003,3587,2836,12426
16218,2020-09-26,(07106) EL CAMPIN,372,273,289,934
16219,2020-06-24,(07113) SANTA ISABEL,403,255,273,931
16220,2020-08-12,(06111) Universidades,329,198,286,813
16221,2020-01-24,(09117) Calle 45,4645,3166,2778,10589
16222,2020-04-26,(10002) Av. Primero de Mayo,368,232,278,878
16223,2020-07-21,(10005) Bicentenario - alimentacion,163,92,146,401
16224,2020-09-29,(04003) Avenida Ciudad de Cali,1202,685,964,2851
16225,2020-06-25,(09000) Cabecera Usme,1775,1112,1212,4099
16226,2020-09-07,(09109) Tercer Milenio,357,225,247,829
16227,2020-09-04,(04002) Carrera 90,771,414,500,1685
16228,2020-09-12,(12001) Carrera 43,283,163,263,709
16229,2020-02-08,(09120) Calle 63,3640,2397,2833,8870
16230,2020-07-26,(02202) Calle 127,330,256,193,779
16231,2020-08-02,(08000) Portal Tunal,191,111,114,416
16232,2020-05-18,(03001) LA CAMPIÑA,842,506,449,1797
16233,2020-09-03,(07109) CAD,648,391,362,1401
16234,2020-07-13,(02105) Calle 142,706,461,411,1578
16235,2020-02-02,(07008) NQS - Calle 30 Sur,508,189,444,1141
16236,2020-07-03,(12003) Ricaurte,407,218,251,876
16237,2020-02-01,(07107) U. NACIONAL,910,675,900,2485
16238,2020-09-17,(02105) Calle 142,889,546,639,2074
16239,2020-07-22,(09109) Tercer Milenio,241,146,187,574
16240,2020-09-12,(03006) NIZA - CALLE 127,394,219,242,855
16241,2020-07-16,(02104) Calle 146,659,430,385,1474
16242,2020-05-12,(06102) Salitre El Greco,161,81,88,330
16243,2020-05-21,(40002) Manitas,320,197,217,734
16244,2020-10-06,(06109) Centro Memoria,315,192,188,695
16245,2020-03-02,(09106) Nariño,1980,1212,1343,4535
16246,2020-05-27,(02001) Centro Comercial Santa Fe,346,212,246,804
16247,2020-04-22,(05100) Banderas P. Central - alimentacion,1623,793,702,3118
16248,2020-05-31,(10000) Portal 20 de Julio,618,278,386,1282
16249,2020-03-31,(02300) Calle 100,716,556,388,1660
16250,2020-09-30,(07006) General Santander,632,377,436,1445
16251,2020-10-10,(09101) Quiroga,448,231,450,1129
16252,2020-02-01,(10006) San Victorino,1138,799,1014,2951
16253,2020-02-01,(07003) SEVILLANA,1210,567,949,2726
16254,2020-09-10,(09122) Calle 72,1150,794,860,2804
16255,2020-04-13,(02204) Pepe Sierra,399,336,213,948
16256,2020-05-05,(02204) Pepe Sierra,477,382,255,1114
16257,2020-01-26,(07001) PERDOMO,915,392,875,2182
16258,2020-08-10,(02200) Alcalá,1540,1066,875,3481
16259,2020-05-05,(07000) Portal Sur,1141,724,736,2601
16260,2020-01-03,(06100) Av. Rojas,828,501,616,1945
16261,2020-03-19,(12004) Carrera 22,389,258,255,902
16262,2020-06-30,(07201) Guatoque -Veraguas,200,110,145,455
16263,2020-07-09,(06100) Av. Rojas,247,147,164,558
16264,2020-06-05,(06109) Centro Memoria,265,155,122,542
16265,2020-04-17,(03002) SUBA - TV- 91,419,266,236,921
16266,2020-06-07,(09103) Olaya,330,172,201,703
16267,2020-06-26,(06104) Gobernación,255,175,137,567
16268,2020-06-07,(07105) MOVISTAR ARENA,50,37,60,147
16269,2020-09-04,(07105) MOVISTAR ARENA,256,154,171,581
16270,2020-06-17,(09121) Las Flores,752,481,425,1658
16271,2020-03-02,(07506) DESPENSA,1387,959,906,3252
16272,2020-05-12,(05105) Pradera,459,278,173,910
16273,2020-09-10,(09114) Calle 26,337,214,268,819
16274,2020-04-23,(02303) Calle 85,343,229,183,755
16275,2020-05-07,(02303) Calle 85,408,294,217,919
16276,2020-05-17,(06109) Centro Memoria,75,45,34,154
16277,2020-06-23,(03003) 21 ANGELES,362,174,207,743
16278,2020-03-20,(02104) Calle 146,453,296,198,947
16279,2020-06-30,(04103) Las Ferias,383,216,183,782
16280,2020-07-23,(07103) AV. CHILE,799,481,353,1633
16281,2020-04-08,(02304) Heroes,365,282,238,885
16282,2020-04-07,(08002) Biblioteca,176,86,82,344
16283,2020-07-28,(03010) PUENTE LARGO,323,198,171,692
16284,2020-06-30,(12000) Puente Aranda,96,44,53,193
16285,2020-07-05,(12000) Puente Aranda,6,6,15,27
16286,2020-05-12,(06105) Quinta Paredes,101,75,48,224
16287,2020-06-04,(02102) Calle 161,218,154,139,511
16288,2020-06-07,(14001) La Sabana,44,34,36,114
16289,2020-03-13,(09113) Calle 22,396,151,182,729
16290,2020-07-20,(07107) U. NACIONAL,109,71,73,253
16291,2020-06-09,(02502) Terminal,398,267,306,971
16292,2020-06-05,(03013) RIO NEGRO,264,171,220,655
16293,2020-04-16,(10009) Museo Nacional,302,207,170,679
16294,2020-06-29,(04000) Cabecera Calle 80,323,229,287,839
16295,2020-08-22,(02502) Terminal,208,170,292,670
16296,2020-08-04,(09114) Calle 26,292,169,200,661
16297,2020-04-04,(09122) Calle 72,424,294,267,985
16298,2020-03-30,(07008) NQS - Calle 30 Sur,130,75,84,289
16299,2020-09-21,(02001) Centro Comercial Santa Fe,442,269,346,1057
16300,2020-09-10,(04000) Cabecera Calle 80 - intermunicipal,372,184,332,888
16301,2020-07-31,(03003) 21 ANGELES,252,142,151,545
16302,2020-08-13,(07506) DESPENSA,440,256,211,907
16303,2020-01-19,(04000) Cabecera Calle 80 - intermunicipal,268,167,397,832
16304,2020-10-09,(03010) PUENTE LARGO,405,256,335,996
16305,2020-06-20,(14004) Museo del Oro,104,98,141,343
16306,2020-08-01,(14004) Museo del Oro,97,79,122,298
16307,2020-07-22,(09108) Hospital,64,40,59,163
16308,2020-01-01,(06107) Ciudad Universitaria,60,40,148,248
16309,2020-09-13,(14004) Museo del Oro,13,51,136,200
16310,2020-04-07,(02304) Heroes,363,292,240,895
16311,2020-10-12,(02201) Prado,341,209,335,885
16312,2020-10-08,(07110) PALOQUEMAO,709,457,391,1557
16313,2020-08-17,(07000) Portal Sur,490,254,379,1123
16314,2020-08-15,(06106) Recinto Ferial,199,116,112,427
16315,2020-04-03,(07006) General Santander,242,131,130,503
16316,2020-06-21,(09114) Calle 26,70,48,82,200
16317,2020-03-20,(04101) Minuto de Dios,159,116,105,380
16318,2020-04-24,(06001) Modelia,261,197,163,621
16319,2020-06-11,(03005) SUBA - AV. BOYACA,450,249,236,935
16320,2020-03-28,(05107) Américas - Cr.53,194,164,118,476
16321,2020-06-14,(09109) Tercer Milenio,96,64,101,261
16322,2020-03-23,(02303) Calle 85,182,139,109,430
16323,2020-05-18,(09111) Calle 19,605,394,444,1443
16324,2020-04-02,(07104) Simon Bolivar,174,137,121,432
16325,2020-06-26,(03005) SUBA - AV. BOYACA,482,308,241,1031
16326,2020-06-12,(14004) Museo del Oro,139,131,213,483
16327,2020-10-04,(06101) El Tiempo,114,93,160,367
16328,2020-09-28,(07007) NQS - Calle 38A Sur,482,296,425,1203
16329,2020-07-05,(02103) Mazurén,40,31,50,121
16330,2020-03-31,(07002) MADELENA,351,166,208,725
16331,2020-08-05,(03005) SUBA - AV. BOYACA,321,180,194,695
16332,2020-08-14,(06106) Recinto Ferial,232,151,124,507
16333,2020-07-18,(04105) Carrera 53,186,99,98,383
16334,2020-09-03,(05103) Marsella,471,249,297,1017
16335,2020-04-01,(05102) Av. Américas - Av. Boyacá,129,80,65,274
16336,2020-03-29,(07108) Av. El Dorado,25,19,8,52
16337,2020-04-26,(06106) Recinto Ferial,45,28,29,102
16338,2020-05-31,(07107) U. NACIONAL,96,63,55,214
16339,2020-03-04,(50006) Corral Carrera 77,32,29,43,104
16340,2020-09-20,(04107) Escuela Militar,35,44,73,152
16341,2020-06-09,(10005) Bicentenario,113,57,62,232
16342,2020-08-02,(14005) Las Aguas,35,31,77,143
16343,2020-04-05,(03004) GRATAMIRA,11,4,4,19
16344,2020-08-13,(03014) SAN MARTIN,0,14,32,46
16345,2020-09-03,(07005) ALQUERIA,560,326,377,1263
16346,2020-04-19,(07504) TERREROS,887,559,434,1880
16347,2020-04-20,(05000) Portal Américas - alimentacion,6269,3339,2792,12400
16348,2020-03-16,(02101) Toberín,9051,5611,4366,19028
16349,2020-02-17,(07003) SEVILLANA,2174,1243,1162,4579
16350,2020-02-18,(07003) SEVILLANA,2186,1255,1158,4599
16351,2020-01-25,(10000) Portal 20 de Julio - alimentacion,7866,3750,5975,17591
16352,2020-06-26,(10000) Portal 20 de Julio - alimentacion,4403,2129,2622,9154
16353,2020-04-28,(09000) Cabecera Usme - alimentacion,4837,2613,3050,10500
16354,2020-10-09,(04002) Carrera 90,887,418,694,1999
16355,2020-01-18,(04000) Cabecera Calle 80 - alimentacion,11412,5248,9274,25934
16356,2020-08-20,(09001) Molinos,2433,1283,1643,5359
16357,2020-02-03,(05001) Patio Bonito,6974,3991,3888,14853
16358,2020-01-11,(02000) Cabecera Autopista Norte - alimentacion,11501,5266,7653,24420
16359,2020-03-03,(07000) Portal Sur - alimentacion,28866,16514,14729,60109
16360,2020-01-11,(07002) MADELENA,2153,914,1482,4549
16361,2020-09-11,(09100) Calle 40 Sur,1801,1016,1178,3995
16362,2020-09-16,(09000) Cabecera Usme,1903,1200,1407,4510
16363,2020-10-11,(09000) Cabecera Usme,556,252,680,1488
16364,2020-06-13,(09115) Calle 34,405,272,327,1004
16365,2020-02-26,(10003) Ciudad Jardín,1078,568,670,2316
16366,2020-02-05,(07113) SANTA ISABEL,2219,1343,1443,5005
16367,2020-05-14,(07505) LEON XIII,1883,1089,903,3875
16368,2020-10-09,(07505) LEON XIII,3172,1630,1866,6668
16369,2020-09-15,(04104) Avenida 68,722,357,439,1518
16370,2020-01-27,(02502) Terminal,4990,3274,2722,10986
16371,2020-03-18,(09123) Calle 76,2618,1880,1487,5985
16372,2020-02-09,(07110) PALOQUEMAO,368,295,417,1080
16373,2020-05-27,(02000) Cabecera Autopista Norte - alimentacion,4200,2387,2143,8730
16374,2020-03-06,(12003) Ricaurte,1207,819,717,2743
16375,2020-02-24,(07002) MADELENA,5108,2970,2502,10580
16376,2020-03-02,(07112) COMUNEROS,3703,2277,2310,8290
16377,2020-03-06,(09113) Calle 22,1521,902,1070,3493
16378,2020-07-07,(07010) Bosa,767,375,475,1617
16379,2020-08-05,(02000) Cabecera Autopista Norte - alimentacion,4186,2286,2234,8706
16380,2020-06-20,(09110) Avenida Jimenez,1158,884,749,2791
16381,2020-01-22,(04003) Avenida Ciudad de Cali,5052,2986,3142,11180
16382,2020-09-01,(07506) DESPENSA,466,265,297,1028
16383,2020-01-23,(10001) Country Sur,4771,2053,2487,9311
16384,2020-03-17,(10001) Country Sur,3056,1385,1677,6118
16385,2020-02-08,(04100) Carrera 77,3911,1930,3020,8861
16386,2020-02-12,(10006) San Victorino,2710,1391,1304,5405
16387,2020-01-24,(10008) San Diego,1245,771,796,2812
16388,2020-01-30,(12001) Carrera 43,1748,978,982,3708
16389,2020-02-09,(07505) LEON XIII,2165,931,1419,4515
16390,2020-02-03,(02302) Virrey,3899,2565,1842,8306
16391,2020-06-22,(03000) Portal Suba,332,225,295,852
16392,2020-08-04,(09116) Avenida 39,327,188,239,754
16393,2020-03-04,(07004) VENECIA,4621,2589,2436,9646
16394,2020-09-24,(09003) Socorro,627,325,401,1353
16395,2020-06-26,(02101) Toberín,1586,1030,1036,3652
16396,2020-04-30,(06108) Concejo de Bogotá,95,65,71,231
16397,2020-09-17,(07001) PERDOMO,1085,661,777,2523
16398,2020-05-24,(09107) Hortúa,195,99,94,388
16399,2020-09-01,(09107) Hortúa,622,372,375,1369
16400,2020-03-04,(05101) Mandalay - Cr.73,1206,649,528,2383
16401,2020-08-08,(40003) Mirador del Paraiso,1318,706,900,2924
16402,2020-03-06,(10009) Museo Nacional,3835,2327,2148,8310
16403,2020-01-27,(03011) SUBA - CALLE 100,2655,1255,1344,5254
16404,2020-03-16,(03012) SUBA - CALLE 95,1094,683,662,2439
16405,2020-06-27,(10000) Portal 20 de Julio,1909,878,1123,3910
16406,2020-08-03,(10000) Portal 20 de Julio,2101,1027,993,4121
16407,2020-07-02,(02202) Calle 127,1185,797,626,2608
16408,2020-08-28,(05105) Pradera,637,353,295,1285
16409,2020-05-26,(07007) NQS - Calle 38A Sur,322,189,210,721
16410,2020-02-26,(09121) Las Flores,3316,2149,2110,7575
16411,2020-07-17,(08000) Portal Tunal,574,201,226,1001
16412,2020-07-26,(05000) Portal Américas - alimentacion,2612,1212,1209,5033
16413,2020-06-11,(02205) Calle 106,312,203,199,714
16414,2020-08-06,(06000) Portal Eldorado - alimentacion,3357,1630,1881,6868
16415,2020-02-03,(03006) NIZA - CALLE 127,2449,1509,1534,5492
16416,2020-01-26,(02000) Cabecera Autopista Norte,1743,910,1706,4359
16417,2020-09-30,(07113) SANTA ISABEL,460,299,348,1107
16418,2020-10-02,(04108) El Polo,584,369,419,1372
16419,2020-05-28,(02300) Calle 100,1150,741,518,2409
16420,2020-03-04,(07000) Portal Sur,7827,4571,4185,16583
16421,2020-01-25,(06000) Portal Eldorado,2552,1801,2166,6519
16422,2020-01-29,(06000) Portal Eldorado,6354,3770,2793,12917
16423,2020-01-07,(05103) Marsella,1743,1004,1086,3833
16424,2020-05-07,(03007) HUMEDAL CORDOBA,83,47,50,180
16425,2020-07-14,(03007) HUMEDAL CORDOBA,143,89,51,283
16426,2020-01-10,(03005) SUBA - AV. BOYACA,1941,1123,1242,4306
16427,2020-04-16,(02000) Cabecera Autopista Norte - alimentacion,2841,1512,1346,5699
16428,2020-02-27,(04103) Las Ferias,1548,933,847,3328
16429,2020-03-16,(04103) Las Ferias,1048,649,569,2266
16430,2020-03-23,(02202) Calle 127,405,284,201,890
16431,2020-08-25,(07104) Simon Bolivar,590,331,267,1188
16432,2020-02-18,(04107) Escuela Militar,711,441,442,1594
16433,2020-06-25,(04107) Escuela Militar,153,92,97,342
16434,2020-07-04,(05000) Portal Américas,2038,1302,1773,5113
16435,2020-02-09,(03001) LA CAMPIÑA,1157,525,1172,2854
16436,2020-03-07,(03003) 21 ANGELES,1009,367,624,2000
16437,2020-05-29,(09106) Nariño,373,212,242,827
16438,2020-02-08,(09109) Tercer Milenio,878,480,762,2120
16439,2020-07-15,(06101) El Tiempo,346,186,132,664
16440,2020-08-05,(09117) Calle 45,640,404,378,1422
16441,2020-08-27,(02104) Calle 146,742,440,505,1687
16442,2020-01-30,(09113) Calle 22,1565,877,1040,3482
16443,2020-03-01,(09101) Quiroga,386,189,516,1091
16444,2020-10-02,(09121) Las Flores,771,497,631,1899
16445,2020-06-19,(02204) Pepe Sierra,862,560,438,1860
16446,2020-09-09,(09118) Marly,1533,962,935,3430
16447,2020-03-08,(03001) LA CAMPIÑA,1127,479,1104,2710
16448,2020-05-23,(07113) SANTA ISABEL,238,157,160,555
16449,2020-04-04,(04108) El Polo,107,77,68,252
16450,2020-09-01,(02105) Calle 142,818,514,545,1877
16451,2020-06-17,(06000) Portal Eldorado,1025,683,524,2232
16452,2020-03-15,(02302) Virrey,342,260,442,1044
16453,2020-09-04,(02302) Virrey,720,510,452,1682
16454,2020-09-19,(02302) Virrey,429,347,435,1211
16455,2020-03-19,(09122) Calle 72,3012,2033,1886,6931
16456,2020-03-10,(03009) Av. Suba- Calle 116,1174,255,410,1839
16457,2020-05-18,(02105) Calle 142,638,411,341,1390
16458,2020-07-03,(03002) SUBA - TV- 91,867,490,518,1875
16459,2020-03-13,(04000) Cabecera Calle 80 - intermunicipal,32,369,425,826
16460,2020-07-09,(09123) Calle 76,1128,769,608,2505
16461,2020-07-17,(09123) Calle 76,822,593,513,1928
16462,2020-05-15,(02103) Mazurén,129,83,89,301
16463,2020-03-15,(10005) Bicentenario,61,47,91,199
16464,2020-07-03,(10005) Bicentenario,106,51,100,257
16465,2020-07-15,(06109) Centro Memoria,212,128,109,449
16466,2020-06-23,(09117) Calle 45,782,483,500,1765
16467,2020-08-15,(04002) Carrera 90,526,273,368,1167
16468,2020-04-16,(05100) Banderas P. Central - alimentacion,1536,723,648,2907
16469,2020-04-17,(09113) Calle 22,274,148,223,645
16470,2020-05-29,(10008) San Diego,257,159,164,580
16471,2020-09-26,(09120) Calle 63,1020,705,953,2678
16472,2020-09-13,(09103) Olaya,414,184,346,944
16473,2020-07-13,(03006) NIZA - CALLE 127,452,250,168,870
16474,2020-02-03,(03004) GRATAMIRA,327,175,146,648
16475,2020-09-26,(07006) General Santander,513,257,427,1197
16476,2020-05-09,(07000) Portal Sur,882,514,536,1932
16477,2020-07-23,(06000) Portal Eldorado,794,483,383,1660
16478,2020-02-26,(09111) Calle 19,1529,1389,1853,4771
16479,2020-03-11,(09111) Calle 19,2181,1341,1476,4998
16480,2020-05-10,(09122) Calle 72,280,202,197,679
16481,2020-06-19,(09122) Calle 72,1256,838,768,2862
16482,2020-06-30,(09118) Marly,1430,935,913,3278
16483,2020-09-27,(09002) Consuelo,177,73,177,427
16484,2020-07-07,(07105) MOVISTAR ARENA,285,143,170,598
16485,2020-06-09,(07000) Portal Sur,1739,1074,925,3738
16486,2020-09-14,(05105) Pradera,609,366,327,1302
16487,2020-05-31,(06109) Centro Memoria,79,42,52,173
16488,2020-09-20,(06109) Centro Memoria,79,52,104,235
16489,2020-10-03,(10007) Las Nieves,517,383,485,1385
16490,2020-01-06,(07105) MOVISTAR ARENA,155,126,217,498
16491,2020-05-15,(04001) Quirigua,290,182,195,667
16492,2020-09-30,(05103) Marsella,554,312,388,1254
16493,2020-04-07,(04103) Las Ferias,185,113,132,430
16494,2020-06-10,(03011) SUBA - CALLE 100,465,213,192,870
16495,2020-09-03,(04103) Las Ferias,367,201,206,774
16496,2020-04-13,(06111) Universidades,0,86,220,306
16497,2020-10-02,(07506) DESPENSA,441,270,355,1066
16498,2019-12-31,(10000) Portal 20 de Julio - alimentacion,109,97,194,400
16499,2020-07-11,(06001) Modelia,263,177,209,649
16500,2020-09-23,(04106) Carrera 47,369,198,261,828
16501,2020-10-04,(04106) Carrera 47,145,64,143,352
16502,2020-10-08,(06002) Normandía,401,248,302,951
16503,2020-07-02,(07200) Tygua-San José,276,128,184,588
16504,2020-08-09,(02302) Virrey,140,112,94,346
16505,2020-08-02,(07003) SEVILLANA,101,46,72,219
16506,2020-03-28,(09115) Calle 34,200,158,129,487
16507,2020-08-17,(09001) Molinos,800,431,599,1830
16508,2020-03-30,(09000) Cabecera Usme,780,422,570,1772
16509,2020-06-27,(04102) Avenida Boyaca,293,165,223,681
16510,2020-10-02,(06002) Normandía,432,239,334,1005
16511,2020-07-06,(04000) Cabecera Calle 80 - intermunicipal,357,195,335,887
16512,2020-03-01,(09108) Hospital,89,43,100,232
16513,2020-06-08,(07006) General Santander - alimentacion,361,224,233,818
16514,2020-04-04,(09003) Socorro,222,88,117,427
16515,2020-05-22,(02502) Terminal,330,225,265,820
16516,2020-05-24,(02502) Terminal,50,39,75,164
16517,2020-06-21,(02502) Terminal,69,52,94,215
16518,2020-06-10,(06105) Quinta Paredes,127,99,72,298
16519,2020-05-23,(07010) Bosa,442,235,294,971
16520,2020-09-12,(12002) CDS - Carrera 32,120,97,76,293
16521,2020-08-04,(07005) ALQUERIA,429,267,296,992
16522,2020-06-07,(02001) Centro Comercial Santa Fe,90,61,98,249
16523,2020-01-05,(07006) General Santander - alimentacion,197,115,282,594
16524,2020-03-15,(05107) Américas - Cr.53,301,217,375,893
16525,2020-04-26,(05100) Banderas P. Central,94,42,60,196
16526,2020-09-24,(10004) Policarpa,287,128,187,602
16527,2020-05-05,(12007) Zona Industrial,220,159,112,491
16528,2020-07-16,(06001) Modelia,320,201,164,685
16529,2020-04-22,(07107) U. NACIONAL,218,157,98,473
16530,2020-03-21,(12001) Carrera 43,147,108,78,333
16531,2020-07-06,(40002) Manitas,446,269,286,1001
16532,2020-06-19,(06106) Recinto Ferial,248,152,137,537
16533,2020-04-12,(07001) PERDOMO,139,83,72,294
16534,2020-07-06,(09105) Río Fucha,121,51,101,273
16535,2020-08-07,(06101) El Tiempo,104,73,78,255
16536,2020-05-25,(06101) El Tiempo,101,69,62,232
16537,2020-04-28,(07113) SANTA ISABEL,236,142,162,540
16538,2020-09-12,(14001) La Sabana,142,104,112,358
16539,2020-06-19,(06100) Av. Rojas,240,128,164,532
16540,2020-08-14,(06108) Concejo de Bogotá,126,79,74,279
16541,2020-02-01,(03014) SAN MARTIN,107,69,139,315
16542,2020-02-23,(03014) SAN MARTIN,38,21,55,114
16543,2020-03-23,(05100) Banderas P. Central,121,62,89,272
16544,2020-08-23,(03004) GRATAMIRA,0,5,12,17
16545,2020-04-25,(04107) Escuela Militar,44,25,40,109
16546,2020-08-21,(06106) Recinto Ferial,221,136,120,477
16547,2019-12-31,(09114) Calle 26,17,11,24,52
16548,2020-06-20,(04103) Las Ferias,313,185,173,671
16549,2020-07-19,(06002) Normandía,55,43,56,154
16550,2020-04-12,(07003) SEVILLANA,52,37,31,120
16551,2020-04-12,(02204) Pepe Sierra,173,159,98,430
16552,2020-03-29,(09115) Calle 34,111,95,68,274
16553,2020-05-26,(10003) Ciudad Jardín,168,94,117,379
16554,2020-08-18,(09105) Río Fucha,0,41,97,138
16555,2020-09-03,(09105) Río Fucha,0,78,155,233
16556,2020-08-17,(05103) Marsella,117,58,74,249
16557,2020-04-27,(09105) Río Fucha,31,22,8,61
16558,2020-06-06,(06104) Gobernación,113,76,94,283
16559,2020-03-25,(12004) Carrera 22,44,40,34,118
16560,2020-08-27,(12000) Puente Aranda,75,38,49,162
16561,2020-05-25,(12007) Zona Industrial,48,44,50,142
16562,2020-05-25,(14005) Las Aguas,0,10,69,79
16563,2020-06-10,(50006) Corral Carrera 77,4,4,4,12
16564,2020-07-01,(50006) Corral Carrera 77,6,5,14,25
16565,2020-09-20,(12000) Puente Aranda,12,10,20,42
16566,2020-05-24,(10005) Bicentenario,26,12,21,59
16567,2020-06-14,(03014) SAN MARTIN,12,4,5,21
16568,2020-04-11,(03014) SAN MARTIN,6,6,9,21
16569,2020-07-14,(04000) Cabecera Calle 80 - alimentacion,3501,2065,2114,7680
16570,2020-07-15,(04000) Cabecera Calle 80 - alimentacion,3520,1999,2168,7687
16571,2020-07-01,(07005) ALQUERIA,605,345,359,1309
16572,2020-08-12,(09002) Consuelo,476,272,265,1013
16573,2020-02-29,(05000) Portal Américas - alimentacion,25014,12907,17148,55069
16574,2020-01-19,(03000) Portal Suba - alimentacion,5919,2621,5262,13802
16575,2020-01-15,(02303) Calle 85,3273,2204,1751,7228
16576,2020-03-24,(07505) LEON XIII,2068,1045,1135,4248
16577,2020-03-09,(02200) Alcalá,2282,3051,1773,7106
16578,2020-03-06,(06000) Portal Eldorado - alimentacion,16449,9255,11031,36735
16579,2020-02-06,(06104) Gobernación,1464,922,717,3103
16580,2020-01-29,(08001) Parque el Tunal,1698,962,913,3573
16581,2020-02-19,(10000) Portal 20 de Julio - alimentacion,11164,5845,7802,24811
16582,2020-02-11,(04002) Carrera 90,3897,2398,2080,8375
16583,2020-02-18,(06107) Ciudad Universitaria,1660,926,929,3515
16584,2020-10-03,(06107) Ciudad Universitaria,146,88,176,410
16585,2020-01-22,(08000) Portal Tunal - alimentacion,22079,12120,11326,45525
16586,2020-02-26,(07010) Bosa,2251,1307,1432,4990
16587,2020-10-01,(07503) SAN MATEO,13702,6915,7500,28117
16588,2020-02-18,(05100) Banderas P. Central,8534,5013,3843,17390
16589,2020-09-10,(05100) Banderas P. Central,972,544,611,2127
16590,2020-08-31,(09000) Cabecera Usme,1699,1057,1255,4011
16591,2020-04-07,(06000) Portal Eldorado - alimentacion,2260,1070,1011,4341
16592,2020-03-14,(05100) Banderas P. Central,2915,1311,2190,6416
16593,2020-01-04,(09120) Calle 63,1531,1086,1479,4096
16594,2020-02-27,(09109) Tercer Milenio,1389,847,864,3100
16595,2020-03-19,(09104) Restrepo,2927,1748,2308,6983
16596,2020-06-17,(07505) LEON XIII,2856,1535,1211,5602
16597,2020-05-23,(03000) Portal Suba - alimentacion,3705,2079,2063,7847
16598,2020-06-30,(03000) Portal Suba - alimentacion,6553,3944,3782,14279
16599,2020-03-26,(07504) TERREROS,2375,1353,1363,5091
16600,2020-06-13,(02204) Pepe Sierra,563,390,323,1276
16601,2020-03-05,(09110) Avenida Jimenez,5015,3320,2936,11271
16602,2020-02-15,(07000) Portal Sur - alimentacion,19854,9714,11704,41272
16603,2020-09-17,(07102) NQS - CALLE 75,482,323,271,1076
16604,2020-03-14,(07000) Portal Sur - alimentacion,17495,8522,10124,36141
16605,2020-03-16,(02103) Mazurén,1803,1141,995,3939
16606,2020-07-23,(14001) La Sabana,102,74,71,247
16607,2020-05-25,(07002) MADELENA,182,86,114,382
16608,2020-09-30,(07002) MADELENA,1083,613,729,2425
16609,2020-01-07,(07106) EL CAMPIN,1274,866,842,2982
16610,2020-02-15,(10002) Av. Primero de Mayo,4923,2375,4002,11300
16611,2020-02-25,(09114) Calle 26,3445,2219,1760,7424
16612,2020-08-23,(05000) Portal Américas,659,348,573,1580
16613,2020-01-11,(07112) COMUNEROS,1787,980,1454,4221
16614,2020-02-21,(05107) Américas - Cr.53,2494,1378,1424,5296
16615,2020-01-14,(09120) Calle 63,3827,2770,2881,9478
16616,2020-02-28,(10001) Country Sur,5219,2233,2780,10232
16617,2020-01-11,(04002) Carrera 90,1565,687,1192,3444
16618,2020-02-17,(10006) San Victorino,2658,1276,1248,5182
16619,2020-10-01,(10006) San Victorino,808,423,463,1694
16620,2020-06-19,(40003) Mirador del Paraiso,1842,1190,1080,4112
16621,2020-09-24,(06000) Portal Eldorado - alimentacion,4279,2101,2559,8939
16622,2020-01-11,(09004) Santa Lucía,4351,1995,2912,9258
16623,2020-04-25,(07000) Portal Sur - alimentacion,3198,1795,1256,6249
16624,2020-06-06,(07000) Portal Sur - alimentacion,5812,3094,2759,11665
16625,2020-01-03,(10000) Portal 20 de Julio,4931,2203,2757,9891
16626,2020-06-26,(05100) Banderas P. Central - alimentacion,3230,1697,1795,6722
16627,2020-07-22,(03000) Portal Suba,1132,714,773,2619
16628,2020-09-01,(03000) Portal Suba,1416,859,928,3203
16629,2020-06-01,(02000) Cabecera Autopista Norte - intermunicipal,457,336,331,1124
16630,2020-08-11,(02000) Cabecera Autopista Norte - intermunicipal,491,324,345,1160
16631,2020-08-05,(10000) Portal 20 de Julio - alimentacion,3928,1712,2313,7953
16632,2020-08-30,(10000) Portal 20 de Julio,756,319,607,1682
16633,2020-09-18,(10000) Portal 20 de Julio,2500,1212,1516,5228
16634,2020-08-29,(10000) Portal 20 de Julio,1806,933,1145,3884
16635,2020-08-07,(07000) Portal Sur - alimentacion,3364,1630,1719,6713
16636,2020-06-02,(02303) Calle 85,613,457,291,1361
16637,2020-01-30,(10007) Las Nieves,1921,1214,1152,4287
16638,2020-05-13,(04100) Carrera 77,932,534,553,2019
16639,2020-07-01,(09003) Socorro,633,356,362,1351
16640,2020-01-22,(05102) Av. Américas - Av. Boyacá,1588,974,944,3506
16641,2020-01-22,(07007) NQS - Calle 38A Sur,1940,1121,1272,4333
16642,2020-02-16,(09123) Calle 76,558,474,863,1895
16643,2020-03-17,(06108) Concejo de Bogotá,511,270,261,1042
16644,2020-07-02,(06108) Concejo de Bogotá,150,91,82,323
16645,2020-09-25,(06108) Concejo de Bogotá,153,87,116,356
16646,2020-07-14,(02101) Toberín,1285,810,826,2921
16647,2020-05-19,(02000) Cabecera Autopista Norte,1013,670,660,2343
16648,2020-01-09,(07001) PERDOMO,3534,1993,2030,7557
16649,2020-03-11,(07001) PERDOMO,4240,2597,2485,9322
16650,2020-01-24,(05100) Banderas P. Central,7074,3817,3582,14473
16651,2020-03-29,(09000) Cabecera Usme - alimentacion,1641,779,826,3246
16652,2020-03-28,(09107) Hortúa,281,184,117,582
16653,2020-06-08,(09107) Hortúa,626,349,349,1324
16654,2020-04-08,(05000) Portal Américas,1210,810,985,3005
16655,2020-10-07,(10000) Portal 20 de Julio,2599,1228,1793,5620
16656,2020-03-05,(07104) Simon Bolivar,2433,1503,1232,5168
16657,2020-08-08,(09104) Restrepo,1113,621,855,2589
16658,2020-06-23,(05001) Patio Bonito,2048,1172,1160,4380
16659,2020-09-19,(05001) Patio Bonito,1927,928,1313,4168
16660,2020-03-03,(06109) Centro Memoria,1168,612,637,2417
16661,2020-09-14,(03009) Av. Suba- Calle 116,523,318,272,1113
16662,2020-04-17,(02205) Calle 106,166,114,85,365
16663,2020-06-24,(02205) Calle 106,373,259,217,849
16664,2020-01-12,(09101) Quiroga,404,204,483,1091
16665,2020-06-23,(04101) Minuto de Dios,365,236,227,828
16666,2020-02-21,(04003) Avenida Ciudad de Cali,5604,2940,3434,11978
16667,2020-01-11,(12007) Zona Industrial,562,413,422,1397
16668,2020-07-14,(07103) AV. CHILE,928,534,401,1863
16669,2020-02-24,(03010) PUENTE LARGO,2116,1423,1211,4750
16670,2020-04-23,(02304) Heroes,435,339,221,995
16671,2020-07-09,(09100) Calle 40 Sur,1838,1151,1132,4121
16672,2020-08-10,(09100) Calle 40 Sur,1681,1020,1094,3795
16673,2020-01-24,(04107) Escuela Militar,620,396,451,1467
16674,2020-02-02,(07109) CAD,579,339,528,1446
16675,2020-09-04,(07004) VENECIA,1146,652,737,2535
16676,2020-01-22,(07109) CAD,2723,1654,1476,5853
16677,2020-09-20,(09109) Tercer Milenio,134,59,141,334
16678,2020-03-22,(03000) Portal Suba - alimentacion,1263,699,677,2639
16679,2020-08-10,(06101) El Tiempo,322,209,179,710
16680,2020-03-20,(03001) LA CAMPIÑA,531,288,262,1081
16681,2020-01-19,(10009) Museo Nacional,309,290,575,1174
16682,2020-04-06,(02000) Cabecera Autopista Norte,484,340,341,1165
16683,2020-05-01,(09110) Avenida Jimenez,232,191,256,679
16684,2020-02-13,(04105) Carrera 53,1489,824,773,3086
16685,2020-06-29,(04104) Avenida 68,234,117,140,491
16686,2020-07-29,(04104) Avenida 68,572,308,310,1190
16687,2020-07-30,(04104) Avenida 68,600,292,319,1211
16688,2020-10-05,(04104) Avenida 68,753,354,511,1618
16689,2020-01-28,(03003) 21 ANGELES,1698,860,875,3433
16690,2020-09-08,(02105) Calle 142,870,552,558,1980
16691,2020-09-06,(07009) SENA,249,144,253,646
16692,2020-03-05,(07008) NQS - Calle 30 Sur,1965,1018,1080,4063
16693,2020-10-07,(09120) Calle 63,1300,908,1111,3319
16694,2020-03-15,(06100) Av. Rojas,151,123,216,490
16695,2020-07-16,(06100) Av. Rojas,179,96,118,393
16696,2020-07-25,(02302) Virrey,347,230,175,752
16697,2020-07-06,(12003) Ricaurte,408,216,228,852
16698,2020-10-09,(12003) Ricaurte,437,316,284,1037
16699,2020-06-03,(10010) San Bernardo,580,301,366,1247
16700,2020-08-21,(10010) San Bernardo,617,282,418,1317
16701,2020-08-25,(04106) Carrera 47,327,151,156,634
16702,2020-03-26,(10008) San Diego,126,98,132,356
16703,2020-05-03,(09116) Avenida 39,78,53,58,189
16704,2020-07-16,(03002) SUBA - TV- 91,659,400,425,1484
16705,2020-08-31,(07007) NQS - Calle 38A Sur,346,245,290,881
16706,2020-01-23,(04000) Cabecera Calle 80 - intermunicipal,1921,1341,1862,5124
16707,2020-09-02,(07103) AV. CHILE,971,592,502,2065
16708,2020-09-11,(12007) Zona Industrial,355,216,185,756
16709,2020-03-21,(40002) Manitas,90,64,69,223
16710,2020-06-11,(09117) Calle 45,744,434,372,1550
16711,2020-06-18,(02304) Heroes,878,597,446,1921
16712,2020-08-21,(02001) Centro Comercial Santa Fe,421,279,296,996
16713,2020-09-28,(02001) Centro Comercial Santa Fe,597,374,473,1444
16714,2020-01-19,(02102) Calle 161,258,157,341,756
16715,2020-09-02,(09123) Calle 76,1124,758,646,2528
16716,2020-06-26,(10008) San Diego,292,182,213,687
16717,2020-04-06,(09101) Quiroga,198,115,195,508
16718,2020-05-14,(02200) Alcalá,1382,952,699,3033
16719,2020-09-30,(03011) SUBA - CALLE 100,652,293,366,1311
16720,2020-08-14,(09117) Calle 45,656,381,422,1459
16721,2020-09-24,(04102) Avenida Boyaca,460,254,314,1028
16722,2020-06-03,(09003) Socorro,567,299,309,1175
16723,2020-09-16,(02300) Calle 100,1227,870,808,2905
16724,2020-07-21,(07111) NQS - RICAURTE,892,559,380,1831
16725,2020-04-02,(07000) Portal Sur,887,502,555,1944
16726,2020-04-16,(02201) Prado,415,294,230,939
16727,2020-06-14,(10007) Las Nieves,85,83,113,281
16728,2020-04-08,(09121) Las Flores,383,287,227,897
16729,2020-08-24,(09121) Las Flores,515,384,354,1253
16730,2020-08-13,(07009) SENA,580,348,334,1262
16731,2020-07-20,(07104) Simon Bolivar,153,96,118,367
16732,2020-04-15,(02200) Alcalá,887,650,449,1986
16733,2020-08-05,(02200) Alcalá,1540,1057,876,3473
16734,2020-05-28,(05105) Pradera,523,374,211,1108
16735,2020-08-11,(07110) PALOQUEMAO,628,378,223,1229
16736,2020-02-01,(06106) Recinto Ferial,797,441,612,1850
16737,2020-09-08,(05102) Av. Américas - Av. Boyacá,252,134,186,572
16738,2020-08-05,(03009) Av. Suba- Calle 116,387,265,206,858
16739,2020-09-18,(09107) Hortúa,625,395,494,1514
16740,2020-09-28,(09107) Hortúa,632,383,469,1484
16741,2020-03-08,(09122) Calle 72,1102,780,1513,3395
16742,2020-06-16,(12000) Puente Aranda,90,53,51,194
16743,2020-09-11,(12001) Carrera 43,392,231,284,907
16744,2020-04-08,(07111) NQS - RICAURTE,368,272,196,836
16745,2020-09-06,(10003) Ciudad Jardín,88,43,73,204
16746,2020-08-12,(02502) Terminal,369,271,302,942
16747,2020-07-31,(06001) Modelia,325,202,182,709
16748,2020-07-06,(06106) Recinto Ferial,255,162,135,552
16749,2020-03-16,(07003) SEVILLANA,1448,788,777,3013
16750,2020-01-26,(04107) Escuela Militar,105,81,170,356
16751,2020-08-03,(10004) Policarpa,218,101,144,463
16752,2020-09-02,(07200) Tygua-San José,233,140,171,544
16753,2020-08-07,(10006) San Victorino,254,149,125,528
16754,2020-03-30,(07003) SEVILLANA,215,129,97,441
16755,2020-04-23,(02001) Centro Comercial Santa Fe,220,143,133,496
16756,2020-07-19,(02001) Centro Comercial Santa Fe,129,88,92,309
16757,2020-01-24,(12002) CDS - Carrera 32,551,340,293,1184
16758,2020-04-30,(12002) CDS - Carrera 32,191,131,58,380
16759,2020-07-27,(40001) Juan Pablo II,517,311,305,1133
16760,2020-05-26,(06100) Av. Rojas,201,111,113,425
16761,2020-06-19,(14004) Museo del Oro,239,186,223,648
16762,2020-06-29,(03001) LA CAMPIÑA,317,165,235,717
16763,2020-03-12,(05005) Transversal 86,53,616,394,1063
16764,2020-03-22,(02103) Mazurén,24,18,26,68
16765,2020-07-05,(07104) Simon Bolivar,130,72,122,324
16766,2020-03-01,(06107) Ciudad Universitaria,214,155,390,759
16767,2020-04-08,(07101) CASTELLANA,62,54,58,174
16768,2020-05-27,(03002) SUBA - TV- 91,642,395,387,1424
16769,2020-04-06,(07009) SENA,284,157,186,627
16770,2020-05-18,(06105) Quinta Paredes,110,79,61,250
16771,2020-08-29,(06105) Quinta Paredes,100,55,87,242
16772,2020-05-13,(07007) NQS - Calle 38A Sur,260,174,185,619
16773,2020-07-27,(06102) Salitre El Greco,233,131,108,472
16774,2020-06-15,(10008) San Diego,93,66,84,243
16775,2020-05-02,(10004) Policarpa,99,48,86,233
16776,2020-05-30,(02304) Heroes,413,332,290,1035
16777,2020-06-21,(04003) Avenida Ciudad de Cali,303,154,236,693
16778,2020-03-20,(03010) PUENTE LARGO,197,146,100,443
16779,2020-07-20,(09109) Tercer Milenio,92,46,86,224
16780,2020-02-06,(12004) Carrera 22,696,459,492,1647
16781,2020-06-24,(06108) Concejo de Bogotá,145,71,86,302
16782,2020-09-05,(06101) El Tiempo,219,160,215,594
16783,2020-03-19,(07101) CASTELLANA,400,303,350,1053
16784,2020-09-01,(10003) Ciudad Jardín,204,96,147,447
16785,2020-04-20,(09106) Nariño,232,134,147,513
16786,2020-08-07,(10007) Las Nieves,160,111,122,393
16787,2020-08-16,(10006) San Victorino,78,63,108,249
16788,2020-06-15,(06103) CAN,166,124,90,380
16789,2020-07-19,(09106) Nariño,121,55,89,265
16790,2020-08-07,(12002) CDS - Carrera 32,53,49,40,142
16791,2020-07-05,(03005) SUBA - AV. BOYACA,114,62,120,296
16792,2020-06-19,(50006) Corral Carrera 77,4,4,6,14
16793,2020-03-29,(02000) Cabecera Autopista Norte - intermunicipal,29,31,27,87
16794,2020-06-15,(12004) Carrera 22,55,36,46,137
16795,2020-01-01,(03014) SAN MARTIN,17,8,41,66
16796,2020-09-09,(04001) Quirigua,416,266,306,988
16797,2020-04-10,(03001) LA CAMPIÑA,172,94,66,332
16798,2020-09-20,(08002) Biblioteca,115,51,106,272
16799,2020-06-14,(40002) Manitas,107,62,91,260
16800,2020-01-01,(12007) Zona Industrial,30,30,103,163
16801,2020-08-04,(06100) Av. Rojas,178,125,123,426
16802,2020-05-14,(14004) Museo del Oro,0,75,144,219
16803,2020-09-06,(10007) Las Nieves,152,113,155,420
16804,2020-09-12,(09105) Río Fucha,0,68,142,210
16805,2020-09-16,(09105) Río Fucha,0,77,172,249
16806,2019-12-31,(07201) Guatoque -Veraguas,6,4,17,27
16807,2020-03-22,(06108) Concejo de Bogotá,46,26,26,98
16808,2020-05-10,(03005) SUBA - AV. BOYACA,86,55,62,203
16809,2020-06-26,(03014) SAN MARTIN,34,10,27,71
16810,2020-04-20,(04105) Carrera 53,182,106,80,368
16811,2020-08-26,(03014) SAN MARTIN,0,14,31,45
16812,2020-07-16,(07113) SANTA ISABEL,345,214,223,782
16813,2020-09-04,(50006) Corral Carrera 77,6,5,7,18
16814,2020-04-10,(10005) Bicentenario - alimentacion,35,23,31,89
16815,2020-03-22,(07111) NQS - RICAURTE,69,64,63,196
16816,2020-08-25,(03014) SAN MARTIN,0,13,26,39
16817,2020-07-12,(50006) Corral Carrera 77,2,0,1,3
16818,2020-03-25,(03004) GRATAMIRA,20,15,9,44
16819,2020-06-07,(04000) Cabecera Calle 80 - alimentacion,935,491,700,2126
16820,2020-06-17,(07005) ALQUERIA,625,363,326,1314
16821,2020-08-01,(09118) Marly,992,625,582,2199
16822,2020-05-02,(07504) TERREROS,1967,1146,1023,4136
16823,2020-05-13,(07504) TERREROS,3999,2465,1896,8360
16824,2020-07-13,(07504) TERREROS,5580,3087,2411,11078
16825,2020-01-21,(04106) Carrera 47,995,531,516,2042
16826,2020-05-20,(03000) Portal Suba - alimentacion,4950,2883,2580,10413
16827,2020-08-20,(05000) Portal Américas,2576,1672,1863,6111
16828,2020-09-01,(05000) Portal Américas,3196,1932,2192,7320
16829,2020-09-02,(05000) Portal Américas,3469,2099,2353,7921
16830,2020-02-11,(06104) Gobernación,1517,916,685,3118
16831,2020-02-07,(09003) Socorro,1655,973,1082,3710
16832,2020-02-17,(09003) Socorro,1675,1052,1049,3776
16833,2020-09-28,(09001) Molinos,2895,1464,2152,6511
16834,2020-02-12,(05001) Patio Bonito,7406,4225,3712,15343
16835,2020-03-04,(05001) Patio Bonito,7407,4020,3686,15113
16836,2020-02-06,(07000) Portal Sur - alimentacion,27946,15749,14037,57732
16837,2020-08-18,(07112) COMUNEROS,742,437,406,1585
16838,2020-01-22,(50006) Corral Carrera 77,32,17,47,96
16839,2020-01-27,(50006) Corral Carrera 77,35,22,42,99
16840,2020-10-03,(10000) Portal 20 de Julio - alimentacion,3959,1617,3151,8727
16841,2020-08-26,(05100) Banderas P. Central,756,434,502,1692
16842,2020-05-30,(06000) Portal Eldorado - alimentacion,2733,1327,1380,5440
16843,2020-01-09,(10003) Ciudad Jardín,781,404,510,1695
16844,2020-02-21,(10003) Ciudad Jardín,1010,495,678,2183
16845,2020-01-23,(02205) Calle 106,2550,1637,1251,5438
16846,2020-06-09,(09000) Cabecera Usme - alimentacion,8072,4637,4449,17158
16847,2020-06-19,(09000) Cabecera Usme - alimentacion,8695,4969,5158,18822
16848,2020-03-17,(07505) LEON XIII,5908,3162,2595,11665
16849,2020-05-29,(03000) Portal Suba - alimentacion,5340,3185,2827,11352
16850,2020-07-07,(03000) Portal Suba - alimentacion,6763,3888,4040,14691
16851,2020-09-03,(02204) Pepe Sierra,840,598,476,1914
16852,2020-09-10,(03000) Portal Suba - alimentacion,6292,3374,4024,13690
16853,2020-02-15,(02502) Terminal,1721,1009,1868,4598
16854,2020-02-06,(07110) PALOQUEMAO,2335,1491,1166,4992
16855,2020-05-19,(09104) Restrepo,1184,765,877,2826
16856,2020-03-11,(07110) PALOQUEMAO,2465,1539,1230,5234
16857,2020-02-26,(02001) Centro Comercial Santa Fe,4893,3062,2699,10654
16858,2020-05-07,(09103) Olaya,672,361,426,1459
16859,2020-01-21,(07106) EL CAMPIN,1362,841,749,2952
16860,2020-02-08,(07112) COMUNEROS,2427,1313,1768,5508
16861,2020-07-09,(02000) Cabecera Autopista Norte,1395,886,839,3120
16862,2020-03-18,(04102) Avenida Boyaca,1224,701,682,2607
16863,2020-02-29,(07109) CAD,1361,925,1182,3468
16864,2020-02-05,(07007) NQS - Calle 38A Sur,2245,1325,1256,4826
16865,2020-07-10,(08000) Portal Tunal - alimentacion,6658,3867,3735,14260
16866,2020-03-18,(04000) Cabecera Calle 80,3460,1948,2147,7555
16867,2020-07-29,(02000) Cabecera Autopista Norte - alimentacion,4326,2387,2309,9022
16868,2020-02-07,(02201) Prado,5991,3662,3101,12754
16869,2020-07-06,(04100) Carrera 77,1353,777,862,2992
16870,2020-08-20,(10006) San Victorino,384,226,286,896
16871,2020-02-18,(10000) Portal 20 de Julio,9169,4396,4047,17612
16872,2020-07-15,(12001) Carrera 43,383,225,198,806
16873,2020-10-10,(12001) Carrera 43,324,197,293,814
16874,2020-01-25,(50003) Corral Molinos,2471,1465,2693,6629
16875,2020-04-20,(02000) Cabecera Autopista Norte - intermunicipal,169,119,117,405
16876,2020-08-18,(09101) Quiroga,534,250,376,1160
16877,2020-01-04,(08001) Parque el Tunal,636,322,487,1445
16878,2020-02-06,(10010) San Bernardo,1917,1118,1477,4512
16879,2020-06-25,(10000) Portal 20 de Julio,2302,1142,1153,4597
16880,2020-05-06,(07112) COMUNEROS,528,303,263,1094
16881,2020-05-26,(07112) COMUNEROS,724,414,407,1545
16882,2020-01-21,(07004) VENECIA,3446,1660,1591,6697
16883,2020-09-02,(08001) Parque el Tunal,496,287,313,1096
16884,2020-10-02,(08001) Parque el Tunal,570,292,447,1309
16885,2020-03-03,(09116) Avenida 39,3304,2100,1682,7086
16886,2020-03-09,(07007) NQS - Calle 38A Sur,434,433,316,1183
16887,2020-04-27,(10000) Portal 20 de Julio - alimentacion,1632,288,516,2436
16888,2020-05-22,(10001) Country Sur,994,419,525,1938
16889,2020-05-11,(02000) Cabecera Autopista Norte,899,610,535,2044
16890,2020-01-20,(05101) Mandalay - Cr.73,1048,570,531,2149
16891,2020-03-02,(05105) Pradera,2587,1555,1218,5360
16892,2020-03-14,(10000) Portal 20 de Julio,5175,2169,3113,10457
16893,2020-07-24,(10000) Portal 20 de Julio,1717,879,906,3502
16894,2020-08-16,(10000) Portal 20 de Julio,662,299,508,1469
16895,2020-07-17,(09119) Calle 57,447,281,260,988
16896,2020-09-08,(50002) Corral Calle 40 Sur,24,10,29,63
16897,2020-01-06,(06000) Portal Eldorado,1150,690,790,2630
16898,2020-03-02,(08000) Portal Tunal,2182,1254,1120,4556
16899,2020-01-28,(05101) Mandalay - Cr.73,1179,625,551,2355
16900,2020-02-16,(07006) General Santander,630,277,594,1501
16901,2020-05-11,(09104) Restrepo,1045,641,743,2429
16902,2020-09-12,(09104) Restrepo,1333,738,1138,3209
16903,2020-10-01,(02302) Virrey,741,525,487,1753
16904,2020-08-20,(06000) Portal Eldorado - alimentacion,3594,1756,1810,7160
16905,2020-03-03,(07201) Guatoque -Veraguas,1035,518,647,2200
16906,2020-02-09,(07001) PERDOMO,955,397,932,2284
16907,2020-08-05,(06111) Universidades,311,180,264,755
16908,2020-08-07,(03007) HUMEDAL CORDOBA,47,29,23,99
16909,2020-09-03,(04100) Carrera 77,1310,751,946,3007
16910,2020-05-22,(07000) Portal Sur,1571,932,874,3377
16911,2020-09-19,(04101) Minuto de Dios,276,153,312,741
16912,2020-03-21,(07110) PALOQUEMAO,182,154,139,475
16913,2020-05-05,(09100) Calle 40 Sur,1094,668,714,2476
16914,2020-01-27,(04107) Escuela Militar,636,393,423,1452
16915,2020-01-09,(07004) VENECIA,3487,1938,2016,7441
16916,2020-03-12,(04002) Carrera 90,163,895,576,1634
16917,2020-08-05,(04105) Carrera 53,222,121,127,470
16918,2020-10-09,(02104) Calle 146,1083,625,912,2620
16919,2020-04-09,(09000) Cabecera Usme - alimentacion,1964,951,902,3817
16920,2020-04-13,(03011) SUBA - CALLE 100,281,177,107,565
16921,2020-01-04,(09121) Las Flores,917,667,875,2459
16922,2020-05-04,(02204) Pepe Sierra,541,391,284,1216
16923,2020-05-23,(09002) Consuelo,308,139,175,622
16924,2020-07-12,(02000) Cabecera Autopista Norte,447,321,377,1145
16925,2020-03-29,(07113) SANTA ISABEL,49,45,39,133
16926,2020-06-03,(07113) SANTA ISABEL,363,233,213,809
16927,2020-03-16,(09122) Calle 72,4784,3308,2796,10888
16928,2020-09-10,(12003) Ricaurte,389,258,191,838
16929,2020-07-13,(07009) SENA,632,356,320,1308
16930,2020-04-01,(02105) Calle 142,370,282,241,893
16931,2020-02-01,(07103) AV. CHILE,2060,1340,1565,4965
16932,2020-02-23,(07103) AV. CHILE,582,361,653,1596
16933,2020-06-27,(03002) SUBA - TV- 91,618,326,391,1335
16934,2020-08-24,(03002) SUBA - TV- 91,712,399,418,1529
16935,2020-09-13,(10010) San Bernardo,201,100,232,533
16936,2020-05-19,(05100) Banderas P. Central - alimentacion,2278,1113,1153,4544
16937,2020-08-31,(12007) Zona Industrial,358,212,128,698
16938,2020-06-20,(40002) Manitas,345,203,246,794
16939,2020-01-26,(10003) Ciudad Jardín,245,86,275,606
16940,2020-06-17,(02001) Centro Comercial Santa Fe,497,331,338,1166
16941,2020-09-29,(04105) Carrera 53,315,167,218,700
16942,2020-06-07,(07003) SEVILLANA,92,49,70,211
16943,2020-07-14,(10009) Museo Nacional,358,218,227,803
16944,2020-09-27,(02304) Heroes,221,200,249,670
16945,2020-07-23,(09120) Calle 63,798,545,504,1847
16946,2020-06-11,(09003) Socorro,556,279,326,1161
16947,2020-01-12,(07003) SEVILLANA,337,178,340,855
16948,2020-04-15,(09004) Santa Lucía,1165,603,605,2373
16949,2020-05-25,(09109) Tercer Milenio,101,66,84,251
16950,2020-06-26,(07110) PALOQUEMAO,693,426,285,1404
16951,2020-01-16,(05101) Mandalay - Cr.73,929,488,499,1916
16952,2020-03-23,(09111) Calle 19,89,60,82,231
16953,2020-02-23,(10007) Las Nieves,201,189,450,840
16954,2020-05-11,(02302) Virrey,463,330,206,999
16955,2020-04-10,(03000) Portal Suba,197,111,138,446
16956,2020-06-30,(09121) Las Flores,735,466,445,1646
16957,2020-03-21,(06109) Centro Memoria,118,82,54,254
16958,2020-04-13,(07113) SANTA ISABEL,185,145,107,437
16959,2020-01-19,(06107) Ciudad Universitaria,192,121,314,627
16960,2020-09-01,(05005) Transversal 86,389,209,296,894
16961,2020-04-09,(10007) Las Nieves,41,37,45,123
16962,2020-05-18,(10007) Las Nieves,465,280,310,1055
16963,2020-07-26,(02201) Prado,219,131,158,508
16964,2020-06-04,(09114) Calle 26,273,198,189,660
16965,2020-06-12,(09122) Calle 72,1186,776,716,2678
16966,2020-08-19,(12000) Puente Aranda,89,40,33,162
16967,2020-03-21,(07103) AV. CHILE,209,169,125,503
16968,2020-10-03,(03011) SUBA - CALLE 100,373,247,398,1018
16969,2020-03-27,(03005) SUBA - AV. BOYACA,165,128,149,442
16970,2020-05-11,(03005) SUBA - AV. BOYACA,298,175,214,687
16971,2020-08-16,(09121) Las Flores,174,107,194,475
16972,2020-08-14,(10004) Policarpa,223,110,168,501
16973,2020-05-18,(04107) Escuela Militar,113,88,77,278
16974,2020-03-23,(10010) San Bernardo,152,107,110,369
16975,2020-05-30,(07102) NQS - CALLE 75,248,194,158,600
16976,2020-09-26,(09003) Socorro,568,240,371,1179
16977,2020-01-19,(04107) Escuela Militar,102,80,182,364
16978,2020-04-10,(10004) Policarpa,60,24,28,112
16979,2020-05-18,(10004) Policarpa,199,99,149,447
16980,2020-02-18,(09105) Río Fucha,881,527,508,1916
16981,2020-08-01,(10007) Las Nieves,444,296,291,1031
16982,2020-09-07,(10007) Las Nieves,650,420,369,1439
16983,2020-08-05,(05101) Mandalay - Cr.73,124,61,74,259
16984,2020-02-16,(12002) CDS - Carrera 32,65,82,80,227
16985,2020-09-01,(40001) Juan Pablo II,574,333,349,1256
16986,2020-04-29,(40001) Juan Pablo II,287,174,191,652
16987,2020-06-08,(40001) Juan Pablo II,528,325,305,1158
16988,2020-04-29,(06002) Normandía,201,119,130,450
16989,2020-05-25,(03003) 21 ANGELES,90,39,47,176
16990,2020-01-12,(04000) Cabecera Calle 80 - intermunicipal,256,151,409,816
16991,2020-06-26,(06001) Modelia,390,276,216,882
16992,2020-07-08,(09108) Hospital,68,45,61,174
16993,2020-10-12,(04103) Las Ferias,123,62,125,310
16994,2020-01-26,(02102) Calle 161,244,160,339,743
16995,2020-07-03,(06101) El Tiempo,370,226,213,809
16996,2020-08-09,(07009) SENA,187,102,162,451
16997,2020-08-17,(07002) MADELENA,192,105,142,439
16998,2020-04-27,(04000) Cabecera Calle 80,297,166,119,582
16999,2020-09-07,(07010) Bosa,637,314,477,1428
17000,2020-06-29,(07102) NQS - CALLE 75,100,74,88,262
17001,2020-03-21,(02204) Pepe Sierra,286,215,163,664
17002,2020-04-26,(07101) CASTELLANA,20,17,33,70
17003,2020-07-02,(07108) Av. El Dorado,152,92,100,344
17004,2020-09-30,(07200) Tygua-San José,282,152,201,635
17005,2020-03-27,(07009) SENA,258,163,138,559
17006,2019-12-31,(06000) Portal Eldorado,119,41,89,249
17007,2020-09-09,(07006) General Santander - alimentacion,412,230,323,965
17008,2020-09-29,(05101) Mandalay - Cr.73,188,108,124,420
17009,2020-02-09,(07006) General Santander,695,299,605,1599
17010,2020-05-19,(05102) Av. Américas - Av. Boyacá,176,92,88,356
17011,2020-04-24,(09117) Calle 45,466,343,244,1053
17012,2020-04-02,(10004) Policarpa,118,83,88,289
17013,2020-05-05,(10004) Policarpa,148,75,117,340
17014,2020-08-30,(12007) Zona Industrial,73,60,55,188
17015,2020-03-23,(10004) Policarpa,71,35,53,159
17016,2020-06-07,(06000) Portal Eldorado,139,131,152,422
17017,2020-03-20,(03004) GRATAMIRA,12,7,9,28
17018,2020-08-10,(04102) Avenida Boyaca,267,180,176,623
17019,2020-09-18,(04102) Avenida Boyaca,472,255,342,1069
17020,2020-09-15,(04000) Cabecera Calle 80 - intermunicipal,392,170,362,924
17021,2020-05-09,(03013) RIO NEGRO,138,100,107,345
17022,2020-06-13,(14005) Las Aguas,68,66,154,288
17023,2020-05-03,(03004) GRATAMIRA,9,3,1,13
17024,2020-08-06,(07113) SANTA ISABEL,303,176,225,704
17025,2020-04-17,(12003) Ricaurte,141,117,93,351
17026,2020-07-12,(04104) Avenida 68,186,109,160,455
17027,2020-06-07,(04105) Carrera 53,88,40,50,178
17028,2020-10-07,(09105) Río Fucha,0,81,207,288
17029,2020-04-24,(50002) Corral Calle 40 Sur,14,7,10,31
17030,2020-04-04,(07101) CASTELLANA,34,32,39,105
17031,2020-04-05,(04107) Escuela Militar,17,15,11,43
17032,2020-08-15,(09105) Río Fucha,0,48,136,184
17033,2020-05-03,(07200) Tygua-San José,39,22,50,111
17034,2020-07-16,(10005) Bicentenario - alimentacion,167,76,134,377
17035,2020-07-20,(09106) Nariño,113,65,82,260
17036,2020-08-10,(12000) Puente Aranda,89,51,37,177
17037,2020-09-27,(06108) Concejo de Bogotá,35,26,44,105
17038,2020-03-22,(05102) Av. Américas - Av. Boyacá,45,23,21,89
17039,2020-04-09,(05102) Av. Américas - Av. Boyacá,50,23,19,92
17040,2020-04-29,(04000) Cabecera Calle 80 - intermunicipal,159,93,133,385
17041,2020-07-19,(12001) Carrera 43,50,30,51,131
17042,2020-08-26,(09105) Río Fucha,0,60,128,188
17043,2020-04-04,(09108) Hospital,19,18,21,58
17044,2020-05-20,(50006) Corral Carrera 77,5,1,6,12
17045,2020-05-24,(04107) Escuela Militar,27,18,28,73
17046,2020-05-28,(03014) SAN MARTIN,25,12,27,64
17047,2020-06-22,(03004) GRATAMIRA,14,7,8,29
17048,2020-05-23,(50002) Corral Calle 40 Sur,15,5,11,31
17049,2020-07-05,(50002) Corral Calle 40 Sur,2,1,2,5
17050,2020-06-09,(09002) Consuelo,453,227,274,954
17051,2020-02-24,(09118) Marly,8099,5204,4045,17348
17052,2020-08-15,(09118) Marly,1067,714,705,2486
17053,2020-07-25,(07504) TERREROS,3915,2067,1882,7864
17054,2020-02-07,(08000) Portal Tunal - alimentacion,24778,13300,12534,50612
17055,2020-01-25,(03000) Portal Suba - alimentacion,15552,7538,10580,33670
17056,2020-03-05,(05000) Portal Américas - alimentacion,32735,21092,22520,76347
17057,2020-02-08,(03002) SUBA - TV- 91,2447,1135,1705,5287
17058,2020-01-07,(09100) Calle 40 Sur,5013,2729,3217,10959
17059,2020-05-30,(10000) Portal 20 de Julio - alimentacion,3244,1429,1942,6615
17060,2020-02-15,(02000) Cabecera Autopista Norte - alimentacion,14796,6980,10339,32115
17061,2020-03-20,(05000) Portal Américas,1336,951,1007,3294
17062,2020-02-26,(04103) Las Ferias,1594,925,850,3369
17063,2020-03-16,(08000) Portal Tunal - alimentacion,17763,9567,8631,35961
17064,2020-02-13,(05005) Transversal 86,2895,1614,1338,5847
17065,2020-03-19,(05005) Transversal 86,1210,571,586,2367
17066,2020-01-10,(09004) Santa Lucía,5697,2895,3592,12184
17067,2020-09-19,(10001) Country Sur,1097,494,854,2445
17068,2020-02-03,(09000) Cabecera Usme,5706,3546,3946,13198
17069,2020-02-21,(09000) Cabecera Usme,5726,3222,3780,12728
17070,2020-06-28,(06000) Portal Eldorado - alimentacion,1338,631,819,2788
17071,2020-01-25,(07002) MADELENA,2542,1097,1804,5443
17072,2020-01-15,(02101) Toberín,12314,7441,6908,26663
17073,2020-03-06,(02204) Pepe Sierra,4910,3070,2620,10600
17074,2020-01-21,(09118) Marly,3867,2604,2438,8909
17075,2020-05-06,(40003) Mirador del Paraiso,1144,710,735,2589
17076,2020-09-23,(04101) Minuto de Dios,392,242,337,971
17077,2020-09-28,(07505) LEON XIII,2994,1547,1558,6099
17078,2020-03-05,(02204) Pepe Sierra,4956,3170,2441,10567
17079,2020-03-02,(09117) Calle 45,6393,4096,3088,13577
17080,2020-02-25,(09123) Calle 76,6036,3920,3265,13221
17081,2020-02-26,(09004) Santa Lucía,7723,3987,4185,15895
17082,2020-06-30,(10000) Portal 20 de Julio - alimentacion,4484,2115,2593,9192
17083,2020-09-28,(10000) Portal 20 de Julio - alimentacion,4471,1913,3041,9425
17084,2020-02-11,(09101) Quiroga,1728,1021,1327,4076
17085,2020-08-15,(04100) Carrera 77,970,487,741,2198
17086,2020-04-22,(09000) Cabecera Usme - alimentacion,5003,2577,2676,10256
17087,2020-05-27,(09118) Marly,1378,923,672,2973
17088,2020-03-03,(09103) Olaya,4148,2542,2524,9214
17089,2020-01-31,(06001) Modelia,2440,1444,1338,5222
17090,2020-02-01,(50003) Corral Molinos,2502,1474,2753,6729
17091,2020-09-05,(50003) Corral Molinos,1383,666,1168,3217
17092,2020-02-14,(07106) EL CAMPIN,2152,1361,1274,4787
17093,2020-01-07,(05100) Banderas P. Central - alimentacion,9591,5256,5857,20704
17094,2020-06-12,(05100) Banderas P. Central - alimentacion,2307,1267,1454,5028
17095,2020-09-08,(05100) Banderas P. Central - alimentacion,3317,1723,2019,7059
17096,2020-10-06,(02200) Alcalá,2183,1384,1556,5123
17097,2020-02-07,(02104) Calle 146,9728,5586,5237,20551
17098,2020-01-29,(10006) San Victorino,2409,1206,1228,4843
17099,2020-04-16,(50003) Corral Molinos,809,390,580,1779
17100,2020-05-26,(50003) Corral Molinos,1388,670,907,2965
17101,2020-03-11,(05002) Tintal,9827,6031,5500,21358
17102,2020-06-16,(04002) Carrera 90,735,384,416,1535
17103,2020-04-09,(10000) Portal 20 de Julio - alimentacion,1233,420,534,2187
17104,2020-06-29,(40003) Mirador del Paraiso,739,387,496,1622
17105,2020-07-06,(12001) Carrera 43,462,248,278,988
17106,2020-03-26,(07505) LEON XIII,1168,660,705,2533
17107,2020-06-19,(10002) Av. Primero de Mayo,2264,1171,1422,4857
17108,2020-02-13,(09101) Quiroga,1778,1036,1241,4055
17109,2020-03-24,(08001) Parque el Tunal,386,201,258,845
17110,2020-02-27,(10010) San Bernardo,1757,1053,1373,4183
17111,2020-01-15,(10010) San Bernardo,1487,892,1290,3669
17112,2020-01-10,(04002) Carrera 90,2733,1430,1649,5812
17113,2020-08-05,(09004) Santa Lucía,2270,1143,1262,4675
17114,2020-08-21,(09004) Santa Lucía,2392,1173,1290,4855
17115,2020-02-11,(04003) Avenida Ciudad de Cali,5850,3508,3646,13004
17116,2020-08-23,(07503) SAN MATEO,2791,1475,1681,5947
17117,2020-02-12,(09113) Calle 22,1657,938,1121,3716
17118,2020-01-02,(09120) Calle 63,1838,1410,1793,5041
17119,2020-05-18,(14004) Museo del Oro,0,87,152,239
17120,2020-10-09,(14004) Museo del Oro,397,312,446,1155
17121,2020-06-18,(02000) Cabecera Autopista Norte,1376,881,795,3052
17122,2020-09-07,(09107) Hortúa,578,333,434,1345
17123,2020-02-19,(05101) Mandalay - Cr.73,1288,728,554,2570
17124,2020-05-12,(03012) SUBA - CALLE 95,257,142,141,540
17125,2020-08-18,(03012) SUBA - CALLE 95,311,181,190,682
17126,2020-03-03,(50002) Corral Calle 40 Sur,128,83,151,362
17127,2020-03-11,(05107) Américas - Cr.53,2422,1340,1297,5059
17128,2020-02-19,(08000) Portal Tunal,2264,1271,1073,4608
17129,2020-02-09,(07002) MADELENA,968,364,866,2198
17130,2020-10-03,(07104) Simon Bolivar,452,316,367,1135
17131,2020-05-08,(09104) Restrepo,977,592,757,2326
17132,2020-05-23,(05005) Transversal 86,224,102,109,435
17133,2020-08-12,(05005) Transversal 86,358,194,221,773
17134,2020-03-15,(02202) Calle 127,848,626,740,2214
17135,2020-03-18,(05105) Pradera,1570,1002,653,3225
17136,2020-06-09,(05107) Américas - Cr.53,432,245,204,881
17137,2020-07-07,(08000) Portal Tunal,800,363,327,1490
17138,2020-08-02,(05000) Portal Américas - alimentacion,2968,1356,1656,5980
17139,2020-03-26,(10002) Av. Primero de Mayo,1096,638,673,2407
17140,2020-02-21,(09101) Quiroga,1582,913,1140,3635
17141,2020-04-30,(09101) Quiroga,319,172,236,727
17142,2020-07-02,(09101) Quiroga,572,304,406,1282
17143,2020-03-03,(04108) El Polo,1934,1223,1185,4342
17144,2020-02-20,(12007) Zona Industrial,1307,796,611,2714
17145,2020-09-21,(02304) Heroes,771,560,471,1802
17146,2020-06-14,(06000) Portal Eldorado - alimentacion,1226,527,703,2456
17147,2020-06-26,(07010) Bosa,785,410,445,1640
17148,2020-09-18,(07113) SANTA ISABEL,431,251,377,1059
17149,2020-08-19,(03001) LA CAMPIÑA,1057,624,578,2259
17150,2020-03-03,(05103) Marsella,3174,1831,1504,6509
17151,2020-01-03,(04103) Las Ferias,690,387,573,1650
17152,2020-09-04,(07104) Simon Bolivar,533,388,357,1278
17153,2020-02-06,(10005) Bicentenario - alimentacion,735,359,545,1639
17154,2020-07-01,(10005) Bicentenario - alimentacion,244,127,226,597
17155,2020-07-30,(10005) Bicentenario - alimentacion,198,94,150,442
17156,2020-02-04,(04107) Escuela Militar,714,425,472,1611
17157,2020-03-02,(06000) Portal Eldorado,6556,3752,2840,13148
17158,2020-01-09,(07109) CAD,2149,1288,1174,4611
17159,2020-08-06,(04002) Carrera 90,622,325,363,1310
17160,2020-05-18,(04105) Carrera 53,247,132,145,524
17161,2020-10-07,(06101) El Tiempo,409,288,289,986
17162,2020-08-05,(02104) Calle 146,600,368,397,1365
17163,2020-10-09,(09110) Avenida Jimenez,1566,1121,1188,3875
17164,2020-01-23,(09111) Calle 19,1939,1280,1482,4701
17165,2020-10-11,(09121) Las Flores,170,128,275,573
17166,2020-04-07,(03001) LA CAMPIÑA,470,278,293,1041
17167,2020-06-11,(03001) LA CAMPIÑA,1072,621,536,2229
17168,2020-04-29,(03007) HUMEDAL CORDOBA,77,43,39,159
17169,2020-02-01,(09002) Consuelo,1003,450,808,2261
17170,2020-05-27,(07113) SANTA ISABEL,346,213,227,786
17171,2020-06-12,(07113) SANTA ISABEL,389,228,244,861
17172,2020-08-03,(04108) El Polo,345,233,184,762
17173,2020-01-05,(06106) Recinto Ferial,201,132,219,552
17174,2020-03-19,(03010) PUENTE LARGO,839,564,511,1914
17175,2020-01-03,(10010) San Bernardo,968,509,861,2338
17176,2020-01-25,(05107) Américas - Cr.53,1295,737,1019,3051
17177,2020-03-30,(09109) Tercer Milenio,125,78,109,312
17178,2020-01-19,(03006) NIZA - CALLE 127,497,313,483,1293
17179,2020-10-04,(03006) NIZA - CALLE 127,192,135,207,534
17180,2020-04-21,(09002) Consuelo,244,131,126,501
17181,2020-07-07,(03002) SUBA - TV- 91,875,508,489,1872
17182,2020-07-28,(03002) SUBA - TV- 91,731,424,455,1610
17183,2020-10-08,(03002) SUBA - TV- 91,978,534,713,2225
17184,2020-09-01,(07007) NQS - Calle 38A Sur,342,225,267,834
17185,2020-10-07,(10010) San Bernardo,675,337,617,1629
17186,2020-10-10,(02104) Calle 146,730,397,702,1829
17187,2020-05-07,(07103) AV. CHILE,678,449,304,1431
17188,2020-03-06,(07105) MOVISTAR ARENA,1216,820,772,2808
17189,2020-03-19,(09117) Calle 45,1634,1088,1136,3858
17190,2020-05-23,(08001) Parque el Tunal,297,151,194,642
17191,2020-07-22,(02304) Heroes,652,472,388,1512
17192,2020-06-04,(02001) Centro Comercial Santa Fe,395,243,280,918
17193,2020-03-10,(06103) CAN,1167,199,248,1614
17194,2020-06-29,(07112) COMUNEROS,231,155,196,582
17195,2020-03-20,(07004) VENECIA,462,293,205,960
17196,2020-07-18,(07004) VENECIA,643,367,412,1422
17197,2020-08-22,(07004) VENECIA,742,427,418,1587
17198,2020-06-02,(05100) Banderas P. Central,430,281,359,1070
17199,2020-09-18,(08000) Portal Tunal,823,341,387,1551
17200,2020-09-16,(06100) Av. Rojas,287,171,199,657
17201,2020-03-16,(40001) Juan Pablo II,1294,748,755,2797
17202,2020-06-25,(40001) Juan Pablo II,603,345,375,1323
17203,2020-06-15,(02204) Pepe Sierra,284,201,180,665
17204,2020-01-08,(05102) Av. Américas - Av. Boyacá,1002,591,661,2254
17205,2020-04-12,(07004) VENECIA,177,100,88,365
17206,2020-05-26,(07004) VENECIA,926,505,486,1917
17207,2020-05-05,(02001) Centro Comercial Santa Fe,254,164,186,604
17208,2020-07-22,(09122) Calle 72,976,626,675,2277
17209,2020-04-16,(03002) SUBA - TV- 91,425,261,207,893
17210,2020-10-05,(07009) SENA,725,448,662,1835
17211,2020-06-18,(04105) Carrera 53,298,162,129,589
17212,2020-02-12,(07006) General Santander - alimentacion,1546,946,963,3455
17213,2020-04-27,(09121) Las Flores,65,196,112,373
17214,2020-05-23,(09110) Avenida Jimenez,684,532,526,1742
17215,2020-04-09,(09119) Calle 57,135,77,79,291
17216,2020-05-16,(09119) Calle 57,292,216,223,731
17217,2020-05-25,(07009) SENA,189,117,121,427
17218,2020-08-01,(07007) NQS - Calle 38A Sur,242,137,177,556
17219,2020-09-04,(09114) Calle 26,346,196,254,796
17220,2020-04-30,(07109) CAD,459,305,221,985
17221,2020-04-18,(12000) Puente Aranda,32,27,30,89
17222,2020-04-19,(07103) AV. CHILE,137,110,87,334
17223,2020-06-25,(04000) Cabecera Calle 80 - intermunicipal,330,184,294,808
17224,2020-09-09,(02102) Calle 161,273,169,198,640
17225,2020-08-10,(12004) Carrera 22,279,147,119,545
17226,2020-04-29,(07111) NQS - RICAURTE,705,461,313,1479
17227,2020-05-27,(07111) NQS - RICAURTE,1029,631,396,2056
17228,2020-04-30,(07107) U. NACIONAL,204,138,97,439
17229,2020-06-15,(02103) Mazurén,41,30,62,133
17230,2020-07-13,(06106) Recinto Ferial,233,115,107,455
17231,2020-10-04,(07003) SEVILLANA,140,59,182,381
17232,2020-07-11,(10009) Museo Nacional,235,215,319,769
17233,2020-04-10,(09118) Marly,440,281,184,905
17234,2020-07-05,(10005) Bicentenario - alimentacion,65,36,101,202
17235,2020-09-10,(10004) Policarpa,246,101,197,544
17236,2020-09-23,(10010) San Bernardo,667,336,532,1535
17237,2020-04-23,(04102) Avenida Boyaca,165,102,89,356
17238,2020-03-27,(03001) LA CAMPIÑA,522,283,262,1067
17239,2020-05-28,(09108) Hospital,61,47,48,156
17240,2020-08-21,(09108) Hospital,66,35,68,169
17241,2020-09-12,(09003) Socorro,514,247,344,1105
17242,2020-07-03,(07005) ALQUERIA,633,341,387,1361
17243,2020-08-23,(07000) Portal Sur,396,218,376,990
17244,2020-07-07,(40002) Manitas,456,287,260,1003
17245,2020-03-25,(10007) Las Nieves,169,136,143,448
17246,2020-07-22,(07010) Bosa,647,319,361,1327
17247,2020-09-21,(07003) SEVILLANA,432,201,243,876
17248,2020-09-05,(07008) NQS - Calle 30 Sur,287,134,238,659
17249,2020-04-30,(03010) PUENTE LARGO,225,167,123,515
17250,2020-02-08,(14001) La Sabana,272,275,355,902
17251,2020-04-11,(04002) Carrera 90,180,97,84,361
17252,2020-02-02,(09106) Nariño,419,220,535,1174
17253,2020-06-27,(09106) Nariño,314,189,284,787
17254,2020-07-31,(06101) El Tiempo,277,186,192,655
17255,2020-03-20,(10004) Policarpa,116,65,53,234
17256,2020-05-05,(09105) Río Fucha,72,39,62,173
17257,2020-03-07,(03004) GRATAMIRA,137,67,96,300
17258,2020-04-08,(04104) Avenida 68,291,163,160,614
17259,2020-06-05,(09106) Nariño,394,216,267,877
17260,2020-09-06,(14005) Las Aguas,73,53,129,255
17261,2020-08-17,(04105) Carrera 53,84,47,69,200
17262,2020-09-13,(07007) NQS - Calle 38A Sur,200,133,146,479
17263,2020-07-30,(10003) Ciudad Jardín,215,101,144,460
17264,2020-10-12,(06102) Salitre El Greco,98,62,95,255
17265,2020-06-20,(04001) Quirigua,356,189,204,749
17266,2020-09-27,(09107) Hortúa,220,136,222,578
17267,2020-08-24,(06104) Gobernación,240,144,77,461
17268,2020-04-15,(04107) Escuela Militar,60,31,38,129
17269,2020-04-24,(09114) Calle 26,167,166,128,461
17270,2020-03-23,(09106) Nariño,83,56,46,185
17271,2020-03-28,(07104) Simon Bolivar,126,100,84,310
17272,2020-04-09,(07104) Simon Bolivar,72,56,61,189
17273,2020-05-17,(09115) Calle 34,125,107,99,331
17274,2020-09-20,(10004) Policarpa,113,56,124,293
17275,2020-05-02,(04105) Carrera 53,124,66,70,260
17276,2020-01-09,(50002) Corral Calle 40 Sur,97,52,92,241
17277,2020-10-04,(07201) Guatoque -Veraguas,48,38,102,188
17278,2020-06-28,(06105) Quinta Paredes,27,24,34,85
17279,2020-08-30,(03005) SUBA - AV. BOYACA,120,77,139,336
17280,2020-03-21,(10009) Museo Nacional,138,104,114,356
17281,2020-05-12,(10003) Ciudad Jardín,144,80,96,320
17282,2020-04-23,(06104) Gobernación,156,108,55,319
17283,2020-03-29,(07009) SENA,83,59,59,201
17284,2020-04-04,(50002) Corral Calle 40 Sur,5,1,5,11
17285,2020-04-25,(50002) Corral Calle 40 Sur,4,6,5,15
17286,2020-04-15,(03014) SAN MARTIN,16,6,12,34
17287,2020-04-24,(09108) Hospital,44,21,42,107
17288,2020-06-08,(03014) SAN MARTIN,24,11,25,60
17289,2020-06-20,(50006) Corral Carrera 77,5,3,8,16
17290,2019-12-31,(07105) MOVISTAR ARENA,15,5,11,31
17291,2019-12-31,(03007) HUMEDAL CORDOBA,7,2,4,13
17292,2020-04-10,(12000) Puente Aranda,10,8,7,25
17293,2020-03-17,(04000) Cabecera Calle 80 - alimentacion,12655,7268,7681,27604
17294,2020-06-28,(04000) Cabecera Calle 80 - alimentacion,1202,590,893,2685
17295,2020-08-20,(04000) Cabecera Calle 80 - alimentacion,3590,2096,2373,8059
17296,2020-03-17,(07005) ALQUERIA,1542,873,847,3262
17297,2020-02-27,(09002) Consuelo,1402,804,861,3067
17298,2020-01-15,(09118) Marly,4925,3299,3140,11364
17299,2020-04-16,(07504) TERREROS,2427,1563,1239,5229
17300,2020-09-16,(07504) TERREROS,6705,3661,3639,14005
17301,2020-05-18,(09119) Calle 57,428,308,270,1006
17302,2020-02-20,(04106) Carrera 47,1487,813,811,3111
17303,2020-02-13,(06000) Portal Eldorado - alimentacion,19175,10234,9752,39161
17304,2020-02-13,(05000) Portal Américas,15754,8707,7654,32115
17305,2020-03-05,(05000) Portal Américas,13162,7975,8165,29302
17306,2020-08-18,(05000) Portal Américas,2566,1695,1839,6100
17307,2020-10-08,(05000) Portal Américas,3914,2169,2794,8877
17308,2020-02-27,(07003) SEVILLANA,2152,1138,1051,4341
17309,2020-06-29,(06104) Gobernación,54,35,62,151
17310,2020-02-22,(04101) Minuto de Dios,1539,861,1288,3688
17311,2020-03-03,(04002) Carrera 90,3705,2245,2054,8004
17312,2020-02-13,(09001) Molinos,7635,4684,5915,18234
17313,2020-08-28,(10000) Portal 20 de Julio - alimentacion,4249,1873,2565,8687
17314,2020-06-30,(07503) SAN MATEO,11825,7039,6285,25149
17315,2020-06-25,(06107) Ciudad Universitaria,170,114,122,406
17316,2020-07-23,(06107) Ciudad Universitaria,141,94,76,311
17317,2020-04-03,(07112) COMUNEROS,385,255,219,859
17318,2020-08-12,(09100) Calle 40 Sur,1653,922,1082,3657
17319,2020-04-13,(06000) Portal Eldorado - alimentacion,2298,1129,957,4384
17320,2020-05-14,(06000) Portal Eldorado - alimentacion,3170,1595,1408,6173
17321,2020-07-06,(09115) Calle 34,693,409,403,1505
17322,2020-02-06,(02105) Calle 142,7187,4315,3816,15318
17323,2020-08-10,(02000) Cabecera Autopista Norte,1161,785,770,2716
17324,2020-01-20,(05107) Américas - Cr.53,2403,1311,1310,5024
17325,2020-02-06,(04000) Cabecera Calle 80 - intermunicipal,2275,1692,1988,5955
17326,2020-03-13,(04101) Minuto de Dios,707,398,412,1517
17327,2020-04-01,(07504) TERREROS,2258,1337,1388,4983
17328,2020-03-09,(09117) Calle 45,2486,486,640,3612
17329,2020-10-12,(07102) NQS - CALLE 75,95,72,134,301
17330,2020-02-18,(03013) RIO NEGRO,1348,824,892,3064
17331,2020-04-17,(03013) RIO NEGRO,158,97,112,367
17332,2020-05-21,(03013) RIO NEGRO,222,149,136,507
17333,2020-07-25,(03013) RIO NEGRO,169,101,124,394
17334,2020-05-03,(09118) Marly,435,288,228,951
17335,2020-03-14,(09103) Olaya,2300,1103,1715,5118
17336,2020-04-23,(09110) Avenida Jimenez,364,298,370,1032
17337,2020-07-11,(03001) LA CAMPIÑA,894,441,616,1951
17338,2020-09-22,(05100) Banderas P. Central - alimentacion,3594,1849,2296,7739
17339,2020-07-13,(14001) La Sabana,101,75,72,248
17340,2020-01-06,(07106) EL CAMPIN,320,249,338,907
17341,2020-07-02,(07106) EL CAMPIN,423,268,227,918
17342,2020-09-12,(02000) Cabecera Autopista Norte,1118,664,931,2713
17343,2020-03-04,(02104) Calle 146,9454,5946,4971,20371
17344,2020-04-14,(09113) Calle 22,171,116,142,429
17345,2020-01-16,(50003) Corral Molinos,3303,1862,3016,8181
17346,2020-07-31,(07010) Bosa,585,297,398,1280
17347,2020-01-03,(02000) Cabecera Autopista Norte - alimentacion,11131,5565,7462,24158
17348,2020-07-15,(09001) Molinos,1731,1009,1207,3947
17349,2020-04-17,(10001) Country Sur,597,258,398,1253
17350,2020-09-04,(10001) Country Sur,1399,599,911,2909
17351,2020-07-03,(06000) Portal Eldorado,961,665,530,2156
17352,2020-08-19,(09123) Calle 76,906,629,518,2053
17353,2020-07-04,(04000) Cabecera Calle 80,885,490,789,2164
17354,2020-04-29,(12001) Carrera 43,305,169,170,644
17355,2020-08-08,(07000) Portal Sur - alimentacion,5514,2759,3169,11442
17356,2020-09-06,(07000) Portal Sur - alimentacion,2948,1303,1998,6249
17357,2020-02-12,(07106) EL CAMPIN,2209,1419,1194,4822
17358,2020-06-16,(03000) Portal Suba,1239,781,764,2784
17359,2020-08-14,(03000) Portal Suba,1058,687,785,2530
17360,2020-09-21,(03000) Portal Suba,1281,744,923,2948
17361,2020-09-23,(02000) Cabecera Autopista Norte - intermunicipal,669,405,552,1626
17362,2020-02-24,(09101) Quiroga,1634,1077,1180,3891
17363,2020-01-12,(09100) Calle 40 Sur,1501,630,1377,3508
17364,2020-08-13,(10000) Portal 20 de Julio,2154,1091,1058,4303
17365,2020-09-22,(06000) Portal Eldorado - alimentacion,4345,2237,2603,9185
17366,2020-04-23,(07503) SAN MATEO,5523,3614,2388,11525
17367,2020-10-05,(06108) Concejo de Bogotá,165,97,127,389
17368,2020-01-03,(10001) Country Sur,2729,1098,1790,5617
17369,2020-07-18,(10001) Country Sur,648,272,460,1380
17370,2020-01-27,(02304) Heroes,4381,3028,2202,9611
17371,2020-07-14,(09107) Hortúa,483,312,263,1058
17372,2020-09-11,(09107) Hortúa,553,311,413,1277
17373,2020-06-16,(09123) Calle 76,1029,705,547,2281
17374,2020-01-03,(05103) Marsella,1149,586,680,2415
17375,2020-04-24,(02300) Calle 100,820,573,426,1819
17376,2020-08-11,(02300) Calle 100,1151,714,619,2484
17377,2020-03-07,(10000) Portal 20 de Julio,5616,2274,3628,11518
17378,2020-06-15,(08000) Portal Tunal,251,141,109,501
17379,2020-04-30,(04000) Cabecera Calle 80,659,425,425,1509
17380,2020-05-04,(05005) Transversal 86,237,130,121,488
17381,2020-08-08,(05005) Transversal 86,234,110,186,530
17382,2020-01-21,(10008) San Diego,392,561,683,1636
17383,2020-08-21,(02205) Calle 106,316,225,213,754
17384,2020-07-13,(04101) Minuto de Dios,280,167,185,632
17385,2020-01-22,(04108) El Polo,1797,1120,1107,4024
17386,2020-06-12,(04108) El Polo,480,322,236,1038
17387,2020-10-07,(04108) El Polo,554,334,382,1270
17388,2020-07-05,(07106) EL CAMPIN,109,70,88,267
17389,2020-09-07,(07106) EL CAMPIN,409,271,265,945
17390,2020-09-04,(07113) SANTA ISABEL,405,237,316,958
17391,2020-06-11,(07000) Portal Sur,1729,1100,1029,3858
17392,2020-07-27,(07000) Portal Sur,1749,1105,1045,3899
17393,2020-06-30,(02101) Toberín,1589,1019,1016,3624
17394,2020-03-28,(05100) Banderas P. Central - alimentacion,1012,452,466,1930
17395,2020-02-17,(04102) Avenida Boyaca,3142,1952,1618,6712
17396,2020-03-25,(02304) Heroes,457,378,279,1114
17397,2020-04-05,(02304) Heroes,163,141,92,396
17398,2020-04-30,(07104) Simon Bolivar,274,180,155,609
17399,2020-06-01,(04107) Escuela Militar,135,83,89,307
17400,2020-09-30,(04003) Avenida Ciudad de Cali,1242,652,1006,2900
17401,2020-02-02,(02200) Alcalá,2055,1167,2163,5385
17402,2020-09-08,(06101) El Tiempo,393,230,227,850
17403,2020-09-01,(02104) Calle 146,796,519,575,1890
17404,2020-08-16,(06000) Portal Eldorado,152,152,215,519
17405,2020-07-20,(02202) Calle 127,364,289,204,857
17406,2020-06-01,(03001) LA CAMPIÑA,982,572,534,2088
17407,2020-09-26,(03001) LA CAMPIÑA,1079,433,851,2363
17408,2020-09-16,(07109) CAD,686,434,375,1495
17409,2020-01-11,(02105) Calle 142,2198,1032,1892,5122
17410,2020-06-12,(02302) Virrey,643,446,334,1423
17411,2020-05-30,(09104) Restrepo,1055,616,783,2454
17412,2020-01-19,(03010) PUENTE LARGO,291,182,349,822
17413,2020-02-02,(03010) PUENTE LARGO,323,206,375,904
17414,2020-05-31,(07009) SENA,173,93,138,404
17415,2020-01-12,(05100) Banderas P. Central - alimentacion,2736,1006,2068,5810
17416,2020-04-24,(10008) San Diego,166,102,102,370
17417,2020-06-05,(03006) NIZA - CALLE 127,439,245,210,894
17418,2020-02-16,(04103) Las Ferias,309,165,294,768
17419,2020-08-21,(05107) Américas - Cr.53,357,223,248,828
17420,2020-10-08,(05107) Américas - Cr.53,506,321,380,1207
17421,2020-01-15,(40002) Manitas,1081,623,706,2410
17422,2020-01-31,(40002) Manitas,1270,668,805,2743
17423,2020-06-16,(09117) Calle 45,728,458,449,1635
17424,2020-06-21,(09117) Calle 45,241,166,180,587
17425,2020-01-22,(12002) CDS - Carrera 32,521,351,276,1148
17426,2020-04-01,(06108) Concejo de Bogotá,82,63,55,200
17427,2020-06-26,(09114) Calle 26,343,225,248,816
17428,2020-06-17,(10006) San Victorino,665,324,356,1345
17429,2020-10-09,(07006) General Santander,697,390,558,1645
17430,2020-07-12,(07112) COMUNEROS,255,157,203,615
17431,2020-06-23,(10008) San Diego,315,180,179,674
17432,2020-04-23,(09101) Quiroga,280,149,197,626
17433,2020-05-23,(03011) SUBA - CALLE 100,256,157,174,587
17434,2020-09-25,(08000) Portal Tunal,813,369,373,1555
17435,2020-02-06,(10004) Policarpa,859,434,565,1858
17436,2020-06-18,(05107) Américas - Cr.53,447,255,274,976
17437,2020-04-06,(05105) Pradera,357,228,156,741
17438,2020-01-25,(03002) SUBA - TV- 91,2063,1037,1547,4647
17439,2020-08-26,(06111) Universidades,355,193,300,848
17440,2020-06-02,(07111) NQS - RICAURTE,1072,662,380,2114
17441,2020-09-28,(02204) Pepe Sierra,893,642,598,2133
17442,2020-04-20,(07000) Portal Sur,901,609,553,2063
17443,2020-03-08,(09111) Calle 19,490,294,570,1354
17444,2020-07-31,(03012) SUBA - CALLE 95,244,147,142,533
17445,2020-08-22,(06109) Centro Memoria,169,109,137,415
17446,2020-06-08,(06104) Gobernación,267,158,126,551
17447,2020-10-10,(06104) Gobernación,104,95,140,339
17448,2020-08-28,(07201) Guatoque -Veraguas,190,124,146,460
17449,2020-05-14,(03000) Portal Suba,894,549,545,1988
17450,2020-07-16,(09121) Las Flores,555,315,311,1181
17451,2020-08-12,(07003) SEVILLANA,436,215,212,863
17452,2020-06-23,(02200) Alcalá,1943,1430,1030,4403
17453,2020-05-08,(02302) Virrey,448,317,234,999
17454,2020-07-20,(09118) Marly,452,318,279,1049
17455,2020-06-15,(09123) Calle 76,228,166,200,594
17456,2020-06-08,(03003) 21 ANGELES,326,159,153,638
17457,2020-04-07,(09119) Calle 57,243,166,159,568
17458,2020-08-03,(09121) Las Flores,584,363,388,1335
17459,2020-08-31,(40001) Juan Pablo II,553,341,389,1283
17460,2020-07-05,(03001) LA CAMPIÑA,297,154,210,661
17461,2020-02-08,(10004) Policarpa,591,261,490,1342
17462,2020-04-26,(09118) Marly,429,294,199,922
17463,2020-03-20,(07007) NQS - Calle 38A Sur,168,111,82,361
17464,2020-07-06,(09122) Calle 72,1265,818,776,2859
17465,2020-10-05,(14005) Las Aguas,263,170,334,767
17466,2020-07-16,(12000) Puente Aranda,72,49,44,165
17467,2020-04-16,(07103) AV. CHILE,519,355,240,1114
17468,2020-05-30,(08001) Parque el Tunal,337,187,174,698
17469,2020-10-08,(02102) Calle 161,295,175,258,728
17470,2020-05-19,(07107) U. NACIONAL,287,157,123,567
17471,2020-02-09,(10003) Ciudad Jardín,209,113,262,584
17472,2020-07-09,(09111) Calle 19,830,498,530,1858
17473,2020-08-05,(03013) RIO NEGRO,226,135,155,516
17474,2020-05-08,(07101) CASTELLANA,133,91,87,311
17475,2020-02-25,(07200) Tygua-San José,825,518,591,1934
17476,2020-03-20,(07005) ALQUERIA,204,129,110,443
17477,2020-05-16,(08001) Parque el Tunal,280,151,164,595
17478,2020-09-04,(07008) NQS - Calle 30 Sur,357,192,263,812
17479,2020-05-10,(05002) Tintal,347,227,229,803
17480,2020-05-02,(09115) Calle 34,241,196,161,598
17481,2020-05-10,(02101) Toberín,158,116,149,423
17482,2020-07-20,(04102) Avenida Boyaca,124,61,58,243
17483,2020-04-11,(10006) San Victorino,95,56,69,220
17484,2020-06-25,(12002) CDS - Carrera 32,194,140,71,405
17485,2020-04-11,(06101) El Tiempo,133,91,62,286
17486,2020-05-08,(04000) Cabecera Calle 80 - intermunicipal,200,101,147,448
17487,2020-05-06,(06002) Normandía,221,118,116,455
17488,2020-07-01,(04101) Minuto de Dios,371,201,276,848
17489,2020-01-02,(07200) Tygua-San José,296,171,284,751
17490,2020-09-25,(04000) Cabecera Calle 80 - intermunicipal,426,210,446,1082
17491,2020-08-31,(07006) General Santander,574,350,306,1230
17492,2020-04-24,(06101) El Tiempo,201,154,121,476
17493,2020-06-28,(09117) Calle 45,257,145,191,593
17494,2020-04-18,(02103) Mazurén,69,35,57,161
17495,2020-04-04,(03012) SUBA - CALLE 95,117,81,84,282
17496,2020-06-25,(14004) Museo del Oro,301,191,246,738
17497,2020-06-23,(09003) Socorro,598,325,354,1277
17498,2020-03-20,(02204) Pepe Sierra,479,333,199,1011
17499,2020-06-06,(06105) Quinta Paredes,103,64,58,225
17500,2020-05-15,(10008) San Diego,230,136,157,523
17501,2020-09-20,(09107) Hortúa,208,128,236,572
17502,2020-04-26,(09117) Calle 45,217,130,95,442
17503,2020-10-12,(02502) Terminal,109,89,193,391
17504,2020-10-10,(05107) Américas - Cr.53,309,265,341,915
17505,2020-04-19,(05107) Américas - Cr.53,71,64,52,187
17506,2020-07-26,(04104) Avenida 68,169,82,99,350
17507,2020-04-16,(03010) PUENTE LARGO,192,153,110,455
17508,2020-04-18,(07005) ALQUERIA,210,123,100,433
17509,2020-04-18,(04001) Quirigua,136,81,56,273
17510,2020-06-28,(04001) Quirigua,142,82,100,324
17511,2020-03-20,(04102) Avenida Boyaca,141,97,87,325
17512,2020-04-01,(03005) SUBA - AV. BOYACA,181,138,151,470
17513,2020-09-06,(09111) Calle 19,229,146,295,670
17514,2020-03-30,(04106) Carrera 47,174,97,92,363
17515,2020-02-27,(12004) Carrera 22,694,426,442,1562
17516,2020-03-15,(03004) GRATAMIRA,44,25,34,103
17517,2020-06-15,(02000) Cabecera Autopista Norte - intermunicipal,107,77,112,296
17518,2020-10-01,(06105) Quinta Paredes,164,104,108,376
17519,2020-09-06,(05107) Américas - Cr.53,79,77,145,301
17520,2020-04-19,(40001) Juan Pablo II,83,43,44,170
17521,2020-07-27,(05101) Mandalay - Cr.73,101,63,56,220
17522,2020-03-15,(07200) Tygua-San José,117,90,214,421
17523,2020-08-09,(06103) CAN,132,82,78,292
17524,2020-05-12,(04000) Cabecera Calle 80 - intermunicipal,212,114,164,490
17525,2020-07-05,(07002) MADELENA,244,118,176,538
17526,2020-04-27,(04003) Avenida Ciudad de Cali,378,47,107,532
17527,2020-04-25,(12007) Zona Industrial,184,134,84,402
17528,2020-09-21,(07108) Av. El Dorado,157,104,99,360
17529,2020-07-26,(06002) Normandía,61,44,50,155
17530,2020-07-19,(05107) Américas - Cr.53,71,51,73,195
17531,2020-05-07,(10003) Ciudad Jardín,129,68,104,301
17532,2020-03-20,(04000) Cabecera Calle 80 - intermunicipal,67,42,73,182
17533,2020-04-11,(04001) Quirigua,109,66,55,230
17534,2020-06-07,(10006) San Victorino,84,74,91,249
17535,2020-04-14,(12007) Zona Industrial,205,148,82,435
17536,2020-08-23,(07201) Guatoque -Veraguas,33,24,49,106
17537,2020-02-23,(10005) Bicentenario,64,50,102,216
17538,2020-05-25,(06105) Quinta Paredes,44,32,28,104
17539,2020-08-14,(03014) SAN MARTIN,0,13,36,49
17540,2020-03-18,(50006) Corral Carrera 77,13,11,11,35
17541,2020-04-10,(09121) Las Flores,152,104,71,327
17542,2020-10-01,(50006) Corral Carrera 77,6,7,15,28
17543,2020-05-10,(09108) Hospital,32,18,27,77
17544,2020-04-13,(12000) Puente Aranda,53,24,28,105
17545,2020-09-26,(12000) Puente Aranda,55,44,66,165
17546,2020-03-22,(12001) Carrera 43,39,26,32,97
17547,2020-04-05,(03003) 21 ANGELES,46,25,35,106
17548,2020-04-11,(07108) Av. El Dorado,30,20,18,68
17549,2020-04-18,(03004) GRATAMIRA,13,12,4,29
17550,2020-10-13,(09000) Cabecera Usme - alimentacion,2,0,0,2
17551,2020-01-24,(07005) ALQUERIA,2389,1324,1373,5086
17552,2020-06-08,(09002) Consuelo,455,240,277,972
17553,2020-08-04,(09118) Marly,1330,864,663,2857
17554,2020-02-16,(10000) Portal 20 de Julio - alimentacion,3543,1384,3064,7991
17555,2020-09-30,(05000) Portal Américas - alimentacion,12275,6660,7710,26645
17556,2020-01-09,(07003) SEVILLANA,1454,827,915,3196
17557,2020-02-13,(04002) Carrera 90,3851,2241,2054,8146
17558,2020-02-05,(07111) NQS - RICAURTE,3195,2043,1875,7113
17559,2020-01-11,(06107) Ciudad Universitaria,387,237,432,1056
17560,2020-01-22,(02000) Cabecera Autopista Norte - alimentacion,21452,12141,12374,45967
17561,2020-02-06,(07010) Bosa,2081,1243,1425,4749
17562,2020-02-10,(02201) Prado,6090,3899,3249,13238
17563,2020-02-24,(07000) Portal Sur - alimentacion,29302,17370,14406,61078
17564,2020-02-26,(07000) Portal Sur - alimentacion,29753,16761,14337,60851
17565,2020-01-22,(10004) Policarpa,776,382,591,1749
17566,2020-02-19,(10004) Policarpa,945,481,585,2011
17567,2020-01-27,(09104) Restrepo,4951,3087,3706,11744
17568,2020-07-29,(05100) Banderas P. Central,581,354,405,1340
17569,2020-04-09,(10001) Country Sur,238,101,131,470
17570,2020-01-23,(09115) Calle 34,3862,2531,2320,8713
17571,2020-02-07,(02502) Terminal,5329,3291,3144,11764
17572,2020-06-29,(10000) Portal 20 de Julio - alimentacion,1731,695,1063,3489
17573,2020-06-25,(07001) PERDOMO,991,590,573,2154
17574,2020-03-11,(09120) Calle 63,6849,4463,3805,15117
17575,2020-04-06,(04100) Carrera 77,625,353,407,1385
17576,2020-02-28,(06106) Recinto Ferial,1511,872,844,3227
17577,2020-02-09,(05000) Portal Américas,2737,1239,2669,6645
17578,2020-02-06,(04100) Carrera 77,6783,3992,3990,14765
17579,2020-09-20,(09118) Marly,517,324,520,1361
17580,2020-06-17,(07000) Portal Sur - alimentacion,8110,4589,3833,16532
17581,2020-09-10,(05100) Banderas P. Central - alimentacion,3232,1634,1880,6746
17582,2020-07-03,(09103) Olaya,1130,649,620,2399
17583,2020-06-22,(09103) Olaya,409,218,242,869
17584,2020-06-27,(14001) La Sabana,149,116,94,359
17585,2020-10-05,(14001) La Sabana,164,94,128,386
17586,2020-07-21,(02000) Cabecera Autopista Norte - alimentacion,4337,2456,2361,9154
17587,2020-03-16,(07112) COMUNEROS,2648,1565,1506,5719
17588,2020-03-02,(09113) Calle 22,1567,882,1032,3481
17589,2020-09-12,(04105) Carrera 53,212,116,180,508
17590,2020-07-29,(08000) Portal Tunal - alimentacion,5874,3393,3213,12480
17591,2020-08-27,(09110) Avenida Jimenez,1287,941,877,3105
17592,2020-01-17,(07506) DESPENSA,1529,784,890,3203
17593,2020-01-29,(10001) Country Sur,5052,2246,2604,9902
17594,2020-02-23,(04002) Carrera 90,703,325,632,1660
17595,2020-01-26,(09111) Calle 19,410,292,585,1287
17596,2020-08-03,(40003) Mirador del Paraiso,1525,918,879,3322
17597,2020-09-07,(40003) Mirador del Paraiso,1705,1017,1095,3817
17598,2020-02-14,(12001) Carrera 43,1790,1015,1144,3949
17599,2020-01-18,(09107) Hortúa,1183,652,1080,2915
17600,2020-09-26,(10010) San Bernardo,495,250,452,1197
17601,2020-04-23,(08000) Portal Tunal - alimentacion,3338,1808,1733,6879
17602,2020-07-27,(10000) Portal 20 de Julio,2109,1122,1078,4309
17603,2020-09-15,(02303) Calle 85,807,538,439,1784
17604,2020-02-07,(07000) Portal Sur,8076,4619,4522,17217
17605,2020-02-21,(07000) Portal Sur,7999,4444,4367,16810
17606,2020-06-30,(08001) Parque el Tunal,514,284,271,1069
17607,2020-08-01,(08001) Parque el Tunal,349,173,244,766
17608,2020-09-25,(02101) Toberín,1869,1098,1489,4456
17609,2020-03-02,(06103) CAN,2607,1546,1126,5279
17610,2020-02-29,(03003) 21 ANGELES,986,382,683,2051
17611,2020-06-03,(03003) 21 ANGELES,305,155,160,620
17612,2020-04-29,(10002) Av. Primero de Mayo,1343,677,801,2821
17613,2020-07-30,(09004) Santa Lucía,2396,1252,1255,4903
17614,2020-03-15,(09107) Hortúa,392,231,468,1091
17615,2020-09-16,(09107) Hortúa,620,362,485,1467
17616,2020-01-30,(05101) Mandalay - Cr.73,1141,613,502,2256
17617,2020-04-16,(05002) Tintal,1344,701,619,2664
17618,2020-03-21,(06000) Portal Eldorado - alimentacion,1625,614,595,2834
17619,2020-02-13,(02300) Calle 100,6963,4718,3800,15481
17620,2020-06-06,(10000) Portal 20 de Julio,1646,790,919,3355
17621,2020-07-03,(04104) Avenida 68,645,343,357,1345
17622,2020-07-04,(05005) Transversal 86,0,141,395,536
17623,2020-08-07,(05000) Portal Américas - alimentacion,4552,2166,2305,9023
17624,2020-05-11,(02202) Calle 127,861,578,424,1863
17625,2020-07-28,(02202) Calle 127,1030,717,491,2238
17626,2020-01-26,(04105) Carrera 53,314,169,250,733
17627,2020-02-18,(04105) Carrera 53,1518,836,773,3127
17628,2020-05-25,(08000) Portal Tunal - alimentacion,2016,1038,1040,4094
17629,2020-09-11,(06109) Centro Memoria,261,153,159,573
17630,2020-08-10,(02205) Calle 106,348,228,180,756
17631,2020-07-21,(04002) Carrera 90,658,346,360,1364
17632,2020-01-12,(12000) Puente Aranda,32,31,55,118
17633,2020-01-20,(03006) NIZA - CALLE 127,2212,1372,1447,5031
17634,2020-05-16,(04000) Cabecera Calle 80,586,348,398,1332
17635,2020-07-08,(07113) SANTA ISABEL,407,263,291,961
17636,2020-08-24,(07113) SANTA ISABEL,309,184,223,716
17637,2020-02-12,(06101) El Tiempo,3167,1727,1411,6305
17638,2020-09-26,(06111) Universidades,372,206,433,1011
17639,2020-09-04,(05001) Patio Bonito,2177,1177,1319,4673
17640,2020-03-08,(03007) HUMEDAL CORDOBA,163,87,170,420
17641,2020-09-30,(08002) Biblioteca,353,186,252,791
17642,2020-09-19,(07000) Portal Sur,1775,952,1561,4288
17643,2020-07-18,(09103) Olaya,567,332,359,1258
17644,2020-01-10,(02202) Calle 127,4080,2623,2304,9007
17645,2020-03-27,(02304) Heroes,400,315,249,964
17646,2020-05-01,(02304) Heroes,208,169,136,513
17647,2020-04-21,(09100) Calle 40 Sur,888,547,495,1930
17648,2020-08-10,(10005) Bicentenario - alimentacion,208,93,190,491
17649,2020-05-31,(05000) Portal Américas,631,346,503,1480
17650,2020-03-06,(09121) Las Flores,3171,2045,2139,7355
17651,2020-02-16,(04000) Cabecera Calle 80,1256,679,1538,3473
17652,2020-09-08,(05002) Tintal,2813,1571,1691,6075
17653,2020-03-14,(05103) Marsella,1254,566,885,2705
17654,2020-04-14,(07002) MADELENA,332,171,218,721
17655,2020-01-20,(07003) SEVILLANA,1882,1048,1056,3986
17656,2020-07-06,(04001) Quirigua,403,261,257,921
17657,2020-06-18,(07113) SANTA ISABEL,394,249,295,938
17658,2020-08-04,(02105) Calle 142,645,427,439,1511
17659,2020-07-01,(02001) Centro Comercial Santa Fe,542,333,364,1239
17660,2020-07-18,(02302) Virrey,339,241,196,776
17661,2020-01-18,(09122) Calle 72,2805,1896,2601,7302
17662,2020-10-06,(12003) Ricaurte,441,306,261,1008
17663,2020-03-14,(03010) PUENTE LARGO,777,563,724,2064
17664,2020-08-30,(03010) PUENTE LARGO,72,56,68,196
17665,2020-07-03,(06103) CAN,372,237,191,800
17666,2020-02-19,(08002) Biblioteca,1007,601,707,2315
17667,2020-09-01,(03013) RIO NEGRO,279,159,194,632
17668,2020-06-25,(03002) SUBA - TV- 91,800,481,465,1746
17669,2020-07-06,(02103) Mazurén,187,122,171,480
17670,2020-07-22,(02103) Mazurén,172,110,154,436
17671,2020-07-01,(12007) Zona Industrial,381,218,179,778
17672,2020-03-03,(07105) MOVISTAR ARENA,1352,859,745,2956
17673,2020-08-03,(06109) Centro Memoria,255,139,123,517
17674,2020-06-28,(02101) Toberín,309,185,299,793
17675,2020-03-29,(02202) Calle 127,336,242,144,722
17676,2020-08-17,(05107) Américas - Cr.53,94,74,83,251
17677,2020-10-11,(08002) Biblioteca,110,62,115,287
17678,2020-10-07,(06111) Universidades,531,277,543,1351
17679,2020-01-12,(09113) Calle 22,365,268,470,1103
17680,2020-05-27,(09109) Tercer Milenio,335,221,193,749
17681,2020-03-12,(07006) General Santander,207,618,458,1283
17682,2020-09-01,(06105) Quinta Paredes,148,95,98,341
17683,2020-06-01,(10003) Ciudad Jardín,168,97,119,384
17684,2020-04-03,(06100) Av. Rojas,115,79,76,270
17685,2020-01-28,(12004) Carrera 22,687,417,481,1585
17686,2020-08-31,(09123) Calle 76,1038,719,648,2405
17687,2020-05-12,(03002) SUBA - TV- 91,588,310,305,1203
17688,2020-08-25,(04105) Carrera 53,293,161,143,597
17689,2020-03-22,(09103) Olaya,182,99,102,383
17690,2020-03-23,(03000) Portal Suba,279,170,186,635
17691,2020-07-11,(07105) MOVISTAR ARENA,207,120,152,479
17692,2020-07-21,(07105) MOVISTAR ARENA,240,125,104,469
17693,2020-03-17,(07506) DESPENSA,893,563,556,2012
17694,2020-03-20,(04003) Avenida Ciudad de Cali,498,332,267,1097
17695,2020-07-08,(10007) Las Nieves,733,428,404,1565
17696,2020-09-15,(06100) Av. Rojas,294,174,167,635
17697,2020-03-30,(05103) Marsella,155,101,99,355
17698,2020-08-26,(05005) Transversal 86,371,199,244,814
17699,2020-07-04,(10004) Policarpa,207,104,139,450
17700,2020-04-23,(10007) Las Nieves,243,168,149,560
17701,2020-03-30,(12003) Ricaurte,82,77,64,223
17702,2020-06-05,(08002) Biblioteca,278,155,198,631
17703,2020-03-19,(07006) General Santander - alimentacion,830,437,511,1778
17704,2020-03-18,(12000) Puente Aranda,192,118,102,412
17705,2020-06-23,(12000) Puente Aranda,93,58,50,201
17706,2020-04-13,(14005) Las Aguas,0,43,95,138
17707,2020-08-23,(05102) Av. Américas - Av. Boyacá,59,37,38,134
17708,2020-05-04,(03011) SUBA - CALLE 100,316,180,142,638
17709,2020-06-04,(12004) Carrera 22,204,109,126,439
17710,2020-05-03,(10009) Museo Nacional,59,54,64,177
17711,2020-06-27,(07101) CASTELLANA,140,86,104,330
17712,2020-05-23,(09119) Calle 57,345,251,232,828
17713,2020-05-26,(04106) Carrera 47,310,162,156,628
17714,2020-01-19,(07104) Simon Bolivar,377,259,487,1123
17715,2020-01-11,(07200) Tygua-San José,367,215,362,944
17716,2020-08-26,(07200) Tygua-San José,223,130,154,507
17717,2020-08-03,(07009) SENA,492,288,303,1083
17718,2020-06-14,(07003) SEVILLANA,98,41,74,213
17719,2020-04-04,(02001) Centro Comercial Santa Fe,113,79,97,289
17720,2020-08-06,(07108) Av. El Dorado,124,90,62,276
17721,2020-08-07,(05107) Américas - Cr.53,127,87,100,314
17722,2019-12-31,(03009) Av. Suba- Calle 116,32,16,25,73
17723,2020-03-08,(03005) SUBA - AV. BOYACA,385,261,539,1185
17724,2020-02-22,(09108) Hospital,174,92,155,421
17725,2020-10-04,(04108) El Polo,103,67,176,346
17726,2020-08-07,(02300) Calle 100,317,262,253,832
17727,2020-04-28,(03006) NIZA - CALLE 127,239,181,129,549
17728,2020-06-10,(07006) General Santander,508,341,265,1114
17729,2020-05-31,(03009) Av. Suba- Calle 116,154,106,69,329
17730,2020-05-17,(10005) Bicentenario - alimentacion,42,21,57,120
17731,2020-08-06,(07005) ALQUERIA,448,245,307,1000
17732,2020-06-02,(10008) San Diego,232,145,162,539
17733,2020-09-19,(07010) Bosa,0,297,847,1144
17734,2020-09-13,(07201) Guatoque -Veraguas,41,25,73,139
17735,2020-03-23,(07005) ALQUERIA,116,66,81,263
17736,2020-10-12,(10009) Museo Nacional,94,95,193,382
17737,2020-05-29,(07107) U. NACIONAL,289,180,127,596
17738,2020-04-04,(05107) Américas - Cr.53,189,166,139,494
17739,2020-09-26,(07109) CAD,428,299,425,1152
17740,2020-05-12,(06101) El Tiempo,249,157,115,521
17741,2020-02-02,(07506) DESPENSA,374,167,383,924
17742,2020-03-28,(07105) MOVISTAR ARENA,93,83,59,235
17743,2020-07-08,(03005) SUBA - AV. BOYACA,480,280,313,1073
17744,2020-07-11,(07106) EL CAMPIN,346,226,205,777
17745,2020-06-20,(09106) Nariño,299,191,246,736
17746,2020-01-01,(05001) Patio Bonito,439,256,656,1351
17747,2020-10-11,(09111) Calle 19,192,135,280,607
17748,2020-05-17,(09121) Las Flores,145,105,110,360
17749,2020-04-13,(04106) Carrera 47,185,97,80,362
17750,2020-04-10,(07506) DESPENSA,78,47,51,176
17751,2020-06-12,(10003) Ciudad Jardín,191,97,126,414
17752,2020-04-28,(14005) Las Aguas,0,50,97,147
17753,2020-06-28,(03011) SUBA - CALLE 100,155,82,94,331
17754,2020-08-06,(06108) Concejo de Bogotá,135,67,62,264
17755,2020-01-22,(03014) SAN MARTIN,247,141,150,538
17756,2020-05-29,(06100) Av. Rojas,203,109,117,429
17757,2020-04-12,(05107) Américas - Cr.53,79,62,43,184
17758,2020-10-07,(07108) Av. El Dorado,183,131,163,477
17759,2020-04-09,(07006) General Santander,110,61,50,221
17760,2020-06-23,(09105) Río Fucha,136,56,96,288
17761,2020-01-01,(07102) NQS - CALLE 75,63,53,147,263
17762,2020-04-12,(06001) Modelia,60,42,51,153
17763,2020-07-19,(03005) SUBA - AV. BOYACA,87,59,85,231
17764,2020-09-11,(05102) Av. Américas - Av. Boyacá,247,138,178,563
17765,2020-03-22,(07103) AV. CHILE,139,97,90,326
17766,2020-03-25,(04102) Avenida Boyaca,165,100,114,379
17767,2020-05-02,(12002) CDS - Carrera 32,114,75,37,226
17768,2020-10-05,(12000) Puente Aranda,95,54,72,221
17769,2020-08-08,(06108) Concejo de Bogotá,75,42,58,175
17770,2020-04-10,(09115) Calle 34,115,82,59,256
17771,2020-08-02,(02104) Calle 146,198,146,153,497
17772,2020-08-16,(07106) EL CAMPIN,93,61,85,239
17773,2020-04-12,(12007) Zona Industrial,21,24,23,68
17774,2020-05-10,(07105) MOVISTAR ARENA,40,30,42,112
17775,2020-05-25,(10008) San Diego,82,51,56,189
17776,2020-05-03,(07107) U. NACIONAL,82,59,42,183
17777,2020-04-28,(06105) Quinta Paredes,87,55,42,184
17778,2020-06-28,(12003) Ricaurte,49,61,56,166
17779,2020-06-27,(03014) SAN MARTIN,21,7,16,44
17780,2020-04-05,(05101) Mandalay - Cr.73,9,8,7,24
17781,2020-08-02,(07107) U. NACIONAL,98,71,71,240
17782,2020-04-07,(50006) Corral Carrera 77,5,3,2,10
17783,2020-10-05,(03004) GRATAMIRA,0,32,53,85
17784,2020-08-05,(03004) GRATAMIRA,0,18,23,41
17785,2020-03-22,(50006) Corral Carrera 77,1,2,2,5
17786,2020-10-13,(05000) Portal Américas,0,0,2,2
17787,2020-06-11,(04000) Cabecera Calle 80 - alimentacion,3819,2214,2323,8356
17788,2020-06-25,(09002) Consuelo,481,254,295,1030
17789,2020-07-22,(09002) Consuelo,356,191,214,761
17790,2020-02-27,(02502) Terminal,5345,3505,2865,11715
17791,2020-09-22,(02502) Terminal,527,368,473,1368
17792,2020-01-05,(09118) Marly,952,601,1000,2553
17793,2020-04-08,(07504) TERREROS,2189,1309,1214,4712
17794,2020-05-06,(07504) TERREROS,3258,2013,1639,6910
17795,2020-02-17,(03000) Portal Suba - alimentacion,29257,17804,16552,63613
17796,2020-01-17,(02101) Toberín,12835,7280,7308,27423
17797,2020-03-07,(07503) SAN MATEO,26825,12882,14321,54028
17798,2020-02-12,(05000) Portal Américas,15759,8891,7756,32406
17799,2020-02-21,(06104) Gobernación,1367,781,676,2824
17800,2020-05-26,(09003) Socorro,530,286,283,1099
17801,2020-09-24,(10000) Portal 20 de Julio - alimentacion,4339,2032,2938,9309
17802,2020-10-06,(05000) Portal Américas - alimentacion,12424,6502,8204,27130
17803,2020-01-21,(07503) SAN MATEO,29596,14339,12275,56210
17804,2020-02-06,(06107) Ciudad Universitaria,1599,1038,1111,3748
17805,2020-01-31,(08000) Portal Tunal - alimentacion,23740,12262,11840,47842
17806,2020-01-20,(50006) Corral Carrera 77,23,19,43,85
17807,2020-06-13,(07503) SAN MATEO,8078,4475,4304,16857
17808,2020-01-31,(03009) Av. Suba- Calle 116,2401,1556,1407,5364
17809,2020-02-09,(06000) Portal Eldorado - alimentacion,4452,1815,3444,9711
17810,2020-04-04,(10001) Country Sur,387,160,263,810
17811,2020-02-20,(09000) Cabecera Usme,5538,3347,3695,12580
17812,2020-03-08,(02102) Calle 161,250,156,337,743
17813,2020-09-05,(09000) Cabecera Usme,1548,818,1411,3777
17814,2020-02-11,(10003) Ciudad Jardín,1120,608,694,2422
17815,2020-03-05,(10002) Av. Primero de Mayo,8292,4176,4688,17156
17816,2020-10-12,(07005) ALQUERIA,215,105,233,553
17817,2020-05-29,(09109) Tercer Milenio,321,194,224,739
17818,2020-02-11,(04000) Cabecera Calle 80 - intermunicipal,2467,1811,2196,6474
17819,2020-07-02,(09104) Restrepo,1611,977,1201,3789
17820,2020-07-19,(04100) Carrera 77,295,143,246,684
17821,2020-09-29,(02101) Toberín,1766,1164,1503,4433
17822,2020-04-11,(09000) Cabecera Usme,479,313,329,1121
17823,2020-02-18,(10006) San Victorino,2604,1336,1271,5211
17824,2020-01-28,(04104) Avenida 68,3670,1925,1801,7396
17825,2020-01-23,(02502) Terminal,4663,3066,2818,10547
17826,2020-01-10,(09123) Calle 76,3369,2415,2309,8093
17827,2020-03-03,(03005) SUBA - AV. BOYACA,2765,1654,1619,6038
17828,2020-06-22,(03013) RIO NEGRO,90,58,75,223
17829,2020-03-11,(02302) Virrey,3725,2552,1873,8150
17830,2020-01-16,(02103) Mazurén,2818,1714,1695,6227
17831,2020-08-25,(09103) Olaya,944,540,604,2088
17832,2020-04-24,(14001) La Sabana,81,67,46,194
17833,2020-05-06,(14001) La Sabana,108,85,65,258
17834,2020-08-01,(07000) Portal Sur - alimentacion,5310,2734,2928,10972
17835,2020-03-03,(07111) NQS - RICAURTE,3169,2025,1845,7039
17836,2020-04-07,(07111) NQS - RICAURTE,377,298,216,891
17837,2020-02-26,(07002) MADELENA,5241,2861,2602,10704
17838,2020-01-30,(04105) Carrera 53,1420,804,761,2985
17839,2020-01-26,(08000) Portal Tunal - alimentacion,5807,2537,3889,12233
17840,2020-05-11,(05000) Portal Américas,1714,1225,1306,4245
17841,2020-07-28,(05000) Portal Américas,2004,1545,1667,5216
17842,2020-09-17,(04000) Cabecera Calle 80,1255,786,1097,3138
17843,2020-09-29,(07010) Bosa,0,391,964,1355
17844,2020-06-17,(02000) Cabecera Autopista Norte - alimentacion,4911,2843,2684,10438
17845,2020-07-31,(02000) Cabecera Autopista Norte - alimentacion,4082,2203,2229,8514
17846,2020-06-14,(07112) COMUNEROS,199,130,142,471
17847,2020-01-16,(04003) Avenida Ciudad de Cali,4787,2686,3123,10596
17848,2020-02-09,(10006) San Victorino,340,324,450,1114
17849,2020-09-23,(40003) Mirador del Paraiso,1816,1057,1280,4153
17850,2020-01-01,(04104) Avenida 68,186,124,336,646
17851,2020-04-18,(02000) Cabecera Autopista Norte - intermunicipal,67,63,71,201
17852,2020-01-16,(06111) Universidades,2787,1786,2094,6667
17853,2020-08-28,(10000) Portal 20 de Julio,2285,1141,1232,4658
17854,2020-01-27,(09116) Avenida 39,2581,1609,1391,5581
17855,2020-05-04,(09004) Santa Lucía,1484,791,897,3172
17856,2020-05-18,(03000) Portal Suba - alimentacion,4995,2937,2632,10564
17857,2020-05-03,(07503) SAN MATEO,2045,1305,843,4193
17858,2020-07-21,(08001) Parque el Tunal,366,198,223,787
17859,2020-08-13,(08001) Parque el Tunal,450,253,271,974
17860,2020-02-08,(09116) Avenida 39,809,626,991,2426
17861,2020-08-21,(09116) Avenida 39,299,184,244,727
17862,2020-04-12,(07505) LEON XIII,504,287,209,1000
17863,2020-02-24,(05102) Av. Américas - Av. Boyacá,1984,1156,948,4088
17864,2020-05-22,(09116) Avenida 39,284,204,178,666
17865,2020-01-04,(14004) Museo del Oro,239,253,460,952
17866,2020-08-20,(02201) Prado,816,526,470,1812
17867,2020-07-08,(09123) Calle 76,1135,749,628,2512
17868,2020-03-16,(02204) Pepe Sierra,3244,2202,1574,7020
17869,2020-02-04,(02300) Calle 100,7401,4623,3870,15894
17870,2020-07-18,(02300) Calle 100,719,485,448,1652
17871,2020-06-16,(03012) SUBA - CALLE 95,324,218,186,728
17872,2020-08-21,(03012) SUBA - CALLE 95,303,192,175,670
17873,2020-10-11,(10000) Portal 20 de Julio,868,368,760,1996
17874,2020-09-01,(50002) Corral Calle 40 Sur,25,13,24,62
17875,2020-02-05,(10010) San Bernardo,1895,1056,1413,4364
17876,2020-03-18,(04104) Avenida 68,1708,884,914,3506
17877,2020-09-12,(07104) Simon Bolivar,475,301,298,1074
17878,2020-07-29,(05005) Transversal 86,256,171,220,647
17879,2020-03-07,(02202) Calle 127,2936,1864,2121,6921
17880,2020-03-18,(08000) Portal Tunal,1400,764,689,2853
17881,2020-06-26,(03009) Av. Suba- Calle 116,531,346,276,1153
17882,2020-05-27,(02205) Calle 106,282,195,157,634
17883,2020-08-03,(06000) Portal Eldorado - alimentacion,3092,1666,1679,6437
17884,2020-02-19,(03006) NIZA - CALLE 127,2494,1518,1529,5541
17885,2020-02-27,(03006) NIZA - CALLE 127,2462,1543,1440,5445
17886,2020-06-06,(03000) Portal Suba,761,419,586,1766
17887,2020-02-26,(12007) Zona Industrial,1287,778,646,2711
17888,2020-03-02,(10009) Museo Nacional,4512,2289,1936,8737
17889,2020-07-21,(10009) Museo Nacional,413,233,278,924
17890,2020-09-08,(05001) Patio Bonito,2119,1080,1201,4400
17891,2020-08-27,(02304) Heroes,819,555,468,1842
17892,2020-06-23,(06000) Portal Eldorado - alimentacion,4036,2230,2022,8288
17893,2020-08-26,(07103) AV. CHILE,889,560,440,1889
17894,2020-08-19,(06000) Portal Eldorado,867,543,458,1868
17895,2020-02-09,(07000) Portal Sur,1487,651,1428,3566
17896,2020-02-16,(02000) Cabecera Autopista Norte,1881,996,1961,4838
17897,2020-06-05,(02303) Calle 85,645,465,327,1437
17898,2020-09-03,(09118) Marly,1490,956,853,3299
17899,2020-10-06,(09100) Calle 40 Sur,1953,1109,1559,4621
17900,2020-09-11,(06000) Portal Eldorado,901,548,562,2011
17901,2020-08-28,(03001) LA CAMPIÑA,1249,692,794,2735
17902,2020-10-10,(04104) Avenida 68,478,313,510,1301
17903,2020-08-28,(02104) Calle 146,784,467,572,1823
17904,2020-09-21,(02104) Calle 146,776,484,484,1744
17905,2020-09-14,(09110) Avenida Jimenez,942,739,818,2499
17906,2020-04-18,(09000) Cabecera Usme - alimentacion,3281,1795,2043,7119
17907,2020-09-07,(02202) Calle 127,1150,834,694,2678
17908,2020-09-04,(06101) El Tiempo,388,215,244,847
17909,2020-06-15,(02205) Calle 106,82,72,69,223
17910,2020-09-03,(08000) Portal Tunal,807,347,317,1471
17911,2020-05-16,(05001) Patio Bonito,965,532,572,2069
17912,2020-06-07,(07503) SAN MATEO,2519,1529,1365,5413
17913,2020-07-21,(02105) Calle 142,685,462,402,1549
17914,2020-07-05,(02001) Centro Comercial Santa Fe,121,94,136,351
17915,2020-06-21,(07009) SENA,203,113,185,501
17916,2020-02-09,(07107) U. NACIONAL,307,245,474,1026
17917,2020-08-14,(02302) Virrey,622,428,371,1421
17918,2020-06-19,(07009) SENA,704,412,432,1548
17919,2020-04-24,(09122) Calle 72,663,480,396,1539
17920,2020-06-20,(10010) San Bernardo,480,219,375,1074
17921,2020-07-09,(10010) San Bernardo,638,339,422,1399
17922,2020-02-13,(07003) SEVILLANA,2240,1148,1145,4533
17923,2020-06-28,(02105) Calle 142,205,165,151,521
17924,2020-08-09,(05002) Tintal,528,290,431,1249
17925,2020-08-31,(09116) Avenida 39,371,238,257,866
17926,2020-03-17,(05102) Av. Américas - Av. Boyacá,952,543,505,2000
17927,2020-02-29,(10009) Museo Nacional,1096,939,1507,3542
17928,2020-02-17,(06109) Centro Memoria,1220,673,624,2517
17929,2020-08-30,(10005) Bicentenario,25,20,31,76
17930,2020-08-05,(06109) Centro Memoria,251,128,113,492
17931,2020-06-01,(09106) Nariño,397,216,248,861
17932,2020-10-08,(04000) Cabecera Calle 80 - intermunicipal,440,218,423,1081
17933,2020-07-16,(02001) Centro Comercial Santa Fe,475,278,299,1052
17934,2020-01-02,(10006) San Victorino,780,528,694,2002
17935,2020-08-03,(10008) San Diego,296,167,147,610
17936,2020-08-27,(03011) SUBA - CALLE 100,556,249,258,1063
17937,2020-07-08,(10009) Museo Nacional,498,323,299,1120
17938,2020-07-16,(07004) VENECIA,824,495,454,1773
17939,2020-07-25,(09115) Calle 34,335,228,249,812
17940,2020-10-01,(04000) Cabecera Calle 80 - intermunicipal,423,214,409,1046
17941,2020-03-25,(07000) Portal Sur,928,559,534,2021
17942,2020-04-14,(07000) Portal Sur,897,542,590,2029
17943,2020-10-07,(07110) PALOQUEMAO,702,422,374,1498
17944,2020-02-18,(09111) Calle 19,2520,1450,1568,5538
17945,2020-02-23,(12004) Carrera 22,109,111,172,392
17946,2020-04-12,(10000) Portal 20 de Julio,432,212,198,842
17947,2020-01-24,(06109) Centro Memoria,1025,588,657,2270
17948,2020-06-04,(04105) Carrera 53,269,133,124,526
17949,2020-07-25,(09002) Consuelo,260,159,171,590
17950,2020-02-09,(07108) Av. El Dorado,148,118,234,500
17951,2020-06-25,(07201) Guatoque -Veraguas,211,108,139,458
17952,2020-01-13,(07105) MOVISTAR ARENA,1137,659,705,2501
17953,2020-07-26,(09000) Cabecera Usme - alimentacion,2036,1025,1221,4282
17954,2020-08-17,(50003) Corral Molinos,569,277,428,1274
17955,2020-06-26,(07107) U. NACIONAL,364,218,180,762
17956,2020-07-18,(06109) Centro Memoria,165,94,103,362
17957,2020-06-06,(03003) 21 ANGELES,213,94,112,419
17958,2020-07-04,(03003) 21 ANGELES,264,115,178,557
17959,2020-06-27,(09121) Las Flores,493,362,448,1303
17960,2020-04-18,(40002) Manitas,131,79,85,295
17961,2020-05-17,(09119) Calle 57,131,74,113,318
17962,2020-07-04,(06107) Ciudad Universitaria,129,99,128,356
17963,2020-08-07,(06107) Ciudad Universitaria,79,42,49,170
17964,2020-08-27,(08000) Portal Tunal,778,300,279,1357
17965,2020-08-28,(05005) Transversal 86,391,190,270,851
17966,2020-03-13,(10007) Las Nieves,953,62,220,1235
17967,2020-09-01,(09114) Calle 26,329,194,232,755
17968,2020-07-24,(10002) Av. Primero de Mayo,1602,761,1005,3368
17969,2020-08-05,(12000) Puente Aranda,84,49,29,162
17970,2020-06-16,(06105) Quinta Paredes,131,83,80,294
17971,2020-07-03,(02102) Calle 161,268,160,173,601
17972,2020-07-14,(12004) Carrera 22,120,77,93,290
17973,2020-09-08,(12004) Carrera 22,203,134,139,476
17974,2020-09-17,(12004) Carrera 22,296,185,168,649
17975,2020-02-27,(07108) Av. El Dorado,979,596,605,2180
17976,2020-03-21,(07505) LEON XIII,872,424,333,1629
17977,2020-06-24,(02502) Terminal,424,326,361,1111
17978,2020-08-25,(06001) Modelia,350,224,230,804
17979,2020-06-03,(04106) Carrera 47,284,171,167,622
17980,2020-08-15,(10004) Policarpa,198,80,147,425
17981,2020-05-20,(07113) SANTA ISABEL,359,205,202,766
17982,2020-09-24,(07008) NQS - Calle 30 Sur,377,194,260,831
17983,2020-04-03,(09122) Calle 72,584,446,377,1407
17984,2020-03-23,(09120) Calle 63,281,191,158,630
17985,2020-09-07,(12002) CDS - Carrera 32,210,130,90,430
17986,2020-08-08,(07506) DESPENSA,328,189,193,710
17987,2020-05-20,(02502) Terminal,306,222,226,754
17988,2020-04-18,(06101) El Tiempo,131,110,80,321
17989,2020-03-22,(10005) Bicentenario - alimentacion,48,17,42,107
17990,2020-04-19,(03012) SUBA - CALLE 95,59,33,39,131
17991,2020-04-05,(02502) Terminal,42,33,38,113
17992,2020-06-27,(07200) Tygua-San José,212,111,145,468
17993,2020-04-08,(03006) NIZA - CALLE 127,248,185,126,559
17994,2020-04-16,(09110) Avenida Jimenez,291,243,269,803
17995,2020-04-10,(07112) COMUNEROS,100,76,55,231
17996,2020-07-01,(03002) SUBA - TV- 91,857,490,546,1893
17997,2020-03-21,(04103) Las Ferias,130,68,56,254
17998,2020-06-14,(03011) SUBA - CALLE 100,142,82,83,307
17999,2020-08-13,(04001) Quirigua,291,172,231,694
18000,2020-04-27,(02001) Centro Comercial Santa Fe,125,46,39,210
18001,2020-06-04,(07006) General Santander - alimentacion,371,218,197,786
18002,2020-08-08,(07008) NQS - Calle 30 Sur,197,95,133,425
18003,2020-04-23,(06001) Modelia,265,186,151,602
18004,2020-08-15,(06001) Modelia,230,160,151,541
18005,2020-01-18,(14001) La Sabana,203,213,255,671
18006,2020-08-23,(14001) La Sabana,38,31,49,118
18007,2020-05-08,(03010) PUENTE LARGO,254,167,112,533
18008,2020-06-03,(04001) Quirigua,387,234,192,813
18009,2020-04-27,(06111) Universidades,0,39,84,123
18010,2020-09-07,(04001) Quirigua,402,245,284,931
18011,2020-06-05,(03004) GRATAMIRA,33,13,29,75
18012,2020-08-07,(09114) Calle 26,85,57,60,202
18013,2020-06-21,(03009) Av. Suba- Calle 116,135,99,100,334
18014,2020-09-15,(09003) Socorro,582,315,351,1248
18015,2020-04-24,(07003) SEVILLANA,240,146,108,494
18016,2020-05-21,(04103) Las Ferias,286,175,138,599
18017,2020-02-04,(03014) SAN MARTIN,273,163,170,606
18018,2020-09-06,(07101) CASTELLANA,27,29,52,108
18019,2020-05-10,(07002) MADELENA,104,62,79,245
18020,2020-07-23,(07113) SANTA ISABEL,292,172,209,673
18021,2020-03-15,(12002) CDS - Carrera 32,58,64,83,205
18022,2020-04-18,(04107) Escuela Militar,38,23,40,101
18023,2020-09-21,(06103) CAN,271,202,189,662
18024,2020-04-07,(09003) Socorro,265,122,172,559
18025,2020-09-17,(03007) HUMEDAL CORDOBA,178,112,107,397
18026,2020-04-18,(07108) Av. El Dorado,51,31,34,116
18027,2020-03-29,(09111) Calle 19,84,54,71,209
18028,2020-10-03,(09108) Hospital,70,40,66,176
18029,2020-04-03,(04001) Quirigua,172,93,90,355
18030,2020-06-09,(12000) Puente Aranda,72,46,26,144
18031,2020-04-19,(04102) Avenida Boyaca,56,41,36,133
18032,2020-03-29,(03014) SAN MARTIN,7,4,6,17
18033,2020-06-22,(10005) Bicentenario - alimentacion,64,33,76,173
18034,2020-04-21,(10005) Bicentenario,58,32,40,130
18035,2020-05-18,(50006) Corral Carrera 77,6,2,7,15
18036,2020-08-17,(50006) Corral Carrera 77,3,0,1,4
18037,2020-09-27,(04000) Cabecera Calle 80 - alimentacion,1473,640,1645,3758
18038,2020-01-08,(09002) Consuelo,1103,546,721,2370
18039,2020-02-06,(05000) Portal Américas - alimentacion,36527,20944,20075,77546
18040,2020-08-20,(09119) Calle 57,462,299,353,1114
18041,2020-02-07,(04106) Carrera 47,1520,841,919,3280
18042,2020-02-18,(02303) Calle 85,3934,2669,1967,8570
18043,2020-01-27,(02200) Alcalá,14017,8995,6442,29454
18044,2020-03-06,(05000) Portal Américas,14925,7626,7887,30438
18045,2020-01-09,(04002) Carrera 90,2588,1446,1569,5603
18046,2020-06-16,(07503) SAN MATEO,10446,6717,6012,23175
18047,2020-06-05,(05001) Patio Bonito,1361,764,881,3006
18048,2020-04-30,(08000) Portal Tunal - alimentacion,3779,2023,2057,7859
18049,2020-02-21,(02201) Prado,5849,3327,2948,12124
18050,2020-03-06,(02201) Prado,5693,3422,3081,12196
18051,2020-03-01,(05005) Transversal 86,470,149,435,1054
18052,2020-09-23,(07112) COMUNEROS,960,528,693,2181
18053,2020-09-24,(07112) COMUNEROS,891,493,669,2053
18054,2020-01-21,(09000) Cabecera Usme - alimentacion,19245,9116,10938,39299
18055,2020-01-21,(07002) MADELENA,3462,1549,1630,6641
18056,2020-07-01,(10001) Country Sur,1329,619,813,2761
18057,2020-08-18,(10001) Country Sur,1109,491,653,2253
18058,2020-03-03,(09000) Cabecera Usme,5982,3547,3994,13523
18059,2020-01-09,(09000) Cabecera Usme,4465,2575,3243,10283
18060,2020-03-10,(09115) Calle 34,2208,325,611,3144
18061,2020-03-04,(07002) MADELENA,5069,2825,2586,10480
18062,2020-05-16,(07000) Portal Sur - alimentacion,4751,2564,2183,9498
18063,2020-06-01,(02105) Calle 142,708,471,438,1617
18064,2020-02-01,(03000) Portal Suba - alimentacion,15923,7853,11833,35609
18065,2020-05-18,(07505) LEON XIII,1992,1187,990,4169
18066,2020-02-14,(04104) Avenida 68,3811,1973,1869,7653
18067,2020-03-11,(12003) Ricaurte,1202,816,636,2654
18068,2020-03-16,(03005) SUBA - AV. BOYACA,1792,1118,994,3904
18069,2020-09-01,(07000) Portal Sur - alimentacion,8260,4626,4546,17432
18070,2020-08-10,(07111) NQS - RICAURTE,1082,643,430,2155
18071,2020-05-14,(02000) Cabecera Autopista Norte - alimentacion,3683,2127,1778,7588
18072,2020-09-18,(09113) Calle 22,448,255,397,1100
18073,2020-09-26,(50003) Corral Molinos,1409,668,1194,3271
18074,2020-02-03,(05002) Tintal,11026,6629,6230,23885
18075,2020-01-11,(09120) Calle 63,2013,1518,2042,5573
18076,2020-01-04,(09114) Calle 26,391,310,554,1255
18077,2020-03-04,(09000) Cabecera Usme - alimentacion,25881,14617,15627,56125
18078,2020-02-11,(06000) Portal Eldorado,7026,4123,2955,14104
18079,2020-06-30,(10002) Av. Primero de Mayo,2235,1206,1420,4861
18080,2020-06-14,(06105) Quinta Paredes,36,15,25,76
18081,2020-02-16,(05001) Patio Bonito,1791,819,1543,4153
18082,2020-01-14,(02302) Virrey,3428,2259,1684,7371
18083,2020-05-16,(03000) Portal Suba - alimentacion,3468,1891,1817,7176
18084,2020-03-06,(09114) Calle 26,3082,2104,1877,7063
18085,2020-09-05,(02303) Calle 85,467,337,393,1197
18086,2020-04-22,(04100) Carrera 77,689,379,411,1479
18087,2020-04-06,(07503) SAN MATEO,5469,3007,2552,11028
18088,2020-04-11,(07503) SAN MATEO,3335,2086,1475,6896
18089,2020-09-30,(07505) LEON XIII,3100,1597,1646,6343
18090,2020-08-22,(02101) Toberín,822,492,746,2060
18091,2020-02-04,(06103) CAN,2734,1564,1166,5464
18092,2020-02-10,(06108) Concejo de Bogotá,977,466,423,1866
18093,2020-07-30,(06108) Concejo de Bogotá,145,83,76,304
18094,2020-09-15,(06108) Concejo de Bogotá,147,75,90,312
18095,2020-02-22,(03000) Portal Suba,4510,2147,3540,10197
18096,2020-03-06,(09120) Calle 63,6697,4468,4010,15175
18097,2020-03-15,(08001) Parque el Tunal,324,138,267,729
18098,2020-02-16,(07001) PERDOMO,945,408,880,2233
18099,2020-02-19,(02105) Calle 142,7215,4463,4009,15687
18100,2020-02-19,(07007) NQS - Calle 38A Sur,2281,1342,1196,4819
18101,2020-06-14,(06002) Normandía,57,50,63,170
18102,2020-08-14,(06102) Salitre El Greco,218,140,117,475
18103,2020-03-28,(09000) Cabecera Usme - alimentacion,3034,1471,1698,6203
18104,2020-07-17,(09107) Hortúa,570,331,304,1205
18105,2020-07-09,(05101) Mandalay - Cr.73,145,85,93,323
18106,2020-01-26,(05103) Marsella,484,189,430,1103
18107,2020-10-02,(10000) Portal 20 de Julio,2643,1199,1821,5663
18108,2020-03-10,(02101) Toberín,1213,4300,2484,7997
18109,2020-02-29,(07104) Simon Bolivar,1436,956,1041,3433
18110,2020-06-02,(05005) Transversal 86,273,155,166,594
18111,2020-01-11,(02202) Calle 127,2358,1529,1634,5521
18112,2020-09-19,(05105) Pradera,480,300,351,1131
18113,2020-07-28,(06109) Centro Memoria,238,143,136,517
18114,2020-01-05,(03009) Av. Suba- Calle 116,285,201,329,815
18115,2020-07-03,(03009) Av. Suba- Calle 116,511,320,274,1105
18116,2020-09-18,(03009) Av. Suba- Calle 116,585,326,311,1222
18117,2020-04-28,(02205) Calle 106,197,129,111,437
18118,2020-01-02,(04002) Carrera 90,1567,880,1037,3484
18119,2020-05-23,(12000) Puente Aranda,45,27,24,96
18120,2020-01-31,(10009) Museo Nacional,3853,2173,2026,8052
18121,2020-03-13,(07101) CASTELLANA,244,48,118,410
18122,2020-05-31,(03003) 21 ANGELES,62,26,54,142
18123,2020-06-28,(05001) Patio Bonito,557,306,381,1244
18124,2020-06-03,(03007) HUMEDAL CORDOBA,120,84,55,259
18125,2020-02-14,(04105) Carrera 53,1502,820,803,3125
18126,2020-09-17,(07000) Portal Sur,2254,1401,1500,5155
18127,2020-09-20,(02101) Toberín,347,230,532,1109
18128,2020-08-03,(10002) Av. Primero de Mayo,2046,1002,1177,4225
18129,2020-09-06,(05100) Banderas P. Central - alimentacion,1091,427,798,2316
18130,2020-06-06,(04107) Escuela Militar,88,68,69,225
18131,2020-10-05,(10009) Museo Nacional,621,376,496,1493
18132,2020-09-19,(09109) Tercer Milenio,318,184,229,731
18133,2020-02-16,(07004) VENECIA,1029,488,915,2432
18134,2020-01-11,(06101) El Tiempo,723,490,731,1944
18135,2020-01-12,(04001) Quirigua,384,186,388,958
18136,2020-07-31,(02204) Pepe Sierra,699,486,373,1558
18137,2020-04-10,(09001) Molinos,351,234,255,840
18138,2020-02-24,(07101) CASTELLANA,983,585,589,2157
18139,2020-04-16,(03001) LA CAMPIÑA,533,326,279,1138
18140,2020-04-23,(03001) LA CAMPIÑA,548,289,313,1150
18141,2020-04-30,(09002) Consuelo,342,152,193,687
18142,2020-04-03,(08000) Portal Tunal - alimentacion,3455,1734,1853,7042
18143,2020-05-06,(07009) SENA,387,229,214,830
18144,2020-09-26,(09104) Restrepo,1340,752,1314,3406
18145,2020-01-21,(07200) Tygua-San José,547,284,409,1240
18146,2020-05-04,(09002) Consuelo,320,163,176,659
18147,2020-08-17,(03002) SUBA - TV- 91,198,112,169,479
18148,2020-04-18,(09123) Calle 76,357,269,213,839
18149,2020-03-28,(06102) Salitre El Greco,125,91,67,283
18150,2020-03-27,(10005) Bicentenario,57,26,47,130
18151,2020-08-20,(10005) Bicentenario,73,44,68,185
18152,2020-09-03,(10005) Bicentenario,99,70,85,254
18153,2020-01-17,(40002) Manitas,1101,633,760,2494
18154,2020-07-01,(02304) Heroes,887,605,506,1998
18155,2020-06-27,(03001) LA CAMPIÑA,828,405,520,1753
18156,2020-06-02,(02001) Centro Comercial Santa Fe,389,255,249,893
18157,2020-03-16,(04105) Carrera 53,960,527,474,1961
18158,2020-09-23,(07003) SEVILLANA,550,283,304,1137
18159,2020-01-05,(10006) San Victorino,211,223,379,813
18160,2020-09-24,(10008) San Diego,331,181,220,732
18161,2020-06-05,(03011) SUBA - CALLE 100,459,217,210,886
18162,2020-04-19,(03000) Portal Suba - alimentacion,1208,741,658,2607
18163,2020-08-16,(05002) Tintal,599,286,461,1346
18164,2020-04-20,(02204) Pepe Sierra,432,337,216,985
18165,2020-05-18,(07000) Portal Sur,1464,935,800,3199
18166,2020-04-25,(12004) Carrera 22,69,45,65,179
18167,2020-07-14,(09106) Nariño,314,193,248,755
18168,2020-05-01,(09123) Calle 76,222,185,147,554
18169,2020-07-01,(07004) VENECIA,1046,630,621,2297
18170,2020-02-01,(06104) Gobernación,346,274,506,1126
18171,2020-07-22,(06104) Gobernación,224,143,96,463
18172,2020-02-14,(07006) General Santander - alimentacion,1554,897,915,3366
18173,2020-05-01,(08000) Portal Tunal,279,126,118,523
18174,2020-05-04,(02200) Alcalá,1076,817,538,2431
18175,2020-05-10,(06109) Centro Memoria,64,41,45,150
18176,2020-09-04,(04102) Avenida Boyaca,454,274,308,1036
18177,2020-10-03,(04102) Avenida Boyaca,355,207,318,880
18178,2020-08-14,(10007) Las Nieves,693,447,368,1508
18179,2020-06-15,(02000) Cabecera Autopista Norte,420,284,341,1045
18180,2020-04-24,(10006) San Victorino,201,150,171,522
18181,2020-05-09,(04103) Las Ferias,189,108,78,375
18182,2020-08-20,(04103) Las Ferias,354,183,150,687
18183,2020-05-14,(40002) Manitas,282,166,191,639
18184,2020-08-17,(06111) Universidades,107,56,111,274
18185,2020-04-10,(07007) NQS - Calle 38A Sur,52,47,26,125
18186,2020-07-10,(03010) PUENTE LARGO,368,245,212,825
18187,2020-08-25,(12000) Puente Aranda,74,44,43,161
18188,2020-08-31,(06002) Normandía,327,170,202,699
18189,2020-09-02,(12001) Carrera 43,485,278,277,1040
18190,2020-04-22,(07002) MADELENA,378,213,187,778
18191,2020-05-19,(07111) NQS - RICAURTE,917,595,331,1843
18192,2020-09-16,(10003) Ciudad Jardín,248,114,201,563
18193,2020-05-29,(02200) Alcalá,1626,1130,810,3566
18194,2020-05-19,(03010) PUENTE LARGO,291,196,173,660
18195,2020-05-16,(07102) NQS - CALLE 75,184,130,144,458
18196,2020-05-31,(08000) Portal Tunal,198,130,77,405
18197,2020-08-02,(04002) Carrera 90,169,92,111,372
18198,2020-02-15,(40001) Juan Pablo II,1238,632,803,2673
18199,2020-05-21,(07003) SEVILLANA,351,186,167,704
18200,2020-01-15,(09106) Nariño,1670,944,1262,3876
18201,2020-02-11,(07008) NQS - Calle 30 Sur,2025,1117,1072,4214
18202,2020-04-16,(02001) Centro Comercial Santa Fe,196,135,145,476
18203,2020-06-09,(07008) NQS - Calle 30 Sur,261,143,152,556
18204,2020-07-13,(06101) El Tiempo,307,175,133,615
18205,2020-09-16,(09122) Calle 72,1314,875,931,3120
18206,2020-07-10,(06002) Normandía,315,199,202,716
18207,2020-02-25,(03014) SAN MARTIN,261,176,153,590
18208,2020-05-31,(06101) El Tiempo,84,72,67,223
18209,2020-09-12,(07108) Av. El Dorado,100,66,85,251
18210,2020-06-24,(06105) Quinta Paredes,153,90,77,320
18211,2020-07-11,(40002) Manitas,392,216,265,873
18212,2020-04-18,(12001) Carrera 43,187,118,98,403
18213,2020-05-01,(08001) Parque el Tunal,123,64,77,264
18214,2020-02-02,(07200) Tygua-San José,166,110,268,544
18215,2020-04-25,(03010) PUENTE LARGO,147,100,87,334
18216,2020-06-09,(03010) PUENTE LARGO,326,208,186,720
18217,2020-07-09,(04001) Quirigua,423,273,228,924
18218,2020-03-17,(03004) GRATAMIRA,116,66,84,266
18219,2020-06-14,(09121) Las Flores,186,110,142,438
18220,2020-06-15,(09121) Las Flores,209,167,179,555
18221,2020-05-24,(06002) Normandía,72,41,46,159
18222,2020-06-26,(07003) SEVILLANA,476,269,258,1003
18223,2020-05-22,(07108) Av. El Dorado,117,78,71,266
18224,2020-06-25,(07006) General Santander - alimentacion,369,222,245,836
18225,2020-10-06,(06105) Quinta Paredes,178,109,119,406
18226,2020-07-19,(09114) Calle 26,57,40,56,153
18227,2020-04-27,(08002) Biblioteca,116,32,25,173
18228,2020-09-13,(03004) GRATAMIRA,0,5,17,22
18229,2020-05-20,(12007) Zona Industrial,247,161,109,517
18230,2020-05-24,(06103) CAN,142,91,64,297
18231,2020-07-19,(09116) Avenida 39,75,60,60,195
18232,2020-08-09,(04103) Las Ferias,88,57,65,210
18233,2020-07-19,(10003) Ciudad Jardín,66,26,44,136
18234,2020-03-21,(07104) Simon Bolivar,82,66,80,228
18235,2020-10-04,(05102) Av. Américas - Av. Boyacá,79,35,90,204
18236,2020-07-29,(03014) SAN MARTIN,0,12,30,42
18237,2020-08-30,(05101) Mandalay - Cr.73,27,12,30,69
18238,2020-08-09,(07107) U. NACIONAL,99,44,63,206
18239,2020-07-30,(03014) SAN MARTIN,0,14,32,46
18240,2020-08-04,(03014) SAN MARTIN,0,10,22,32
18241,2020-04-10,(10003) Ciudad Jardín,23,22,16,61
18242,2020-05-01,(50006) Corral Carrera 77,3,1,0,4
18243,2020-03-18,(04000) Cabecera Calle 80 - alimentacion,11206,6248,6713,24167
18244,2020-09-23,(04000) Cabecera Calle 80 - alimentacion,4934,2763,3796,11493
18245,2020-09-09,(09119) Calle 57,623,398,490,1511
18246,2020-03-16,(03000) Portal Suba - alimentacion,20241,11555,10744,42540
18247,2020-01-02,(03002) SUBA - TV- 91,1830,1079,1214,4123
18248,2020-07-04,(07503) SAN MATEO,9548,5276,5255,20079
18249,2020-02-15,(06104) Gobernación,383,311,539,1233
18250,2020-01-10,(03010) PUENTE LARGO,1462,916,993,3371
18251,2020-06-05,(10000) Portal 20 de Julio - alimentacion,4089,1886,2355,8330
18252,2020-01-20,(07503) SAN MATEO,37017,21010,17333,75360
18253,2020-10-05,(04000) Cabecera Calle 80 - alimentacion,4936,2773,4112,11821
18254,2020-09-21,(06107) Ciudad Universitaria,143,108,141,392
18255,2020-10-09,(09001) Molinos,3088,1493,2429,7010
18256,2020-03-03,(09118) Marly,8250,5278,4094,17622
18257,2020-01-13,(07000) Portal Sur - alimentacion,24320,13676,12926,50922
18258,2020-01-23,(09000) Cabecera Usme - alimentacion,24558,13015,14698,52271
18259,2020-01-19,(10000) Portal 20 de Julio - alimentacion,3590,1281,2888,7759
18260,2020-01-19,(10004) Policarpa,244,107,276,627
18261,2020-03-26,(03002) SUBA - TV- 91,422,226,197,845
18262,2020-09-21,(05100) Banderas P. Central,819,335,514,1668
18263,2020-09-15,(10001) Country Sur,1345,605,807,2757
18264,2020-03-19,(09000) Cabecera Usme,3600,2021,2375,7996
18265,2020-08-09,(09000) Cabecera Usme,411,232,375,1018
18266,2020-05-26,(06000) Portal Eldorado - alimentacion,3669,1910,1822,7401
18267,2020-02-03,(10003) Ciudad Jardín,1073,556,730,2359
18268,2020-01-22,(10005) Bicentenario - alimentacion,655,290,539,1484
18269,2020-04-25,(07505) LEON XIII,960,623,442,2025
18270,2020-06-16,(03000) Portal Suba - alimentacion,6025,3640,3266,12931
18271,2020-05-07,(05002) Tintal,1560,880,860,3300
18272,2020-01-04,(09000) Cabecera Usme,2274,1200,1986,5460
18273,2020-09-21,(07110) PALOQUEMAO,592,370,344,1306
18274,2020-02-12,(09116) Avenida 39,3436,2148,1604,7188
18275,2020-02-21,(02103) Mazurén,3369,1805,1803,6977
18276,2020-04-03,(09104) Restrepo,675,468,605,1748
18277,2020-03-08,(02303) Calle 85,480,380,614,1474
18278,2020-08-14,(07000) Portal Sur - alimentacion,7905,4360,4067,16332
18279,2020-09-21,(07000) Portal Sur - alimentacion,7717,3425,4067,15209
18280,2020-08-13,(05100) Banderas P. Central - alimentacion,3019,1576,1540,6135
18281,2020-05-21,(09103) Olaya,782,433,402,1617
18282,2020-09-19,(07000) Portal Sur - alimentacion,7559,3670,4876,16105
18283,2020-03-13,(02000) Cabecera Autopista Norte - alimentacion,1839,3700,3165,8704
18284,2020-03-15,(07002) MADELENA,729,287,619,1635
18285,2020-04-13,(04102) Avenida Boyaca,139,88,94,321
18286,2020-02-04,(07007) NQS - Calle 38A Sur,2172,1295,1255,4722
18287,2020-02-20,(07007) NQS - Calle 38A Sur,2166,1327,1132,4625
18288,2020-01-09,(50003) Corral Molinos,2881,1693,2747,7321
18289,2020-10-06,(02201) Prado,1015,679,799,2493
18290,2020-07-01,(04100) Carrera 77,1306,768,907,2981
18291,2020-03-11,(10006) San Victorino,2326,1320,1282,4928
18292,2020-03-13,(06000) Portal Eldorado,1791,414,684,2889
18293,2020-01-14,(10008) San Diego,1192,665,725,2582
18294,2020-03-15,(09004) Santa Lucía,1848,719,1306,3873
18295,2020-06-01,(12001) Carrera 43,401,208,213,822
18296,2020-08-30,(12001) Carrera 43,85,69,93,247
18297,2020-03-01,(50003) Corral Molinos,866,501,1265,2632
18298,2020-02-13,(02205) Calle 106,2710,1830,1475,6015
18299,2020-01-27,(06101) El Tiempo,2893,1535,1263,5691
18300,2020-09-05,(02304) Heroes,583,453,493,1529
18301,2020-06-25,(03000) Portal Suba,1347,808,864,3019
18302,2020-08-04,(03000) Portal Suba,918,605,655,2178
18303,2020-09-28,(09101) Quiroga,565,305,479,1349
18304,2020-09-13,(03000) Portal Suba - alimentacion,2073,954,1789,4816
18305,2020-03-13,(10000) Portal 20 de Julio,225,1378,1112,2715
18306,2020-07-17,(07112) COMUNEROS,751,474,416,1641
18307,2020-07-30,(07112) COMUNEROS,697,410,398,1505
18308,2020-08-09,(07000) Portal Sur - alimentacion,2328,1102,1281,4711
18309,2020-02-17,(08002) Biblioteca,1049,637,660,2346
18310,2020-01-31,(09105) Río Fucha,769,410,529,1708
18311,2020-06-16,(10001) Country Sur,1221,577,694,2492
18312,2020-03-07,(05002) Tintal,6830,3288,4641,14759
18313,2020-05-16,(10002) Av. Primero de Mayo,1203,637,769,2609
18314,2020-02-19,(10007) Las Nieves,2211,1279,1201,4691
18315,2020-03-03,(05100) Banderas P. Central,8262,4727,3827,16816
18316,2020-02-17,(09107) Hortúa,2515,1533,1455,5503
18317,2020-06-13,(09107) Hortúa,440,250,266,956
18318,2020-09-17,(09107) Hortúa,618,354,429,1401
18319,2020-03-02,(04002) Carrera 90,3616,2267,1955,7838
18320,2020-07-08,(02300) Calle 100,1343,872,691,2906
18321,2020-01-13,(03012) SUBA - CALLE 95,1144,726,810,2680
18322,2020-06-27,(03012) SUBA - CALLE 95,227,157,188,572
18323,2020-10-07,(03012) SUBA - CALLE 95,385,218,266,869
18324,2020-07-28,(50002) Corral Calle 40 Sur,26,15,25,66
18325,2020-09-04,(50002) Corral Calle 40 Sur,35,13,27,75
18326,2020-03-16,(10010) San Bernardo,1221,718,918,2857
18327,2020-02-03,(07104) Simon Bolivar,2350,1440,1161,4951
18328,2020-02-25,(07104) Simon Bolivar,2452,1490,1234,5176
18329,2020-01-10,(08000) Portal Tunal,1613,894,944,3451
18330,2020-01-20,(07106) EL CAMPIN,1906,1228,1116,4250
18331,2020-06-04,(02205) Calle 106,312,207,178,697
18332,2020-02-17,(03006) NIZA - CALLE 127,2419,1549,1482,5450
18333,2020-08-26,(04000) Cabecera Calle 80,1028,607,791,2426
18334,2020-06-24,(09101) Quiroga,616,300,359,1275
18335,2020-01-20,(04108) El Polo,1755,1096,1076,3927
18336,2020-01-31,(04108) El Polo,1835,1182,1184,4201
18337,2020-07-04,(02201) Prado,781,490,488,1759
18338,2020-05-21,(07106) EL CAMPIN,269,176,158,603
18339,2020-03-19,(09121) Las Flores,1711,1115,1023,3849
18340,2020-03-05,(06102) Salitre El Greco,1499,859,722,3080
18341,2020-04-16,(10006) San Victorino,213,149,150,512
18342,2020-01-29,(07108) Av. El Dorado,913,555,570,2038
18343,2020-09-15,(05101) Mandalay - Cr.73,138,80,88,306
18344,2020-03-25,(02101) Toberín,683,483,447,1613
18345,2020-07-20,(02000) Cabecera Autopista Norte - alimentacion,1688,867,864,3419
18346,2020-09-24,(14005) Las Aguas,246,165,288,699
18347,2020-01-13,(04101) Minuto de Dios,1983,1198,1443,4624
18348,2020-01-21,(04102) Avenida Boyaca,1837,1074,979,3890
18349,2020-01-18,(04000) Cabecera Calle 80 - intermunicipal,839,532,1069,2440
18350,2020-02-15,(09100) Calle 40 Sur,4568,2224,3321,10113
18351,2020-04-04,(09100) Calle 40 Sur,564,355,393,1312
18352,2020-04-16,(09100) Calle 40 Sur,857,555,598,2010
18353,2020-04-17,(09100) Calle 40 Sur,886,522,585,1993
18354,2020-02-27,(04107) Escuela Militar,675,448,431,1554
18355,2020-09-17,(04107) Escuela Militar,168,109,127,404
18356,2020-03-18,(04003) Avenida Ciudad de Cali,2910,1589,1695,6194
18357,2020-06-03,(02303) Calle 85,645,453,276,1374
18358,2020-07-08,(05103) Marsella,472,241,254,967
18359,2020-03-17,(09109) Tercer Milenio,973,578,523,2074
18360,2020-01-05,(06111) Universidades,273,197,472,942
18361,2020-09-15,(06000) Portal Eldorado,968,637,622,2227
18362,2020-09-09,(06101) El Tiempo,392,232,233,857
18363,2020-09-21,(07109) CAD,595,371,307,1273
18364,2020-04-19,(08000) Portal Tunal - alimentacion,1330,712,681,2723
18365,2020-09-29,(02105) Calle 142,967,601,740,2308
18366,2020-09-13,(06100) Av. Rojas,38,36,69,143
18367,2020-03-22,(02302) Virrey,204,127,117,448
18368,2020-07-25,(03010) PUENTE LARGO,218,132,142,492
18369,2020-08-01,(03010) PUENTE LARGO,162,112,118,392
18370,2020-04-21,(09109) Tercer Milenio,177,104,127,408
18371,2020-01-06,(07007) NQS - Calle 38A Sur,458,260,347,1065
18372,2020-07-11,(05107) Américas - Cr.53,341,211,253,805
18373,2020-02-19,(04000) Cabecera Calle 80 - intermunicipal,2316,1735,2283,6334
18374,2020-07-09,(05100) Banderas P. Central - alimentacion,3213,1746,1677,6636
18375,2020-06-19,(10005) Bicentenario,111,52,66,229
18376,2020-08-14,(02001) Centro Comercial Santa Fe,452,267,323,1042
18377,2020-09-08,(02001) Centro Comercial Santa Fe,525,312,394,1231
18378,2020-10-12,(05100) Banderas P. Central - alimentacion,1057,428,898,2383
18379,2020-05-12,(09123) Calle 76,720,516,413,1649
18380,2020-09-04,(09123) Calle 76,1105,774,779,2658
18381,2020-02-27,(10005) Bicentenario,781,421,376,1578
18382,2020-05-03,(09120) Calle 63,244,170,199,613
18383,2020-06-02,(06111) Universidades,0,107,381,488
18384,2020-08-17,(40001) Juan Pablo II,185,94,155,434
18385,2020-09-14,(09115) Calle 34,714,423,480,1617
18386,2020-08-27,(03006) NIZA - CALLE 127,497,268,256,1021
18387,2020-06-23,(09004) Santa Lucía,2766,1487,1393,5646
18388,2020-03-25,(02104) Calle 146,397,300,249,946
18389,2020-03-26,(07000) Portal Sur,774,499,507,1780
18390,2020-02-18,(40002) Manitas,1417,806,821,3044
18391,2020-10-01,(09103) Olaya,1143,634,766,2543
18392,2020-04-25,(03012) SUBA - CALLE 95,119,86,70,275
18393,2020-01-10,(09106) Nariño,1412,806,1102,3320
18394,2020-08-31,(06104) Gobernación,267,151,137,555
18395,2020-01-19,(07105) MOVISTAR ARENA,182,131,309,622
18396,2020-01-23,(07105) MOVISTAR ARENA,1231,775,716,2722
18397,2020-08-08,(09114) Calle 26,160,104,156,420
18398,2020-07-17,(02200) Alcalá,1666,1114,888,3668
18399,2020-08-02,(02200) Alcalá,433,306,337,1076
18400,2020-07-18,(07107) U. NACIONAL,219,136,132,487
18401,2020-01-24,(02102) Calle 161,1793,1010,1132,3935
18402,2020-02-20,(10007) Las Nieves,2100,1285,1130,4515
18403,2020-08-31,(10007) Las Nieves,652,366,325,1343
18404,2020-05-20,(03003) 21 ANGELES,272,131,140,543
18405,2020-06-04,(14004) Museo del Oro,0,111,255,366
18406,2020-08-06,(14004) Museo del Oro,271,168,205,644
18407,2020-08-15,(03001) LA CAMPIÑA,847,371,581,1799
18408,2020-07-17,(06000) Portal Eldorado,835,528,474,1837
18409,2020-07-20,(06000) Portal Eldorado,220,159,146,525
18410,2020-05-27,(04103) Las Ferias,330,169,147,646
18411,2020-05-22,(07110) PALOQUEMAO,613,377,243,1233
18412,2020-06-20,(08000) Portal Tunal,669,293,283,1245
18413,2020-06-05,(03000) Portal Suba,1159,714,734,2607
18414,2020-05-22,(02104) Calle 146,638,401,379,1418
18415,2020-04-29,(40002) Manitas,194,130,132,456
18416,2020-04-30,(10007) Las Nieves,288,184,194,666
18417,2020-07-30,(08002) Biblioteca,311,175,171,657
18418,2020-01-21,(12000) Puente Aranda,108,112,120,340
18419,2020-02-24,(12000) Puente Aranda,317,175,169,661
18420,2020-07-04,(12000) Puente Aranda,64,35,66,165
18421,2020-04-18,(07002) MADELENA,229,126,130,485
18422,2020-08-21,(12004) Carrera 22,282,150,132,564
18423,2020-05-12,(06001) Modelia,325,222,153,700
18424,2020-08-22,(03013) RIO NEGRO,190,112,157,459
18425,2020-04-10,(02000) Cabecera Autopista Norte - alimentacion,1009,557,359,1925
18426,2020-07-13,(09110) Avenida Jimenez,466,389,468,1323
18427,2020-08-16,(09003) Socorro,215,77,145,437
18428,2020-05-05,(07008) NQS - Calle 30 Sur,163,97,90,350
18429,2020-10-06,(07008) NQS - Calle 30 Sur,410,223,305,938
18430,2020-09-26,(03010) PUENTE LARGO,253,161,253,667
18431,2020-06-27,(10007) Las Nieves,496,334,334,1164
18432,2020-03-27,(07003) SEVILLANA,238,121,105,464
18433,2020-03-30,(14001) La Sabana,59,44,47,150
18434,2020-04-27,(07112) COMUNEROS,161,152,96,409
18435,2020-06-07,(04108) El Polo,76,50,84,210
18436,2020-06-01,(12002) CDS - Carrera 32,191,150,73,414
18437,2020-03-23,(09113) Calle 22,83,80,112,275
18438,2020-04-10,(09113) Calle 22,99,58,91,248
18439,2020-02-09,(09109) Tercer Milenio,351,175,400,926
18440,2020-05-26,(04102) Avenida Boyaca,266,166,165,597
18441,2020-03-27,(04003) Avenida Ciudad de Cali,498,303,341,1142
18442,2020-05-05,(02502) Terminal,251,162,202,615
18443,2020-04-12,(02502) Terminal,42,32,41,115
18444,2020-01-26,(07107) U. NACIONAL,265,218,445,928
18445,2020-04-17,(04103) Las Ferias,199,124,97,420
18446,2020-07-07,(06105) Quinta Paredes,165,99,88,352
18447,2020-08-19,(02303) Calle 85,609,419,312,1340
18448,2020-10-04,(02303) Calle 85,195,158,239,592
18449,2020-10-12,(03000) Portal Suba,434,219,513,1166
18450,2020-04-25,(05102) Av. Américas - Av. Boyacá,83,55,57,195
18451,2020-07-25,(06001) Modelia,187,131,129,447
18452,2020-07-08,(06102) Salitre El Greco,248,145,114,507
18453,2020-09-09,(06100) Av. Rojas,270,172,170,612
18454,2020-06-02,(03010) PUENTE LARGO,308,207,165,680
18455,2020-07-12,(03002) SUBA - TV- 91,246,138,219,603
18456,2020-06-06,(03011) SUBA - CALLE 100,302,174,184,660
18457,2020-07-03,(10004) Policarpa,254,128,192,574
18458,2020-07-29,(10004) Policarpa,235,109,144,488
18459,2020-04-24,(03011) SUBA - CALLE 100,275,181,139,595
18460,2020-04-21,(04001) Quirigua,203,112,99,414
18461,2020-01-06,(10005) Bicentenario,53,32,85,170
18462,2020-05-28,(07008) NQS - Calle 30 Sur,232,117,141,490
18463,2020-07-04,(06103) CAN,253,167,169,589
18464,2020-05-27,(06101) El Tiempo,304,196,176,676
18465,2020-06-13,(06101) El Tiempo,228,166,192,586
18466,2020-06-07,(05107) Américas - Cr.53,80,70,93,243
18467,2020-02-18,(12004) Carrera 22,781,459,461,1701
18468,2020-04-04,(07006) General Santander,171,103,89,363
18469,2020-05-05,(07200) Tygua-San José,147,81,128,356
18470,2020-05-01,(02000) Cabecera Autopista Norte - intermunicipal,80,50,51,181
18471,2020-06-20,(14005) Las Aguas,119,72,168,359
18472,2020-09-22,(06100) Av. Rojas,319,177,204,700
18473,2020-03-21,(03006) NIZA - CALLE 127,187,138,74,399
18474,2020-04-21,(07002) MADELENA,378,191,219,788
18475,2020-06-15,(03004) GRATAMIRA,11,9,8,28
18476,2020-03-28,(04107) Escuela Militar,39,33,29,101
18477,2020-04-04,(10008) San Diego,87,59,66,212
18478,2020-01-14,(12000) Puente Aranda,217,123,134,474
18479,2020-09-01,(06100) Av. Rojas,261,146,137,544
18480,2020-08-16,(10004) Policarpa,75,39,88,202
18481,2020-10-12,(07105) MOVISTAR ARENA,46,42,97,185
18482,2020-09-01,(09105) Río Fucha,0,68,134,202
18483,2020-09-07,(07003) SEVILLANA,484,247,317,1048
18484,2020-04-10,(04105) Carrera 53,43,28,20,91
18485,2020-07-31,(07101) CASTELLANA,182,82,100,364
18486,2020-07-19,(07102) NQS - CALLE 75,74,50,59,183
18487,2020-08-09,(06101) El Tiempo,98,71,84,253
18488,2020-03-07,(03014) SAN MARTIN,109,76,128,313
18489,2020-03-05,(50006) Corral Carrera 77,28,24,50,102
18490,2020-03-27,(50006) Corral Carrera 77,6,4,3,13
18491,2020-05-30,(50006) Corral Carrera 77,2,2,1,5
18492,2020-03-19,(04000) Cabecera Calle 80 - alimentacion,10069,5303,6285,21657
18493,2020-10-02,(04000) Cabecera Calle 80 - alimentacion,5260,2702,4186,12148
18494,2020-07-24,(07005) ALQUERIA,410,270,287,967
18495,2020-06-05,(09002) Consuelo,449,246,276,971
18496,2020-03-21,(09118) Marly,781,512,325,1618
18497,2020-03-18,(09119) Calle 57,1828,1170,997,3995
18498,2020-03-05,(02200) Alcalá,14393,8837,6834,30064
18499,2020-02-04,(05000) Portal Américas,12067,8642,9639,30348
18500,2020-01-09,(08001) Parque el Tunal,1245,664,761,2670
18501,2020-01-18,(07503) SAN MATEO,25939,12348,13600,51887
18502,2020-04-16,(04000) Cabecera Calle 80 - alimentacion,1859,1139,1128,4126
18503,2020-02-01,(05001) Patio Bonito,4775,2384,3060,10219
18504,2020-01-21,(07112) COMUNEROS,2625,1502,1346,5473
18505,2020-03-16,(07000) Portal Sur - alimentacion,21676,12150,10484,44310
18506,2020-01-23,(05005) Transversal 86,2437,1358,1313,5108
18507,2020-03-16,(05005) Transversal 86,1902,1038,855,3795
18508,2020-01-23,(09004) Santa Lucía,6893,3749,4086,14728
18509,2020-01-28,(09004) Santa Lucía,7223,3997,4133,15353
18510,2020-08-21,(05100) Banderas P. Central,765,386,526,1677
18511,2020-03-04,(10001) Country Sur,4948,2366,2814,10128
18512,2020-08-12,(10001) Country Sur,1180,534,689,2403
18513,2020-08-31,(10001) Country Sur,1297,582,744,2623
18514,2020-02-21,(05100) Banderas P. Central - alimentacion,15295,8101,8311,31707
18515,2020-03-07,(05100) Banderas P. Central,3418,1463,2622,7503
18516,2020-02-17,(02205) Calle 106,2879,1761,1320,5960
18517,2020-09-08,(07001) PERDOMO,1023,595,740,2358
18518,2020-01-28,(02000) Cabecera Autopista Norte,10981,6774,5824,23579
18519,2020-03-17,(40003) Mirador del Paraiso,3524,1973,1999,7496
18520,2020-07-04,(05107) Américas - Cr.53,324,192,262,778
18521,2020-02-18,(09104) Restrepo,5494,3431,3953,12878
18522,2020-06-30,(07505) LEON XIII,2957,1586,1299,5842
18523,2020-09-12,(02204) Pepe Sierra,575,413,430,1418
18524,2020-03-17,(09123) Calle 76,3031,2120,1773,6924
18525,2020-01-27,(06106) Recinto Ferial,1444,833,798,3075
18526,2020-02-13,(06106) Recinto Ferial,1572,895,834,3301
18527,2020-02-05,(02304) Heroes,4654,3325,2311,10290
18528,2020-06-02,(09118) Marly,1309,946,693,2948
18529,2020-01-02,(04100) Carrera 77,2723,1555,2041,6319
18530,2020-02-25,(02103) Mazurén,3427,2133,1892,7452
18531,2020-05-20,(02103) Mazurén,151,86,106,343
18532,2020-08-26,(05100) Banderas P. Central - alimentacion,2917,1498,1657,6072
18533,2020-03-15,(09103) Olaya,802,384,709,1895
18534,2020-09-03,(09103) Olaya,1062,588,689,2339
18535,2020-04-13,(07111) NQS - RICAURTE,406,319,230,955
18536,2020-04-15,(07111) NQS - RICAURTE,518,366,236,1120
18537,2020-09-29,(07111) NQS - RICAURTE,1235,794,660,2689
18538,2020-05-27,(07002) MADELENA,649,397,349,1395
18539,2020-09-22,(07002) MADELENA,1027,581,665,2273
18540,2020-02-19,(02104) Calle 146,9673,6128,4906,20707
18541,2020-02-08,(10007) Las Nieves,1101,889,1022,3012
18542,2020-10-01,(09004) Santa Lucía,2854,1423,1810,6087
18543,2020-01-04,(07109) CAD,754,519,699,1972
18544,2020-03-13,(50003) Corral Molinos,66,645,781,1492
18545,2020-05-28,(04000) Cabecera Calle 80,898,618,632,2148
18546,2020-07-21,(04000) Cabecera Calle 80,954,624,688,2266
18547,2020-08-06,(07010) Bosa,605,278,386,1269
18548,2020-03-12,(09110) Avenida Jimenez,2602,182,510,3294
18549,2020-03-10,(05100) Banderas P. Central - alimentacion,820,4089,2700,7609
18550,2020-04-13,(10001) Country Sur,547,252,351,1150
18551,2020-03-18,(04100) Carrera 77,3296,1876,1944,7116
18552,2020-06-11,(04100) Carrera 77,1224,674,727,2625
18553,2020-10-09,(10006) San Victorino,791,429,519,1739
18554,2020-10-07,(03000) Portal Suba,1737,1083,1419,4239
18555,2020-05-09,(10000) Portal 20 de Julio - alimentacion,2447,1080,1373,4900
18556,2020-06-11,(12001) Carrera 43,389,234,186,809
18557,2020-01-09,(07505) LEON XIII,6639,3535,3303,13477
18558,2020-05-27,(10002) Av. Primero de Mayo,1821,977,1084,3882
18559,2020-09-18,(10002) Av. Primero de Mayo,2443,1229,1753,5425
18560,2020-04-14,(06101) El Tiempo,207,159,124,490
18561,2020-06-10,(02000) Cabecera Autopista Norte - intermunicipal,522,327,346,1195
18562,2020-09-07,(09101) Quiroga,556,293,390,1239
18563,2020-09-19,(10002) Av. Primero de Mayo,1787,872,1574,4233
18564,2020-03-03,(09107) Hortúa,2489,1510,1488,5487
18565,2020-02-27,(09116) Avenida 39,3433,2178,1628,7239
18566,2020-04-14,(07505) LEON XIII,1154,735,611,2500
18567,2020-01-16,(07007) NQS - Calle 38A Sur,1815,1000,1111,3926
18568,2020-06-21,(02101) Toberín,323,191,311,825
18569,2020-04-23,(10002) Av. Primero de Mayo,1201,674,795,2670
18570,2020-08-18,(09120) Calle 63,938,621,662,2221
18571,2020-03-18,(02202) Calle 127,2569,1978,1433,5980
18572,2020-02-22,(07007) NQS - Calle 38A Sur,1433,744,948,3125
18573,2020-01-05,(06001) Modelia,216,121,271,608
18574,2020-08-31,(06102) Salitre El Greco,221,133,135,489
18575,2020-04-03,(03000) Portal Suba - alimentacion,3303,1731,1783,6817
18576,2020-05-14,(03000) Portal Suba - alimentacion,4649,2698,2394,9741
18577,2020-01-21,(10009) Museo Nacional,1094,1618,1961,4673
18578,2020-04-26,(09107) Hortúa,192,107,86,385
18579,2020-06-19,(09107) Hortúa,635,343,356,1334
18580,2020-06-26,(09107) Hortúa,600,372,422,1394
18581,2020-08-02,(09107) Hortúa,193,124,143,460
18582,2020-08-08,(05002) Tintal,1594,817,1074,3485
18583,2020-02-23,(05103) Marsella,444,194,415,1053
18584,2020-07-26,(02300) Calle 100,225,176,191,592
18585,2020-03-10,(09001) Molinos,370,2149,1820,4339
18586,2020-04-30,(09001) Molinos,1494,807,1023,3324
18587,2020-07-06,(09001) Molinos,2645,1518,1807,5970
18588,2020-01-01,(06000) Portal Eldorado,520,329,541,1390
18589,2020-03-17,(07007) NQS - Calle 38A Sur,1183,693,675,2551
18590,2020-02-28,(05105) Pradera,2591,1563,1226,5380
18591,2020-01-26,(05100) Banderas P. Central,833,340,857,2030
18592,2020-06-13,(07104) Simon Bolivar,515,333,267,1115
18593,2020-09-27,(09104) Restrepo,544,308,579,1431
18594,2020-08-17,(05005) Transversal 86,87,38,83,208
18595,2020-10-08,(05005) Transversal 86,511,270,366,1147
18596,2020-10-07,(02202) Calle 127,1179,883,851,2913
18597,2020-05-26,(06109) Centro Memoria,270,145,153,568
18598,2020-09-08,(06109) Centro Memoria,281,162,152,595
18599,2020-10-09,(02205) Calle 106,443,299,390,1132
18600,2020-09-23,(09118) Marly,1577,1023,1003,3603
18601,2020-05-27,(07101) CASTELLANA,171,101,105,377
18602,2020-07-20,(07106) EL CAMPIN,131,100,89,320
18603,2020-06-25,(07113) SANTA ISABEL,422,245,265,932
18604,2020-08-09,(07113) SANTA ISABEL,93,59,123,275
18605,2020-10-02,(07113) SANTA ISABEL,468,281,433,1182
18606,2020-09-30,(02200) Alcalá,2220,1384,1450,5054
18607,2020-02-16,(03007) HUMEDAL CORDOBA,159,98,169,426
18608,2020-04-12,(03007) HUMEDAL CORDOBA,33,24,19,76
18609,2020-01-21,(07000) Portal Sur,5972,2940,2872,11784
18610,2020-10-12,(04100) Carrera 77,431,208,513,1152
18611,2020-04-19,(09100) Calle 40 Sur,309,185,212,706
18612,2020-08-29,(09100) Calle 40 Sur,1417,783,1044,3244
18613,2020-03-14,(07109) CAD,1194,851,1011,3056
18614,2020-10-04,(04003) Avenida Ciudad de Cali,362,173,479,1014
18615,2020-10-05,(10006) San Victorino,754,426,474,1654
18616,2020-05-19,(09109) Tercer Milenio,296,199,174,669
18617,2020-05-29,(10001) Country Sur,1035,435,610,2080
18618,2020-07-03,(09117) Calle 45,788,487,523,1798
18619,2020-01-26,(02202) Calle 127,1035,717,918,2670
18620,2020-06-20,(07101) CASTELLANA,136,85,98,319
18621,2020-05-30,(05001) Patio Bonito,1240,652,708,2600
18622,2020-05-05,(09116) Avenida 39,197,128,154,479
18623,2020-07-10,(03007) HUMEDAL CORDOBA,177,104,87,368
18624,2020-07-09,(02105) Calle 142,813,529,524,1866
18625,2020-10-09,(02105) Calle 142,1033,584,800,2417
18626,2020-01-05,(07003) SEVILLANA,280,133,283,696
18627,2020-04-26,(02105) Calle 142,146,115,74,335
18628,2020-09-15,(07009) SENA,659,414,482,1555
18629,2020-08-14,(03002) SUBA - TV- 91,641,378,404,1423
18630,2020-08-29,(03002) SUBA - TV- 91,603,322,441,1366
18631,2020-05-22,(05100) Banderas P. Central - alimentacion,2396,1143,1170,4709
18632,2020-01-25,(07201) Guatoque -Veraguas,491,266,465,1222
18633,2020-03-30,(06109) Centro Memoria,146,109,106,361
18634,2020-07-30,(02304) Heroes,789,559,440,1788
18635,2020-09-25,(02001) Centro Comercial Santa Fe,610,361,532,1503
18636,2020-09-17,(10008) San Diego,330,179,206,715
18637,2020-07-27,(03011) SUBA - CALLE 100,502,223,230,955
18638,2020-02-23,(02303) Calle 85,443,374,596,1413
18639,2020-07-15,(07111) NQS - RICAURTE,778,523,366,1667
18640,2020-07-24,(03006) NIZA - CALLE 127,445,239,199,883
18641,2020-02-13,(03004) GRATAMIRA,339,184,134,657
18642,2020-04-22,(07000) Portal Sur,970,632,532,2134
18643,2020-03-09,(06105) Quinta Paredes,244,137,116,497
18644,2020-04-25,(09106) Nariño,182,98,119,399
18645,2020-06-23,(07200) Tygua-San José,244,138,165,547
18646,2020-03-13,(09122) Calle 72,2522,409,884,3815
18647,2020-09-28,(07103) AV. CHILE,990,620,676,2286
18648,2020-02-08,(50003) Corral Molinos,2651,1514,2804,6969
18649,2020-06-19,(02302) Virrey,723,479,369,1571
18650,2020-09-13,(09123) Calle 76,237,179,260,676
18651,2020-09-26,(07105) MOVISTAR ARENA,192,121,184,497
18652,2020-02-29,(07506) DESPENSA,985,565,788,2338
18653,2020-05-27,(04003) Avenida Ciudad de Cali,882,530,559,1971
18654,2020-06-01,(10007) Las Nieves,556,327,310,1193
18655,2020-09-18,(03011) SUBA - CALLE 100,638,303,375,1316
18656,2020-09-23,(40001) Juan Pablo II,631,371,435,1437
18657,2020-02-02,(03011) SUBA - CALLE 100,402,243,517,1162
18658,2020-03-24,(07007) NQS - Calle 38A Sur,304,197,197,698
18659,2020-08-30,(07007) NQS - Calle 38A Sur,197,122,128,447
18660,2020-05-06,(08002) Biblioteca,177,114,98,389
18661,2020-02-13,(50002) Corral Calle 40 Sur,127,98,162,387
18662,2020-02-25,(12000) Puente Aranda,315,174,184,673
18663,2020-07-01,(12000) Puente Aranda,93,51,55,199
18664,2020-04-23,(03005) SUBA - AV. BOYACA,206,136,129,471
18665,2020-04-16,(02102) Calle 161,89,62,55,206
18666,2020-05-19,(09111) Calle 19,600,383,369,1352
18667,2020-09-07,(06000) Portal Eldorado,955,614,559,2128
18668,2020-04-03,(10009) Museo Nacional,288,202,197,687
18669,2020-03-23,(02300) Calle 100,295,282,223,800
18670,2020-02-14,(07200) Tygua-San José,791,519,588,1898
18671,2020-04-04,(05001) Patio Bonito,639,327,343,1309
18672,2020-06-21,(04108) El Polo,90,61,82,233
18673,2020-07-24,(07006) General Santander,444,277,193,914
18674,2020-05-13,(04001) Quirigua,310,202,158,670
18675,2020-04-30,(10009) Museo Nacional,300,229,172,701
18676,2020-03-27,(09113) Calle 22,164,109,144,417
18677,2020-06-18,(04000) Cabecera Calle 80 - intermunicipal,289,177,286,752
18678,2020-07-01,(06002) Normandía,346,182,198,726
18679,2020-02-07,(09108) Hospital,255,142,202,599
18680,2020-03-20,(02105) Calle 142,389,286,191,866
18681,2020-03-21,(04000) Cabecera Calle 80,308,197,214,719
18682,2020-04-21,(09122) Calle 72,614,454,376,1444
18683,2020-04-22,(03006) NIZA - CALLE 127,243,155,119,517
18684,2020-08-13,(02102) Calle 161,227,134,147,508
18685,2020-02-05,(03004) GRATAMIRA,328,181,157,666
18686,2020-03-20,(07112) COMUNEROS,394,246,182,822
18687,2020-07-25,(07112) COMUNEROS,512,292,298,1102
18688,2020-05-05,(06105) Quinta Paredes,74,55,39,168
18689,2020-05-19,(06105) Quinta Paredes,109,70,53,232
18690,2020-08-17,(07005) ALQUERIA,145,83,129,357
18691,2020-06-10,(04106) Carrera 47,318,165,171,654
18692,2020-05-21,(05105) Pradera,482,314,180,976
18693,2020-05-25,(02001) Centro Comercial Santa Fe,104,71,93,268
18694,2020-05-09,(09108) Hospital,48,27,44,119
18695,2020-05-24,(07006) General Santander - alimentacion,63,50,58,171
18696,2020-03-24,(06001) Modelia,456,338,268,1062
18697,2020-04-17,(04003) Avenida Ciudad de Cali,560,312,368,1240
18698,2020-04-06,(04101) Minuto de Dios,163,95,122,380
18699,2020-06-28,(02303) Calle 85,190,124,138,452
18700,2020-09-27,(02303) Calle 85,184,155,201,540
18701,2020-06-09,(09113) Calle 22,399,255,378,1032
18702,2020-07-15,(07506) DESPENSA,482,253,233,968
18703,2020-06-13,(08002) Biblioteca,228,113,154,495
18704,2020-09-27,(10004) Policarpa,112,47,94,253
18705,2020-06-03,(04103) Las Ferias,337,178,150,665
18706,2020-08-18,(04000) Cabecera Calle 80 - intermunicipal,343,169,285,797
18707,2020-02-13,(03014) SAN MARTIN,262,152,172,586
18708,2020-07-22,(06103) CAN,327,203,140,670
18709,2020-08-15,(02103) Mazurén,127,80,140,347
18710,2020-08-12,(04102) Avenida Boyaca,268,166,185,619
18711,2020-05-10,(04002) Carrera 90,122,80,62,264
18712,2020-04-15,(14004) Museo del Oro,0,39,88,127
18713,2020-04-16,(07104) Simon Bolivar,208,149,117,474
18714,2020-05-07,(06106) Recinto Ferial,173,101,75,349
18715,2020-05-28,(06106) Recinto Ferial,216,137,100,453
18716,2020-09-24,(09105) Río Fucha,0,86,183,269
18717,2020-04-05,(07105) MOVISTAR ARENA,31,24,33,88
18718,2020-04-25,(06107) Ciudad Universitaria,80,42,49,171
18719,2020-07-01,(06107) Ciudad Universitaria,190,115,118,423
18720,2020-09-16,(04101) Minuto de Dios,356,212,328,896
18721,2020-08-09,(06108) Concejo de Bogotá,43,14,30,87
18722,2020-08-26,(06105) Quinta Paredes,127,77,70,274
18723,2020-08-05,(06100) Av. Rojas,193,126,137,456
18724,2020-03-23,(09003) Socorro,131,67,63,261
18725,2020-02-16,(50002) Corral Calle 40 Sur,14,11,30,55
18726,2020-10-11,(12002) CDS - Carrera 32,33,32,29,94
18727,2020-04-02,(09101) Quiroga,169,109,154,432
18728,2020-04-19,(07106) EL CAMPIN,60,61,36,157
18729,2020-05-17,(07101) CASTELLANA,24,21,31,76
18730,2020-07-26,(09108) Hospital,27,12,14,53
18731,2020-01-05,(12000) Puente Aranda,17,24,38,79
18732,2020-04-17,(50002) Corral Calle 40 Sur,9,7,11,27
18733,2020-04-20,(50006) Corral Carrera 77,5,1,2,8
18734,2020-05-09,(50006) Corral Carrera 77,3,1,8,12
18735,2020-08-25,(04000) Cabecera Calle 80 - alimentacion,3791,2128,2566,8485
18736,2020-10-06,(09118) Marly,1559,1022,1142,3723
18737,2020-02-12,(07504) TERREROS,18271,11030,9123,38424
18738,2020-02-25,(10000) Portal 20 de Julio - alimentacion,11277,5845,7460,24582
18739,2020-08-10,(09119) Calle 57,536,347,369,1252
18740,2020-01-11,(07111) NQS - RICAURTE,1634,1175,1107,3916
18741,2020-01-14,(02303) Calle 85,3283,2236,1736,7255
18742,2020-01-09,(02200) Alcalá,9057,5567,4922,19546
18743,2020-01-22,(05000) Portal Américas,13175,7903,7454,28532
18744,2020-02-03,(07003) SEVILLANA,2091,1191,1181,4463
18745,2020-01-23,(07111) NQS - RICAURTE,3029,1949,1688,6666
18746,2020-09-03,(07503) SAN MATEO,12398,6954,6196,25548
18747,2020-01-28,(06107) Ciudad Universitaria,1602,913,923,3438
18748,2020-03-03,(05001) Patio Bonito,7190,3992,3655,14837
18749,2020-02-07,(07000) Portal Sur - alimentacion,29552,16613,14940,61105
18750,2020-02-02,(07002) MADELENA,970,357,881,2208
18751,2020-01-10,(05100) Banderas P. Central,5207,2740,2962,10909
18752,2020-06-20,(10001) Country Sur,939,458,664,2061
18753,2020-08-25,(09000) Cabecera Usme,1671,1016,1204,3891
18754,2020-02-11,(05100) Banderas P. Central - alimentacion,16337,9815,9159,35311
18755,2020-03-06,(07009) SENA,3643,2066,2193,7902
18756,2020-04-21,(06000) Portal Eldorado - alimentacion,2373,1229,1012,4614
18757,2020-01-10,(06102) Salitre El Greco,1069,652,579,2300
18758,2020-03-11,(05100) Banderas P. Central,7712,4342,3663,15717
18759,2020-02-07,(09109) Tercer Milenio,1446,874,936,3256
18760,2020-01-19,(07504) TERREROS,4562,1871,3585,10018
18761,2020-02-10,(06002) Normandía,2685,1608,1301,5594
18762,2020-02-15,(05002) Tintal,7297,3351,4780,15428
18763,2020-09-26,(05001) Patio Bonito,1972,878,1268,4118
18764,2020-01-31,(06106) Recinto Ferial,1474,820,855,3149
18765,2020-02-22,(03013) RIO NEGRO,712,430,664,1806
18766,2020-01-05,(02304) Heroes,491,386,549,1426
18767,2020-03-04,(50003) Corral Molinos,3474,2263,3475,9212
18768,2020-03-10,(07106) EL CAMPIN,954,230,289,1473
18769,2020-09-15,(07000) Portal Sur - alimentacion,8698,4714,4908,18320
18770,2020-08-27,(09103) Olaya,1050,563,606,2219
18771,2020-05-04,(14001) La Sabana,99,75,64,238
18772,2020-09-07,(07002) MADELENA,842,533,573,1948
18773,2020-09-08,(08000) Portal Tunal - alimentacion,6501,3530,4029,14060
18774,2020-05-01,(02000) Cabecera Autopista Norte,346,247,195,788
18775,2020-07-23,(09113) Calle 22,304,166,274,744
18776,2020-08-25,(09004) Santa Lucía,2368,1201,1294,4863
18777,2020-01-29,(06105) Quinta Paredes,1045,626,515,2186
18778,2020-02-22,(03002) SUBA - TV- 91,2420,1143,1715,5278
18779,2020-03-10,(04106) Carrera 47,390,240,232,862
18780,2020-09-13,(09114) Calle 26,55,44,111,210
18781,2020-09-19,(02201) Prado,787,468,640,1895
18782,2020-02-11,(10001) Country Sur,5420,2476,2732,10628
18783,2020-06-11,(04002) Carrera 90,684,379,338,1401
18784,2020-01-25,(10001) Country Sur,2746,1132,2001,5879
18785,2020-05-22,(40003) Mirador del Paraiso,1493,978,844,3315
18786,2020-06-16,(40003) Mirador del Paraiso,1807,1111,1044,3962
18787,2020-02-20,(09107) Hortúa,2365,1428,1375,5168
18788,2020-06-06,(09107) Hortúa,429,234,275,938
18789,2020-03-05,(14004) Museo del Oro,4064,2534,2077,8675
18790,2020-08-04,(06105) Quinta Paredes,133,85,75,293
18791,2020-10-02,(02304) Heroes,989,716,719,2424
18792,2020-06-15,(09101) Quiroga,197,97,143,437
18793,2020-03-06,(06111) Universidades,5201,3425,2804,11430
18794,2020-07-08,(02201) Prado,936,620,580,2136
18795,2020-03-05,(07004) VENECIA,4541,2515,2522,9578
18796,2020-01-10,(09107) Hortúa,1685,1032,1239,3956
18797,2020-06-23,(09116) Avenida 39,390,236,209,835
18798,2020-01-30,(07008) NQS - Calle 30 Sur,1890,1004,1076,3970
18799,2020-03-05,(09003) Socorro,1654,962,1082,3698
18800,2020-09-04,(09120) Calle 63,1300,862,888,3050
18801,2020-08-24,(09123) Calle 76,798,603,469,1870
18802,2020-01-13,(02103) Mazurén,2603,1653,1531,5787
18803,2020-01-11,(03011) SUBA - CALLE 100,947,540,858,2345
18804,2020-03-15,(02300) Calle 100,662,556,849,2067
18805,2020-04-29,(02300) Calle 100,844,581,399,1824
18806,2020-01-15,(03012) SUBA - CALLE 95,1236,813,912,2961
18807,2020-01-17,(10010) San Bernardo,1481,925,1242,3648
18808,2020-01-26,(14005) Las Aguas,304,203,581,1088
18809,2020-03-15,(05005) Transversal 86,367,138,255,760
18810,2020-03-22,(05005) Transversal 86,90,43,27,160
18811,2020-06-06,(02202) Calle 127,858,571,450,1879
18812,2020-08-20,(02205) Calle 106,317,223,203,743
18813,2020-09-03,(02205) Calle 106,426,284,245,955
18814,2020-08-21,(09101) Quiroga,468,281,323,1072
18815,2020-02-11,(07201) Guatoque -Veraguas,1142,588,643,2373
18816,2020-03-19,(06106) Recinto Ferial,733,392,371,1496
18817,2020-08-17,(07113) SANTA ISABEL,104,64,104,272
18818,2020-03-15,(06111) Universidades,373,231,553,1157
18819,2020-07-14,(04104) Avenida 68,580,272,245,1097
18820,2020-03-10,(02204) Pepe Sierra,1862,494,565,2921
18821,2020-04-30,(02101) Toberín,771,532,522,1825
18822,2020-06-10,(05100) Banderas P. Central,536,295,421,1252
18823,2020-08-30,(05100) Banderas P. Central - alimentacion,985,408,713,2106
18824,2020-05-03,(02304) Heroes,162,110,104,376
18825,2020-05-17,(09100) Calle 40 Sur,416,230,259,905
18826,2020-01-20,(07104) Simon Bolivar,2109,1326,1270,4705
18827,2020-09-16,(07104) Simon Bolivar,654,390,330,1374
18828,2020-01-07,(09109) Tercer Milenio,943,572,686,2201
18829,2020-06-08,(09109) Tercer Milenio,339,196,223,758
18830,2020-02-15,(07103) AV. CHILE,2090,1474,1546,5110
18831,2020-02-17,(07104) Simon Bolivar,2413,1501,1231,5145
18832,2020-02-22,(07004) VENECIA,2950,1463,1862,6275
18833,2020-07-05,(07000) Portal Sur,440,258,353,1051
18834,2020-04-28,(06101) El Tiempo,218,140,104,462
18835,2020-10-05,(06101) El Tiempo,371,266,265,902
18836,2020-07-18,(09117) Calle 45,431,260,285,976
18837,2020-10-08,(02104) Calle 146,1029,628,918,2575
18838,2020-09-04,(03002) SUBA - TV- 91,877,499,570,1946
18839,2020-02-12,(07003) SEVILLANA,2235,1237,1137,4609
18840,2020-04-06,(02103) Mazurén,84,66,67,217
18841,2020-06-07,(05002) Tintal,499,242,347,1088
18842,2020-08-26,(07101) CASTELLANA,213,129,141,483
18843,2020-08-01,(05001) Patio Bonito,1252,651,749,2652
18844,2020-08-19,(07109) CAD,618,378,276,1272
18845,2020-03-09,(02202) Calle 127,1884,690,634,3208
18846,2020-09-28,(40001) Juan Pablo II,632,338,493,1463
18847,2020-04-02,(02000) Cabecera Autopista Norte,487,341,355,1183
18848,2020-05-09,(07009) SENA,326,196,224,746
18849,2020-02-23,(07008) NQS - Calle 30 Sur,456,175,424,1055
18850,2020-06-14,(08000) Portal Tunal - alimentacion,1896,921,1161,3978
18851,2020-05-07,(02105) Calle 142,540,336,309,1185
18852,2020-01-12,(05102) Av. Américas - Av. Boyacá,227,113,239,579
18853,2020-07-11,(03002) SUBA - TV- 91,633,326,433,1392
18854,2020-06-19,(07007) NQS - Calle 38A Sur,425,251,308,984
18855,2020-04-08,(10010) San Bernardo,322,223,285,830
18856,2020-02-21,(40002) Manitas,1312,693,795,2800
18857,2020-03-14,(06109) Centro Memoria,496,319,467,1282
18858,2020-09-17,(09106) Nariño,493,283,383,1159
18859,2020-01-14,(05105) Pradera,2049,1237,1067,4353
18860,2020-03-29,(05100) Banderas P. Central - alimentacion,493,222,214,929
18861,2020-05-26,(05100) Banderas P. Central,609,330,419,1358
18862,2020-05-18,(10008) San Diego,228,139,139,506
18863,2020-07-22,(03011) SUBA - CALLE 100,510,225,215,950
18864,2020-05-23,(09115) Calle 34,328,232,270,830
18865,2020-02-16,(09115) Calle 34,553,375,774,1702
18866,2020-02-19,(07107) U. NACIONAL,2142,1358,1246,4746
18867,2020-01-06,(07001) PERDOMO,763,352,635,1750
18868,2020-07-03,(07110) PALOQUEMAO,724,423,295,1442
18869,2020-09-26,(04000) Cabecera Calle 80,1001,495,1019,2515
18870,2020-01-02,(09106) Nariño,849,503,697,2049
18871,2020-04-17,(06109) Centro Memoria,170,114,91,375
18872,2020-03-20,(06102) Salitre El Greco,206,108,70,384
18873,2020-05-18,(02302) Virrey,499,335,279,1113
18874,2020-01-02,(07107) U. NACIONAL,469,387,526,1382
18875,2020-03-18,(07107) U. NACIONAL,816,570,476,1862
18876,2020-06-11,(07107) U. NACIONAL,327,199,157,683
18877,2020-02-18,(07506) DESPENSA,1692,977,909,3578
18878,2020-06-09,(04003) Avenida Ciudad de Cali,962,559,655,2176
18879,2020-09-10,(07105) MOVISTAR ARENA,236,113,176,525
18880,2020-04-30,(02104) Calle 146,460,324,275,1059
18881,2020-10-06,(04103) Las Ferias,411,238,296,945
18882,2020-05-24,(04104) Avenida 68,174,79,94,347
18883,2020-07-09,(03009) Av. Suba- Calle 116,495,332,258,1085
18884,2020-05-10,(40002) Manitas,92,54,61,207
18885,2020-06-23,(08002) Biblioteca,310,175,204,689
18886,2020-05-24,(09000) Cabecera Usme,370,212,270,852
18887,2020-05-14,(05102) Av. Américas - Av. Boyacá,163,73,104,340
18888,2020-05-12,(07506) DESPENSA,352,196,194,742
18889,2020-06-15,(07506) DESPENSA,165,82,110,357
18890,2020-10-03,(08001) Parque el Tunal,423,176,377,976
18891,2020-09-18,(07200) Tygua-San José,256,156,195,607
18892,2020-02-09,(14004) Museo del Oro,0,153,453,606
18893,2020-03-29,(14004) Museo del Oro,0,12,24,36
18894,2020-04-13,(03012) SUBA - CALLE 95,180,127,99,406
18895,2020-07-17,(10010) San Bernardo,507,276,318,1101
18896,2020-05-10,(06108) Concejo de Bogotá,38,24,31,93
18897,2020-04-29,(05100) Banderas P. Central,408,246,265,919
18898,2020-01-28,(12002) CDS - Carrera 32,594,388,320,1302
18899,2020-06-06,(12002) CDS - Carrera 32,139,88,55,282
18900,2020-04-05,(09100) Calle 40 Sur,303,175,219,697
18901,2020-05-20,(04102) Avenida Boyaca,246,157,153,556
18902,2020-01-26,(03005) SUBA - AV. BOYACA,419,220,577,1216
18903,2020-09-11,(09108) Hospital,66,33,56,155
18904,2020-05-17,(04000) Cabecera Calle 80,176,114,163,453
18905,2020-05-16,(09117) Calle 45,447,269,277,993
18906,2020-08-11,(06103) CAN,343,220,171,734
18907,2020-04-29,(02502) Terminal,205,147,177,529
18908,2020-06-09,(07006) General Santander,490,301,243,1034
18909,2020-03-29,(02304) Heroes,191,147,91,429
18910,2020-08-23,(09120) Calle 63,287,179,283,749
18911,2020-05-15,(07200) Tygua-San José,179,85,120,384
18912,2020-07-15,(07200) Tygua-San José,153,77,105,335
18913,2020-03-26,(03012) SUBA - CALLE 95,157,128,98,383
18914,2020-05-26,(06105) Quinta Paredes,120,80,60,260
18915,2020-05-26,(05101) Mandalay - Cr.73,109,52,49,210
18916,2020-04-17,(07506) DESPENSA,244,142,142,528
18917,2020-06-01,(06102) Salitre El Greco,191,112,110,413
18918,2020-03-31,(07006) General Santander - alimentacion,161,100,122,383
18919,2020-08-02,(12007) Zona Industrial,23,24,42,89
18920,2020-07-04,(12004) Carrera 22,208,117,154,479
18921,2020-06-10,(03004) GRATAMIRA,31,20,14,65
18922,2020-04-07,(07004) VENECIA,454,281,247,982
18923,2020-05-11,(07113) SANTA ISABEL,262,189,186,637
18924,2020-09-19,(05102) Av. Américas - Av. Boyacá,218,121,185,524
18925,2020-09-29,(10003) Ciudad Jardín,246,129,229,604
18926,2020-06-28,(09109) Tercer Milenio,101,47,120,268
18927,2020-06-29,(09116) Avenida 39,91,68,92,251
18928,2020-10-11,(04104) Avenida 68,215,133,247,595
18929,2020-09-16,(03004) GRATAMIRA,0,26,43,69
18930,2020-07-12,(07109) CAD,187,133,136,456
18931,2020-08-30,(04105) Carrera 53,95,54,90,239
18932,2020-04-16,(07006) General Santander - alimentacion,174,125,102,401
18933,2020-08-22,(14005) Las Aguas,127,86,153,366
18934,2020-04-19,(06001) Modelia,68,44,50,162
18935,2020-05-31,(06001) Modelia,86,52,73,211
18936,2020-05-02,(07200) Tygua-San José,95,58,70,223
18937,2020-04-12,(02103) Mazurén,36,14,33,83
18938,2020-01-01,(10005) Bicentenario,36,22,77,135
18939,2020-03-22,(02204) Pepe Sierra,181,142,142,465
18940,2020-07-19,(07106) EL CAMPIN,106,68,61,235
18941,2020-02-23,(50002) Corral Calle 40 Sur,11,13,30,54
18942,2020-04-11,(07003) SEVILLANA,106,64,61,231
18943,2020-08-09,(14004) Museo del Oro,27,17,59,103
18944,2020-01-13,(50006) Corral Carrera 77,25,15,50,90
18945,2020-03-16,(50006) Corral Carrera 77,18,12,29,59
18946,2020-04-05,(14004) Museo del Oro,0,16,26,42
18947,2020-04-13,(03014) SAN MARTIN,14,5,21,40
18948,2020-09-23,(50006) Corral Carrera 77,2,4,8,14
18949,2020-04-12,(10006) San Victorino,49,46,31,126
18950,2020-06-24,(50002) Corral Calle 40 Sur,17,11,28,56
18951,2020-03-20,(03014) SAN MARTIN,26,15,19,60
18952,2020-04-30,(50006) Corral Carrera 77,4,4,7,15
18953,2020-09-20,(03014) SAN MARTIN,0,1,13,14
18954,2020-08-30,(04000) Cabecera Calle 80 - alimentacion,1260,595,1255,3110
18955,2020-08-31,(04000) Cabecera Calle 80 - alimentacion,3910,2309,2879,9098
18956,2020-08-29,(09118) Marly,1037,689,732,2458
18957,2020-05-09,(07504) TERREROS,2543,1461,1333,5337
18958,2020-01-10,(05000) Portal Américas - alimentacion,28849,15419,17279,61547
18959,2020-03-09,(03002) SUBA - TV- 91,262,1282,809,2353
18960,2020-03-11,(03002) SUBA - TV- 91,4379,2495,2226,9100
18961,2020-02-12,(09100) Calle 40 Sur,7908,4577,4289,16774
18962,2020-03-10,(09100) Calle 40 Sur,447,1950,1372,3769
18963,2020-02-18,(08001) Parque el Tunal,1721,1017,988,3726
18964,2020-06-11,(10000) Portal 20 de Julio - alimentacion,4081,1876,2265,8222
18965,2020-06-09,(04101) Minuto de Dios,313,162,201,676
18966,2020-03-24,(07503) SAN MATEO,9584,4778,4967,19329
18967,2020-07-28,(07503) SAN MATEO,10513,6270,5006,21789
18968,2020-03-13,(05000) Portal Américas - alimentacion,937,6899,5166,13002
18969,2020-03-20,(04000) Cabecera Calle 80 - alimentacion,1892,1085,940,3917
18970,2020-02-15,(06107) Ciudad Universitaria,687,440,762,1889
18971,2020-08-11,(09001) Molinos,2374,1293,1648,5315
18972,2020-09-18,(09001) Molinos,2984,1505,2195,6684
18973,2020-02-17,(14004) Museo del Oro,4411,2574,1898,8883
18974,2020-02-16,(07002) MADELENA,927,380,844,2151
18975,2020-03-08,(03002) SUBA - TV- 91,747,369,792,1908
18976,2020-01-08,(06000) Portal Eldorado - alimentacion,12257,6289,7327,25873
18977,2020-07-07,(05100) Banderas P. Central,877,500,591,1968
18978,2020-08-31,(05100) Banderas P. Central,837,477,574,1888
18979,2020-09-15,(05100) Banderas P. Central,972,590,688,2250
18980,2020-05-24,(10001) Country Sur,240,93,175,508
18981,2020-02-21,(02102) Calle 161,1877,1001,1076,3954
18982,2020-01-18,(09000) Cabecera Usme,3613,1839,3026,8478
18983,2020-04-16,(06000) Portal Eldorado - alimentacion,2263,1146,997,4406
18984,2020-01-07,(06102) Salitre El Greco,1027,585,539,2151
18985,2020-02-25,(06102) Salitre El Greco,1577,851,656,3084
18986,2020-02-22,(07002) MADELENA,2733,1157,1893,5783
18987,2020-03-18,(02205) Calle 106,1089,779,621,2489
18988,2020-02-01,(10005) Bicentenario - alimentacion,420,202,455,1077
18989,2020-05-26,(07001) PERDOMO,806,437,501,1744
18990,2020-01-14,(02000) Cabecera Autopista Norte,8464,5190,5182,18836
18991,2020-09-11,(03000) Portal Suba - alimentacion,6548,3558,3953,14059
18992,2020-01-14,(02204) Pepe Sierra,4209,2709,2201,9119
18993,2020-09-24,(07000) Portal Sur - alimentacion,9204,4777,5168,19149
18994,2020-01-09,(09004) Santa Lucía,5599,2968,3594,12161
18995,2020-06-09,(09101) Quiroga,531,270,337,1138
18996,2020-07-02,(04100) Carrera 77,1320,762,899,2981
18997,2020-09-25,(07102) NQS - CALLE 75,467,325,309,1101
18998,2020-05-02,(03013) RIO NEGRO,109,71,80,260
18999,2020-06-12,(03013) RIO NEGRO,277,170,167,614
19000,2020-02-16,(09000) Cabecera Usme - alimentacion,6021,2716,5221,13958
19001,2020-08-04,(09000) Cabecera Usme - alimentacion,7930,4169,4547,16646
19002,2020-06-08,(09118) Marly,1393,953,718,3064
19003,2020-06-16,(09118) Marly,1447,993,782,3222
19004,2020-09-21,(06000) Portal Eldorado - alimentacion,3316,1473,2034,6823
19005,2020-09-23,(06000) Portal Eldorado - alimentacion,4531,2238,2696,9465
19006,2020-03-08,(03000) Portal Suba - alimentacion,5876,2695,5385,13956
19007,2020-05-05,(09103) Olaya,684,366,381,1431
19008,2020-07-28,(07111) NQS - RICAURTE,950,602,422,1974
19009,2020-05-20,(07002) MADELENA,595,361,303,1259
19010,2020-03-19,(07002) MADELENA,2167,1158,1174,4499
19011,2020-01-15,(07112) COMUNEROS,3212,1916,2124,7252
19012,2020-01-23,(07112) COMUNEROS,3574,2107,2265,7946
19013,2020-05-09,(02000) Cabecera Autopista Norte,576,368,390,1334
19014,2020-08-29,(04102) Avenida Boyaca,320,185,197,702
19015,2020-02-06,(07107) U. NACIONAL,1553,1704,2145,5402
19016,2020-01-04,(09113) Calle 22,635,433,590,1658
19017,2020-04-01,(04105) Carrera 53,168,116,81,365
19018,2020-04-23,(04105) Carrera 53,177,117,99,393
19019,2020-02-01,(09004) Santa Lucía,5203,2435,3567,11205
19020,2020-10-09,(09004) Santa Lucía,2963,1369,1998,6330
19021,2020-03-01,(09001) Molinos,1967,842,1962,4771
19022,2020-07-21,(07010) Bosa,687,342,364,1393
19023,2020-01-20,(05002) Tintal,10190,5808,5810,21808
19024,2020-09-03,(07506) DESPENSA,444,282,308,1034
19025,2020-08-03,(04100) Carrera 77,943,564,682,2189
19026,2020-08-15,(09111) Calle 19,616,397,495,1508
19027,2020-05-19,(06000) Portal Eldorado,1024,655,376,2055
19028,2020-10-12,(08000) Portal Tunal - alimentacion,2303,1038,1903,5244
19029,2020-06-21,(40003) Mirador del Paraiso,561,337,409,1307
19030,2020-07-15,(03000) Portal Suba - alimentacion,5535,3236,3016,11787
19031,2020-02-24,(12001) Carrera 43,1738,1012,1043,3793
19032,2020-03-19,(12001) Carrera 43,968,510,578,2056
19033,2020-10-03,(12001) Carrera 43,337,198,321,856
19034,2020-05-10,(07000) Portal Sur - alimentacion,1765,926,774,3465
19035,2020-01-18,(04104) Avenida 68,1575,895,1324,3794
19036,2020-03-05,(07113) SANTA ISABEL,2095,1234,1465,4794
19037,2020-01-28,(09107) Hortúa,2323,1419,1522,5264
19038,2020-02-05,(09107) Hortúa,2598,1552,1520,5670
19039,2020-02-03,(02205) Calle 106,2764,1749,1337,5850
19040,2020-01-22,(02302) Virrey,3688,2359,1791,7838
19041,2020-03-04,(07106) EL CAMPIN,2089,1351,1183,4623
19042,2020-09-22,(09000) Cabecera Usme - alimentacion,9429,4865,5909,20203
19043,2020-05-12,(10000) Portal 20 de Julio - alimentacion,3237,1544,1953,6734
19044,2020-08-15,(02303) Calle 85,441,320,325,1086
19045,2020-02-16,(07000) Portal Sur,1452,699,1392,3543
19046,2020-05-18,(09116) Avenida 39,285,197,166,648
19047,2020-01-26,(09004) Santa Lucía,2142,867,1671,4680
19048,2020-05-06,(09004) Santa Lucía,1470,769,821,3060
19049,2020-10-07,(09004) Santa Lucía,2831,1394,1911,6136
19050,2020-04-27,(08001) Parque el Tunal,196,22,26,244
19051,2020-03-10,(06108) Concejo de Bogotá,356,67,122,545
19052,2020-04-20,(07001) PERDOMO,414,274,256,944
19053,2020-04-07,(03003) 21 ANGELES,154,71,78,303
19054,2020-02-13,(02202) Calle 127,6026,3928,2988,12942
19055,2020-08-02,(02201) Prado,187,134,161,482
19056,2020-08-16,(02000) Cabecera Autopista Norte - alimentacion,1477,671,1057,3205
19057,2020-07-12,(06002) Normandía,76,65,82,223
19058,2020-01-20,(10007) Las Nieves,1907,1181,1101,4189
19059,2020-03-09,(06108) Concejo de Bogotá,271,70,97,438
19060,2020-07-10,(09107) Hortúa,632,376,389,1397
19061,2020-01-10,(05101) Mandalay - Cr.73,747,362,380,1489
19062,2020-08-23,(05002) Tintal,506,277,392,1175
19063,2020-07-07,(03012) SUBA - CALLE 95,341,216,208,765
19064,2020-03-12,(10000) Portal 20 de Julio,262,1693,1172,3127
19065,2020-09-19,(10000) Portal 20 de Julio,1974,952,1542,4468
19066,2020-06-25,(02101) Toberín,1628,991,975,3594
19067,2020-02-12,(05107) Américas - Cr.53,2800,1564,1397,5761
19068,2020-04-22,(05005) Transversal 86,215,103,93,411
19069,2020-05-02,(05005) Transversal 86,180,76,92,348
19070,2020-08-15,(05105) Pradera,450,305,277,1032
19071,2020-05-29,(07007) NQS - Calle 38A Sur,315,193,209,717
19072,2020-02-06,(09121) Las Flores,3286,2182,2013,7481
19073,2020-01-27,(09106) Nariño,1970,1144,1324,4438
19074,2020-08-13,(08000) Portal Tunal,768,239,311,1318
19075,2020-03-22,(10002) Av. Primero de Mayo,423,204,222,849
19076,2020-06-11,(04108) El Polo,484,300,233,1017
19077,2020-01-19,(07000) Portal Sur,1469,639,1559,3667
19078,2020-08-25,(07000) Portal Sur,1827,1145,1197,4169
19079,2020-01-29,(10009) Museo Nacional,4206,2253,1874,8333
19080,2020-03-17,(07201) Guatoque -Veraguas,596,339,417,1352
19081,2020-01-06,(07101) CASTELLANA,49,58,124,231
19082,2020-02-25,(07001) PERDOMO,4721,2857,2612,10190
19083,2020-06-13,(07106) EL CAMPIN,281,193,163,637
19084,2020-03-12,(07103) AV. CHILE,1234,249,385,1868
19085,2020-09-06,(07113) SANTA ISABEL,128,77,175,380
19086,2020-06-05,(04104) Avenida 68,620,303,327,1250
19087,2020-07-26,(10000) Portal 20 de Julio,575,268,394,1237
19088,2020-07-06,(08002) Biblioteca,302,186,213,701
19089,2020-05-02,(09000) Cabecera Usme,688,420,480,1588
19090,2020-01-08,(10010) San Bernardo,1270,749,1105,3124
19091,2020-01-11,(04107) Escuela Militar,248,209,267,724
19092,2020-09-05,(04003) Avenida Ciudad de Cali,884,404,859,2147
19093,2020-05-27,(09001) Molinos,2146,1205,1427,4778
19094,2020-08-17,(03000) Portal Suba - alimentacion,1943,1049,1343,4335
19095,2020-06-30,(05001) Patio Bonito,0,878,2126,3004
19096,2020-07-13,(09117) Calle 45,619,358,357,1334
19097,2020-04-10,(03011) SUBA - CALLE 100,102,73,59,234
19098,2020-09-02,(09121) Las Flores,751,464,484,1699
19099,2020-03-30,(05002) Tintal,1113,601,605,2319
19100,2020-08-05,(08000) Portal Tunal,718,276,227,1221
19101,2020-05-31,(02000) Cabecera Autopista Norte,336,223,243,802
19102,2020-07-29,(02302) Virrey,633,415,309,1357
19103,2020-03-17,(09122) Calle 72,3834,2616,2355,8805
19104,2020-03-31,(02302) Virrey,319,224,187,730
19105,2020-01-11,(03003) 21 ANGELES,699,294,494,1487
19106,2020-09-01,(09109) Tercer Milenio,352,205,252,809
19107,2020-07-29,(07009) SENA,523,327,354,1204
19108,2020-09-17,(03006) NIZA - CALLE 127,578,332,273,1183
19109,2020-01-15,(10005) Bicentenario,656,334,313,1303
19110,2020-09-24,(03002) SUBA - TV- 91,904,546,644,2094
19111,2020-08-12,(07007) NQS - Calle 38A Sur,365,244,209,818
19112,2020-04-24,(05107) Américas - Cr.53,326,203,167,696
19113,2020-06-20,(07103) AV. CHILE,649,428,416,1493
19114,2020-10-04,(07103) AV. CHILE,222,152,281,655
19115,2020-04-28,(06102) Salitre El Greco,142,75,81,298
19116,2020-09-26,(10005) Bicentenario,69,63,106,238
19117,2020-03-09,(40002) Manitas,66,322,211,599
19118,2020-01-18,(07006) General Santander - alimentacion,841,487,709,2037
19119,2020-06-23,(02104) Calle 146,786,535,504,1825
19120,2020-07-23,(02104) Calle 146,589,399,430,1418
19121,2020-08-16,(07112) COMUNEROS,222,134,166,522
19122,2020-01-06,(10005) Bicentenario - alimentacion,122,54,165,341
19123,2020-09-26,(10005) Bicentenario - alimentacion,172,79,201,452
19124,2020-04-26,(09120) Calle 63,211,155,124,490
19125,2020-08-07,(05105) Pradera,221,149,123,493
19126,2020-08-06,(06111) Universidades,323,175,296,794
19127,2020-07-07,(03006) NIZA - CALLE 127,543,287,268,1098
19128,2020-09-03,(07110) PALOQUEMAO,710,417,336,1463
19129,2020-08-20,(02105) Calle 142,656,423,456,1535
19130,2020-06-11,(07201) Guatoque -Veraguas,176,95,127,398
19131,2020-07-14,(06109) Centro Memoria,201,100,110,411
19132,2020-07-29,(07001) PERDOMO,814,499,551,1864
19133,2020-10-03,(07000) Portal Sur,1810,851,1636,4297
19134,2020-08-10,(06104) Gobernación,256,142,101,499
19135,2020-08-02,(07105) MOVISTAR ARENA,54,33,45,132
19136,2020-04-20,(09121) Las Flores,403,289,252,944
19137,2020-07-12,(02200) Alcalá,567,434,426,1427
19138,2020-06-02,(07107) U. NACIONAL,283,184,121,588
19139,2020-08-24,(04102) Avenida Boyaca,332,186,188,706
19140,2020-07-26,(03003) 21 ANGELES,72,30,41,143
19141,2020-04-18,(07113) SANTA ISABEL,130,92,95,317
19142,2020-06-19,(07004) VENECIA,1051,599,557,2207
19143,2020-01-25,(07107) U. NACIONAL,835,591,826,2252
19144,2020-09-24,(06102) Salitre El Greco,257,156,160,573
19145,2020-06-23,(03011) SUBA - CALLE 100,560,252,242,1054
19146,2020-05-10,(07001) PERDOMO,176,91,95,362
19147,2020-01-12,(03005) SUBA - AV. BOYACA,431,240,454,1125
19148,2020-04-03,(09119) Calle 57,241,187,186,614
19149,2020-05-09,(04104) Avenida 68,306,184,160,650
19150,2020-08-17,(02000) Cabecera Autopista Norte,388,260,287,935
19151,2020-06-17,(07109) CAD,676,414,323,1413
19152,2020-05-25,(07506) DESPENSA,132,69,81,282
19153,2020-08-17,(10002) Av. Primero de Mayo,606,270,522,1398
19154,2020-04-23,(07002) MADELENA,384,216,213,813
19155,2020-08-03,(02502) Terminal,368,269,286,923
19156,2020-09-04,(06001) Modelia,417,248,280,945
19157,2020-06-29,(09003) Socorro,224,110,161,495
19158,2020-09-07,(07008) NQS - Calle 30 Sur,316,191,251,758
19159,2020-03-29,(02302) Virrey,146,113,74,333
19160,2020-07-05,(50003) Corral Molinos,508,248,468,1224
19161,2020-05-08,(02001) Centro Comercial Santa Fe,288,197,192,677
19162,2020-06-14,(09122) Calle 72,348,212,299,859
19163,2020-05-15,(07112) COMUNEROS,622,358,349,1329
19164,2020-09-03,(07008) NQS - Calle 30 Sur,341,174,239,754
19165,2020-07-22,(04000) Cabecera Calle 80 - intermunicipal,274,180,254,708
19166,2020-08-03,(07108) Av. El Dorado,133,75,75,283
19167,2020-01-19,(09114) Calle 26,205,161,426,792
19168,2020-07-27,(06103) CAN,345,205,152,702
19169,2020-06-11,(06002) Normandía,310,184,168,662
19170,2020-08-26,(06002) Normandía,301,153,160,614
19171,2020-08-27,(06002) Normandía,296,183,189,668
19172,2020-04-15,(04101) Minuto de Dios,143,103,114,360
19173,2020-06-01,(03010) PUENTE LARGO,333,216,179,728
19174,2020-08-12,(09108) Hospital,81,42,83,206
19175,2020-07-25,(04103) Las Ferias,248,143,141,532
19176,2020-06-21,(06101) El Tiempo,115,63,83,261
19177,2020-07-03,(06107) Ciudad Universitaria,186,127,149,462
19178,2020-04-08,(03012) SUBA - CALLE 95,145,118,103,366
19179,2020-03-13,(06103) CAN,657,122,229,1008
19180,2020-06-27,(03004) GRATAMIRA,29,17,19,65
19181,2020-03-30,(07108) Av. El Dorado,58,46,41,145
19182,2020-08-01,(09111) Calle 19,568,373,398,1339
19183,2020-03-13,(03010) PUENTE LARGO,478,154,243,875
19184,2020-06-27,(06105) Quinta Paredes,97,72,77,246
19185,2020-08-18,(06104) Gobernación,253,146,85,484
19186,2020-10-04,(09113) Calle 22,218,131,267,616
19187,2020-05-05,(03010) PUENTE LARGO,223,178,148,549
19188,2020-08-30,(04101) Minuto de Dios,71,46,124,241
19189,2020-06-21,(12001) Carrera 43,56,36,69,161
19190,2020-01-18,(03004) GRATAMIRA,152,69,102,323
19191,2020-06-24,(03002) SUBA - TV- 91,834,464,497,1795
19192,2020-03-22,(50003) Corral Molinos,271,112,204,587
19193,2020-08-20,(10003) Ciudad Jardín,190,82,137,409
19194,2020-05-26,(09105) Río Fucha,125,59,81,265
19195,2020-06-06,(40002) Manitas,301,171,210,682
19196,2020-05-09,(03005) SUBA - AV. BOYACA,213,124,151,488
19197,2020-04-16,(09105) Río Fucha,83,42,56,181
19198,2020-07-19,(10008) San Diego,73,41,53,167
19199,2020-07-27,(07106) EL CAMPIN,390,244,190,824
19200,2019-12-31,(10002) Av. Primero de Mayo,71,42,115,228
19201,2020-04-24,(09121) Las Flores,400,276,249,925
19202,2020-09-17,(06100) Av. Rojas,268,176,201,645
19203,2020-06-27,(07006) General Santander - alimentacion,305,169,215,689
19204,2020-05-11,(04107) Escuela Militar,89,61,71,221
19205,2020-04-11,(10008) San Diego,81,56,56,193
19206,2020-04-05,(06002) Normandía,53,36,40,129
19207,2020-02-02,(03014) SAN MARTIN,35,22,78,135
19208,2020-08-25,(05103) Marsella,386,197,209,792
19209,2020-08-04,(03005) SUBA - AV. BOYACA,311,193,207,711
19210,2020-03-29,(10005) Bicentenario - alimentacion,40,20,33,93
19211,2020-04-26,(02205) Calle 106,45,45,29,119
19212,2020-04-12,(07107) U. NACIONAL,78,61,34,173
19213,2020-07-31,(04105) Carrera 53,206,128,116,450
19214,2020-05-06,(50002) Corral Calle 40 Sur,16,8,13,37
19215,2020-06-11,(50002) Corral Calle 40 Sur,23,4,15,42
19216,2020-05-02,(04108) El Polo,144,106,99,349
19217,2019-12-31,(02105) Calle 142,36,21,46,103
19218,2020-05-01,(05100) Banderas P. Central,161,99,99,359
19219,2020-03-22,(04000) Cabecera Calle 80 - intermunicipal,23,19,23,65
19220,2020-04-05,(03014) SAN MARTIN,5,6,10,21
19221,2020-10-08,(12000) Puente Aranda,103,51,70,224
19222,2020-04-25,(06105) Quinta Paredes,63,50,28,141
19223,2020-05-25,(04000) Cabecera Calle 80 - intermunicipal,39,22,24,85
19224,2020-10-13,(07504) TERREROS,0,1,2,3
19225,2020-02-01,(04000) Cabecera Calle 80 - alimentacion,12539,5630,10542,28711
19226,2020-07-11,(09002) Consuelo,438,193,299,930
19227,2020-07-18,(09002) Consuelo,267,145,172,584
19228,2020-09-04,(09002) Consuelo,555,291,376,1222
19229,2020-03-14,(09118) Marly,3334,2295,2550,8179
19230,2020-06-10,(07504) TERREROS,5377,3106,2519,11002
19231,2020-01-20,(09119) Calle 57,2878,1941,1771,6590
19232,2020-02-17,(09119) Calle 57,3941,2452,2083,8476
19233,2020-09-29,(09119) Calle 57,677,451,542,1670
19234,2020-01-29,(03002) SUBA - TV- 91,4492,2561,2360,9413
19235,2020-01-31,(05000) Portal Américas,14607,7760,7838,30205
19236,2020-01-27,(03010) PUENTE LARGO,2176,1385,1155,4716
19237,2020-10-05,(09000) Cabecera Usme - alimentacion,9798,4848,6666,21312
19238,2020-03-26,(05000) Portal Américas - alimentacion,5812,2747,2610,11169
19239,2020-04-26,(05000) Portal Américas - alimentacion,2496,1259,1046,4801
19240,2020-05-30,(05000) Portal Américas - alimentacion,7772,3855,3702,15329
19241,2020-01-24,(06107) Ciudad Universitaria,1375,838,879,3092
19242,2020-09-22,(07000) Portal Sur - alimentacion,9061,4872,5153,19086
19243,2020-02-11,(08000) Portal Tunal - alimentacion,25686,14209,12391,52286
19244,2020-01-18,(14004) Museo del Oro,441,508,813,1762
19245,2020-07-31,(07112) COMUNEROS,654,347,411,1412
19246,2020-01-09,(09000) Cabecera Usme - alimentacion,20189,10411,13147,43747
19247,2020-01-29,(07103) AV. CHILE,3699,2204,1815,7718
19248,2020-07-17,(05100) Banderas P. Central,691,370,471,1532
19249,2020-01-14,(09100) Calle 40 Sur,6211,3298,3746,13255
19250,2020-05-14,(09100) Calle 40 Sur,1326,815,718,2859
19251,2020-09-28,(09100) Calle 40 Sur,1829,1133,1556,4518
19252,2020-09-19,(07503) SAN MATEO,10608,5077,6360,22045
19253,2020-07-07,(09115) Calle 34,712,455,426,1593
19254,2020-07-01,(07001) PERDOMO,895,537,597,2029
19255,2020-01-07,(40003) Mirador del Paraiso,3653,1893,2393,7939
19256,2020-05-30,(07505) LEON XIII,1730,1004,824,3558
19257,2020-08-28,(07505) LEON XIII,2858,1491,1283,5632
19258,2020-10-02,(02204) Pepe Sierra,939,669,672,2280
19259,2020-08-10,(05002) Tintal,2317,1363,1368,5048
19260,2020-01-19,(09123) Calle 76,519,447,866,1832
19261,2020-02-08,(09123) Calle 76,2219,1746,2164,6129
19262,2020-03-04,(09123) Calle 76,5628,3740,3309,12677
19263,2020-03-06,(07102) NQS - CALLE 75,1434,1010,1032,3476
19264,2020-06-02,(07102) NQS - CALLE 75,347,254,192,793
19265,2020-05-05,(03013) RIO NEGRO,191,137,134,462
19266,2020-07-22,(05100) Banderas P. Central - alimentacion,2772,1394,1479,5645
19267,2020-08-31,(05100) Banderas P. Central - alimentacion,3051,1641,1744,6436
19268,2020-02-12,(14001) La Sabana,675,421,362,1458
19269,2020-04-13,(14001) La Sabana,82,55,68,205
19270,2020-09-28,(14001) La Sabana,162,109,136,407
19271,2020-01-23,(07106) EL CAMPIN,1988,1244,1197,4429
19272,2020-01-29,(10007) Las Nieves,1918,1223,1121,4262
19273,2020-02-04,(10002) Av. Primero de Mayo,8591,4380,4686,17657
19274,2020-01-13,(02104) Calle 146,7009,4399,4121,15529
19275,2020-03-19,(04000) Cabecera Calle 80,3152,1674,2136,6962
19276,2020-01-08,(02000) Cabecera Autopista Norte - intermunicipal,3073,2074,2071,7218
19277,2020-06-12,(04100) Carrera 77,1269,703,824,2796
19278,2020-05-13,(09000) Cabecera Usme - alimentacion,6545,3543,3451,13539
19279,2020-09-05,(10006) San Victorino,572,349,357,1278
19280,2020-06-24,(40003) Mirador del Paraiso,1733,1144,1070,3947
19281,2020-07-05,(40003) Mirador del Paraiso,679,341,473,1493
19282,2020-01-23,(04001) Quirigua,1860,1102,1214,4176
19283,2020-08-08,(10002) Av. Primero de Mayo,1452,733,1007,3192
19284,2020-01-26,(04104) Avenida 68,638,398,677,1713
19285,2020-01-09,(06111) Universidades,1860,1113,1535,4508
19286,2020-02-05,(06111) Universidades,6125,3770,2622,12517
19287,2020-01-13,(10006) San Victorino,1668,953,1088,3709
19288,2020-03-14,(02201) Prado,2641,1439,1901,5981
19289,2020-01-30,(40001) Juan Pablo II,1630,967,953,3550
19290,2020-01-27,(07106) EL CAMPIN,1971,1278,1090,4339
19291,2020-08-31,(03000) Portal Suba,1305,836,967,3108
19292,2020-07-28,(02000) Cabecera Autopista Norte - intermunicipal,507,346,357,1210
19293,2020-08-29,(03000) Portal Suba - alimentacion,4909,2518,3357,10784
19294,2020-02-28,(06100) Av. Rojas,2646,1449,1307,5402
19295,2020-03-04,(06100) Av. Rojas,2796,1565,1329,5690
19296,2020-03-13,(09119) Calle 57,1037,220,410,1667
19297,2020-02-10,(10010) San Bernardo,1862,1051,1446,4359
19298,2020-07-22,(07112) COMUNEROS,796,430,437,1663
19299,2020-08-23,(07112) COMUNEROS,183,128,181,492
19300,2020-04-10,(07000) Portal Sur - alimentacion,1344,774,498,2616
19301,2020-09-12,(07000) Portal Sur,1612,881,1321,3814
19302,2020-03-14,(02300) Calle 100,2378,1882,2378,6638
19303,2020-08-20,(07004) VENECIA,960,551,509,2020
19304,2020-09-04,(02101) Toberín,1543,972,1175,3690
19305,2020-02-21,(06108) Concejo de Bogotá,857,420,456,1733
19306,2020-09-02,(06108) Concejo de Bogotá,139,63,99,301
19307,2020-06-13,(10001) Country Sur,838,378,577,1793
19308,2020-09-29,(09120) Calle 63,1277,887,949,3113
19309,2020-05-06,(14004) Museo del Oro,0,55,121,176
19310,2020-04-06,(05000) Portal Américas,1225,851,999,3075
19311,2020-06-22,(02201) Prado,286,206,210,702
19312,2020-02-27,(03011) SUBA - CALLE 100,2721,1351,1480,5552
19313,2020-09-22,(02300) Calle 100,1278,926,874,3078
19314,2020-08-03,(09119) Calle 57,521,338,335,1194
19315,2020-09-10,(09123) Calle 76,1018,623,708,2349
19316,2020-04-18,(04000) Cabecera Calle 80 - alimentacion,1245,740,681,2666
19317,2020-06-03,(05101) Mandalay - Cr.73,81,41,42,164
19318,2020-06-22,(08000) Portal Tunal,279,161,117,557
19319,2020-02-21,(09121) Las Flores,3000,2079,2006,7085
19320,2020-02-13,(09106) Nariño,2081,1305,1387,4773
19321,2020-07-23,(08000) Portal Tunal,579,207,217,1003
19322,2020-02-04,(03009) Av. Suba- Calle 116,2663,1699,1489,5851
19323,2020-08-27,(02205) Calle 106,335,225,210,770
19324,2020-01-04,(03006) NIZA - CALLE 127,736,435,581,1752
19325,2020-07-10,(04003) Avenida Ciudad de Cali,1177,665,788,2630
19326,2020-08-11,(04003) Avenida Ciudad de Cali,863,483,667,2013
19327,2020-02-08,(04108) El Polo,1000,605,964,2569
19328,2020-02-09,(05100) Banderas P. Central - alimentacion,3218,1219,2577,7014
19329,2020-03-10,(07000) Portal Sur,204,2362,1663,4229
19330,2020-08-15,(07106) EL CAMPIN,281,185,200,666
19331,2020-09-03,(07106) EL CAMPIN,437,288,253,978
19332,2020-01-08,(03007) HUMEDAL CORDOBA,577,368,363,1308
19333,2020-01-04,(03011) SUBA - CALLE 100,729,406,573,1708
19334,2020-04-07,(02000) Cabecera Autopista Norte - alimentacion,2639,1385,1335,5359
19335,2020-03-20,(02101) Toberín,808,592,504,1904
19336,2020-03-11,(04103) Las Ferias,1510,887,787,3184
19337,2020-03-30,(02202) Calle 127,660,492,341,1493
19338,2020-05-08,(07110) PALOQUEMAO,544,310,207,1061
19339,2020-05-31,(09100) Calle 40 Sur,446,263,327,1036
19340,2020-07-25,(09100) Calle 40 Sur,979,573,613,2165
19341,2020-03-25,(10005) Bicentenario - alimentacion,168,77,118,363
19342,2020-07-15,(09000) Cabecera Usme,1123,773,855,2751
19343,2020-05-04,(05103) Marsella,238,120,111,469
19344,2020-01-04,(04103) Las Ferias,482,259,383,1124
19345,2020-09-12,(05001) Patio Bonito,1776,828,1119,3723
19346,2020-05-20,(09117) Calle 45,640,379,362,1381
19347,2020-09-07,(02104) Calle 146,832,548,583,1963
19348,2020-08-13,(03002) SUBA - TV- 91,620,379,391,1390
19349,2020-01-19,(09119) Calle 57,432,351,806,1589
19350,2020-02-28,(07003) SEVILLANA,2069,1087,1185,4341
19351,2020-01-04,(06002) Normandía,451,259,438,1148
19352,2020-02-13,(06100) Av. Rojas,2889,1629,1301,5819
19353,2020-07-15,(03001) LA CAMPIÑA,988,598,524,2110
19354,2020-09-20,(09116) Avenida 39,92,69,147,308
19355,2020-01-06,(04003) Avenida Ciudad de Cali,788,399,803,1990
19356,2020-03-11,(07003) SEVILLANA,1938,1087,1075,4100
19357,2020-09-17,(07003) SEVILLANA,464,273,336,1073
19358,2020-01-21,(40001) Juan Pablo II,1285,630,757,2672
19359,2020-03-20,(02302) Virrey,346,259,170,775
19360,2020-06-22,(05100) Banderas P. Central,181,89,150,420
19361,2020-05-02,(02105) Calle 142,355,236,185,776
19362,2020-05-31,(02105) Calle 142,148,131,144,423
19363,2020-07-24,(09109) Tercer Milenio,234,138,174,546
19364,2020-08-06,(09109) Tercer Milenio,344,216,225,785
19365,2020-05-24,(09002) Consuelo,122,40,84,246
19366,2020-05-04,(09122) Calle 72,753,543,435,1731
19367,2020-04-14,(05107) Américas - Cr.53,333,233,175,741
19368,2020-01-06,(07103) AV. CHILE,388,260,538,1186
19369,2020-05-14,(06102) Salitre El Greco,177,96,106,379
19370,2020-06-27,(40002) Manitas,348,184,234,766
19371,2020-09-17,(02001) Centro Comercial Santa Fe,575,331,455,1361
19372,2020-04-02,(02300) Calle 100,728,551,420,1699
19373,2020-06-05,(02102) Calle 161,228,144,121,493
19374,2020-01-04,(07003) SEVILLANA,638,327,471,1436
19375,2020-03-02,(40001) Juan Pablo II,1608,930,956,3494
19376,2020-04-17,(09101) Quiroga,272,144,198,614
19377,2020-04-18,(09101) Quiroga,184,98,125,407
19378,2020-08-25,(09120) Calle 63,964,621,656,2241
19379,2020-09-17,(09120) Calle 63,1265,827,875,2967
19380,2020-09-23,(10000) Portal 20 de Julio,2484,1238,1447,5169
19381,2020-07-18,(12007) Zona Industrial,282,192,132,606
19382,2020-03-30,(09004) Santa Lucía,1036,506,604,2146
19383,2020-08-26,(09115) Calle 34,613,367,343,1323
19384,2020-04-15,(09115) Calle 34,362,261,217,840
19385,2020-06-10,(03006) NIZA - CALLE 127,420,216,192,828
19386,2020-08-10,(02204) Pepe Sierra,699,505,446,1650
19387,2020-09-29,(10002) Av. Primero de Mayo,2461,1227,1816,5504
19388,2020-06-13,(07000) Portal Sur,1362,783,960,3105
19389,2020-05-15,(02201) Prado,683,420,403,1506
19390,2020-05-02,(07004) VENECIA,420,253,249,922
19391,2020-10-01,(09107) Hortúa,646,416,552,1614
19392,2020-06-13,(06104) Gobernación,139,85,111,335
19393,2020-03-13,(06109) Centro Memoria,338,70,131,539
19394,2020-05-02,(07105) MOVISTAR ARENA,101,64,70,235
19395,2020-01-20,(09105) Río Fucha,690,396,499,1585
19396,2020-06-15,(07104) Simon Bolivar,173,130,124,427
19397,2020-09-30,(09115) Calle 34,736,461,607,1804
19398,2020-07-30,(07107) U. NACIONAL,330,175,191,696
19399,2020-09-23,(09114) Calle 26,373,240,338,951
19400,2020-05-21,(09123) Calle 76,792,533,440,1765
19401,2020-04-07,(05001) Patio Bonito,872,485,483,1840
19402,2020-05-28,(06107) Ciudad Universitaria,149,103,101,353
19403,2020-10-04,(10007) Las Nieves,129,100,204,433
19404,2020-07-11,(06102) Salitre El Greco,186,122,146,454
19405,2020-06-10,(09110) Avenida Jimenez,968,775,789,2532
19406,2020-09-11,(40001) Juan Pablo II,580,329,419,1328
19407,2020-01-21,(40002) Manitas,957,504,601,2062
19408,2020-07-06,(10007) Las Nieves,723,404,413,1540
19409,2020-04-05,(12003) Ricaurte,38,22,28,88
19410,2020-03-25,(08002) Biblioteca,166,96,90,352
19411,2020-05-21,(08002) Biblioteca,241,133,140,514
19412,2020-01-30,(50002) Corral Calle 40 Sur,125,105,154,384
19413,2020-04-23,(03007) HUMEDAL CORDOBA,76,51,27,154
19414,2020-03-20,(12000) Puente Aranda,65,41,41,147
19415,2020-03-24,(07002) MADELENA,713,353,422,1488
19416,2020-06-30,(12004) Carrera 22,252,124,148,524
19417,2020-09-22,(07107) U. NACIONAL,411,250,292,953
19418,2020-08-19,(09111) Calle 19,637,385,441,1463
19419,2020-06-11,(02502) Terminal,386,256,316,958
19420,2020-06-09,(06001) Modelia,391,236,182,809
19421,2020-04-17,(10009) Museo Nacional,294,199,176,669
19422,2020-05-01,(10009) Museo Nacional,87,67,87,241
19423,2020-10-06,(05101) Mandalay - Cr.73,170,109,127,406
19424,2020-04-04,(02200) Alcalá,622,466,310,1398
19425,2020-03-26,(03013) RIO NEGRO,142,87,94,323
19426,2020-08-10,(07008) NQS - Calle 30 Sur,267,168,152,587
19427,2020-09-21,(07008) NQS - Calle 30 Sur,273,150,199,622
19428,2020-03-27,(02103) Mazurén,75,54,66,195
19429,2020-02-01,(12002) CDS - Carrera 32,269,180,259,708
19430,2020-06-19,(12002) CDS - Carrera 32,196,117,87,400
19431,2020-03-28,(04101) Minuto de Dios,98,77,74,249
19432,2020-07-04,(07506) DESPENSA,376,208,238,822
19433,2020-03-01,(06104) Gobernación,133,132,216,481
19434,2020-06-05,(09108) Hospital,68,39,36,143
19435,2020-09-30,(07006) General Santander - alimentacion,410,236,323,969
19436,2020-06-21,(02300) Calle 100,292,218,224,734
19437,2020-07-08,(07506) DESPENSA,480,267,272,1019
19438,2020-09-22,(09121) Las Flores,753,466,563,1782
19439,2020-05-10,(06102) Salitre El Greco,46,31,27,104
19440,2020-06-22,(03011) SUBA - CALLE 100,168,102,105,375
19441,2020-07-11,(09113) Calle 22,437,237,304,978
19442,2020-08-07,(10004) Policarpa,135,49,83,267
19443,2020-10-05,(06102) Salitre El Greco,250,164,209,623
19444,2020-04-19,(10001) Country Sur,215,105,143,463
19445,2020-08-12,(03011) SUBA - CALLE 100,426,198,228,852
19446,2020-07-10,(07506) DESPENSA,524,274,288,1086
19447,2020-05-11,(04001) Quirigua,277,176,182,635
19448,2020-05-28,(12007) Zona Industrial,284,198,124,606
19449,2020-05-11,(06111) Universidades,0,101,297,398
19450,2020-09-06,(04001) Quirigua,133,67,155,355
19451,2020-03-26,(12003) Ricaurte,83,76,54,213
19452,2020-06-01,(40002) Manitas,388,228,251,867
19453,2020-03-08,(14005) Las Aguas,292,235,591,1118
19454,2020-05-09,(02000) Cabecera Autopista Norte - intermunicipal,156,108,115,379
19455,2020-04-19,(07506) DESPENSA,91,54,54,199
19456,2020-03-29,(09122) Calle 72,217,159,126,502
19457,2020-07-02,(07007) NQS - Calle 38A Sur,420,249,284,953
19458,2020-04-18,(09116) Avenida 39,110,88,82,280
19459,2020-03-10,(03014) SAN MARTIN,106,28,44,178
19460,2020-06-28,(04107) Escuela Militar,34,38,56,128
19461,2020-08-07,(02204) Pepe Sierra,249,217,191,657
19462,2020-08-26,(06100) Av. Rojas,247,125,131,503
19463,2020-03-25,(06107) Ciudad Universitaria,102,64,70,236
19464,2020-04-25,(14004) Museo del Oro,0,30,77,107
19465,2020-07-24,(05101) Mandalay - Cr.73,81,54,46,181
19466,2020-03-22,(06109) Centro Memoria,63,46,30,139
19467,2020-08-09,(06109) Centro Memoria,71,51,58,180
19468,2020-05-25,(03005) SUBA - AV. BOYACA,101,82,69,252
19469,2020-05-08,(10003) Ciudad Jardín,128,72,85,285
19470,2020-09-26,(10003) Ciudad Jardín,212,91,180,483
19471,2020-04-06,(04102) Avenida Boyaca,129,84,103,316
19472,2020-09-09,(50002) Corral Calle 40 Sur,24,14,32,70
19473,2020-06-22,(07200) Tygua-San José,69,45,70,184
19474,2020-05-29,(07101) CASTELLANA,179,113,102,394
19475,2020-07-26,(09106) Nariño,99,54,96,249
19476,2020-10-12,(07101) CASTELLANA,28,24,59,111
19477,2020-04-09,(03010) PUENTE LARGO,108,72,33,213
19478,2020-07-19,(07101) CASTELLANA,30,16,30,76
19479,2020-01-04,(50006) Corral Carrera 77,11,10,15,36
19480,2020-04-07,(10005) Bicentenario,50,34,38,122
19481,2020-07-22,(03004) GRATAMIRA,27,10,9,46
19482,2020-04-23,(03004) GRATAMIRA,20,12,10,42
19483,2020-08-16,(50006) Corral Carrera 77,0,1,4,5
19484,2020-10-01,(09002) Consuelo,530,271,395,1196
19485,2020-07-30,(02502) Terminal,390,253,325,968
19486,2020-10-05,(02502) Terminal,564,365,593,1522
19487,2020-09-17,(05000) Portal Américas - alimentacion,12109,6693,7325,26127
19488,2020-01-28,(04106) Carrera 47,1497,831,831,3159
19489,2020-01-24,(03000) Portal Suba - alimentacion,26034,14218,15329,55581
19490,2020-03-02,(03002) SUBA - TV- 91,4692,2731,2360,9783
19491,2020-03-16,(03002) SUBA - TV- 91,3054,1769,1558,6381
19492,2020-10-12,(07503) SAN MATEO,3929,1852,3101,8882
19493,2020-02-03,(06000) Portal Eldorado - alimentacion,18102,9805,9737,37644
19494,2020-08-11,(05000) Portal Américas - alimentacion,10342,5546,5480,21368
19495,2020-04-01,(06107) Ciudad Universitaria,101,69,82,252
19496,2020-01-22,(09001) Molinos,6978,4294,5630,16902
19497,2020-01-08,(02000) Cabecera Autopista Norte - alimentacion,15928,8455,10097,34480
19498,2020-08-24,(02000) Cabecera Autopista Norte - alimentacion,4089,2119,2360,8568
19499,2020-01-07,(07112) COMUNEROS,2401,1443,1686,5530
19500,2020-05-19,(10000) Portal 20 de Julio - alimentacion,3403,1569,1940,6912
19501,2020-02-01,(05100) Banderas P. Central,3370,1386,2543,7299
19502,2020-01-30,(10001) Country Sur,5054,2211,2623,9888
19503,2020-06-25,(10001) Country Sur,1283,570,743,2596
19504,2020-03-13,(40001) Juan Pablo II,44,370,275,689
19505,2020-02-19,(04000) Cabecera Calle 80,7743,4746,4945,17434
19506,2020-03-13,(06000) Portal Eldorado - alimentacion,1608,2795,2434,6837
19507,2020-05-19,(07001) PERDOMO,701,420,444,1565
19508,2020-08-14,(02204) Pepe Sierra,748,520,417,1685
19509,2020-03-04,(04104) Avenida 68,3692,1995,1821,7508
19510,2020-01-22,(06002) Normandía,2340,1384,1208,4932
19511,2020-02-25,(06002) Normandía,2679,1632,1299,5610
19512,2020-02-10,(02502) Terminal,5483,3674,2961,12118
19513,2020-02-27,(07111) NQS - RICAURTE,3125,2069,1863,7057
19514,2020-01-14,(03005) SUBA - AV. BOYACA,2402,1278,1376,5056
19515,2020-03-30,(07102) NQS - CALLE 75,132,114,107,353
19516,2020-09-04,(09118) Marly,1487,983,960,3430
19517,2020-02-04,(03001) LA CAMPIÑA,6828,4270,4106,15204
19518,2020-02-07,(03001) LA CAMPIÑA,6833,3855,4433,15121
19519,2020-09-04,(50003) Corral Molinos,1618,864,1231,3713
19520,2020-03-06,(07106) EL CAMPIN,2072,1334,1291,4697
19521,2020-07-21,(02103) Mazurén,187,126,149,462
19522,2020-06-15,(09103) Olaya,393,196,244,833
19523,2020-10-01,(02000) Cabecera Autopista Norte - alimentacion,5415,2717,3764,11896
19524,2020-09-01,(07002) MADELENA,888,515,574,1977
19525,2020-01-16,(02104) Calle 146,7787,4565,4384,16736
19526,2020-09-30,(04000) Cabecera Calle 80,1326,832,1234,3392
19527,2020-05-26,(08000) Portal Tunal - alimentacion,5943,3174,3127,12244
19528,2020-09-24,(09110) Avenida Jimenez,1555,1140,963,3658
19529,2020-01-10,(06106) Recinto Ferial,1045,589,646,2280
19530,2020-01-03,(04106) Carrera 47,684,387,527,1598
19531,2020-06-12,(04002) Carrera 90,714,365,394,1473
19532,2020-02-17,(10001) Country Sur,5355,2449,2668,10472
19533,2020-02-13,(40003) Mirador del Paraiso,4919,2835,2555,10309
19534,2020-02-04,(02000) Cabecera Autopista Norte - intermunicipal,5261,3572,3078,11911
19535,2020-05-23,(09107) Hortúa,359,229,241,829
19536,2020-09-19,(06105) Quinta Paredes,94,68,79,241
19537,2020-07-29,(03000) Portal Suba,1185,740,785,2710
19538,2020-04-04,(08001) Parque el Tunal,156,84,87,327
19539,2020-04-30,(03000) Portal Suba - alimentacion,3938,2233,1819,7990
19540,2020-05-11,(09108) Hospital,57,45,59,161
19541,2020-02-19,(07000) Portal Sur,8205,4816,4326,17347
19542,2020-01-12,(04002) Carrera 90,679,278,623,1580
19543,2020-03-11,(09107) Hortúa,2369,1400,1454,5223
19544,2020-07-01,(09116) Avenida 39,367,225,264,856
19545,2020-02-03,(02300) Calle 100,7068,4481,3962,15511
19546,2020-09-22,(02000) Cabecera Autopista Norte - alimentacion,5219,2787,3517,11523
19547,2020-09-22,(14004) Museo del Oro,418,274,350,1042
19548,2020-07-14,(02201) Prado,808,503,420,1731
19549,2020-04-04,(09000) Cabecera Usme - alimentacion,3372,1618,1809,6799
19550,2020-06-27,(40003) Mirador del Paraiso,1582,950,1046,3578
19551,2020-03-12,(07112) COMUNEROS,622,593,539,1754
19552,2020-10-10,(02103) Mazurén,148,88,186,422
19553,2020-02-10,(03011) SUBA - CALLE 100,2806,1437,1472,5715
19554,2020-03-07,(03011) SUBA - CALLE 100,1172,748,1131,3051
19555,2020-10-09,(02300) Calle 100,1384,998,1124,3506
19556,2020-06-30,(09119) Calle 57,610,390,434,1434
19557,2020-07-08,(50002) Corral Calle 40 Sur,22,12,25,59
19558,2020-08-20,(50002) Corral Calle 40 Sur,31,12,28,71
19559,2020-02-01,(07006) General Santander,1577,794,1234,3605
19560,2020-01-21,(10010) San Bernardo,1112,643,909,2664
19561,2020-01-11,(07104) Simon Bolivar,1146,726,776,2648
19562,2020-06-07,(09104) Restrepo,404,245,363,1012
19563,2020-04-07,(05005) Transversal 86,171,89,99,359
19564,2020-07-14,(02000) Cabecera Autopista Norte,1177,732,650,2559
19565,2020-01-16,(10007) Las Nieves,1781,1218,1134,4133
19566,2020-03-14,(02205) Calle 106,783,575,804,2162
19567,2020-07-14,(04003) Avenida Ciudad de Cali,861,486,584,1931
19568,2020-07-19,(06000) Portal Eldorado - alimentacion,1113,527,586,2226
19569,2020-05-21,(04108) El Polo,389,236,184,809
19570,2020-01-30,(07101) CASTELLANA,950,570,616,2136
19571,2020-07-11,(07010) Bosa,625,267,419,1311
19572,2020-01-04,(02200) Alcalá,3177,1721,2266,7164
19573,2020-06-08,(06101) El Tiempo,334,220,176,730
19574,2020-09-21,(08002) Biblioteca,176,126,233,535
19575,2020-02-14,(07108) Av. El Dorado,914,602,606,2122
19576,2020-02-11,(06001) Modelia,2763,1689,1305,5757
19577,2020-03-19,(07000) Portal Sur,4275,2440,2444,9159
19578,2020-08-24,(07000) Portal Sur,1827,1056,1067,3950
19579,2020-04-07,(02101) Toberín,545,372,360,1277
19580,2020-03-08,(09001) Molinos,1883,758,1780,4421
19581,2020-01-30,(14005) Las Aguas,3068,1862,1769,6699
19582,2020-03-12,(04101) Minuto de Dios,808,507,422,1737
19583,2020-05-11,(07110) PALOQUEMAO,562,328,225,1115
19584,2020-08-18,(10005) Bicentenario - alimentacion,177,97,206,480
19585,2020-10-02,(04003) Avenida Ciudad de Cali,1281,657,1064,3002
19586,2020-05-13,(09123) Calle 76,760,527,397,1684
19587,2020-01-05,(09001) Molinos,1604,680,1532,3816
19588,2020-10-11,(07113) SANTA ISABEL,132,68,227,427
19589,2020-09-07,(10006) San Victorino,564,309,359,1232
19590,2020-02-12,(09109) Tercer Milenio,1484,870,925,3279
19591,2020-09-02,(03001) LA CAMPIÑA,1257,772,702,2731
19592,2020-10-05,(09117) Calle 45,735,442,711,1888
19593,2020-04-06,(05001) Patio Bonito,865,452,542,1859
19594,2020-05-21,(03001) LA CAMPIÑA,839,466,445,1750
19595,2020-04-13,(04108) El Polo,229,159,121,509
19596,2020-07-31,(09120) Calle 63,1009,666,598,2273
19597,2020-07-05,(06100) Av. Rojas,40,31,56,127
19598,2020-04-15,(02302) Virrey,337,235,191,763
19599,2020-01-22,(09122) Calle 72,6282,4016,3690,13988
19600,2020-06-27,(05100) Banderas P. Central,559,276,465,1300
19601,2020-08-02,(04100) Carrera 77,271,143,220,634
19602,2020-07-04,(02105) Calle 142,600,356,447,1403
19603,2020-07-25,(02105) Calle 142,467,264,295,1026
19604,2020-07-04,(03002) SUBA - TV- 91,632,323,445,1400
19605,2020-04-16,(09123) Calle 76,499,388,268,1155
19606,2020-08-25,(02103) Mazurén,180,129,170,479
19607,2020-08-27,(02103) Mazurén,200,120,185,505
19608,2020-08-04,(07103) AV. CHILE,665,442,387,1494
19609,2020-04-24,(06102) Salitre El Greco,138,96,81,315
19610,2020-01-28,(40002) Manitas,1217,696,756,2669
19611,2020-09-07,(02001) Centro Comercial Santa Fe,527,334,367,1228
19612,2020-09-08,(09114) Calle 26,330,225,249,804
19613,2020-01-30,(07006) General Santander,2796,1621,1563,5980
19614,2020-06-29,(02102) Calle 161,77,58,61,196
19615,2020-09-13,(07112) COMUNEROS,272,138,266,676
19616,2020-03-15,(04000) Cabecera Calle 80,945,512,1138,2595
19617,2020-09-03,(09120) Calle 63,1255,787,855,2897
19618,2020-07-04,(03011) SUBA - CALLE 100,370,211,249,830
19619,2020-09-17,(10009) Museo Nacional,558,329,431,1318
19620,2020-03-22,(06102) Salitre El Greco,75,51,30,156
19621,2019-12-31,(04102) Avenida Boyaca,55,14,28,97
19622,2020-06-10,(09003) Socorro,540,285,321,1146
19623,2020-06-20,(04101) Minuto de Dios,240,145,188,573
19624,2020-06-09,(06111) Universidades,0,148,418,566
19625,2020-05-11,(07111) NQS - RICAURTE,788,535,306,1629
19626,2020-09-03,(09115) Calle 34,665,435,478,1578
19627,2020-10-03,(09115) Calle 34,456,309,555,1320
19628,2020-10-05,(02202) Calle 127,1220,852,791,2863
19629,2020-09-25,(07110) PALOQUEMAO,701,437,382,1520
19630,2020-06-04,(02105) Calle 142,721,428,417,1566
19631,2020-02-07,(12004) Carrera 22,736,433,493,1662
19632,2020-03-08,(12007) Zona Industrial,105,134,194,433
19633,2020-09-16,(06104) Gobernación,310,161,158,629
19634,2020-08-12,(09114) Calle 26,293,184,205,682
19635,2020-08-23,(07105) MOVISTAR ARENA,54,32,57,143
19636,2020-05-31,(02200) Alcalá,437,345,321,1103
19637,2020-02-16,(05102) Av. Américas - Av. Boyacá,232,101,232,565
19638,2020-08-04,(03011) SUBA - CALLE 100,382,189,193,764
19639,2019-12-31,(07505) LEON XIII,79,73,120,272
19640,2020-06-14,(10009) Museo Nacional,79,65,87,231
19641,2020-05-07,(12000) Puente Aranda,61,34,23,118
19642,2020-03-22,(07001) PERDOMO,171,79,90,340
19643,2020-07-06,(14005) Las Aguas,204,143,233,580
19644,2020-09-19,(07506) DESPENSA,410,228,335,973
19645,2020-04-24,(02102) Calle 161,93,79,53,225
19646,2020-05-11,(10004) Policarpa,166,101,124,391
19647,2020-04-17,(09111) Calle 19,317,199,298,814
19648,2020-10-10,(09111) Calle 19,596,401,604,1601
19649,2020-08-16,(02103) Mazurén,25,21,52,98
19650,2020-07-01,(06106) Recinto Ferial,249,157,142,548
19651,2020-08-01,(03006) NIZA - CALLE 127,262,168,156,586
19652,2020-04-11,(04106) Carrera 47,105,66,51,222
19653,2020-07-04,(09120) Calle 63,959,620,702,2281
19654,2020-05-18,(03010) PUENTE LARGO,279,175,164,618
19655,2020-01-19,(07101) CASTELLANA,64,73,185,322
19656,2020-07-05,(07004) VENECIA,309,152,226,687
19657,2020-04-21,(09115) Calle 34,361,260,196,817
19658,2020-04-08,(10009) Museo Nacional,303,214,183,700
19659,2020-06-28,(09119) Calle 57,208,121,148,477
19660,2020-05-01,(07108) Av. El Dorado,34,16,29,79
19661,2020-05-15,(06002) Normandía,254,148,137,539
19662,2020-03-24,(04101) Minuto de Dios,285,199,245,729
19663,2020-08-21,(03010) PUENTE LARGO,325,213,182,720
19664,2020-06-29,(09108) Hospital,23,17,22,62
19665,2020-05-28,(06101) El Tiempo,284,193,168,645
19666,2020-07-26,(07004) VENECIA,221,126,152,499
19667,2020-01-18,(12002) CDS - Carrera 32,244,163,228,635
19668,2020-05-23,(04103) Las Ferias,231,139,129,499
19669,2020-04-17,(07006) General Santander,264,167,158,589
19670,2020-03-22,(04100) Carrera 77,200,111,128,439
19671,2020-08-09,(05101) Mandalay - Cr.73,27,10,17,54
19672,2020-04-26,(10008) San Diego,47,37,37,121
19673,2020-04-17,(12001) Carrera 43,280,162,145,587
19674,2020-10-12,(04002) Carrera 90,236,113,237,586
19675,2020-09-12,(07109) CAD,414,308,334,1056
19676,2020-07-16,(07008) NQS - Calle 30 Sur,292,155,151,598
19677,2020-06-30,(10005) Bicentenario,111,69,89,269
19678,2020-04-26,(06000) Portal Eldorado,194,157,113,464
19679,2020-06-28,(06108) Concejo de Bogotá,50,33,41,124
19680,2020-06-06,(06106) Recinto Ferial,172,107,93,372
19681,2020-05-06,(40002) Manitas,218,120,158,496
19682,2020-01-26,(07104) Simon Bolivar,400,249,462,1111
19683,2020-07-27,(09106) Nariño,328,198,248,774
19684,2020-10-11,(09123) Calle 76,214,182,314,710
19685,2020-07-14,(07006) General Santander - alimentacion,271,150,182,603
19686,2020-04-03,(06103) CAN,298,257,145,700
19687,2020-04-26,(07002) MADELENA,99,54,58,211
19688,2020-06-20,(04107) Escuela Militar,102,72,86,260
19689,2020-09-10,(07101) CASTELLANA,227,117,130,474
19690,2020-03-22,(02000) Cabecera Autopista Norte - intermunicipal,32,22,23,77
19691,2020-04-11,(07104) Simon Bolivar,115,83,83,281
19692,2020-06-29,(03009) Av. Suba- Calle 116,165,104,103,372
19693,2020-07-05,(04105) Carrera 53,101,42,66,209
19694,2020-03-30,(06100) Av. Rojas,119,76,79,274
19695,2020-04-23,(06100) Av. Rojas,115,73,75,263
19696,2020-06-22,(06104) Gobernación,59,39,35,133
19697,2020-07-26,(03009) Av. Suba- Calle 116,121,87,55,263
19698,2019-12-31,(07000) Portal Sur,54,50,83,187
19699,2020-03-23,(06103) CAN,192,132,94,418
19700,2020-03-26,(05100) Banderas P. Central,343,201,221,765
19701,2020-04-21,(06105) Quinta Paredes,74,66,38,178
19702,2020-04-19,(10003) Ciudad Jardín,31,28,21,80
19703,2020-03-21,(09109) Tercer Milenio,88,52,48,188
19704,2020-05-03,(03002) SUBA - TV- 91,147,93,91,331
19705,2020-08-09,(09105) Río Fucha,0,22,47,69
19706,2020-07-16,(03014) SAN MARTIN,29,8,16,53
19707,2020-05-02,(50006) Corral Carrera 77,3,2,3,8
19708,2019-12-31,(02204) Pepe Sierra,30,12,32,74
19709,2020-09-29,(50006) Corral Carrera 77,5,3,4,12
19710,2020-04-12,(09108) Hospital,24,14,9,47
19711,2020-05-06,(10005) Bicentenario,78,38,38,154
19712,2020-06-01,(50006) Corral Carrera 77,5,3,4,12
19713,2020-06-15,(50006) Corral Carrera 77,2,1,2,5
19714,2020-05-15,(04000) Cabecera Calle 80 - alimentacion,3101,1761,1822,6684
19715,2020-07-22,(07005) ALQUERIA,490,275,286,1051
19716,2020-09-07,(09002) Consuelo,499,262,340,1101
19717,2020-03-16,(07504) TERREROS,13109,8224,6897,28230
19718,2020-01-03,(02303) Calle 85,1547,1115,1097,3759
19719,2020-01-09,(07503) SAN MATEO,32208,17447,14873,64528
19720,2020-09-03,(05000) Portal Américas,3374,2004,2319,7697
19721,2020-03-17,(09121) Las Flores,2117,1338,1095,4550
19722,2020-02-18,(04002) Carrera 90,3945,2348,2058,8351
19723,2020-08-18,(07503) SAN MATEO,10601,6062,5093,21756
19724,2020-04-01,(05000) Portal Américas - alimentacion,5973,2730,2566,11269
19725,2020-10-02,(06107) Ciudad Universitaria,227,141,217,585
19726,2020-02-26,(07112) COMUNEROS,3895,2274,2297,8466
19727,2020-01-14,(14004) Museo del Oro,2472,1644,1440,5556
19728,2020-01-28,(14004) Museo del Oro,3831,2365,1866,8062
19729,2020-04-02,(03009) Av. Suba- Calle 116,325,222,157,704
19730,2020-09-23,(05100) Banderas P. Central,1113,648,822,2583
19731,2020-01-18,(09100) Calle 40 Sur,4194,1973,2933,9100
19732,2020-09-07,(09100) Calle 40 Sur,1722,1049,1243,4014
19733,2020-03-02,(02102) Calle 161,1832,1179,1070,4081
19734,2020-08-15,(09000) Cabecera Usme,1372,706,1247,3325
19735,2020-02-17,(02000) Cabecera Autopista Norte,11649,7412,6046,25107
19736,2020-03-07,(07009) SENA,2204,1148,1598,4950
19737,2020-01-30,(10003) Ciudad Jardín,1005,511,642,2158
19738,2020-02-27,(02204) Pepe Sierra,4950,3280,2406,10636
19739,2020-05-08,(10000) Portal 20 de Julio - alimentacion,2908,1396,1728,6032
19740,2020-05-15,(07001) PERDOMO,720,393,403,1516
19741,2020-01-22,(07113) SANTA ISABEL,1962,1183,1297,4442
19742,2020-08-15,(04101) Minuto de Dios,224,139,205,568
19743,2020-01-23,(07505) LEON XIII,8074,4481,3790,16345
19744,2020-03-17,(02204) Pepe Sierra,2649,1763,1361,5773
19745,2020-06-19,(05002) Tintal,2683,1440,1451,5574
19746,2020-06-26,(05002) Tintal,2773,1508,1541,5822
19747,2020-01-29,(09123) Calle 76,5251,3487,2902,11640
19748,2020-02-27,(07110) PALOQUEMAO,2777,1732,1156,5665
19749,2020-07-09,(02000) Cabecera Autopista Norte - alimentacion,4992,2793,2774,10559
19750,2020-09-19,(04100) Carrera 77,1072,542,963,2577
19751,2020-10-07,(07102) NQS - CALLE 75,491,346,323,1160
19752,2020-06-01,(03013) RIO NEGRO,258,171,176,605
19753,2020-01-08,(50003) Corral Molinos,2535,1742,2868,7145
19754,2020-04-29,(14001) La Sabana,100,73,72,245
19755,2020-07-16,(14001) La Sabana,102,78,74,254
19756,2020-09-26,(14001) La Sabana,131,74,112,317
19757,2020-03-15,(02000) Cabecera Autopista Norte - alimentacion,5135,2155,3684,10974
19758,2020-03-07,(02200) Alcalá,6562,3510,4500,14572
19759,2020-10-06,(07112) COMUNEROS,904,526,732,2162
19760,2020-04-29,(05000) Portal Américas,1444,1050,1083,3577
19761,2020-02-01,(09104) Restrepo,3220,1976,3130,8326
19762,2020-06-19,(02201) Prado,963,655,554,2172
19763,2020-03-14,(04002) Carrera 90,1845,845,1304,3994
19764,2020-03-25,(06000) Portal Eldorado,862,695,468,2025
19765,2020-01-15,(02204) Pepe Sierra,4203,2771,2142,9116
19766,2020-02-11,(09107) Hortúa,2511,1570,1569,5650
19767,2020-02-28,(06111) Universidades,5551,3572,2851,11974
19768,2020-02-19,(06105) Quinta Paredes,1109,646,501,2256
19769,2020-07-24,(06105) Quinta Paredes,120,71,61,252
19770,2020-07-01,(09101) Quiroga,581,311,489,1381
19771,2020-05-11,(02000) Cabecera Autopista Norte - alimentacion,3648,2052,1909,7609
19772,2020-03-12,(09119) Calle 57,1187,282,471,1940
19773,2020-01-26,(04108) El Polo,292,201,407,900
19774,2020-01-09,(08002) Biblioteca,716,392,527,1635
19775,2020-07-31,(10000) Portal 20 de Julio,2117,1061,1084,4262
19776,2020-08-18,(09004) Santa Lucía,2387,1214,1283,4884
19777,2020-09-27,(09004) Santa Lucía,1009,398,829,2236
19778,2020-03-07,(09003) Socorro,1308,593,946,2847
19779,2020-08-17,(07503) SAN MATEO,3062,1692,1886,6640
19780,2020-03-12,(09118) Marly,2812,564,763,4139
19781,2020-05-22,(08001) Parque el Tunal,414,233,225,872
19782,2020-02-17,(05102) Av. Américas - Av. Boyacá,1930,1188,1004,4122
19783,2020-01-23,(06108) Concejo de Bogotá,855,437,387,1679
19784,2020-08-28,(06108) Concejo de Bogotá,127,66,94,287
19785,2020-08-21,(10001) Country Sur,1124,484,728,2336
19786,2020-07-29,(09123) Calle 76,995,688,552,2235
19787,2020-03-10,(02103) Mazurén,182,923,565,1670
19788,2020-09-21,(10000) Portal 20 de Julio,1983,746,971,3700
19789,2020-03-15,(02200) Alcalá,1595,978,1478,4051
19790,2020-05-14,(02300) Calle 100,1065,650,498,2213
19791,2020-03-03,(07006) General Santander,2856,1642,1575,6073
19792,2020-07-02,(07104) Simon Bolivar,607,373,305,1285
19793,2020-03-29,(09104) Restrepo,234,185,205,624
19794,2020-05-31,(05005) Transversal 86,95,42,64,201
19795,2020-08-04,(06109) Centro Memoria,240,132,126,498
19796,2020-02-17,(09121) Las Flores,3591,2191,2012,7794
19797,2020-05-15,(05107) Américas - Cr.53,326,223,218,767
19798,2020-02-27,(03009) Av. Suba- Calle 116,2622,1671,1389,5682
19799,2020-04-03,(02205) Calle 106,171,125,114,410
19800,2020-01-31,(04101) Minuto de Dios,2660,1496,1714,5870
19801,2020-05-23,(04108) El Polo,257,168,164,589
19802,2020-06-30,(04108) El Polo,503,313,281,1097
19803,2020-09-04,(07201) Guatoque -Veraguas,184,135,152,471
19804,2020-09-18,(07010) Bosa,0,412,1040,1452
19805,2020-09-16,(04100) Carrera 77,1370,791,1059,3220
19806,2020-09-27,(04100) Carrera 77,423,199,529,1151
19807,2020-07-03,(05001) Patio Bonito,0,914,2246,3160
19808,2020-04-28,(03007) HUMEDAL CORDOBA,70,45,41,156
19809,2020-05-09,(03007) HUMEDAL CORDOBA,75,47,44,166
19810,2020-10-02,(03007) HUMEDAL CORDOBA,170,124,129,423
19811,2020-04-11,(02000) Cabecera Autopista Norte - alimentacion,1702,956,672,3330
19812,2020-09-10,(05101) Mandalay - Cr.73,145,87,88,320
19813,2020-05-28,(02101) Toberín,1262,794,720,2776
19814,2020-01-16,(07104) Simon Bolivar,1516,1183,1273,3972
19815,2020-06-06,(07104) Simon Bolivar,503,300,232,1035
19816,2020-03-27,(04107) Escuela Militar,51,41,40,132
19817,2020-07-31,(09121) Las Flores,565,362,353,1280
19818,2020-06-22,(02202) Calle 127,431,330,228,989
19819,2020-06-05,(09109) Tercer Milenio,312,193,259,764
19820,2020-09-05,(09109) Tercer Milenio,282,188,232,702
19821,2020-07-13,(07002) MADELENA,530,344,354,1228
19822,2020-09-28,(06101) El Tiempo,411,234,300,945
19823,2020-07-25,(09117) Calle 45,445,265,268,978
19824,2020-09-18,(03002) SUBA - TV- 91,929,541,691,2161
19825,2020-10-02,(03002) SUBA - TV- 91,989,555,762,2306
19826,2020-01-23,(12003) Ricaurte,1195,769,577,2541
19827,2020-04-21,(09001) Molinos,1227,731,900,2858
19828,2020-02-06,(40001) Juan Pablo II,1667,968,1037,3672
19829,2020-03-04,(07101) CASTELLANA,924,604,594,2122
19830,2020-04-21,(03001) LA CAMPIÑA,534,281,282,1097
19831,2020-09-05,(07003) SEVILLANA,375,180,265,820
19832,2020-08-26,(07113) SANTA ISABEL,361,221,240,822
19833,2020-01-06,(04108) El Polo,212,137,326,675
19834,2020-04-22,(06000) Portal Eldorado,814,540,356,1710
19835,2020-03-21,(07009) SENA,205,120,84,409
19836,2020-10-08,(12003) Ricaurte,445,301,269,1015
19837,2020-02-02,(12007) Zona Industrial,146,154,245,545
19838,2020-07-15,(03009) Av. Suba- Calle 116,481,297,226,1004
19839,2020-06-25,(10010) San Bernardo,623,345,410,1378
19840,2020-01-30,(07001) PERDOMO,4652,2680,2672,10004
19841,2020-05-24,(07106) EL CAMPIN,95,74,68,237
19842,2020-04-08,(02105) Calle 142,403,285,221,909
19843,2020-07-12,(02105) Calle 142,197,165,205,567
19844,2020-07-27,(03002) SUBA - TV- 91,748,442,413,1603
19845,2020-02-29,(50003) Corral Molinos,2259,1621,3138,7018
19846,2020-06-17,(02103) Mazurén,217,132,154,503
19847,2020-07-09,(02103) Mazurén,193,119,179,491
19848,2020-05-28,(06102) Salitre El Greco,181,113,115,409
19849,2020-06-17,(09117) Calle 45,705,431,421,1557
19850,2020-03-27,(05002) Tintal,1016,607,643,2266
19851,2020-02-25,(12002) CDS - Carrera 32,688,386,321,1395
19852,2020-03-16,(09106) Nariño,1354,826,900,3080
19853,2020-06-25,(09106) Nariño,407,255,302,964
19854,2020-03-09,(04000) Cabecera Calle 80 - intermunicipal,30,543,521,1094
19855,2020-04-09,(06108) Concejo de Bogotá,48,42,26,116
19856,2020-07-25,(02001) Centro Comercial Santa Fe,291,177,213,681
19857,2020-07-11,(04105) Carrera 53,224,112,144,480
19858,2020-08-28,(09123) Calle 76,1024,726,560,2310
19859,2020-05-26,(07102) NQS - CALLE 75,373,247,222,842
19860,2020-05-04,(07004) VENECIA,604,351,337,1292
19861,2020-01-18,(08002) Biblioteca,541,282,483,1306
19862,2020-06-24,(08002) Biblioteca,334,180,188,702
19863,2020-08-03,(06111) Universidades,289,175,245,709
19864,2020-06-11,(06100) Av. Rojas,217,120,120,457
19865,2020-09-25,(06100) Av. Rojas,297,197,219,713
19866,2020-07-03,(03006) NIZA - CALLE 127,538,296,284,1118
19867,2020-01-10,(07105) MOVISTAR ARENA,967,599,607,2173
19868,2020-01-25,(07105) MOVISTAR ARENA,617,421,569,1607
19869,2020-05-15,(02104) Calle 146,560,368,359,1287
19870,2020-02-02,(07006) General Santander,669,286,661,1616
19871,2020-04-06,(07000) Portal Sur,903,493,601,1997
19872,2020-01-05,(07110) PALOQUEMAO,277,205,315,797
19873,2020-03-13,(40002) Manitas,43,223,218,484
19874,2020-03-05,(09111) Calle 19,2362,1410,1586,5358
19875,2020-04-27,(06109) Centro Memoria,34,91,44,169
19876,2020-02-02,(05102) Av. Américas - Av. Boyacá,232,117,258,607
19877,2020-03-28,(09103) Olaya,316,187,147,650
19878,2020-03-27,(02303) Calle 85,325,244,182,751
19879,2020-09-12,(09002) Consuelo,413,194,309,916
19880,2020-01-25,(50002) Corral Calle 40 Sur,56,23,84,163
19881,2020-05-13,(07201) Guatoque -Veraguas,140,92,94,326
19882,2020-07-17,(07105) MOVISTAR ARENA,243,143,116,502
19883,2020-06-19,(09121) Las Flores,741,502,432,1675
19884,2020-08-12,(02200) Alcalá,1577,1089,898,3564
19885,2020-08-07,(40001) Juan Pablo II,231,145,161,537
19886,2020-06-11,(10004) Policarpa,222,118,119,459
19887,2020-03-23,(02104) Calle 146,213,142,95,450
19888,2020-09-17,(04103) Las Ferias,370,206,224,800
19889,2020-05-31,(07001) PERDOMO,228,107,125,460
19890,2020-04-08,(02104) Calle 146,365,260,253,878
19891,2020-03-24,(07109) CAD,606,448,384,1438
19892,2020-05-29,(09122) Calle 72,1032,714,633,2379
19893,2020-06-03,(08002) Biblioteca,304,165,189,658
19894,2020-01-16,(50002) Corral Calle 40 Sur,123,70,121,314
19895,2020-07-20,(07009) SENA,192,122,141,455
19896,2020-04-13,(07109) CAD,424,291,183,898
19897,2020-03-21,(07109) CAD,217,158,107,482
19898,2020-03-31,(03005) SUBA - AV. BOYACA,176,137,117,430
19899,2020-04-07,(03005) SUBA - AV. BOYACA,178,123,156,457
19900,2020-06-01,(03005) SUBA - AV. BOYACA,388,241,214,843
19901,2020-04-01,(08001) Parque el Tunal,225,122,134,481
19902,2020-05-29,(02102) Calle 161,228,126,140,494
19903,2020-10-05,(12004) Carrera 22,295,179,203,677
19904,2020-08-01,(02103) Mazurén,102,59,103,264
19905,2020-07-04,(03013) RIO NEGRO,227,133,197,557
19906,2020-06-06,(07005) ALQUERIA,399,240,208,847
19907,2020-06-25,(07109) CAD,623,404,307,1334
19908,2020-10-09,(07008) NQS - Calle 30 Sur,456,221,345,1022
19909,2020-09-18,(09120) Calle 63,1339,894,933,3166
19910,2020-05-11,(02200) Alcalá,1272,935,687,2894
19911,2020-06-13,(07008) NQS - Calle 30 Sur,234,117,165,516
19912,2020-08-05,(12002) CDS - Carrera 32,172,105,68,345
19913,2020-01-12,(06002) Normandía,267,164,304,735
19914,2020-10-07,(09106) Nariño,477,269,479,1225
19915,2020-08-27,(07506) DESPENSA,464,270,259,993
19916,2020-06-06,(05107) Américas - Cr.53,299,190,194,683
19917,2020-08-13,(04000) Cabecera Calle 80 - intermunicipal,314,178,274,766
19918,2020-04-12,(04001) Quirigua,79,45,40,164
19919,2020-05-28,(04001) Quirigua,332,222,202,756
19920,2020-04-27,(04102) Avenida Boyaca,80,51,32,163
19921,2020-07-29,(14004) Museo del Oro,272,166,181,619
19922,2020-02-19,(09108) Hospital,247,156,183,586
19923,2020-08-23,(09108) Hospital,25,20,19,64
19924,2020-04-17,(02502) Terminal,171,112,143,426
19925,2020-08-18,(07506) DESPENSA,427,264,254,945
19926,2020-04-03,(10007) Las Nieves,174,125,160,459
19927,2020-05-31,(05107) Américas - Cr.53,88,66,71,225
19928,2020-04-20,(12001) Carrera 43,295,178,148,621
19929,2020-08-15,(09108) Hospital,76,37,59,172
19930,2020-06-13,(12007) Zona Industrial,228,151,125,504
19931,2020-05-31,(06102) Salitre El Greco,56,29,43,128
19932,2020-08-23,(04104) Avenida 68,182,106,130,418
19933,2020-09-27,(04001) Quirigua,152,74,151,377
19934,2020-10-04,(12004) Carrera 22,67,47,73,187
19935,2020-06-13,(07006) General Santander,367,228,245,840
19936,2020-05-28,(03004) GRATAMIRA,17,12,23,52
19937,2020-06-22,(07004) VENECIA,297,180,174,651
19938,2020-08-25,(03002) SUBA - TV- 91,708,426,462,1596
19939,2020-04-26,(03009) Av. Suba- Calle 116,136,91,73,300
19940,2020-06-26,(07109) CAD,650,431,314,1395
19941,2020-04-20,(07010) Bosa,298,176,205,679
19942,2020-04-27,(07006) General Santander,184,31,29,244
19943,2020-04-12,(07007) NQS - Calle 38A Sur,50,37,37,124
19944,2020-08-10,(07006) General Santander - alimentacion,340,204,228,772
19945,2020-10-11,(10006) San Victorino,221,167,202,590
19946,2020-04-15,(06103) CAN,310,215,124,649
19947,2020-04-22,(12004) Carrera 22,80,56,55,191
19948,2020-04-30,(02103) Mazurén,107,82,85,274
19949,2020-08-26,(10005) Bicentenario - alimentacion,182,95,156,433
19950,2020-05-01,(08002) Biblioteca,115,60,49,224
19951,2020-05-30,(12002) CDS - Carrera 32,117,92,51,260
19952,2020-05-10,(08001) Parque el Tunal,86,49,61,196
19953,2020-05-17,(09111) Calle 19,162,96,170,428
19954,2020-03-23,(07201) Guatoque -Veraguas,18,21,26,65
19955,2020-10-04,(03009) Av. Suba- Calle 116,142,101,179,422
19956,2020-08-23,(12003) Ricaurte,45,41,62,148
19957,2020-10-04,(10003) Ciudad Jardín,88,34,105,227
19958,2020-09-13,(10003) Ciudad Jardín,88,46,91,225
19959,2020-04-26,(04001) Quirigua,79,47,33,159
19960,2020-06-13,(14004) Museo del Oro,63,69,121,253
19961,2020-08-13,(50006) Corral Carrera 77,2,3,6,11
19962,2020-03-02,(03013) RIO NEGRO,1184,752,842,2778
19963,2020-06-13,(07504) TERREROS,4415,2249,2409,9073
19964,2020-07-10,(07504) TERREROS,6609,3587,3028,13224
19965,2020-02-03,(10000) Portal 20 de Julio - alimentacion,10195,5672,7996,23863
19966,2020-02-12,(04106) Carrera 47,1554,864,878,3296
19967,2020-01-13,(03002) SUBA - TV- 91,3478,2098,2125,7701
19968,2020-03-14,(02101) Toberín,5079,2427,4298,11804
19969,2020-09-27,(07503) SAN MATEO,4012,1767,2777,8556
19970,2020-02-06,(02200) Alcalá,14520,9317,7037,30874
19971,2020-02-13,(09100) Calle 40 Sur,7807,4459,4121,16387
19972,2020-01-29,(06104) Gobernación,1377,825,609,2811
19973,2020-01-20,(09003) Socorro,1516,828,947,3291
19974,2020-01-29,(02000) Cabecera Autopista Norte - alimentacion,23062,13064,13139,49265
19975,2020-03-16,(09001) Molinos,5812,3387,4276,13475
19976,2020-08-16,(09001) Molinos,763,352,606,1721
19977,2020-06-10,(05000) Portal Américas - alimentacion,10258,5280,4768,20306
19978,2020-07-18,(05000) Portal Américas - alimentacion,7677,3832,4040,15549
19979,2020-09-22,(06107) Ciudad Universitaria,206,128,158,492
19980,2020-08-18,(04103) Las Ferias,350,190,143,683
19981,2020-09-14,(09000) Cabecera Usme,1768,1124,1362,4254
19982,2020-02-14,(02000) Cabecera Autopista Norte,11605,6745,6453,24803
19983,2020-02-05,(07009) SENA,3890,2247,1984,8121
19984,2020-01-28,(02204) Pepe Sierra,5003,3286,2328,10617
19985,2020-02-21,(02205) Calle 106,2624,1582,1337,5543
19986,2020-09-03,(10005) Bicentenario - alimentacion,244,115,242,601
19987,2020-08-11,(09104) Restrepo,1520,851,1063,3434
19988,2020-03-08,(04101) Minuto de Dios,444,231,573,1248
19989,2020-02-28,(04100) Carrera 77,7035,3906,4191,15132
19990,2020-09-14,(07505) LEON XIII,2887,1511,1411,5809
19991,2020-01-10,(09110) Avenida Jimenez,3055,2265,2208,7528
19992,2020-02-01,(09110) Avenida Jimenez,3164,2314,2263,7741
19993,2020-02-07,(07110) PALOQUEMAO,2492,1429,1251,5172
19994,2020-08-06,(09101) Quiroga,546,279,348,1173
19995,2020-06-05,(07102) NQS - CALLE 75,387,253,194,834
19996,2020-06-20,(07102) NQS - CALLE 75,289,228,217,734
19997,2020-07-06,(06000) Portal Eldorado - alimentacion,4109,2221,2138,8468
19998,2020-09-25,(07000) Portal Sur - alimentacion,9496,4958,5543,19997
19999,2020-03-17,(09110) Avenida Jimenez,3287,2291,1937,7515
20000,2020-01-13,(06001) Modelia,1921,1185,1180,4286
20001,2020-03-03,(02103) Mazurén,3462,2150,1838,7450
20002,2020-03-12,(02303) Calle 85,1824,136,349,2309
20003,2020-10-02,(07000) Portal Sur - alimentacion,9887,5028,6088,21003
20004,2020-09-24,(05100) Banderas P. Central - alimentacion,3682,1886,2253,7821
20005,2020-06-09,(09103) Olaya,969,567,490,2026
20006,2020-10-04,(09103) Olaya,416,192,399,1007
20007,2020-08-22,(07002) MADELENA,510,238,381,1129
20008,2020-08-01,(07111) NQS - RICAURTE,762,473,363,1598
20009,2020-09-10,(07002) MADELENA,854,463,559,1876
20010,2020-06-30,(07002) MADELENA,913,525,545,1983
20011,2020-08-03,(04102) Avenida Boyaca,246,149,156,551
20012,2020-10-12,(04102) Avenida Boyaca,164,84,169,417
20013,2020-02-12,(07107) U. NACIONAL,2625,1601,1392,5618
20014,2020-01-01,(07109) CAD,252,153,310,715
20015,2020-08-23,(08000) Portal Tunal - alimentacion,1827,828,1215,3870
20016,2020-02-27,(07007) NQS - Calle 38A Sur,2249,1339,1135,4723
20017,2020-06-04,(50003) Corral Molinos,1420,740,955,3115
20018,2020-05-20,(09104) Restrepo,1210,739,871,2820
20019,2020-09-02,(10006) San Victorino,811,355,369,1535
20020,2020-09-04,(06000) Portal Eldorado,963,672,650,2285
20021,2020-01-07,(04001) Quirigua,1311,778,834,2923
20022,2020-02-27,(09107) Hortúa,2486,1525,1487,5498
20023,2020-02-28,(10005) Bicentenario - alimentacion,757,352,553,1662
20024,2020-03-06,(02105) Calle 142,7043,3843,3961,14847
20025,2020-02-20,(09101) Quiroga,1562,990,1156,3708
20026,2020-09-09,(09101) Quiroga,530,297,436,1263
20027,2020-01-13,(06111) Universidades,2104,1323,1699,5126
20028,2020-01-28,(04108) El Polo,1883,1205,1083,4171
20029,2020-07-23,(10000) Portal 20 de Julio,1658,878,869,3405
20030,2020-09-14,(10000) Portal 20 de Julio,2304,1134,1258,4696
20031,2020-02-15,(02303) Calle 85,1260,1159,1476,3895
20032,2020-07-30,(02303) Calle 85,677,457,365,1499
20033,2020-03-04,(09105) Río Fucha,792,443,546,1781
20034,2020-01-13,(06102) Salitre El Greco,1206,700,613,2519
20035,2020-06-29,(07504) TERREROS,1823,943,1016,3782
20036,2020-03-28,(07503) SAN MATEO,4306,2338,2147,8791
20037,2020-07-01,(08001) Parque el Tunal,528,295,301,1124
20038,2020-05-26,(09116) Avenida 39,317,205,185,707
20039,2020-03-29,(04000) Cabecera Calle 80,155,103,91,349
20040,2020-09-06,(04000) Cabecera Calle 80,321,193,435,949
20041,2020-05-28,(02201) Prado,805,552,407,1764
20042,2020-03-10,(07007) NQS - Calle 38A Sur,451,446,345,1242
20043,2020-09-19,(09114) Calle 26,186,166,303,655
20044,2020-01-17,(05101) Mandalay - Cr.73,944,493,509,1946
20045,2020-06-12,(05101) Mandalay - Cr.73,103,47,65,215
20046,2020-02-23,(03000) Portal Suba,1410,684,1537,3631
20047,2020-08-09,(02300) Calle 100,224,185,193,602
20048,2020-03-31,(09001) Molinos,1150,584,816,2550
20049,2020-10-03,(08000) Portal Tunal,644,330,448,1422
20050,2020-06-10,(05101) Mandalay - Cr.73,104,45,63,212
20051,2020-06-29,(05005) Transversal 86,125,55,82,262
20052,2020-07-21,(05005) Transversal 86,256,172,241,669
20053,2020-01-21,(08000) Portal Tunal,1699,878,684,3261
20054,2020-02-02,(08000) Portal Tunal,560,378,418,1356
20055,2020-03-08,(07007) NQS - Calle 38A Sur,617,345,511,1473
20056,2020-04-24,(02205) Calle 106,165,119,96,380
20057,2020-07-03,(02205) Calle 106,381,236,251,868
20058,2020-05-15,(03000) Portal Suba - alimentacion,4728,2758,2502,9988
20059,2020-09-07,(06000) Portal Eldorado - alimentacion,3939,2011,2377,8327
20060,2020-01-30,(03006) NIZA - CALLE 127,2456,1521,1468,5445
20061,2020-09-01,(04000) Cabecera Calle 80,1113,675,879,2667
20062,2020-02-12,(07201) Guatoque -Veraguas,1100,562,633,2295
20063,2020-07-03,(07101) CASTELLANA,211,131,145,487
20064,2020-03-09,(07010) Bosa,68,582,453,1103
20065,2020-05-23,(06000) Portal Eldorado,630,437,340,1407
20066,2020-07-31,(10006) San Victorino,649,298,328,1275
20067,2020-03-23,(09116) Avenida 39,68,82,70,220
20068,2020-08-21,(09117) Calle 45,607,382,405,1394
20069,2020-08-07,(08000) Portal Tunal,340,166,135,641
20070,2020-04-08,(07000) Portal Sur,854,483,481,1818
20071,2020-06-13,(09103) Olaya,821,430,496,1747
20072,2020-05-20,(02000) Cabecera Autopista Norte - alimentacion,3990,2254,1940,8184
20073,2020-01-25,(02105) Calle 142,2698,1273,2113,6084
20074,2020-05-13,(07110) PALOQUEMAO,588,369,219,1176
20075,2020-07-06,(09100) Calle 40 Sur,1934,1133,1199,4266
20076,2020-02-06,(07104) Simon Bolivar,2265,1472,1256,4993
20077,2020-09-14,(04107) Escuela Militar,167,113,104,384
20078,2020-09-16,(04107) Escuela Militar,157,116,130,403
20079,2020-10-06,(07004) VENECIA,1156,699,834,2689
20080,2020-09-01,(07109) CAD,623,399,318,1340
20081,2020-03-09,(09121) Las Flores,1629,265,466,2360
20082,2020-10-05,(02303) Calle 85,881,576,577,2034
20083,2020-05-03,(05103) Marsella,74,32,34,140
20084,2020-05-30,(05103) Marsella,221,103,147,471
20085,2020-02-10,(09109) Tercer Milenio,1418,890,895,3203
20086,2020-08-14,(09109) Tercer Milenio,360,202,226,788
20087,2020-08-02,(03000) Portal Suba - alimentacion,1425,743,966,3134
20088,2020-02-23,(06101) El Tiempo,347,259,413,1019
20089,2020-01-19,(02200) Alcalá,1910,1009,1990,4909
20090,2020-10-11,(07004) VENECIA,339,162,347,848
20091,2020-08-09,(06111) Universidades,93,52,125,270
20092,2020-01-04,(04104) Avenida 68,957,567,801,2325
20093,2020-01-04,(09117) Calle 45,886,651,1007,2544
20094,2020-01-26,(09117) Calle 45,753,510,1015,2278
20095,2020-08-18,(06101) El Tiempo,325,200,169,694
20096,2020-07-20,(02000) Cabecera Autopista Norte,372,254,244,870
20097,2020-03-19,(02105) Calle 142,2272,1286,1380,4938
20098,2020-08-03,(02105) Calle 142,652,432,385,1469
20099,2020-10-02,(02001) Centro Comercial Santa Fe,636,357,587,1580
20100,2020-01-25,(12003) Ricaurte,734,576,505,1815
20101,2020-07-02,(05100) Banderas P. Central,844,480,553,1877
20102,2020-02-28,(07200) Tygua-San José,828,488,618,1934
20103,2020-09-12,(06103) CAN,217,148,201,566
20104,2020-04-15,(02105) Calle 142,455,274,208,937
20105,2020-04-02,(09109) Tercer Milenio,147,90,110,347
20106,2020-07-28,(09109) Tercer Milenio,354,193,214,761
20107,2020-04-29,(09002) Consuelo,285,141,153,579
20108,2020-08-22,(05107) Américas - Cr.53,236,149,221,606
20109,2020-04-30,(07103) AV. CHILE,596,414,286,1296
20110,2020-06-21,(40002) Manitas,136,64,87,287
20111,2020-09-19,(02200) Alcalá,1620,1004,1201,3825
20112,2020-10-06,(10008) San Diego,341,191,239,771
20113,2020-05-15,(09120) Calle 63,828,583,523,1934
20114,2020-02-17,(10004) Policarpa,923,476,623,2022
20115,2020-07-22,(06111) Universidades,256,145,262,663
20116,2020-10-11,(05002) Tintal,756,344,851,1951
20117,2020-10-12,(07001) PERDOMO,307,148,325,780
20118,2020-04-17,(07110) PALOQUEMAO,469,289,177,935
20119,2020-03-19,(04000) Cabecera Calle 80 - intermunicipal,631,442,774,1847
20120,2020-07-19,(07201) Guatoque -Veraguas,21,24,20,65
20121,2020-03-24,(03000) Portal Suba,1021,695,892,2608
20122,2020-04-13,(07105) MOVISTAR ARENA,158,115,82,355
20123,2020-03-25,(02200) Alcalá,958,719,484,2161
20124,2020-05-30,(04003) Avenida Ciudad de Cali,640,373,456,1469
20125,2020-08-17,(03003) 21 ANGELES,95,42,70,207
20126,2020-04-08,(04003) Avenida Ciudad de Cali,517,288,404,1209
20127,2020-04-19,(07110) PALOQUEMAO,135,91,61,287
20128,2020-05-11,(07004) VENECIA,694,407,368,1469
20129,2020-07-19,(10006) San Victorino,78,45,84,207
20130,2020-08-05,(05102) Av. Américas - Av. Boyacá,216,120,148,484
20131,2020-08-29,(40003) Mirador del Paraiso,1504,841,1054,3399
20132,2020-05-15,(09122) Calle 72,908,622,577,2107
20133,2020-05-27,(12000) Puente Aranda,71,40,28,139
20134,2020-08-26,(12000) Puente Aranda,72,40,51,163
20135,2020-09-29,(12000) Puente Aranda,99,58,57,214
20136,2020-05-28,(07506) DESPENSA,407,230,209,846
20137,2020-06-20,(07002) MADELENA,624,317,463,1404
20138,2020-07-22,(09111) Calle 19,460,295,386,1141
20139,2020-10-01,(09111) Calle 19,812,502,582,1896
20140,2020-03-19,(04106) Carrera 47,739,406,417,1562
20141,2020-05-24,(10009) Museo Nacional,79,57,68,204
20142,2020-07-25,(07102) NQS - CALLE 75,257,181,171,609
20143,2020-10-04,(10005) Bicentenario - alimentacion,52,38,102,192
20144,2020-05-27,(02502) Terminal,357,258,259,874
20145,2020-08-23,(08000) Portal Tunal,225,147,109,481
20146,2020-08-23,(03013) RIO NEGRO,72,41,90,203
20147,2020-06-18,(07109) CAD,646,429,305,1380
20148,2020-05-06,(03000) Portal Suba,741,472,412,1625
20149,2020-09-09,(09113) Calle 22,443,219,321,983
20150,2020-03-31,(02001) Centro Comercial Santa Fe,169,130,153,452
20151,2020-04-03,(14001) La Sabana,57,40,65,162
20152,2020-06-02,(12003) Ricaurte,290,191,157,638
20153,2020-01-09,(04102) Avenida Boyaca,1965,1124,1187,4276
20154,2020-03-28,(03002) SUBA - TV- 91,276,151,156,583
20155,2020-01-01,(09105) Río Fucha,38,25,111,174
20156,2020-08-13,(04105) Carrera 53,219,139,138,496
20157,2020-10-08,(06103) CAN,404,278,278,960
20158,2020-07-30,(05107) Américas - Cr.53,334,216,234,784
20159,2020-03-25,(03012) SUBA - CALLE 95,190,132,112,434
20160,2020-08-01,(04000) Cabecera Calle 80 - intermunicipal,163,80,151,394
20161,2020-02-18,(03004) GRATAMIRA,311,177,165,653
20162,2020-07-23,(07101) CASTELLANA,187,109,100,396
20163,2020-05-12,(07108) Av. El Dorado,94,53,65,212
20164,2020-09-02,(07506) DESPENSA,486,303,329,1118
20165,2020-02-29,(09108) Hospital,183,100,176,459
20166,2020-04-20,(06106) Recinto Ferial,165,118,71,354
20167,2020-03-23,(07112) COMUNEROS,178,120,104,402
20168,2020-07-15,(03002) SUBA - TV- 91,667,391,352,1410
20169,2020-05-15,(06105) Quinta Paredes,102,75,45,222
20170,2020-07-13,(06105) Quinta Paredes,126,83,57,266
20171,2020-04-02,(07004) VENECIA,485,305,275,1065
20172,2020-04-12,(09001) Molinos,413,242,270,925
20173,2020-03-30,(12001) Carrera 43,248,153,126,527
20174,2020-09-06,(04002) Carrera 90,249,121,243,613
20175,2020-10-02,(10004) Policarpa,309,139,210,658
20176,2020-07-20,(04000) Cabecera Calle 80,261,163,236,660
20177,2020-07-18,(09109) Tercer Milenio,164,97,157,418
20178,2020-04-28,(09115) Calle 34,417,289,241,947
20179,2020-04-10,(04001) Quirigua,62,42,26,130
20180,2020-06-16,(03004) GRATAMIRA,33,22,26,81
20181,2020-04-08,(07104) Simon Bolivar,198,146,122,466
20182,2020-04-01,(07102) NQS - CALLE 75,137,111,111,359
20183,2020-03-12,(12000) Puente Aranda,84,20,48,152
20184,2020-08-05,(07113) SANTA ISABEL,315,196,250,761
20185,2020-08-12,(07106) EL CAMPIN,366,235,208,809
20186,2020-10-08,(12004) Carrera 22,283,185,164,632
20187,2020-02-06,(03014) SAN MARTIN,263,171,196,630
20188,2020-08-18,(14005) Las Aguas,145,97,175,417
20189,2020-04-07,(05100) Banderas P. Central,313,194,208,715
20190,2020-03-13,(50002) Corral Calle 40 Sur,9,22,28,59
20191,2020-09-20,(02000) Cabecera Autopista Norte - intermunicipal,144,118,202,464
20192,2020-04-13,(09113) Calle 22,204,134,195,533
20193,2020-09-02,(04102) Avenida Boyaca,447,270,271,988
20194,2020-06-29,(03005) SUBA - AV. BOYACA,117,77,124,318
20195,2020-05-09,(10003) Ciudad Jardín,104,52,75,231
20196,2020-04-11,(07101) CASTELLANA,32,27,40,99
20197,2020-08-04,(04105) Carrera 53,221,116,135,472
20198,2020-08-27,(09105) Río Fucha,0,68,148,216
20199,2020-08-27,(09114) Calle 26,293,211,221,725
20200,2020-03-23,(06001) Modelia,129,81,62,272
20201,2020-07-20,(06001) Modelia,85,47,62,194
20202,2020-07-05,(12002) CDS - Carrera 32,25,28,28,81
20203,2020-05-24,(06108) Concejo de Bogotá,38,27,23,88
20204,2020-04-22,(05101) Mandalay - Cr.73,57,31,20,108
20205,2020-08-28,(50006) Corral Carrera 77,5,4,4,13
20206,2019-12-31,(02103) Mazurén,10,3,12,25
20207,2020-10-04,(09105) Río Fucha,0,27,87,114
20208,2020-03-21,(50006) Corral Carrera 77,1,0,1,2
20209,2020-03-22,(09118) Marly,458,326,210,994
20210,2020-02-14,(07504) TERREROS,18167,10434,9420,38021
20211,2020-09-21,(09119) Calle 57,442,304,375,1121
20212,2020-02-04,(04106) Carrera 47,1537,862,896,3295
20213,2020-03-03,(05000) Portal Américas,14600,8459,8189,31248
20214,2020-02-11,(03010) PUENTE LARGO,2182,1498,1272,4952
20215,2020-02-14,(04101) Minuto de Dios,3563,2020,1970,7553
20216,2020-06-30,(09001) Molinos,2696,1515,1848,6059
20217,2020-03-30,(05000) Portal Américas - alimentacion,5971,2759,2644,11374
20218,2020-01-11,(07010) Bosa,1272,666,957,2895
20219,2020-02-10,(04103) Las Ferias,1609,976,833,3418
20220,2020-01-15,(14004) Museo del Oro,2539,1607,1593,5739
20221,2020-02-18,(07112) COMUNEROS,3945,2339,2345,8629
20222,2020-01-19,(03000) Portal Suba,1381,674,1498,3553
20223,2020-01-03,(03009) Av. Suba- Calle 116,1238,776,822,2836
20224,2020-01-28,(03009) Av. Suba- Calle 116,2556,1602,1412,5570
20225,2020-01-21,(09115) Calle 34,2709,1762,1602,6073
20226,2020-06-16,(09115) Calle 34,654,411,402,1467
20227,2020-02-18,(05100) Banderas P. Central - alimentacion,16863,9753,8661,35277
20228,2020-01-18,(09118) Marly,3062,1983,2412,7457
20229,2020-02-27,(02205) Calle 106,2685,1747,1339,5771
20230,2020-01-18,(10005) Bicentenario - alimentacion,414,178,426,1018
20231,2020-03-24,(10005) Bicentenario - alimentacion,191,111,199,501
20232,2020-10-07,(10005) Bicentenario - alimentacion,212,104,274,590
20233,2020-06-04,(07001) PERDOMO,839,475,411,1725
20234,2020-01-20,(07113) SANTA ISABEL,1892,1136,1328,4356
20235,2020-02-12,(09104) Restrepo,5616,3388,4032,13036
20236,2020-08-05,(07505) LEON XIII,2506,1318,1115,4939
20237,2020-02-15,(06002) Normandía,1069,592,997,2658
20238,2020-04-27,(09110) Avenida Jimenez,71,254,127,452
20239,2020-01-17,(07110) PALOQUEMAO,2203,1325,1118,4646
20240,2020-03-11,(06001) Modelia,2418,1484,1201,5103
20241,2020-07-03,(50003) Corral Molinos,1671,894,1200,3765
20242,2020-03-30,(09104) Restrepo,690,474,558,1722
20243,2020-04-15,(09104) Restrepo,764,490,596,1850
20244,2020-01-05,(09103) Olaya,711,343,689,1743
20245,2020-01-09,(09103) Olaya,2844,1681,1935,6460
20246,2020-07-01,(09103) Olaya,1107,626,597,2330
20247,2020-06-11,(14001) La Sabana,164,111,101,376
20248,2020-04-18,(07111) NQS - RICAURTE,347,219,150,716
20249,2020-09-06,(07002) MADELENA,266,126,230,622
20250,2020-05-17,(05000) Portal Américas,510,335,425,1270
20251,2020-01-24,(05107) Américas - Cr.53,2302,1297,1261,4860
20252,2020-02-03,(10001) Country Sur,5068,2264,2843,10175
20253,2020-05-04,(09000) Cabecera Usme - alimentacion,5263,2793,3104,11160
20254,2020-09-25,(09000) Cabecera Usme - alimentacion,9836,4956,6350,21142
20255,2020-01-22,(03000) Portal Suba,8061,4932,4929,17922
20256,2020-03-11,(10000) Portal 20 de Julio,8518,3964,3786,16268
20257,2020-09-28,(12001) Carrera 43,504,293,324,1121
20258,2020-09-16,(50003) Corral Molinos,1601,813,1330,3744
20259,2020-08-01,(06105) Quinta Paredes,98,51,53,202
20260,2020-02-19,(07106) EL CAMPIN,2217,1381,1154,4752
20261,2020-09-08,(03000) Portal Suba,1460,914,1011,3385
20262,2020-09-26,(03000) Portal Suba,1131,613,1090,2834
20263,2020-10-05,(09101) Quiroga,568,285,493,1346
20264,2020-04-16,(03000) Portal Suba - alimentacion,3412,1926,1714,7052
20265,2020-03-22,(07503) SAN MATEO,2681,1261,1187,5129
20266,2020-07-23,(10002) Av. Primero de Mayo,1564,783,921,3268
20267,2020-07-20,(07112) COMUNEROS,232,146,156,534
20268,2020-10-08,(08001) Parque el Tunal,555,292,454,1301
20269,2020-09-30,(02101) Toberín,1893,1151,1432,4476
20270,2020-04-24,(06108) Concejo de Bogotá,103,75,66,244
20271,2020-07-10,(10001) Country Sur,1386,620,834,2840
20272,2020-02-06,(09120) Calle 63,7101,4738,3842,15681
20273,2020-05-22,(09120) Calle 63,888,636,556,2080
20274,2020-09-25,(09120) Calle 63,1297,913,995,3205
20275,2020-06-12,(04000) Cabecera Calle 80 - alimentacion,4117,2265,2520,8902
20276,2020-05-14,(09107) Hortúa,525,320,238,1083
20277,2020-09-04,(05002) Tintal,2867,1653,1863,6383
20278,2020-01-02,(05105) Pradera,1049,692,696,2437
20279,2020-01-23,(03007) HUMEDAL CORDOBA,964,600,529,2093
20280,2020-06-24,(03012) SUBA - CALLE 95,380,224,180,784
20281,2020-08-28,(03012) SUBA - CALLE 95,326,189,222,737
20282,2020-09-11,(10000) Portal 20 de Julio,2318,1088,1181,4587
20283,2020-07-02,(09119) Calle 57,602,375,433,1410
20284,2020-03-14,(02104) Calle 146,2956,1445,2482,6883
20285,2020-03-16,(02104) Calle 146,5034,3153,2537,10724
20286,2020-04-27,(05105) Pradera,83,195,73,351
20287,2020-05-06,(02205) Calle 106,199,158,114,471
20288,2020-09-07,(02205) Calle 106,434,281,258,973
20289,2020-04-30,(05002) Tintal,1530,833,862,3225
20290,2020-01-30,(10008) San Diego,1422,794,753,2969
20291,2020-08-26,(09118) Marly,1315,828,733,2876
20292,2020-10-09,(04003) Avenida Ciudad de Cali,1074,646,1216,2936
20293,2020-01-24,(12007) Zona Industrial,1168,759,592,2519
20294,2020-09-20,(09000) Cabecera Usme,552,283,601,1436
20295,2020-02-10,(07201) Guatoque -Veraguas,1087,550,649,2286
20296,2020-04-01,(10006) San Victorino,194,135,155,484
20297,2020-07-25,(09000) Cabecera Usme,987,565,821,2373
20298,2020-07-01,(07000) Portal Sur,1934,1244,1153,4331
20299,2020-05-04,(02000) Cabecera Autopista Norte - alimentacion,3231,1822,1600,6653
20300,2020-03-03,(06101) El Tiempo,2787,1701,1535,6023
20301,2020-06-17,(07104) Simon Bolivar,646,366,296,1308
20302,2020-05-08,(10005) Bicentenario - alimentacion,175,76,123,374
20303,2020-03-11,(04107) Escuela Militar,624,394,410,1428
20304,2020-10-06,(04107) Escuela Militar,182,111,126,419
20305,2020-02-21,(03006) NIZA - CALLE 127,2329,1393,1364,5086
20306,2020-08-21,(07004) VENECIA,969,573,551,2093
20307,2020-08-22,(09121) Las Flores,449,310,373,1132
20308,2020-10-11,(03007) HUMEDAL CORDOBA,41,28,71,140
20309,2020-01-14,(04107) Escuela Militar,520,353,341,1214
20310,2020-02-02,(07103) AV. CHILE,558,377,765,1700
20311,2020-09-24,(07004) VENECIA,1178,706,766,2650
20312,2020-09-24,(03001) LA CAMPIÑA,1329,802,943,3074
20313,2020-09-15,(06101) El Tiempo,382,228,260,870
20314,2020-08-26,(09117) Calle 45,594,379,403,1376
20315,2020-03-12,(09117) Calle 45,2257,416,606,3279
20316,2020-05-10,(10001) Country Sur,248,96,174,518
20317,2020-03-20,(02205) Calle 106,199,148,112,459
20318,2020-09-04,(08000) Portal Tunal,812,360,394,1566
20319,2020-01-13,(40001) Juan Pablo II,1381,767,872,3020
20320,2020-08-21,(02200) Alcalá,1695,1065,938,3698
20321,2020-05-17,(05001) Patio Bonito,412,216,248,876
20322,2020-07-19,(05001) Patio Bonito,404,219,299,922
20323,2020-07-20,(03001) LA CAMPIÑA,250,158,156,564
20324,2020-08-15,(07109) CAD,410,291,268,969
20325,2020-01-04,(40001) Juan Pablo II,782,383,541,1706
20326,2020-09-20,(08000) Portal Tunal - alimentacion,2360,1006,1786,5152
20327,2020-01-24,(04101) Minuto de Dios,2491,1404,1632,5527
20328,2020-06-09,(02302) Virrey,604,408,308,1320
20329,2020-09-29,(06000) Portal Eldorado - alimentacion,4316,2193,2735,9244
20330,2020-08-05,(12003) Ricaurte,349,221,159,729
20331,2020-05-30,(03010) PUENTE LARGO,194,138,122,454
20332,2020-08-31,(10010) San Bernardo,612,307,374,1293
20333,2020-03-24,(05002) Tintal,1896,1041,1185,4122
20334,2020-09-01,(06001) Modelia,378,233,260,871
20335,2020-03-24,(02105) Calle 142,707,516,530,1753
20336,2020-04-15,(09109) Tercer Milenio,157,95,112,364
20337,2020-02-02,(07007) NQS - Calle 38A Sur,644,332,489,1465
20338,2020-10-01,(05107) Américas - Cr.53,471,292,381,1144
20339,2020-07-05,(10010) San Bernardo,232,129,210,571
20340,2020-05-22,(02103) Mazurén,149,102,113,364
20341,2020-01-15,(07103) AV. CHILE,3335,1960,1737,7032
20342,2020-09-29,(06109) Centro Memoria,303,214,213,730
20343,2020-04-01,(10005) Bicentenario,40,28,36,104
20344,2020-07-03,(02304) Heroes,911,625,548,2084
20345,2020-07-26,(03001) LA CAMPIÑA,242,138,169,549
20346,2020-07-28,(09123) Calle 76,954,703,562,2219
20347,2020-08-04,(07003) SEVILLANA,402,203,250,855
20348,2020-08-06,(07004) VENECIA,895,525,579,1999
20349,2020-08-10,(07004) VENECIA,917,575,494,1986
20350,2020-09-22,(03011) SUBA - CALLE 100,628,288,326,1242
20351,2020-06-09,(05105) Pradera,472,309,228,1009
20352,2020-10-01,(09115) Calle 34,760,470,628,1858
20353,2020-04-30,(02204) Pepe Sierra,501,374,268,1143
20354,2020-06-22,(07110) PALOQUEMAO,162,117,99,378
20355,2020-10-04,(04000) Cabecera Calle 80,373,217,547,1137
20356,2020-10-12,(06100) Av. Rojas,49,27,97,173
20357,2020-03-15,(10003) Ciudad Jardín,154,81,183,418
20358,2020-07-04,(09106) Nariño,317,196,260,773
20359,2020-05-28,(07004) VENECIA,873,502,446,1821
20360,2020-07-22,(09000) Cabecera Usme,1216,778,916,2910
20361,2020-06-06,(06109) Centro Memoria,196,126,108,430
20362,2020-01-14,(04101) Minuto de Dios,2067,1245,1386,4698
20363,2020-08-02,(09114) Calle 26,59,38,69,166
20364,2020-05-26,(07107) U. NACIONAL,293,177,151,621
20365,2020-08-29,(07003) SEVILLANA,335,183,239,757
20366,2020-07-11,(10007) Las Nieves,521,367,379,1267
20367,2020-05-05,(07004) VENECIA,614,383,374,1371
20368,2020-10-04,(07105) MOVISTAR ARENA,65,47,118,230
20369,2020-04-27,(02104) Calle 146,180,143,76,399
20370,2020-07-09,(04103) Las Ferias,386,213,191,790
20371,2020-05-16,(04104) Avenida 68,344,211,174,729
20372,2020-05-04,(02205) Calle 106,212,162,126,500
20373,2020-04-11,(07001) PERDOMO,247,136,129,512
20374,2020-06-06,(02304) Heroes,459,346,318,1123
20375,2020-04-08,(08002) Biblioteca,166,90,90,346
20376,2020-06-16,(09122) Calle 72,1206,856,718,2780
20377,2020-08-30,(14005) Las Aguas,58,42,124,224
20378,2020-03-16,(12000) Puente Aranda,221,145,141,507
20379,2020-08-22,(12000) Puente Aranda,57,47,32,136
20380,2020-03-25,(07103) AV. CHILE,416,359,285,1060
20381,2020-10-03,(05100) Banderas P. Central,801,342,776,1919
20382,2020-02-24,(04102) Avenida Boyaca,3156,1900,1588,6644
20383,2020-06-14,(10006) San Victorino,99,72,113,284
20384,2020-10-05,(02102) Calle 161,286,165,274,725
20385,2020-05-19,(12004) Carrera 22,168,106,92,366
20386,2020-06-20,(10009) Museo Nacional,247,182,300,729
20387,2020-09-29,(07105) MOVISTAR ARENA,272,155,203,630
20388,2020-01-09,(10004) Policarpa,596,328,459,1383
20389,2020-08-13,(02201) Prado,734,495,429,1658
20390,2020-08-07,(03013) RIO NEGRO,85,54,80,219
20391,2020-04-11,(10000) Portal 20 de Julio,696,352,308,1356
20392,2020-06-19,(50003) Corral Molinos,1547,824,1144,3515
20393,2020-06-15,(10010) San Bernardo,246,128,188,562
20394,2020-09-27,(02205) Calle 106,70,61,141,272
20395,2020-04-08,(14001) La Sabana,71,54,57,182
20396,2020-05-05,(12002) CDS - Carrera 32,202,133,53,388
20397,2020-06-26,(04102) Avenida Boyaca,387,216,269,872
20398,2020-07-09,(09106) Nariño,407,283,319,1009
20399,2020-05-03,(07506) DESPENSA,91,44,54,189
20400,2020-09-13,(02103) Mazurén,44,33,70,147
20401,2020-07-19,(07009) SENA,196,98,132,426
20402,2020-04-20,(04103) Las Ferias,179,121,97,397
20403,2020-09-15,(07105) MOVISTAR ARENA,267,156,156,579
20404,2020-08-20,(07506) DESPENSA,459,253,237,949
20405,2020-09-07,(07006) General Santander - alimentacion,400,211,280,891
20406,2020-10-07,(07006) General Santander - alimentacion,403,224,383,1010
20407,2020-04-16,(09116) Avenida 39,175,131,123,429
20408,2020-04-17,(12007) Zona Industrial,224,165,102,491
20409,2020-07-25,(07010) Bosa,457,215,253,925
20410,2020-08-17,(02303) Calle 85,162,136,127,425
20411,2020-09-18,(10003) Ciudad Jardín,247,124,213,584
20412,2020-03-14,(07200) Tygua-San José,422,261,446,1129
20413,2020-01-01,(10006) San Victorino,53,72,208,333
20414,2020-06-22,(07102) NQS - CALLE 75,95,73,79,247
20415,2020-04-28,(03011) SUBA - CALLE 100,307,164,137,608
20416,2020-05-08,(07008) NQS - Calle 30 Sur,163,102,96,361
20417,2020-04-25,(05101) Mandalay - Cr.73,39,26,20,85
20418,2020-07-05,(05101) Mandalay - Cr.73,24,9,21,54
20419,2020-08-07,(05101) Mandalay - Cr.73,47,18,22,87
20420,2020-04-28,(07201) Guatoque -Veraguas,110,71,81,262
20421,2020-04-07,(03007) HUMEDAL CORDOBA,74,49,40,163
20422,2020-04-18,(07006) General Santander,165,101,105,371
20423,2020-04-15,(12003) Ricaurte,134,125,78,337
20424,2020-08-16,(03010) PUENTE LARGO,70,43,69,182
20425,2020-03-23,(10005) Bicentenario - alimentacion,49,25,39,113
20426,2020-07-01,(50002) Corral Calle 40 Sur,31,12,21,64
20427,2020-07-04,(06106) Recinto Ferial,227,146,149,522
20428,2020-09-14,(10005) Bicentenario,105,60,77,242
20429,2020-07-29,(07101) CASTELLANA,194,100,90,384
20430,2020-05-06,(07101) CASTELLANA,115,71,91,277
20431,2020-01-06,(07201) Guatoque -Veraguas,59,58,177,294
20432,2020-04-18,(12002) CDS - Carrera 32,121,76,35,232
20433,2020-04-29,(06105) Quinta Paredes,83,59,43,185
20434,2020-05-03,(05100) Banderas P. Central,101,50,72,223
20435,2020-04-19,(10006) San Victorino,52,36,61,149
20436,2020-09-18,(50002) Corral Calle 40 Sur,36,14,34,84
20437,2020-05-22,(05102) Av. Américas - Av. Boyacá,187,91,126,404
20438,2020-05-31,(09114) Calle 26,55,38,50,143
20439,2020-03-29,(06106) Recinto Ferial,40,43,31,114
20440,2020-06-07,(05101) Mandalay - Cr.73,19,9,9,37
20441,2020-06-07,(09108) Hospital,31,21,30,82
20442,2020-09-21,(12000) Puente Aranda,53,45,50,148
20443,2020-04-26,(06105) Quinta Paredes,17,19,17,53
20444,2020-06-01,(03014) SAN MARTIN,28,12,24,64
20445,2020-09-22,(03014) SAN MARTIN,0,15,37,52
20446,2020-05-08,(03004) GRATAMIRA,33,18,9,60
20447,2020-07-15,(50002) Corral Calle 40 Sur,13,11,18,42
20448,2020-07-04,(50002) Corral Calle 40 Sur,13,6,17,36
20449,2020-05-09,(50002) Corral Calle 40 Sur,5,2,11,18
20450,2020-07-02,(04000) Cabecera Calle 80 - alimentacion,4411,2537,2907,9855
20451,2020-07-15,(09002) Consuelo,336,162,182,680
20452,2020-08-20,(09002) Consuelo,462,232,289,983
20453,2020-09-10,(09002) Consuelo,463,240,301,1004
20454,2020-01-06,(09118) Marly,999,627,971,2597
20455,2020-01-10,(08000) Portal Tunal - alimentacion,18869,9496,10017,38382
20456,2020-02-19,(04106) Carrera 47,1543,850,870,3263
20457,2020-02-07,(02303) Calle 85,3658,2552,2089,8299
20458,2020-02-12,(09003) Socorro,1725,1013,1050,3788
20459,2020-02-22,(05000) Portal Américas - alimentacion,25491,12964,15783,54238
20460,2020-09-08,(05000) Portal Américas - alimentacion,11495,6138,6341,23974
20461,2020-02-24,(06107) Ciudad Universitaria,1624,917,859,3400
20462,2020-07-24,(06107) Ciudad Universitaria,158,91,113,362
20463,2020-06-20,(05001) Patio Bonito,1572,869,954,3395
20464,2020-01-16,(09000) Cabecera Usme - alimentacion,23193,12033,14584,49810
20465,2020-01-07,(06000) Portal Eldorado - alimentacion,11794,6251,7229,25274
20466,2020-01-15,(09115) Calle 34,3531,2357,2203,8091
20467,2020-03-09,(09115) Calle 34,2051,285,535,2871
20468,2020-03-04,(05100) Banderas P. Central - alimentacion,15770,9208,8640,33618
20469,2020-03-05,(07002) MADELENA,4963,2721,2728,10412
20470,2020-02-27,(10003) Ciudad Jardín,1035,561,681,2277
20471,2020-02-07,(10002) Av. Primero de Mayo,8564,4100,4818,17482
20472,2020-01-31,(02204) Pepe Sierra,4738,3146,2409,10293
20473,2020-04-13,(07001) PERDOMO,428,268,258,954
20474,2020-03-04,(05103) Marsella,3182,1840,1450,6472
20475,2020-01-29,(09110) Avenida Jimenez,4937,3222,2809,10968
20476,2020-02-24,(05002) Tintal,10724,6798,6084,23606
20477,2020-03-31,(02502) Terminal,124,106,143,373
20478,2020-03-14,(12003) Ricaurte,673,579,559,1811
20479,2020-03-19,(12003) Ricaurte,838,602,431,1871
20480,2020-01-08,(09101) Quiroga,1250,695,992,2937
20481,2020-07-28,(09000) Cabecera Usme - alimentacion,8050,4409,4458,16917
20482,2020-06-14,(07000) Portal Sur - alimentacion,2353,1157,1194,4704
20483,2020-01-24,(09110) Avenida Jimenez,4293,3074,2798,10165
20484,2020-03-04,(07110) PALOQUEMAO,2631,1648,1321,5600
20485,2020-01-27,(03001) LA CAMPIÑA,6236,3833,3970,14039
20486,2020-08-18,(05100) Banderas P. Central - alimentacion,2853,1449,1591,5893
20487,2020-03-14,(14001) La Sabana,279,241,280,800
20488,2020-09-22,(14001) La Sabana,163,98,118,379
20489,2020-03-05,(07107) U. NACIONAL,2246,1811,1921,5978
20490,2020-09-12,(09113) Calle 22,384,212,346,942
20491,2020-01-29,(04105) Carrera 53,1381,792,789,2962
20492,2020-07-18,(09001) Molinos,1494,768,1018,3280
20493,2020-02-17,(02104) Calle 146,9601,6349,4932,20882
20494,2020-03-06,(02104) Calle 146,9094,5181,5066,19341
20495,2020-07-02,(50003) Corral Molinos,1603,861,1140,3604
20496,2020-05-14,(08000) Portal Tunal - alimentacion,4835,2661,2349,9845
20497,2020-01-09,(06109) Centro Memoria,810,461,537,1808
20498,2020-04-06,(10000) Portal 20 de Julio - alimentacion,2745,960,1397,5102
20499,2020-01-17,(12001) Carrera 43,1424,834,970,3228
20500,2020-07-16,(12001) Carrera 43,378,203,206,787
20501,2020-02-25,(09107) Hortúa,2550,1496,1515,5561
20502,2020-02-19,(06111) Universidades,6170,3719,2588,12477
20503,2020-08-13,(03000) Portal Suba,965,636,727,2328
20504,2020-02-15,(10010) San Bernardo,1003,576,1136,2715
20505,2020-02-18,(10002) Av. Primero de Mayo,8678,4445,4605,17728
20506,2020-05-15,(07010) Bosa,581,306,323,1210
20507,2020-01-21,(09116) Avenida 39,1662,1137,1049,3848
20508,2020-08-22,(07000) Portal Sur,1409,789,1031,3229
20509,2020-08-16,(10002) Av. Primero de Mayo,493,259,600,1352
20510,2020-01-03,(09004) Santa Lucía,4225,2106,2891,9222
20511,2020-06-27,(09004) Santa Lucía,2262,1110,1366,4738
20512,2020-07-09,(09004) Santa Lucía,2667,1407,1432,5506
20513,2020-02-05,(07108) Av. El Dorado,981,601,604,2186
20514,2020-03-09,(09118) Marly,3058,619,806,4483
20515,2020-07-28,(08001) Parque el Tunal,454,250,259,963
20516,2020-08-20,(02302) Virrey,567,399,342,1308
20517,2020-04-07,(02000) Cabecera Autopista Norte,494,323,345,1162
20518,2020-06-03,(02000) Cabecera Autopista Norte,1160,755,642,2557
20519,2020-03-18,(06001) Modelia,1180,744,589,2513
20520,2020-08-25,(06102) Salitre El Greco,196,116,127,439
20521,2020-08-18,(05002) Tintal,2388,1346,1344,5078
20522,2020-04-23,(50003) Corral Molinos,768,422,591,1781
20523,2020-01-15,(02300) Calle 100,6275,3890,3575,13740
20524,2020-05-04,(10000) Portal 20 de Julio,1433,720,721,2874
20525,2020-07-18,(08000) Portal Tunal - alimentacion,3480,1907,2100,7487
20526,2020-01-16,(08000) Portal Tunal,1768,1053,1011,3832
20527,2020-04-01,(05005) Transversal 86,168,101,75,344
20528,2020-04-14,(05005) Transversal 86,184,97,99,380
20529,2020-07-16,(02202) Calle 127,1021,734,471,2226
20530,2020-07-31,(10008) San Diego,283,136,138,557
20531,2020-08-02,(10008) San Diego,83,54,77,214
20532,2020-01-19,(04105) Carrera 53,318,174,318,810
20533,2020-01-20,(09106) Nariño,1737,1080,1303,4120
20534,2020-04-28,(08000) Portal Tunal,492,208,189,889
20535,2020-02-28,(03006) NIZA - CALLE 127,2398,1519,1447,5364
20536,2020-02-05,(12007) Zona Industrial,1297,829,647,2773
20537,2020-03-17,(10009) Museo Nacional,2414,1377,1089,4880
20538,2020-02-14,(07201) Guatoque -Veraguas,1024,506,611,2141
20539,2020-09-02,(02201) Prado,922,624,591,2137
20540,2020-02-08,(07113) SANTA ISABEL,1285,655,1006,2946
20541,2020-02-01,(09121) Las Flores,1589,1061,1531,4181
20542,2020-10-10,(03006) NIZA - CALLE 127,378,262,341,981
20543,2020-07-08,(02101) Toberín,1612,1002,1005,3619
20544,2020-01-14,(06101) El Tiempo,2304,1278,1179,4761
20545,2020-03-10,(04107) Escuela Militar,275,76,141,492
20546,2020-09-30,(04107) Escuela Militar,171,119,112,402
20547,2020-10-07,(09121) Las Flores,748,495,631,1874
20548,2020-08-27,(04101) Minuto de Dios,313,196,255,764
20549,2020-05-15,(04108) El Polo,367,227,185,779
20550,2020-05-10,(02304) Heroes,167,120,97,384
20551,2020-03-07,(04103) Las Ferias,809,454,703,1966
20552,2020-09-17,(03001) LA CAMPIÑA,1342,784,857,2983
20553,2020-08-13,(03001) LA CAMPIÑA,925,505,544,1974
20554,2020-03-31,(09114) Calle 26,142,130,126,398
20555,2020-04-17,(02202) Calle 127,655,449,315,1419
20556,2020-06-30,(02202) Calle 127,1199,828,668,2695
20557,2020-07-01,(02202) Calle 127,1201,817,650,2668
20558,2020-07-15,(02202) Calle 127,1061,695,470,2226
20559,2020-05-27,(04001) Quirigua,320,187,197,704
20560,2020-05-13,(05002) Tintal,1596,872,873,3341
20561,2020-08-24,(07101) CASTELLANA,220,108,103,431
20562,2020-08-16,(09116) Avenida 39,71,50,71,192
20563,2020-01-09,(07103) AV. CHILE,2567,1597,1429,5593
20564,2020-08-20,(07109) CAD,584,361,279,1224
20565,2020-07-17,(09120) Calle 63,821,559,587,1967
20566,2020-08-30,(02302) Virrey,163,114,159,436
20567,2020-02-11,(12003) Ricaurte,1340,820,635,2795
20568,2020-06-29,(03010) PUENTE LARGO,91,73,86,250
20569,2020-03-29,(04100) Carrera 77,180,113,121,414
20570,2020-04-12,(03013) RIO NEGRO,43,26,28,97
20571,2020-06-20,(03006) NIZA - CALLE 127,414,241,207,862
20572,2020-03-15,(02502) Terminal,234,241,566,1041
20573,2020-02-04,(10005) Bicentenario,877,435,370,1682
20574,2020-08-07,(10010) San Bernardo,292,142,193,627
20575,2020-04-11,(09123) Calle 76,249,232,157,638
20576,2020-07-01,(02103) Mazurén,218,147,207,572
20577,2020-09-30,(06109) Centro Memoria,307,171,196,674
20578,2020-01-29,(40002) Manitas,1219,731,721,2671
20579,2020-03-26,(40002) Manitas,149,85,123,357
20580,2020-03-30,(40002) Manitas,152,68,114,334
20581,2020-01-02,(12002) CDS - Carrera 32,201,155,172,528
20582,2020-06-14,(10003) Ciudad Jardín,61,28,49,138
20583,2020-03-08,(07003) SEVILLANA,361,188,402,951
20584,2020-04-01,(05100) Banderas P. Central - alimentacion,1508,660,693,2861
20585,2020-04-15,(09114) Calle 26,163,133,138,434
20586,2020-07-07,(09114) Calle 26,349,209,218,776
20587,2020-01-14,(02102) Calle 161,1527,942,992,3461
20588,2020-01-07,(06105) Quinta Paredes,595,323,380,1298
20589,2020-03-15,(07006) General Santander,497,274,447,1218
20590,2020-03-10,(09106) Nariño,206,490,425,1121
20591,2020-02-02,(02103) Mazurén,277,166,461,904
20592,2020-09-16,(09003) Socorro,626,336,418,1380
20593,2020-04-09,(05105) Pradera,112,71,54,237
20594,2020-03-25,(09004) Santa Lucía,1131,586,577,2294
20595,2020-07-01,(07111) NQS - RICAURTE,1221,731,486,2438
20596,2020-04-25,(09115) Calle 34,243,188,135,566
20597,2020-05-21,(07005) ALQUERIA,444,267,236,947
20598,2020-03-28,(07000) Portal Sur,598,342,343,1283
20599,2020-05-23,(02200) Alcalá,1144,801,607,2552
20600,2020-03-11,(40002) Manitas,1249,698,712,2659
20601,2020-09-29,(09107) Hortúa,663,355,470,1488
20602,2020-09-28,(09111) Calle 19,773,480,585,1838
20603,2020-07-10,(05102) Av. Américas - Av. Boyacá,240,145,175,560
20604,2020-06-11,(06109) Centro Memoria,270,160,128,558
20605,2020-09-09,(03003) 21 ANGELES,384,186,197,767
20606,2020-05-08,(10006) San Victorino,271,173,200,644
20607,2020-07-30,(08000) Portal Tunal,706,271,258,1235
20608,2020-06-21,(06107) Ciudad Universitaria,48,26,46,120
20609,2020-01-05,(40002) Manitas,243,123,256,622
20610,2020-08-25,(03005) SUBA - AV. BOYACA,428,233,266,927
20611,2020-08-07,(04104) Avenida 68,207,114,128,449
20612,2020-09-02,(09122) Calle 72,1259,862,872,2993
20613,2020-03-31,(07109) CAD,371,282,217,870
20614,2020-06-02,(09122) Calle 72,1022,736,616,2374
20615,2020-07-13,(04000) Cabecera Calle 80 - intermunicipal,293,172,265,730
20616,2020-04-20,(07103) AV. CHILE,532,373,193,1098
20617,2020-08-14,(07107) U. NACIONAL,334,180,174,688
20618,2020-08-14,(09111) Calle 19,772,413,491,1676
20619,2020-08-03,(06001) Modelia,300,201,196,697
20620,2020-03-30,(03013) RIO NEGRO,136,92,99,327
20621,2020-08-02,(10009) Museo Nacional,74,62,93,229
20622,2020-06-19,(04106) Carrera 47,356,180,183,719
20623,2020-04-22,(03013) RIO NEGRO,170,112,105,387
20624,2020-03-28,(09109) Tercer Milenio,101,56,65,222
20625,2020-05-23,(07102) NQS - CALLE 75,206,163,130,499
20626,2020-09-28,(09003) Socorro,633,335,400,1368
20627,2020-07-27,(02201) Prado,835,541,497,1873
20628,2020-05-21,(09002) Consuelo,403,205,231,839
20629,2020-01-01,(02103) Mazurén,81,39,160,280
20630,2020-09-09,(06106) Recinto Ferial,271,146,150,567
20631,2020-06-12,(07008) NQS - Calle 30 Sur,316,161,192,669
20632,2020-02-09,(02303) Calle 85,463,376,614,1453
20633,2020-01-04,(12002) CDS - Carrera 32,140,98,157,395
20634,2020-08-03,(12002) CDS - Carrera 32,169,102,61,332
20635,2020-06-27,(07108) Av. El Dorado,109,73,77,259
20636,2020-08-10,(07108) Av. El Dorado,147,88,74,309
20637,2020-10-01,(06103) CAN,428,276,264,968
20638,2020-04-26,(04000) Cabecera Calle 80 - intermunicipal,22,13,23,58
20639,2020-07-30,(06100) Av. Rojas,184,130,119,433
20640,2020-07-31,(04001) Quirigua,281,190,152,623
20641,2020-01-06,(09121) Las Flores,456,293,527,1276
20642,2020-01-19,(07107) U. NACIONAL,228,217,450,895
20643,2020-03-01,(03009) Av. Suba- Calle 116,356,252,502,1110
20644,2020-05-27,(06105) Quinta Paredes,118,76,60,254
20645,2020-07-10,(07006) General Santander - alimentacion,403,244,258,905
20646,2020-08-18,(07006) General Santander - alimentacion,338,191,219,748
20647,2020-06-26,(04106) Carrera 47,339,180,193,712
20648,2020-08-29,(05101) Mandalay - Cr.73,121,57,74,252
20649,2020-04-21,(07506) DESPENSA,247,140,151,538
20650,2020-04-26,(04100) Carrera 77,228,147,165,540
20651,2020-09-16,(07008) NQS - Calle 30 Sur,377,199,234,810
20652,2020-05-12,(04106) Carrera 47,242,125,138,505
20653,2020-07-01,(07109) CAD,599,408,354,1361
20654,2020-07-13,(10004) Policarpa,173,85,122,380
20655,2020-05-25,(02000) Cabecera Autopista Norte - intermunicipal,92,84,83,259
20656,2020-09-27,(07006) General Santander,200,92,213,505
20657,2020-03-29,(10006) San Victorino,64,39,45,148
20658,2020-04-19,(07004) VENECIA,174,93,100,367
20659,2020-05-07,(03013) RIO NEGRO,204,137,133,474
20660,2020-08-07,(06103) CAN,159,111,71,341
20661,2020-08-01,(06104) Gobernación,128,79,91,298
20662,2020-08-31,(03005) SUBA - AV. BOYACA,454,258,284,996
20663,2020-06-03,(04105) Carrera 53,268,153,121,542
20664,2020-10-04,(07200) Tygua-San José,90,49,120,259
20665,2020-10-10,(09105) Río Fucha,0,65,152,217
20666,2020-01-01,(06100) Av. Rojas,72,50,152,274
20667,2020-03-23,(09105) Río Fucha,31,15,24,70
20668,2020-04-26,(02204) Pepe Sierra,167,137,109,413
20669,2020-04-24,(14005) Las Aguas,0,40,93,133
20670,2020-03-21,(12002) CDS - Carrera 32,66,38,43,147
20671,2020-03-21,(09003) Socorro,164,82,85,331
20672,2020-03-23,(02102) Calle 161,32,21,30,83
20673,2020-08-22,(06105) Quinta Paredes,86,54,61,201
20674,2019-12-31,(03011) SUBA - CALLE 100,44,6,30,80
20675,2020-03-23,(05103) Marsella,65,42,46,153
20676,2020-08-09,(04000) Cabecera Calle 80 - intermunicipal,42,23,35,100
20677,2020-04-04,(07007) NQS - Calle 38A Sur,117,77,74,268
20678,2020-08-23,(04101) Minuto de Dios,76,46,99,221
20679,2020-08-06,(03014) SAN MARTIN,0,15,28,43
20680,2020-05-18,(05101) Mandalay - Cr.73,95,47,40,182
20681,2020-09-04,(03014) SAN MARTIN,0,16,44,60
20682,2020-07-05,(08002) Biblioteca,99,43,69,211
20683,2020-02-10,(04000) Cabecera Calle 80 - alimentacion,24541,15552,14694,54787
20684,2020-02-20,(07005) ALQUERIA,2613,1476,1368,5457
20685,2020-02-07,(07504) TERREROS,18242,10539,9810,38591
20686,2020-03-19,(07504) TERREROS,10991,6116,5498,22605
20687,2020-03-06,(03000) Portal Suba - alimentacion,28859,15930,17196,61985
20688,2020-04-18,(05000) Portal Américas - alimentacion,4588,2449,1848,8885
20689,2020-01-22,(02101) Toberín,13980,8741,7363,30084
20690,2020-08-10,(07503) SAN MATEO,11092,6112,4936,22140
20691,2020-09-24,(05000) Portal Américas,3790,2095,2542,8427
20692,2020-02-07,(08001) Parque el Tunal,1756,958,1054,3768
20693,2020-02-29,(04101) Minuto de Dios,1528,892,1369,3789
20694,2020-06-01,(10000) Portal 20 de Julio - alimentacion,4017,1838,2225,8080
20695,2020-05-01,(04000) Cabecera Calle 80 - alimentacion,921,514,544,1979
20696,2020-02-28,(06107) Ciudad Universitaria,1460,895,936,3291
20697,2020-02-29,(06107) Ciudad Universitaria,596,402,743,1741
20698,2020-02-06,(09001) Molinos,7488,4693,5913,18094
20699,2020-03-13,(02000) Cabecera Autopista Norte - intermunicipal,348,788,767,1903
20700,2020-01-20,(14004) Museo del Oro,3072,1947,1708,6727
20701,2020-02-10,(05005) Transversal 86,2836,1730,1307,5873
20702,2020-10-08,(05100) Banderas P. Central,1177,667,922,2766
20703,2020-05-11,(09100) Calle 40 Sur,1249,740,739,2728
20704,2020-02-12,(09000) Cabecera Usme,6132,3708,3999,13839
20705,2020-08-21,(09000) Cabecera Usme,1678,994,1231,3903
20706,2020-03-14,(09115) Calle 34,1366,1000,1459,3825
20707,2020-01-24,(05100) Banderas P. Central - alimentacion,13973,7278,7880,29131
20708,2020-02-04,(06102) Salitre El Greco,1644,898,813,3355
20709,2020-02-18,(10003) Ciudad Jardín,1109,598,690,2397
20710,2020-02-05,(09120) Calle 63,7412,4568,4021,16001
20711,2020-02-07,(04000) Cabecera Calle 80 - intermunicipal,2340,1622,2282,6244
20712,2020-06-11,(09104) Restrepo,1431,866,965,3262
20713,2020-09-08,(04101) Minuto de Dios,365,203,288,856
20714,2020-01-02,(03000) Portal Suba - alimentacion,12177,6710,8344,27231
20715,2020-01-24,(09123) Calle 76,4753,3325,2956,11034
20716,2020-01-01,(07110) PALOQUEMAO,97,94,226,417
20717,2020-01-08,(07110) PALOQUEMAO,1713,995,880,3588
20718,2020-02-20,(12003) Ricaurte,1325,833,652,2810
20719,2020-08-06,(08000) Portal Tunal - alimentacion,5927,3237,3430,12594
20720,2020-06-04,(07102) NQS - CALLE 75,377,251,193,821
20721,2020-07-30,(03013) RIO NEGRO,297,168,161,626
20722,2020-02-17,(07110) PALOQUEMAO,2731,1667,1192,5590
20723,2020-02-13,(02103) Mazurén,3546,2121,1886,7553
20724,2020-03-26,(09103) Olaya,446,255,239,940
20725,2020-07-19,(09103) Olaya,253,136,167,556
20726,2020-01-16,(14001) La Sabana,316,256,322,894
20727,2020-01-07,(04105) Carrera 53,898,506,557,1961
20728,2020-04-28,(50003) Corral Molinos,898,447,624,1969
20729,2020-10-03,(04000) Cabecera Calle 80,1002,510,1140,2652
20730,2020-09-25,(09123) Calle 76,1116,766,864,2746
20731,2020-02-04,(10001) Country Sur,5376,2367,2695,10438
20732,2020-06-30,(10001) Country Sur,1318,626,822,2766
20733,2020-04-22,(09111) Calle 19,268,169,244,681
20734,2020-07-04,(10006) San Victorino,532,275,311,1118
20735,2020-08-19,(10006) San Victorino,394,239,304,937
20736,2020-02-26,(06000) Portal Eldorado,6803,3901,2925,13629
20737,2020-03-05,(06000) Portal Eldorado,6513,3746,2861,13120
20738,2020-02-12,(40003) Mirador del Paraiso,4935,2828,2589,10352
20739,2020-01-13,(12001) Carrera 43,1415,835,864,3114
20740,2020-05-05,(12001) Carrera 43,317,195,180,692
20741,2020-02-09,(04104) Avenida 68,655,361,640,1656
20742,2020-01-31,(06111) Universidades,5256,3317,2698,11271
20743,2020-01-03,(10006) San Victorino,883,598,811,2292
20744,2020-02-24,(02304) Heroes,4791,3191,2277,10259
20745,2020-09-14,(03000) Portal Suba,1422,952,1053,3427
20746,2020-10-06,(02000) Cabecera Autopista Norte - intermunicipal,673,444,576,1693
20747,2020-06-20,(09101) Quiroga,488,214,349,1051
20748,2020-02-06,(06100) Av. Rojas,2823,1585,1436,5844
20749,2020-02-15,(04106) Carrera 47,917,431,627,1975
20750,2020-09-06,(05000) Portal Américas,923,484,916,2323
20751,2020-06-26,(10000) Portal 20 de Julio,2462,1189,1200,4851
20752,2020-05-06,(09116) Avenida 39,232,147,145,524
20753,2020-01-18,(02300) Calle 100,2489,1834,2550,6873
20754,2020-02-11,(07004) VENECIA,4823,2802,2510,10135
20755,2020-07-29,(09118) Marly,1378,896,675,2949
20756,2020-03-17,(09116) Avenida 39,1404,990,883,3277
20757,2020-10-05,(09116) Avenida 39,455,287,363,1105
20758,2020-07-15,(07007) NQS - Calle 38A Sur,358,210,226,794
20759,2020-02-07,(07001) PERDOMO,4859,2721,2731,10311
20760,2020-07-11,(10001) Country Sur,1071,495,739,2305
20761,2020-01-29,(09113) Calle 22,1432,852,1061,3345
20762,2020-08-19,(02201) Prado,808,572,497,1877
20763,2020-03-15,(10000) Portal 20 de Julio,1664,633,1236,3533
20764,2020-08-15,(09107) Hortúa,438,276,346,1060
20765,2020-05-06,(05002) Tintal,1657,913,809,3379
20766,2020-03-15,(05105) Pradera,439,308,362,1109
20767,2020-07-20,(05103) Marsella,99,43,77,219
20768,2020-09-20,(05103) Marsella,160,84,168,412
20769,2020-02-09,(06106) Recinto Ferial,290,136,305,731
20770,2020-03-07,(04002) Carrera 90,2069,919,1580,4568
20771,2020-02-05,(02300) Calle 100,7309,4628,3919,15856
20772,2020-02-07,(03012) SUBA - CALLE 95,1500,936,1017,3453
20773,2020-02-14,(10010) San Bernardo,1826,1050,1426,4302
20774,2020-01-27,(05101) Mandalay - Cr.73,1114,615,551,2280
20775,2020-07-12,(09104) Restrepo,536,326,530,1392
20776,2020-09-20,(09104) Restrepo,537,322,614,1473
20777,2020-05-20,(05005) Transversal 86,310,157,164,631
20778,2020-03-14,(02202) Calle 127,2559,1691,1805,6055
20779,2020-10-03,(02202) Calle 127,845,647,793,2285
20780,2020-07-18,(05105) Pradera,437,274,230,941
20781,2020-07-27,(08000) Portal Tunal,703,289,292,1284
20782,2020-08-01,(06000) Portal Eldorado - alimentacion,2348,1145,1373,4866
20783,2020-04-14,(05002) Tintal,1351,744,639,2734
20784,2020-01-03,(06000) Portal Eldorado - alimentacion,8887,4394,5572,18853
20785,2020-09-27,(06000) Portal Eldorado - alimentacion,1556,668,1279,3503
20786,2020-05-18,(04108) El Polo,402,252,225,879
20787,2020-07-29,(04108) El Polo,469,272,223,964
20788,2020-02-16,(07101) CASTELLANA,63,70,172,305
20789,2020-01-13,(05001) Patio Bonito,5511,3222,3352,12085
20790,2020-08-14,(02201) Prado,772,528,497,1797
20791,2020-09-13,(07106) EL CAMPIN,146,113,135,394
20792,2020-02-11,(07103) AV. CHILE,3843,2333,1994,8170
20793,2020-07-11,(07113) SANTA ISABEL,295,165,259,719
20794,2020-02-15,(04102) Avenida Boyaca,1578,866,1162,3606
20795,2020-06-04,(02101) Toberín,1322,859,820,3001
20796,2020-07-11,(02101) Toberín,1043,620,891,2554
20797,2020-07-04,(09103) Olaya,928,474,531,1933
20798,2020-04-20,(10010) San Bernardo,430,237,263,930
20799,2020-05-28,(10010) San Bernardo,560,297,327,1184
20800,2020-09-10,(04107) Escuela Militar,148,85,99,332
20801,2020-07-03,(07109) CAD,680,399,345,1424
20802,2020-09-29,(07004) VENECIA,1119,650,789,2558
20803,2020-07-05,(04003) Avenida Ciudad de Cali,308,181,276,765
20804,2020-08-03,(04104) Avenida 68,465,233,249,947
20805,2020-06-18,(09109) Tercer Milenio,379,198,273,850
20806,2020-06-27,(09109) Tercer Milenio,302,206,245,753
20807,2020-09-26,(09109) Tercer Milenio,287,172,264,723
20808,2020-05-26,(04002) Carrera 90,640,359,391,1390
20809,2020-08-29,(06101) El Tiempo,210,159,202,571
20810,2020-05-22,(03001) LA CAMPIÑA,881,474,470,1825
20811,2020-08-18,(07004) VENECIA,992,570,532,2094
20812,2020-09-10,(03001) LA CAMPIÑA,1218,644,723,2585
20813,2020-07-30,(06101) El Tiempo,279,171,199,649
20814,2020-08-09,(09101) Quiroga,142,84,148,374
20815,2020-01-01,(04001) Quirigua,130,63,211,404
20816,2020-03-04,(07003) SEVILLANA,2053,1180,1085,4318
20817,2020-06-18,(02204) Pepe Sierra,838,565,422,1825
20818,2020-03-24,(05001) Patio Bonito,1422,745,934,3101
20819,2020-08-24,(02105) Calle 142,654,415,415,1484
20820,2020-09-27,(07009) SENA,230,135,268,633
20821,2020-07-12,(06000) Portal Eldorado,219,175,248,642
20822,2020-09-29,(02302) Virrey,761,534,416,1711
20823,2020-10-03,(06000) Portal Eldorado,634,528,865,2027
20824,2020-08-07,(03012) SUBA - CALLE 95,89,48,66,203
20825,2020-07-11,(03010) PUENTE LARGO,260,157,181,598
20826,2020-10-09,(06001) Modelia,398,241,327,966
20827,2020-03-12,(07107) U. NACIONAL,1062,128,328,1518
20828,2020-05-11,(02105) Calle 142,554,363,333,1250
20829,2020-03-31,(09109) Tercer Milenio,143,81,107,331
20830,2020-04-22,(05107) Américas - Cr.53,321,210,147,678
20831,2020-04-11,(10010) San Bernardo,288,136,180,604
20832,2020-05-24,(05100) Banderas P. Central - alimentacion,628,291,310,1229
20833,2020-07-21,(12007) Zona Industrial,344,220,156,720
20834,2020-05-19,(06102) Salitre El Greco,164,97,95,356
20835,2020-02-26,(12002) CDS - Carrera 32,655,390,335,1380
20836,2020-03-06,(09106) Nariño,2056,1177,1431,4664
20837,2020-01-05,(02001) Centro Comercial Santa Fe,406,255,588,1249
20838,2020-01-18,(10009) Museo Nacional,952,777,1181,2910
20839,2020-07-22,(07004) VENECIA,891,514,537,1942
20840,2020-07-12,(05002) Tintal,630,322,514,1466
20841,2020-04-17,(09120) Calle 63,572,407,409,1388
20842,2020-07-25,(09120) Calle 63,675,461,467,1603
20843,2020-08-28,(10009) Museo Nacional,488,280,353,1121
20844,2020-10-01,(07000) Portal Sur,2329,1325,1664,5318
20845,2020-02-16,(05107) Américas - Cr.53,379,280,473,1132
20846,2020-07-15,(05105) Pradera,582,341,220,1143
20847,2020-05-14,(09004) Santa Lucía,1889,962,988,3839
20848,2020-07-01,(03006) NIZA - CALLE 127,519,297,250,1066
20849,2020-05-13,(06109) Centro Memoria,257,133,119,509
20850,2020-10-09,(06109) Centro Memoria,311,197,225,733
20851,2020-06-03,(05102) Av. Américas - Av. Boyacá,158,91,111,360
20852,2020-09-16,(04105) Carrera 53,310,174,214,698
20853,2020-09-15,(06104) Gobernación,300,149,119,568
20854,2020-08-22,(50003) Corral Molinos,1237,550,855,2642
20855,2020-06-02,(07105) MOVISTAR ARENA,231,138,129,498
20856,2020-06-13,(07105) MOVISTAR ARENA,152,107,133,392
20857,2020-05-17,(07104) Simon Bolivar,101,64,84,249
20858,2020-07-31,(07107) U. NACIONAL,305,172,166,643
20859,2020-04-22,(09123) Calle 76,536,412,305,1253
20860,2020-05-09,(07008) NQS - Calle 30 Sur,134,64,76,274
20861,2020-07-29,(03003) 21 ANGELES,322,158,180,660
20862,2020-09-08,(03003) 21 ANGELES,341,174,172,687
20863,2020-05-23,(09000) Cabecera Usme,1088,655,796,2539
20864,2020-06-06,(06107) Ciudad Universitaria,110,85,109,304
20865,2020-08-19,(10007) Las Nieves,541,325,300,1166
20866,2020-08-23,(10007) Las Nieves,73,69,103,245
20867,2020-02-23,(02502) Terminal,321,296,767,1384
20868,2020-05-02,(08000) Portal Tunal,365,176,139,680
20869,2020-07-28,(04000) Cabecera Calle 80,1038,628,725,2391
20870,2020-05-13,(09110) Avenida Jimenez,780,605,506,1891
20871,2020-03-07,(03005) SUBA - AV. BOYACA,1461,810,1150,3421
20872,2020-06-20,(12000) Puente Aranda,57,40,37,134
20873,2020-04-28,(03005) SUBA - AV. BOYACA,225,156,156,537
20874,2020-08-10,(02102) Calle 161,195,131,131,457
20875,2020-08-20,(12004) Carrera 22,268,150,133,551
20876,2020-05-17,(02103) Mazurén,24,21,28,73
20877,2020-03-12,(06108) Concejo de Bogotá,237,58,122,417
20878,2020-07-26,(07110) PALOQUEMAO,132,99,70,301
20879,2020-05-03,(07006) General Santander - alimentacion,63,51,40,154
20880,2020-07-13,(04000) Cabecera Calle 80,933,577,675,2185
20881,2020-10-11,(02201) Prado,307,173,342,822
20882,2020-09-24,(08000) Portal Tunal,770,340,384,1494
20883,2020-08-17,(06000) Portal Eldorado,198,160,209,567
20884,2020-04-25,(07003) SEVILLANA,155,85,90,330
20885,2020-06-15,(14001) La Sabana,56,54,45,155
20886,2020-05-05,(09115) Calle 34,429,314,239,982
20887,2020-06-07,(07005) ALQUERIA,141,64,103,308
20888,2020-07-09,(07005) ALQUERIA,576,339,372,1287
20889,2020-07-16,(40001) Juan Pablo II,354,228,230,812
20890,2020-04-23,(04101) Minuto de Dios,177,106,138,421
20891,2020-04-29,(04102) Avenida Boyaca,187,115,122,424
20892,2020-04-27,(07109) CAD,65,217,80,362
20893,2020-05-03,(07109) CAD,178,117,78,373
20894,2020-04-08,(02103) Mazurén,81,63,73,217
20895,2020-10-11,(02103) Mazurén,52,37,94,183
20896,2020-04-07,(02502) Terminal,125,96,133,354
20897,2020-01-12,(03004) GRATAMIRA,65,34,44,143
20898,2020-01-11,(09108) Hospital,126,78,120,324
20899,2020-09-04,(14005) Las Aguas,214,144,266,624
20900,2020-03-19,(09105) Río Fucha,314,191,246,751
20901,2020-07-28,(04106) Carrera 47,317,149,170,636
20902,2020-08-01,(06102) Salitre El Greco,153,90,90,333
20903,2020-04-11,(09117) Calle 45,283,200,128,611
20904,2020-03-21,(03009) Av. Suba- Calle 116,247,162,139,548
20905,2020-07-27,(07010) Bosa,614,306,372,1292
20906,2020-05-09,(04003) Avenida Ciudad de Cali,509,273,342,1124
20907,2020-03-24,(09111) Calle 19,397,290,458,1145
20908,2020-05-12,(07106) EL CAMPIN,250,173,145,568
20909,2020-08-16,(06001) Modelia,70,42,70,182
20910,2020-05-02,(07106) EL CAMPIN,157,121,103,381
20911,2020-04-13,(09105) Río Fucha,70,47,61,178
20912,2020-07-20,(03005) SUBA - AV. BOYACA,107,58,77,242
20913,2020-04-12,(06111) Universidades,0,23,74,97
20914,2020-02-23,(40001) Juan Pablo II,450,217,362,1029
20915,2020-07-12,(04000) Cabecera Calle 80,310,179,337,826
20916,2020-04-05,(04001) Quirigua,60,43,33,136
20917,2020-10-08,(07101) CASTELLANA,264,151,177,592
20918,2020-08-17,(03005) SUBA - AV. BOYACA,120,78,92,290
20919,2020-08-16,(07200) Tygua-San José,67,44,70,181
20920,2020-07-26,(07010) Bosa,163,77,103,343
20921,2020-06-04,(07101) CASTELLANA,179,116,127,422
20922,2020-07-13,(12003) Ricaurte,171,140,116,427
20923,2020-04-09,(06107) Ciudad Universitaria,45,30,34,109
20924,2020-05-14,(09105) Río Fucha,115,56,58,229
20925,2020-06-08,(14005) Las Aguas,0,65,215,280
20926,2020-03-25,(07105) MOVISTAR ARENA,147,139,110,396
20927,2020-04-09,(05107) Américas - Cr.53,78,70,53,201
20928,2020-06-28,(10007) Las Nieves,122,89,131,342
20929,2020-08-10,(09105) Río Fucha,0,61,149,210
20930,2020-08-27,(03007) HUMEDAL CORDOBA,145,96,84,325
20931,2020-04-05,(08002) Biblioteca,64,39,34,137
20932,2020-10-04,(04101) Minuto de Dios,108,55,196,359
20933,2020-05-24,(06106) Recinto Ferial,64,41,31,136
20934,2020-07-08,(03014) SAN MARTIN,35,14,28,77
20935,2020-02-15,(50006) Corral Carrera 77,26,7,29,62
20936,2020-04-28,(06100) Av. Rojas,121,82,67,270
20937,2020-05-10,(06111) Universidades,0,18,87,105
20938,2020-04-08,(09108) Hospital,34,27,35,96
20939,2020-04-12,(14005) Las Aguas,0,15,27,42
20940,2020-04-05,(06104) Gobernación,43,44,29,116
20941,2020-03-20,(07200) Tygua-San José,64,43,63,170
20942,2020-04-23,(50002) Corral Calle 40 Sur,15,6,18,39
20943,2020-04-16,(03014) SAN MARTIN,14,8,9,31
20944,2020-08-20,(03014) SAN MARTIN,0,14,32,46
20945,2020-05-13,(03014) SAN MARTIN,19,8,38,65
20946,2020-08-17,(03014) SAN MARTIN,0,5,17,22
20947,2020-08-23,(50006) Corral Carrera 77,1,0,3,4
20948,2020-01-31,(04000) Cabecera Calle 80 - alimentacion,23082,12408,14915,50405
20949,2020-09-04,(07005) ALQUERIA,579,319,385,1283
20950,2020-02-16,(03013) RIO NEGRO,240,170,341,751
20951,2020-08-31,(07504) TERREROS,6021,3332,2949,12302
20952,2020-08-27,(09119) Calle 57,546,345,368,1259
20953,2020-09-16,(07505) LEON XIII,2919,1628,1470,6017
20954,2020-08-22,(05000) Portal Américas,2036,1140,1548,4724
20955,2020-06-25,(06104) Gobernación,260,164,117,541
20956,2020-02-02,(50003) Corral Molinos,936,503,1274,2713
20957,2020-03-18,(07503) SAN MATEO,25374,13692,10399,49465
20958,2020-10-08,(09001) Molinos,2977,1483,2426,6886
20959,2020-09-24,(05001) Patio Bonito,2281,1162,1335,4778
20960,2020-01-24,(02000) Cabecera Autopista Norte - alimentacion,21926,11719,12736,46381
20961,2020-02-01,(07010) Bosa,1513,766,1203,3482
20962,2020-01-08,(05000) Portal Américas,10669,6037,6146,22852
20963,2020-01-08,(14004) Museo del Oro,1732,1128,1154,4014
20964,2020-07-06,(05100) Banderas P. Central,822,488,546,1856
20965,2020-07-27,(09100) Calle 40 Sur,1585,974,1028,3587
20966,2020-01-03,(06102) Salitre El Greco,699,422,436,1557
20967,2020-02-27,(10002) Av. Primero de Mayo,8648,4328,4556,17532
20968,2020-02-29,(07000) Portal Sur - alimentacion,19658,9592,12082,41332
20969,2020-02-21,(02204) Pepe Sierra,4932,3101,2371,10404
20970,2020-01-09,(02105) Calle 142,4536,2669,2720,9925
20971,2020-01-13,(04000) Cabecera Calle 80 - intermunicipal,1635,1088,1656,4379
20972,2020-05-26,(04101) Minuto de Dios,297,184,226,707
20973,2020-03-16,(07505) LEON XIII,6463,3519,2890,12872
20974,2020-09-05,(02204) Pepe Sierra,550,428,488,1466
20975,2020-03-05,(09123) Calle 76,5660,3738,3264,12662
20976,2020-09-26,(09123) Calle 76,715,549,779,2043
20977,2020-01-07,(07110) PALOQUEMAO,1617,938,861,3416
20978,2020-05-15,(09101) Quiroga,359,203,255,817
20979,2020-07-25,(09101) Quiroga,294,139,236,669
20980,2020-07-09,(04100) Carrera 77,1335,759,891,2985
20981,2020-04-27,(03013) RIO NEGRO,30,74,40,144
20982,2020-06-23,(07000) Portal Sur - alimentacion,8307,4716,4046,17069
20983,2020-09-25,(09103) Olaya,1188,651,762,2601
20984,2020-02-05,(14001) La Sabana,625,413,376,1414
20985,2020-08-13,(02000) Cabecera Autopista Norte - alimentacion,4404,2275,2537,9216
20986,2020-09-14,(02000) Cabecera Autopista Norte - alimentacion,4821,2569,3166,10556
20987,2020-10-04,(02200) Alcalá,601,443,641,1685
20988,2020-02-19,(02001) Centro Comercial Santa Fe,4997,3135,2701,10833
20989,2020-08-19,(08000) Portal Tunal - alimentacion,5590,3061,3107,11758
20990,2020-05-21,(05000) Portal Américas,1997,1362,1400,4759
20991,2020-06-25,(02000) Cabecera Autopista Norte - alimentacion,4975,2795,2875,10645
20992,2020-01-14,(02000) Cabecera Autopista Norte - intermunicipal,3695,2534,2496,8725
20993,2020-01-04,(04002) Carrera 90,1119,553,827,2499
20994,2020-06-20,(04002) Carrera 90,596,299,341,1236
20995,2020-07-16,(04002) Carrera 90,676,345,388,1409
20996,2020-10-10,(07000) Portal Sur - alimentacion,7214,3384,5239,15837
20997,2020-03-02,(12001) Carrera 43,1631,1029,1049,3709
20998,2020-07-29,(12001) Carrera 43,374,212,176,762
20999,2020-08-10,(03000) Portal Suba,1013,656,701,2370
21000,2020-05-20,(10000) Portal 20 de Julio - alimentacion,3495,1666,2011,7172
21001,2020-02-12,(09101) Quiroga,1735,1026,1270,4031
21002,2020-01-03,(08001) Parque el Tunal,945,473,623,2041
21003,2020-08-18,(10000) Portal 20 de Julio - alimentacion,3924,1712,2331,7967
21004,2020-10-04,(07004) VENECIA,343,171,388,902
21005,2020-07-29,(09004) Santa Lucía,2395,1249,1220,4864
21006,2020-08-27,(08001) Parque el Tunal,439,246,267,952
21007,2020-01-24,(07008) NQS - Calle 30 Sur,1810,920,1052,3782
21008,2020-02-13,(06103) CAN,2717,1607,1197,5521
21009,2020-02-24,(09120) Calle 63,7383,4660,3665,15708
21010,2020-10-05,(14004) Museo del Oro,439,302,380,1121
21011,2020-03-15,(02101) Toberín,1309,678,1599,3586
21012,2020-09-21,(07001) PERDOMO,869,439,540,1848
21013,2020-08-13,(06102) Salitre El Greco,234,137,120,491
21014,2020-09-05,(06102) Salitre El Greco,184,109,154,447
21015,2020-01-17,(10009) Museo Nacional,3303,1863,1847,7013
21016,2020-09-14,(09107) Hortúa,600,330,456,1386
21017,2020-02-24,(03007) HUMEDAL CORDOBA,1058,670,521,2249
21018,2020-01-30,(04102) Avenida Boyaca,2934,1733,1592,6259
21019,2020-04-03,(10000) Portal 20 de Julio,1167,568,528,2263
21020,2020-02-11,(03011) SUBA - CALLE 100,2776,1462,1567,5805
21021,2020-09-18,(03012) SUBA - CALLE 95,385,229,253,867
21022,2020-01-21,(05105) Pradera,721,955,750,2426
21023,2020-05-20,(07104) Simon Bolivar,532,340,251,1123
21024,2020-06-11,(02000) Cabecera Autopista Norte,1258,806,709,2773
21025,2020-06-11,(10008) San Diego,262,157,160,579
21026,2020-01-26,(02104) Calle 146,1234,542,1297,3073
21027,2020-09-21,(03009) Av. Suba- Calle 116,474,286,287,1047
21028,2020-03-17,(04101) Minuto de Dios,1259,758,861,2878
21029,2020-01-20,(04003) Avenida Ciudad de Cali,4957,2910,3238,11105
21030,2020-07-09,(04003) Avenida Ciudad de Cali,1106,670,751,2527
21031,2020-07-30,(04003) Avenida Ciudad de Cali,1004,585,781,2370
21032,2020-07-22,(04108) El Polo,450,264,181,895
21033,2020-06-13,(07201) Guatoque -Veraguas,137,84,117,338
21034,2020-02-28,(07101) CASTELLANA,878,596,585,2059
21035,2020-05-22,(06000) Portal Eldorado - alimentacion,3395,1745,1635,6775
21036,2020-03-01,(02000) Cabecera Autopista Norte - intermunicipal,668,414,829,1911
21037,2020-04-08,(06000) Portal Eldorado,759,536,327,1622
21038,2020-08-24,(05001) Patio Bonito,1694,849,922,3465
21039,2020-08-22,(03001) LA CAMPIÑA,748,367,476,1591
21040,2020-08-09,(10000) Portal 20 de Julio,666,312,465,1443
21041,2020-03-25,(09116) Avenida 39,192,166,147,505
21042,2020-04-02,(02101) Toberín,567,386,389,1342
21043,2020-04-30,(02202) Calle 127,743,513,344,1600
21044,2020-01-21,(04000) Cabecera Calle 80 - intermunicipal,1401,824,1204,3429
21045,2020-01-08,(07104) Simon Bolivar,1510,967,920,3397
21046,2020-06-10,(05103) Marsella,329,159,178,666
21047,2020-02-09,(09100) Calle 40 Sur,1661,765,1493,3919
21048,2020-03-15,(09117) Calle 45,664,431,824,1919
21049,2020-09-15,(04002) Carrera 90,780,400,479,1659
21050,2020-08-31,(12001) Carrera 43,453,251,242,946
21051,2020-06-26,(09117) Calle 45,767,459,473,1699
21052,2020-04-07,(40003) Mirador del Paraiso,722,417,408,1547
21053,2020-04-02,(03002) SUBA - TV- 91,421,228,251,900
21054,2020-09-11,(03002) SUBA - TV- 91,847,491,535,1873
21055,2020-01-04,(04000) Cabecera Calle 80 - intermunicipal,447,296,584,1327
21056,2020-01-12,(03011) SUBA - CALLE 100,397,237,452,1086
21057,2020-03-02,(03011) SUBA - CALLE 100,2683,1317,1450,5450
21058,2020-03-25,(09118) Marly,1165,807,518,2490
21059,2020-01-16,(07101) CASTELLANA,661,498,656,1815
21060,2020-05-06,(07113) SANTA ISABEL,257,156,167,580
21061,2020-02-23,(06106) Recinto Ferial,275,172,309,756
21062,2020-01-13,(06103) CAN,2087,1179,1014,4280
21063,2020-07-16,(12003) Ricaurte,223,167,152,542
21064,2020-08-12,(12003) Ricaurte,387,264,171,822
21065,2020-06-05,(03010) PUENTE LARGO,318,208,173,699
21066,2020-08-21,(09104) Restrepo,1507,839,1061,3407
21067,2020-05-08,(09001) Molinos,1708,980,1108,3796
21068,2020-01-02,(06103) CAN,935,584,567,2086
21069,2020-09-17,(07009) SENA,698,432,549,1679
21070,2020-02-09,(05002) Tintal,2073,1002,1917,4992
21071,2020-03-24,(09000) Cabecera Usme,1305,701,913,2919
21072,2020-05-15,(09000) Cabecera Usme,1321,816,869,3006
21073,2020-01-25,(03006) NIZA - CALLE 127,1192,717,923,2832
21074,2020-02-11,(07105) MOVISTAR ARENA,1432,877,721,3030
21075,2020-03-31,(10005) Bicentenario,51,31,38,120
21076,2020-01-03,(40002) Manitas,695,397,556,1648
21077,2020-05-29,(09117) Calle 45,628,388,385,1401
21078,2020-06-22,(09117) Calle 45,287,201,198,686
21079,2020-06-19,(09106) Nariño,442,261,338,1041
21080,2020-06-29,(05100) Banderas P. Central - alimentacion,962,470,540,1972
21081,2020-06-24,(02102) Calle 161,241,165,177,583
21082,2020-02-25,(40001) Juan Pablo II,1703,1021,912,3636
21083,2020-06-23,(09118) Marly,1510,967,842,3319
21084,2020-08-22,(09120) Calle 63,747,492,533,1772
21085,2020-06-24,(03011) SUBA - CALLE 100,554,255,270,1079
21086,2020-09-24,(10009) Museo Nacional,572,372,428,1372
21087,2020-05-27,(09003) Socorro,519,272,294,1085
21088,2020-05-14,(03006) NIZA - CALLE 127,290,199,151,640
21089,2020-03-27,(02204) Pepe Sierra,373,298,262,933
21090,2020-01-10,(05102) Av. Américas - Av. Boyacá,1085,605,690,2380
21091,2020-07-31,(05001) Patio Bonito,1546,868,874,3288
21092,2020-04-14,(02201) Prado,447,334,244,1025
21093,2020-06-04,(06109) Centro Memoria,258,164,107,529
21094,2020-09-21,(04105) Carrera 53,275,150,127,552
21095,2020-07-29,(09002) Consuelo,448,248,249,945
21096,2020-01-17,(07105) MOVISTAR ARENA,1109,720,758,2587
21097,2020-06-03,(09121) Las Flores,653,429,367,1449
21098,2020-07-08,(07003) SEVILLANA,465,251,271,987
21099,2020-01-02,(09107) Hortúa,1115,684,825,2624
21100,2020-07-30,(06109) Centro Memoria,238,141,140,519
21101,2020-05-10,(09119) Calle 57,120,87,108,315
21102,2020-09-16,(04103) Las Ferias,371,202,236,809
21103,2020-05-07,(05005) Transversal 86,235,126,130,491
21104,2020-08-21,(09110) Avenida Jimenez,864,676,814,2354
21105,2020-05-30,(40002) Manitas,304,163,171,638
21106,2020-05-03,(10007) Las Nieves,54,40,45,139
21107,2020-08-12,(02202) Calle 127,903,711,622,2236
21108,2020-06-10,(12000) Puente Aranda,86,47,37,170
21109,2020-07-24,(12000) Puente Aranda,79,50,36,165
21110,2020-06-21,(09003) Socorro,206,101,144,451
21111,2020-06-09,(02102) Calle 161,237,147,158,542
21112,2020-02-01,(04107) Escuela Militar,330,233,368,931
21113,2020-07-08,(03013) RIO NEGRO,311,179,186,676
21114,2020-05-19,(07005) ALQUERIA,429,298,225,952
21115,2020-09-13,(06000) Portal Eldorado,143,172,301,616
21116,2020-06-06,(02502) Terminal,223,133,218,574
21117,2020-04-10,(03013) RIO NEGRO,41,29,26,96
21118,2020-02-15,(07200) Tygua-San José,461,277,508,1246
21119,2020-03-01,(14004) Museo del Oro,0,156,424,580
21120,2020-04-11,(04100) Carrera 77,275,191,167,633
21121,2020-03-28,(07003) SEVILLANA,171,106,79,356
21122,2020-09-13,(09117) Calle 45,227,144,268,639
21123,2020-09-20,(06102) Salitre El Greco,96,69,93,258
21124,2020-06-04,(06100) Av. Rojas,197,121,138,456
21125,2020-03-27,(12002) CDS - Carrera 32,130,116,64,310
21126,2020-04-27,(02502) Terminal,96,67,54,217
21127,2020-09-27,(07108) Av. El Dorado,36,28,50,114
21128,2020-05-29,(05107) Américas - Cr.53,357,234,239,830
21129,2020-08-27,(07200) Tygua-San José,225,127,149,501
21130,2020-07-04,(07200) Tygua-San José,223,125,162,510
21131,2020-06-17,(07506) DESPENSA,500,266,241,1007
21132,2020-01-06,(07506) DESPENSA,277,147,234,658
21133,2020-01-26,(08001) Parque el Tunal,363,155,323,841
21134,2020-08-28,(07005) ALQUERIA,551,318,338,1207
21135,2020-06-14,(09114) Calle 26,56,39,69,164
21136,2020-05-31,(14004) Museo del Oro,0,19,47,66
21137,2020-03-28,(12001) Carrera 43,146,110,84,340
21138,2020-07-05,(07506) DESPENSA,124,67,85,276
21139,2020-05-08,(05102) Av. Américas - Av. Boyacá,155,89,103,347
21140,2020-09-23,(40002) Manitas,443,285,357,1085
21141,2020-05-03,(04001) Quirigua,81,52,51,184
21142,2020-03-26,(10009) Museo Nacional,350,245,236,831
21143,2020-05-28,(06108) Concejo de Bogotá,133,61,67,261
21144,2020-09-11,(06101) El Tiempo,346,216,190,752
21145,2020-07-18,(07006) General Santander,352,190,188,730
21146,2020-05-24,(09106) Nariño,109,67,75,251
21147,2020-08-25,(07007) NQS - Calle 38A Sur,383,235,266,884
21148,2020-08-05,(09111) Calle 19,729,445,447,1621
21149,2020-05-21,(07108) Av. El Dorado,124,71,59,254
21150,2020-04-06,(03004) GRATAMIRA,28,9,16,53
21151,2020-04-06,(04106) Carrera 47,175,110,100,385
21152,2020-05-02,(09114) Calle 26,92,85,92,269
21153,2020-09-05,(09114) Calle 26,192,151,230,573
21154,2020-05-16,(04103) Las Ferias,227,117,126,470
21155,2020-09-26,(04103) Las Ferias,304,135,226,665
21156,2020-07-26,(05101) Mandalay - Cr.73,15,11,19,45
21157,2020-09-10,(03005) SUBA - AV. BOYACA,453,247,332,1032
21158,2020-06-14,(07200) Tygua-San José,69,40,48,157
21159,2020-06-28,(05103) Marsella,125,66,84,275
21160,2020-03-28,(05103) Marsella,101,58,68,227
21161,2020-04-04,(04104) Avenida 68,201,129,119,449
21162,2020-06-04,(14005) Las Aguas,0,60,193,253
21163,2020-04-18,(09106) Nariño,130,85,114,329
21164,2020-08-19,(07108) Av. El Dorado,129,84,82,295
21165,2020-04-23,(07101) CASTELLANA,83,65,53,201
21166,2020-04-20,(12004) Carrera 22,67,52,50,169
21167,2020-05-17,(05103) Marsella,59,32,37,128
21168,2020-04-03,(07105) MOVISTAR ARENA,145,99,109,353
21169,2020-09-15,(06107) Ciudad Universitaria,204,117,144,465
21170,2020-01-24,(50006) Corral Carrera 77,25,20,50,95
21171,2020-04-26,(07107) U. NACIONAL,79,60,35,174
21172,2020-05-31,(07003) SEVILLANA,93,55,64,212
21173,2020-07-27,(03014) SAN MARTIN,0,11,25,36
21174,2020-03-22,(10004) Policarpa,57,34,26,117
21175,2020-03-29,(10004) Policarpa,63,30,32,125
21176,2019-12-31,(03012) SUBA - CALLE 95,24,8,9,41
21177,2020-05-24,(06104) Gobernación,44,30,27,101
21178,2020-07-21,(03014) SAN MARTIN,0,17,38,55
21179,2020-01-21,(07005) ALQUERIA,1754,850,858,3462
21180,2020-03-04,(07005) ALQUERIA,2586,1487,1500,5573
21181,2020-02-18,(09002) Consuelo,1505,850,824,3179
21182,2020-03-18,(09002) Consuelo,938,486,523,1947
21183,2020-04-20,(10000) Portal 20 de Julio - alimentacion,2782,1133,1553,5468
21184,2020-01-09,(07111) NQS - RICAURTE,2265,1491,1304,5060
21185,2020-01-25,(04106) Carrera 47,818,411,605,1834
21186,2020-02-21,(04106) Carrera 47,1438,764,850,3052
21187,2020-02-20,(07505) LEON XIII,8347,4753,3621,16721
21188,2020-02-26,(09122) Calle 72,7781,5582,4552,17915
21189,2020-02-05,(06104) Gobernación,1394,835,683,2912
21190,2020-03-02,(09003) Socorro,1645,938,1037,3620
21191,2020-02-11,(08001) Parque el Tunal,1753,1011,975,3739
21192,2020-02-22,(02000) Cabecera Autopista Norte - alimentacion,14768,6822,9584,31174
21193,2020-03-03,(09001) Molinos,7436,4603,6178,18217
21194,2020-07-15,(05000) Portal Américas - alimentacion,9759,5233,4807,19799
21195,2020-02-08,(02000) Cabecera Autopista Norte - alimentacion,14954,6891,9663,31508
21196,2020-02-05,(14004) Museo del Oro,4300,2600,2047,8947
21197,2020-04-28,(08000) Portal Tunal - alimentacion,3939,1991,1943,7873
21198,2020-01-31,(05100) Banderas P. Central,7668,3986,3852,15506
21199,2020-02-26,(10001) Country Sur,5255,2289,2780,10324
21200,2020-08-13,(10001) Country Sur,1242,559,694,2495
21201,2020-09-06,(10001) Country Sur,380,164,368,912
21202,2020-05-12,(09100) Calle 40 Sur,1326,776,786,2888
21203,2020-05-16,(09100) Calle 40 Sur,1013,577,601,2191
21204,2020-02-04,(09000) Cabecera Usme,5991,3560,4033,13584
21205,2020-02-28,(02102) Calle 161,1893,1075,1190,4158
21206,2020-07-03,(09115) Calle 34,724,436,482,1642
21207,2020-03-09,(09113) Calle 22,539,196,214,949
21208,2020-02-28,(06102) Salitre El Greco,1470,843,793,3106
21209,2020-05-16,(10000) Portal 20 de Julio - alimentacion,2805,1244,1637,5686
21210,2020-07-27,(07001) PERDOMO,846,486,533,1865
21211,2020-01-28,(05107) Américas - Cr.53,2556,1413,1373,5342
21212,2020-01-31,(04100) Carrera 77,6483,3544,4092,14119
21213,2020-06-19,(07505) LEON XIII,2928,1564,1309,5801
21214,2020-02-14,(09110) Avenida Jimenez,5142,3547,2933,11622
21215,2020-05-22,(10000) Portal 20 de Julio - alimentacion,3553,1700,2071,7324
21216,2020-06-07,(02000) Cabecera Autopista Norte - alimentacion,1571,804,967,3342
21217,2020-01-29,(07102) NQS - CALLE 75,1480,970,826,3276
21218,2020-07-07,(09000) Cabecera Usme - alimentacion,9135,5030,5334,19499
21219,2020-02-12,(07110) PALOQUEMAO,2781,1618,1270,5669
21220,2020-02-28,(02303) Calle 85,3538,2534,2000,8072
21221,2020-06-12,(09103) Olaya,1011,557,563,2131
21222,2020-07-10,(09103) Olaya,1125,628,619,2372
21223,2020-07-02,(07002) MADELENA,931,530,573,2034
21224,2020-02-01,(09113) Calle 22,1224,678,958,2860
21225,2020-05-25,(09113) Calle 22,215,121,197,533
21226,2020-02-19,(50003) Corral Molinos,2306,2342,4026,8674
21227,2020-06-30,(50003) Corral Molinos,1612,886,1173,3671
21228,2020-05-09,(05000) Portal Américas,1085,811,921,2817
21229,2020-01-22,(09123) Calle 76,5044,3291,2872,11207
21230,2020-01-06,(02000) Cabecera Autopista Norte - alimentacion,4643,2122,3541,10306
21231,2020-03-06,(07506) DESPENSA,1299,890,953,3142
21232,2020-08-26,(10001) Country Sur,1028,491,701,2220
21233,2020-04-03,(10000) Portal 20 de Julio - alimentacion,2685,960,1417,5062
21234,2020-04-10,(10000) Portal 20 de Julio - alimentacion,1040,412,432,1884
21235,2020-08-16,(03000) Portal Suba - alimentacion,1707,797,1247,3751
21236,2020-08-19,(03000) Portal Suba - alimentacion,5632,3221,3312,12165
21237,2020-02-08,(04000) Cabecera Calle 80,3760,1913,3460,9133
21238,2020-07-31,(12001) Carrera 43,380,205,199,784
21239,2020-05-22,(09107) Hortúa,542,345,276,1163
21240,2020-02-12,(08002) Biblioteca,1098,611,633,2342
21241,2020-07-11,(02303) Calle 85,504,364,329,1197
21242,2020-01-13,(07000) Portal Sur,6622,3975,3907,14504
21243,2020-03-10,(02201) Prado,1064,1217,898,3179
21244,2020-06-26,(09004) Santa Lucía,2725,1476,1403,5604
21245,2020-02-08,(02502) Terminal,1747,1038,1912,4697
21246,2020-02-19,(06102) Salitre El Greco,1606,887,687,3180
21247,2020-04-21,(04100) Carrera 77,668,403,396,1467
21248,2020-06-06,(09116) Avenida 39,175,134,183,492
21249,2020-03-03,(06108) Concejo de Bogotá,883,420,459,1762
21250,2020-08-02,(10002) Av. Primero de Mayo,573,277,468,1318
21251,2020-10-05,(02201) Prado,1057,714,798,2569
21252,2020-08-21,(02000) Cabecera Autopista Norte - alimentacion,4390,2245,2567,9202
21253,2020-03-13,(02000) Cabecera Autopista Norte,1105,1620,1437,4162
21254,2020-01-26,(09107) Hortúa,533,313,611,1457
21255,2020-05-03,(09107) Hortúa,174,111,97,382
21256,2020-02-19,(03011) SUBA - CALLE 100,2746,1425,1466,5637
21257,2020-10-05,(02300) Calle 100,1364,978,1011,3353
21258,2020-06-05,(08000) Portal Tunal,751,299,280,1330
21259,2020-04-29,(09104) Restrepo,911,550,620,2081
21260,2020-02-02,(05005) Transversal 86,474,178,431,1083
21261,2020-04-24,(05105) Pradera,414,299,156,869
21262,2020-01-07,(08000) Portal Tunal,1427,857,908,3192
21263,2020-05-20,(05107) Américas - Cr.53,351,222,202,775
21264,2020-02-22,(02205) Calle 106,939,682,901,2522
21265,2020-09-10,(07113) SANTA ISABEL,364,203,287,854
21266,2020-01-24,(04003) Avenida Ciudad de Cali,5152,2792,3285,11229
21267,2020-07-04,(04003) Avenida Ciudad de Cali,821,446,681,1948
21268,2020-08-21,(06000) Portal Eldorado - alimentacion,3681,1764,1916,7361
21269,2020-05-30,(04108) El Polo,268,173,162,603
21270,2020-06-08,(05001) Patio Bonito,1420,761,980,3161
21271,2020-01-18,(06102) Salitre El Greco,613,389,526,1528
21272,2020-07-02,(07113) SANTA ISABEL,409,244,279,932
21273,2020-07-24,(03007) HUMEDAL CORDOBA,116,84,64,264
21274,2020-06-18,(04104) Avenida 68,652,312,341,1305
21275,2020-01-21,(07108) Av. El Dorado,589,386,381,1356
21276,2020-10-09,(06000) Portal Eldorado,882,682,790,2354
21277,2020-01-14,(05107) Américas - Cr.53,2147,1217,1183,4547
21278,2020-04-13,(05105) Pradera,395,282,151,828
21279,2020-02-02,(04103) Las Ferias,266,157,280,703
21280,2020-07-03,(09109) Tercer Milenio,366,190,277,833
21281,2020-07-10,(09109) Tercer Milenio,383,219,232,834
21282,2020-09-14,(04002) Carrera 90,740,408,451,1599
21283,2020-07-22,(09117) Calle 45,601,386,349,1336
21284,2020-09-25,(09121) Las Flores,759,495,614,1868
21285,2020-09-28,(06002) Normandía,378,240,280,898
21286,2020-03-21,(09116) Avenida 39,120,82,74,276
21287,2020-05-28,(07113) SANTA ISABEL,332,215,181,728
21288,2020-06-01,(07113) SANTA ISABEL,354,230,252,836
21289,2020-01-04,(04108) El Polo,468,304,539,1311
21290,2020-07-17,(02105) Calle 142,715,431,456,1602
21291,2020-01-02,(07008) NQS - Calle 30 Sur,789,435,548,1772
21292,2020-07-21,(02302) Virrey,504,341,278,1123
21293,2020-05-09,(12003) Ricaurte,160,139,91,390
21294,2020-09-17,(03013) RIO NEGRO,302,183,258,743
21295,2020-03-08,(03010) PUENTE LARGO,280,179,359,818
21296,2020-04-04,(02302) Virrey,227,183,124,534
21297,2020-04-19,(02302) Virrey,145,106,80,331
21298,2020-05-21,(05100) Banderas P. Central,529,292,353,1174
21299,2020-03-14,(06103) CAN,584,499,751,1834
21300,2020-02-22,(06001) Modelia,1067,664,919,2650
21301,2020-07-29,(06103) CAN,333,197,146,676
21302,2020-04-02,(02105) Calle 142,365,275,270,910
21303,2020-03-29,(07005) ALQUERIA,109,67,63,239
21304,2020-01-20,(10005) Bicentenario,726,355,344,1425
21305,2020-06-01,(05107) Américas - Cr.53,442,238,230,910
21306,2020-03-28,(09123) Calle 76,354,259,187,800
21307,2020-06-02,(05100) Banderas P. Central - alimentacion,1462,1040,1463,3965
21308,2020-08-25,(12007) Zona Industrial,379,213,132,724
21309,2020-03-05,(07201) Guatoque -Veraguas,1021,495,632,2148
21310,2020-03-13,(02300) Calle 100,2141,273,705,3119
21311,2020-08-07,(07003) SEVILLANA,133,85,103,321
21312,2020-02-08,(07006) General Santander - alimentacion,933,580,762,2275
21313,2020-04-22,(10000) Portal 20 de Julio,1281,670,589,2540
21314,2020-04-26,(10000) Portal 20 de Julio,461,250,231,942
21315,2020-03-01,(04105) Carrera 53,353,203,367,923
21316,2020-03-11,(02102) Calle 161,1797,1093,1029,3919
21317,2020-01-05,(10009) Museo Nacional,229,225,463,917
21318,2020-07-09,(09113) Calle 22,435,259,336,1030
21319,2020-03-20,(09120) Calle 63,566,387,277,1230
21320,2020-09-19,(04107) Escuela Militar,111,77,105,293
21321,2020-08-07,(10008) San Diego,109,64,64,237
21322,2020-06-25,(05107) Américas - Cr.53,481,270,266,1017
21323,2020-06-02,(09004) Santa Lucía,2399,1180,1258,4837
21324,2020-06-04,(07111) NQS - RICAURTE,1060,675,384,2119
21325,2020-06-06,(09115) Calle 34,361,270,304,935
21326,2020-05-26,(04000) Cabecera Calle 80 - intermunicipal,267,165,188,620
21327,2020-02-16,(03009) Av. Suba- Calle 116,394,280,456,1130
21328,2020-03-25,(05102) Av. Américas - Av. Boyacá,150,81,84,315
21329,2020-09-16,(02200) Alcalá,2102,1337,1288,4727
21330,2020-05-07,(12004) Carrera 22,151,71,88,310
21331,2020-05-30,(02101) Toberín,797,487,576,1860
21332,2020-07-19,(09122) Calle 72,290,201,227,718
21333,2020-09-11,(07009) SENA,639,369,485,1493
21334,2020-10-08,(09100) Calle 40 Sur,1934,1096,1623,4653
21335,2020-02-01,(07105) MOVISTAR ARENA,670,435,576,1681
21336,2020-04-12,(03000) Portal Suba,182,121,136,439
21337,2020-03-16,(07506) DESPENSA,1194,673,657,2524
21338,2020-07-08,(14005) Las Aguas,217,139,212,568
21339,2020-07-09,(07107) U. NACIONAL,353,193,190,736
21340,2020-08-16,(07107) U. NACIONAL,82,63,75,220
21341,2020-08-15,(09114) Calle 26,176,129,199,504
21342,2020-04-24,(03003) 21 ANGELES,164,76,86,326
21343,2020-04-12,(02104) Calle 146,139,133,64,336
21344,2020-05-13,(05102) Av. Américas - Av. Boyacá,174,85,116,375
21345,2020-03-27,(03002) SUBA - TV- 91,403,216,230,849
21346,2020-03-25,(09122) Calle 72,664,483,387,1534
21347,2020-04-21,(10007) Las Nieves,232,168,147,547
21348,2020-05-05,(09122) Calle 72,774,522,485,1781
21349,2020-07-12,(14005) Las Aguas,62,48,108,218
21350,2020-06-13,(07109) CAD,406,276,242,924
21351,2020-10-05,(07506) DESPENSA,485,264,355,1104
21352,2020-01-07,(09111) Calle 19,1490,961,1169,3620
21353,2020-06-11,(06001) Modelia,384,234,185,803
21354,2020-08-24,(03013) RIO NEGRO,262,138,184,584
21355,2020-02-02,(03009) Av. Suba- Calle 116,378,241,468,1087
21356,2020-09-07,(09122) Calle 72,1244,843,861,2948
21357,2020-06-29,(02000) Cabecera Autopista Norte,451,313,328,1092
21358,2020-04-28,(04000) Cabecera Calle 80,643,433,367,1443
21359,2020-09-04,(07109) CAD,637,404,406,1447
21360,2020-02-08,(07200) Tygua-San José,497,277,464,1238
21361,2020-09-05,(07200) Tygua-San José,199,114,170,483
21362,2020-02-28,(09105) Río Fucha,811,394,529,1734
21363,2020-07-18,(50003) Corral Molinos,981,527,770,2278
21364,2020-06-29,(02502) Terminal,84,74,103,261
21365,2020-01-18,(06103) CAN,613,478,704,1795
21366,2020-08-17,(03006) NIZA - CALLE 127,179,120,99,398
21367,2020-04-05,(09001) Molinos,435,238,300,973
21368,2020-05-07,(07005) ALQUERIA,374,233,189,796
21369,2020-01-18,(09105) Río Fucha,397,200,391,988
21370,2020-10-05,(04000) Cabecera Calle 80 - intermunicipal,433,242,452,1127
21371,2020-07-04,(06002) Normandía,234,120,199,553
21372,2020-05-30,(03001) LA CAMPIÑA,631,314,351,1296
21373,2020-07-05,(09108) Hospital,28,21,28,77
21374,2020-08-16,(06108) Concejo de Bogotá,42,22,27,91
21375,2020-03-28,(09000) Cabecera Usme,562,312,360,1234
21376,2020-03-30,(05105) Pradera,357,251,164,772
21377,2019-12-31,(07005) ALQUERIA,27,26,41,94
21378,2020-10-07,(07105) MOVISTAR ARENA,294,163,223,680
21379,2020-07-18,(09115) Calle 34,341,228,234,803
21380,2020-07-21,(09115) Calle 34,594,350,335,1279
21381,2020-03-27,(09003) Socorro,249,119,160,528
21382,2020-07-31,(07005) ALQUERIA,472,260,322,1054
21383,2020-03-20,(07107) U. NACIONAL,227,161,115,503
21384,2020-04-20,(10004) Policarpa,133,73,84,290
21385,2020-07-04,(09108) Hospital,61,40,40,141
21386,2020-06-07,(07000) Portal Sur,372,231,327,930
21387,2020-03-21,(09117) Calle 45,319,219,174,712
21388,2020-04-04,(04001) Quirigua,106,69,60,235
21389,2020-06-18,(04001) Quirigua,444,268,251,963
21390,2020-08-08,(09121) Las Flores,397,264,364,1025
21391,2020-05-23,(06001) Modelia,251,151,129,531
21392,2020-08-12,(14004) Museo del Oro,305,180,199,684
21393,2020-08-04,(04106) Carrera 47,224,122,146,492
21394,2020-06-06,(09106) Nariño,313,178,216,707
21395,2020-06-28,(09121) Las Flores,210,124,170,504
21396,2020-05-10,(07007) NQS - Calle 38A Sur,75,48,56,179
21397,2020-08-17,(10003) Ciudad Jardín,64,32,56,152
21398,2020-06-15,(06108) Concejo de Bogotá,41,30,40,111
21399,2020-08-09,(12007) Zona Industrial,47,45,32,124
21400,2020-05-01,(04102) Avenida Boyaca,73,47,53,173
21401,2020-06-07,(09119) Calle 57,172,97,150,419
21402,2020-05-31,(09110) Avenida Jimenez,167,180,235,582
21403,2020-03-23,(40001) Juan Pablo II,100,61,77,238
21404,2020-07-07,(05101) Mandalay - Cr.73,161,90,101,352
21405,2020-08-14,(05101) Mandalay - Cr.73,125,72,63,260
21406,2020-04-04,(12004) Carrera 22,35,27,31,93
21407,2020-06-29,(08002) Biblioteca,127,55,74,256
21408,2020-10-04,(06104) Gobernación,44,48,57,149
21409,2020-07-19,(07108) Av. El Dorado,35,20,28,83
21410,2020-10-07,(50002) Corral Calle 40 Sur,30,25,47,102
21411,2019-12-31,(07104) Simon Bolivar,23,15,31,69
21412,2019-12-31,(05100) Banderas P. Central,46,23,54,123
21413,2020-04-26,(10005) Bicentenario,18,11,20,49
21414,2020-04-08,(04105) Carrera 53,139,91,82,312
21415,2020-05-09,(12002) CDS - Carrera 32,101,64,42,207
21416,2020-04-11,(09110) Avenida Jimenez,144,138,177,459
21417,2020-04-13,(06105) Quinta Paredes,70,53,49,172
21418,2020-03-25,(07101) CASTELLANA,53,61,81,195
21419,2020-03-29,(07201) Guatoque -Veraguas,4,10,24,38
21420,2020-04-09,(09105) Río Fucha,34,20,17,71
21421,2020-04-06,(12000) Puente Aranda,35,23,28,86
21422,2020-04-03,(05101) Mandalay - Cr.73,57,36,28,121
21423,2020-10-12,(06105) Quinta Paredes,39,32,52,123
21424,2020-04-10,(06108) Concejo de Bogotá,37,29,23,89
21425,2020-02-09,(03013) RIO NEGRO,268,164,357,789
21426,2020-01-20,(10000) Portal 20 de Julio - alimentacion,10545,4899,6931,22375
21427,2020-04-29,(05000) Portal Américas - alimentacion,7135,3652,2976,13763
21428,2020-01-07,(02000) Cabecera Autopista Norte - alimentacion,15293,8279,10247,33819
21429,2020-01-30,(02000) Cabecera Autopista Norte - alimentacion,22801,12854,13137,48792
21430,2020-03-03,(09121) Las Flores,3440,2180,2184,7804
21431,2020-03-14,(09121) Las Flores,1440,1007,1434,3881
21432,2020-01-09,(09118) Marly,3973,2668,2752,9393
21433,2020-01-07,(07010) Bosa,1554,962,1228,3744
21434,2020-03-19,(07010) Bosa,1251,667,883,2801
21435,2020-01-07,(02000) Cabecera Autopista Norte - intermunicipal,2892,1933,2106,6931
21436,2020-01-18,(09104) Restrepo,3105,1851,2859,7815
21437,2020-06-19,(10001) Country Sur,1285,550,774,2609
21438,2020-02-08,(07009) SENA,2178,1201,1682,5061
21439,2020-02-28,(10003) Ciudad Jardín,1060,534,635,2229
21440,2020-02-22,(03000) Portal Suba - alimentacion,17009,8526,11661,37196
21441,2020-02-12,(04000) Cabecera Calle 80 - intermunicipal,2506,1843,2169,6518
21442,2020-07-10,(09000) Cabecera Usme,1796,1175,1283,4254
21443,2020-01-18,(02200) Alcalá,5504,2876,3976,12356
21444,2020-09-18,(10000) Portal 20 de Julio - alimentacion,4703,2076,3036,9815
21445,2020-07-24,(09101) Quiroga,401,191,274,866
21446,2020-02-19,(03013) RIO NEGRO,1300,851,889,3040
21447,2020-04-06,(09000) Cabecera Usme - alimentacion,4419,2127,2569,9115
21448,2020-05-16,(09000) Cabecera Usme - alimentacion,5092,2710,2934,10736
21449,2020-08-02,(09103) Olaya,334,159,249,742
21450,2020-01-28,(14001) La Sabana,439,354,351,1144
21451,2020-07-30,(05000) Portal Américas,2131,1518,1817,5466
21452,2020-03-01,(09114) Calle 26,224,188,460,872
21453,2020-06-01,(04002) Carrera 90,676,367,372,1415
21454,2020-08-31,(10006) San Victorino,530,291,340,1161
21455,2020-06-24,(06000) Portal Eldorado,1030,679,492,2201
21456,2020-01-07,(10008) San Diego,987,554,647,2188
21457,2020-06-23,(40003) Mirador del Paraiso,1808,1134,1076,4018
21458,2020-01-24,(04001) Quirigua,1847,1052,1161,4060
21459,2020-05-21,(04000) Cabecera Calle 80,816,546,557,1919
21460,2020-02-17,(09004) Santa Lucía,7618,4466,4206,16290
21461,2020-03-02,(09004) Santa Lucía,7470,4259,4131,15860
21462,2020-03-25,(07505) LEON XIII,1375,683,596,2654
21463,2019-12-31,(10006) San Victorino,13,20,39,72
21464,2020-05-28,(06105) Quinta Paredes,112,63,52,227
21465,2020-02-04,(02302) Virrey,3983,2548,1826,8357
21466,2020-03-15,(07106) EL CAMPIN,362,234,348,944
21467,2020-10-03,(03000) Portal Suba,1285,607,1224,3116
21468,2020-02-24,(09119) Calle 57,3920,2367,2049,8336
21469,2020-09-11,(02303) Calle 85,767,497,483,1747
21470,2020-08-18,(07000) Portal Sur,1875,1117,1101,4093
21471,2020-03-07,(02001) Centro Comercial Santa Fe,2074,1006,1938,5018
21472,2020-01-13,(04000) Cabecera Calle 80,6078,3560,4179,13817
21473,2020-09-20,(07503) SAN MATEO,3983,1795,2802,8580
21474,2020-04-16,(08001) Parque el Tunal,229,134,142,505
21475,2020-06-05,(08001) Parque el Tunal,434,278,237,949
21476,2020-06-13,(09116) Avenida 39,183,142,199,524
21477,2020-02-04,(05102) Av. Américas - Av. Boyacá,1991,1184,938,4113
21478,2020-01-14,(07008) NQS - Calle 30 Sur,1561,845,904,3310
21479,2020-09-13,(10002) Av. Primero de Mayo,622,284,628,1534
21480,2020-08-19,(04000) Cabecera Calle 80,1009,615,787,2411
21481,2020-07-30,(09113) Calle 22,385,226,296,907
21482,2020-06-04,(05000) Portal Américas,2141,1495,1639,5275
21483,2020-03-07,(02105) Calle 142,3000,1397,2519,6916
21484,2020-08-06,(02201) Prado,646,476,506,1628
21485,2020-03-29,(02000) Cabecera Autopista Norte - alimentacion,1073,513,409,1995
21486,2020-08-26,(07001) PERDOMO,869,529,530,1928
21487,2020-07-20,(09107) Hortúa,235,126,164,525
21488,2020-06-04,(05101) Mandalay - Cr.73,79,51,37,167
21489,2020-03-05,(02300) Calle 100,6867,4580,3859,15306
21490,2020-08-06,(50002) Corral Calle 40 Sur,19,12,20,51
21491,2020-03-14,(07006) General Santander,1443,714,1057,3214
21492,2020-03-17,(07006) General Santander,1621,931,868,3420
21493,2020-01-08,(02104) Calle 146,5636,3477,3439,12552
21494,2020-05-11,(10000) Portal 20 de Julio - alimentacion,3087,1460,1774,6321
21495,2020-04-26,(05005) Transversal 86,62,25,33,120
21496,2020-08-20,(05005) Transversal 86,336,192,225,753
21497,2020-08-03,(05105) Pradera,467,268,255,990
21498,2020-08-12,(05105) Pradera,576,320,222,1118
21499,2020-07-08,(10008) San Diego,326,190,210,726
21500,2020-08-08,(06109) Centro Memoria,139,89,106,334
21501,2020-08-26,(06109) Centro Memoria,227,154,152,533
21502,2020-04-02,(08000) Portal Tunal - alimentacion,3355,1649,1780,6784
21503,2020-01-24,(03009) Av. Suba- Calle 116,2312,1482,1378,5172
21504,2020-09-05,(03009) Av. Suba- Calle 116,366,274,250,890
21505,2020-08-05,(02205) Calle 106,288,212,182,682
21506,2020-02-10,(02001) Centro Comercial Santa Fe,4935,3184,2734,10853
21507,2020-02-29,(09101) Quiroga,998,537,997,2532
21508,2020-06-11,(06102) Salitre El Greco,200,121,123,444
21509,2020-08-27,(07106) EL CAMPIN,365,240,201,806
21510,2020-09-25,(06000) Portal Eldorado,932,672,687,2291
21511,2020-03-18,(07000) Portal Sur,4730,2613,2561,9904
21512,2020-05-06,(07010) Bosa,431,232,251,914
21513,2020-07-05,(10002) Av. Primero de Mayo,600,308,552,1460
21514,2020-02-28,(14005) Las Aguas,3232,2060,2075,7367
21515,2020-09-18,(10005) Bicentenario - alimentacion,220,109,239,568
21516,2020-09-22,(10005) Bicentenario - alimentacion,208,133,231,572
21517,2020-03-05,(04107) Escuela Militar,652,408,393,1453
21518,2020-07-11,(08000) Portal Tunal,701,334,331,1366
21519,2020-04-13,(05103) Marsella,178,108,103,389
21520,2020-05-18,(10001) Country Sur,916,383,553,1852
21521,2020-05-19,(09117) Calle 45,618,391,338,1347
21522,2020-08-30,(02200) Alcalá,551,399,489,1439
21523,2020-09-11,(02104) Calle 146,832,474,574,1880
21524,2020-07-12,(09101) Quiroga,196,109,176,481
21525,2020-07-08,(09121) Las Flores,761,475,434,1670
21526,2020-01-05,(06000) Portal Eldorado,627,493,815,1935
21527,2020-03-27,(05001) Patio Bonito,770,425,503,1698
21528,2020-04-20,(05001) Patio Bonito,973,530,595,2098
21529,2020-03-19,(07004) VENECIA,2461,1259,1263,4983
21530,2020-03-03,(07004) VENECIA,4615,2610,2471,9696
21531,2020-10-09,(07009) SENA,753,424,689,1866
21532,2020-05-31,(05000) Portal Américas - alimentacion,3053,1380,1490,5923
21533,2020-07-20,(02302) Virrey,178,107,93,378
21534,2020-07-24,(02302) Virrey,511,353,267,1131
21535,2020-08-07,(07009) SENA,239,144,200,583
21536,2020-03-31,(09122) Calle 72,530,399,359,1288
21537,2020-02-04,(12003) Ricaurte,1277,693,719,2689
21538,2020-03-24,(02300) Calle 100,1210,936,849,2995
21539,2020-05-29,(09004) Santa Lucía,2220,1171,1217,4608
21540,2020-06-12,(02304) Heroes,765,564,459,1788
21541,2020-03-27,(02001) Centro Comercial Santa Fe,147,110,144,401
21542,2020-03-28,(02000) Cabecera Autopista Norte - intermunicipal,65,54,58,177
21543,2020-05-20,(10005) Bicentenario,96,49,74,219
21544,2020-07-05,(09120) Calle 63,352,244,331,927
21545,2020-02-16,(08000) Portal Tunal,560,376,410,1346
21546,2020-01-25,(04107) Escuela Militar,336,237,341,914
21547,2020-03-24,(04107) Escuela Militar,99,69,90,258
21548,2020-09-14,(10009) Museo Nacional,597,337,395,1329
21549,2020-05-22,(03002) SUBA - TV- 91,646,356,394,1396
21550,2020-05-19,(06111) Universidades,0,103,309,412
21551,2020-07-07,(06111) Universidades,349,223,343,915
21552,2020-07-07,(07111) NQS - RICAURTE,1229,764,495,2488
21553,2020-08-27,(09115) Calle 34,615,392,366,1373
21554,2020-08-31,(09115) Calle 34,637,411,415,1463
21555,2020-06-15,(09115) Calle 34,163,119,151,433
21556,2020-01-19,(07005) ALQUERIA,575,316,558,1449
21557,2020-05-19,(02201) Prado,760,502,398,1660
21558,2020-06-09,(07200) Tygua-San José,222,125,138,485
21559,2020-02-23,(09122) Calle 72,1080,792,1466,3338
21560,2020-02-02,(08001) Parque el Tunal,382,174,372,928
21561,2020-04-13,(04100) Carrera 77,585,344,356,1285
21562,2020-09-19,(06109) Centro Memoria,208,133,172,513
21563,2020-02-09,(09002) Consuelo,416,172,404,992
21564,2020-07-08,(02302) Virrey,730,469,377,1576
21565,2020-04-09,(03000) Portal Suba,215,123,129,467
21566,2020-05-11,(07105) MOVISTAR ARENA,179,130,112,421
21567,2020-06-05,(09121) Las Flores,667,460,405,1532
21568,2020-01-22,(09105) Río Fucha,731,398,549,1678
21569,2020-01-05,(09107) Hortúa,415,223,472,1110
21570,2020-09-11,(10007) Las Nieves,660,434,392,1486
21571,2020-08-26,(07004) VENECIA,963,561,509,2033
21572,2020-01-05,(05103) Marsella,299,134,289,722
21573,2020-05-10,(02104) Calle 146,187,134,104,425
21574,2020-08-08,(09119) Calle 57,389,256,309,954
21575,2020-05-09,(04000) Cabecera Calle 80,519,335,378,1232
21576,2020-08-17,(06102) Salitre El Greco,68,38,55,161
21577,2020-07-14,(40001) Juan Pablo II,304,206,191,701
21578,2020-03-13,(07107) U. NACIONAL,552,115,248,915
21579,2020-05-06,(09115) Calle 34,451,328,262,1041
21580,2020-10-06,(07103) AV. CHILE,1004,636,683,2323
21581,2020-09-29,(03005) SUBA - AV. BOYACA,517,301,374,1192
21582,2020-05-18,(08002) Biblioteca,243,131,127,501
21583,2020-02-12,(50002) Corral Calle 40 Sur,142,93,153,388
21584,2020-04-15,(04000) Cabecera Calle 80,557,366,391,1314
21585,2020-08-12,(07107) U. NACIONAL,323,177,168,668
21586,2020-05-15,(04107) Escuela Militar,109,76,93,278
21587,2020-05-19,(06001) Modelia,359,228,173,760
21588,2020-05-31,(09109) Tercer Milenio,93,51,102,246
21589,2020-01-20,(09108) Hospital,217,126,230,573
21590,2020-08-17,(03013) RIO NEGRO,75,55,80,210
21591,2020-08-14,(07008) NQS - Calle 30 Sur,304,148,190,642
21592,2020-10-07,(07008) NQS - Calle 30 Sur,387,219,298,904
21593,2020-05-22,(07200) Tygua-San José,197,109,140,446
21594,2020-08-20,(50003) Corral Molinos,1439,781,996,3216
21595,2020-01-06,(09106) Nariño,287,174,357,818
21596,2020-04-05,(09122) Calle 72,267,178,129,574
21597,2020-05-31,(07112) COMUNEROS,199,115,133,447
21598,2020-09-17,(06106) Recinto Ferial,290,171,179,640
21599,2020-04-20,(02502) Terminal,160,122,129,411
21600,2020-07-14,(06002) Normandía,239,142,153,534
21601,2020-08-25,(07006) General Santander,507,314,280,1101
21602,2020-10-12,(07009) SENA,247,154,293,694
21603,2020-03-21,(03001) LA CAMPIÑA,255,172,141,568
21604,2020-06-28,(02103) Mazurén,37,35,54,126
21605,2020-07-23,(07004) VENECIA,770,479,457,1706
21606,2020-07-19,(40001) Juan Pablo II,101,52,88,241
21607,2020-08-13,(06107) Ciudad Universitaria,154,112,121,387
21608,2020-05-26,(07010) Bosa,616,311,367,1294
21609,2020-06-15,(02502) Terminal,91,75,96,262
21610,2020-05-02,(04103) Las Ferias,173,116,68,357
21611,2020-03-29,(50003) Corral Molinos,290,121,197,608
21612,2020-05-25,(03011) SUBA - CALLE 100,127,76,95,298
21613,2020-07-06,(04106) Carrera 47,350,180,210,740
21614,2020-08-11,(09106) Nariño,377,211,311,899
21615,2020-07-06,(10004) Policarpa,261,140,214,615
21616,2020-08-15,(03005) SUBA - AV. BOYACA,322,184,285,791
21617,2020-01-12,(07101) CASTELLANA,59,56,148,263
21618,2020-05-25,(03001) LA CAMPIÑA,254,147,148,549
21619,2020-03-28,(10007) Las Nieves,92,89,98,279
21620,2020-04-16,(07005) ALQUERIA,273,165,137,575
21621,2020-08-16,(07005) ALQUERIA,151,78,137,366
21622,2020-05-24,(06100) Av. Rojas,46,23,26,95
21623,2020-08-17,(03004) GRATAMIRA,0,11,16,27
21624,2020-07-12,(07000) Portal Sur,508,272,451,1231
21625,2020-04-19,(09105) Río Fucha,20,15,13,48
21626,2020-07-17,(09106) Nariño,339,181,256,776
21627,2020-10-03,(09105) Río Fucha,0,66,172,238
21628,2019-12-31,(09123) Calle 76,23,13,46,82
21629,2020-04-01,(05100) Banderas P. Central,314,196,219,729
21630,2020-05-10,(09121) Las Flores,146,106,144,396
21631,2020-08-09,(09121) Las Flores,146,95,148,389
21632,2020-03-23,(07111) NQS - RICAURTE,101,100,69,270
21633,2020-05-01,(07004) VENECIA,271,139,150,560
21634,2020-04-19,(09121) Las Flores,134,93,93,320
21635,2020-07-13,(14005) Las Aguas,128,77,160,365
21636,2020-06-07,(14005) Las Aguas,0,12,62,74
21637,2020-04-12,(10003) Ciudad Jardín,33,14,20,67
21638,2020-05-12,(14004) Museo del Oro,0,78,168,246
21639,2020-07-12,(06001) Modelia,101,62,106,269
21640,2020-03-21,(09115) Calle 34,248,169,143,560
21641,2020-04-02,(04102) Avenida Boyaca,128,73,76,277
21642,2020-08-09,(07006) General Santander,122,66,118,306
21643,2020-05-29,(06102) Salitre El Greco,177,98,111,386
21644,2020-05-01,(12002) CDS - Carrera 32,71,58,30,159
21645,2020-03-29,(07008) NQS - Calle 30 Sur,47,23,21,91
21646,2020-03-22,(07201) Guatoque -Veraguas,12,11,18,41
21647,2020-04-05,(07006) General Santander,97,47,50,194
21648,2020-08-24,(06108) Concejo de Bogotá,126,63,57,246
21649,2020-04-26,(04103) Las Ferias,79,56,45,180
21650,2020-01-02,(50006) Corral Carrera 77,11,12,23,46
21651,2020-07-02,(50006) Corral Carrera 77,4,3,11,18
21652,2020-05-09,(03004) GRATAMIRA,18,9,13,40
21653,2020-09-06,(50006) Corral Carrera 77,3,0,3,6
21654,2020-07-16,(09002) Consuelo,313,177,191,681
21655,2020-03-29,(09118) Marly,454,285,169,908
21656,2020-01-29,(07504) TERREROS,17295,10623,9127,37045
21657,2020-06-12,(07504) TERREROS,5686,3284,2781,11751
21658,2020-06-17,(07504) TERREROS,5924,3497,2809,12230
21659,2020-02-22,(09119) Calle 57,1802,1107,1520,4429
21660,2020-01-04,(05000) Portal Américas - alimentacion,15736,7324,9387,32447
21661,2020-02-12,(06000) Portal Eldorado - alimentacion,19076,10632,10015,39723
21662,2020-01-13,(10000) Portal 20 de Julio - alimentacion,9744,4666,6717,21127
21663,2020-03-17,(10000) Portal 20 de Julio - alimentacion,7661,3857,5462,16980
21664,2020-03-06,(02000) Cabecera Autopista Norte - alimentacion,23253,12938,13670,49861
21665,2020-02-04,(04002) Carrera 90,3769,2300,2117,8186
21666,2020-01-17,(09003) Socorro,1509,777,948,3234
21667,2020-02-11,(07111) NQS - RICAURTE,3246,2070,1824,7140
21668,2020-09-04,(04000) Cabecera Calle 80 - alimentacion,4634,2492,3364,10490
21669,2020-04-03,(04000) Cabecera Calle 80 - alimentacion,1875,997,1133,4005
21670,2020-10-05,(06107) Ciudad Universitaria,204,143,204,551
21671,2020-09-05,(07503) SAN MATEO,10118,4976,5843,20937
21672,2020-03-04,(02000) Cabecera Autopista Norte - intermunicipal,4975,3437,3087,11499
21673,2020-01-27,(02201) Prado,5590,3597,2944,12131
21674,2020-03-06,(05005) Transversal 86,2795,1459,1405,5659
21675,2020-02-01,(06000) Portal Eldorado - alimentacion,10485,4726,7184,22395
21676,2020-01-30,(05100) Banderas P. Central,7714,4464,3709,15887
21677,2020-08-04,(05100) Banderas P. Central,619,374,390,1383
21678,2020-08-19,(10001) Country Sur,1028,500,714,2242
21679,2020-10-04,(10001) Country Sur,414,198,480,1092
21680,2020-02-19,(40001) Juan Pablo II,1692,989,935,3616
21681,2020-08-24,(09000) Cabecera Usme,1537,879,1077,3493
21682,2020-02-06,(05100) Banderas P. Central - alimentacion,15687,8763,8064,32514
21683,2020-01-20,(02205) Calle 106,2556,1605,1301,5462
21684,2020-10-03,(10005) Bicentenario - alimentacion,176,88,210,474
21685,2020-10-04,(40003) Mirador del Paraiso,666,346,590,1602
21686,2020-01-30,(09104) Restrepo,5121,3036,3812,11969
21687,2020-08-13,(07505) LEON XIII,2605,1349,1171,5125
21688,2020-03-24,(07504) TERREROS,4233,2253,2521,9007
21689,2020-03-03,(04104) Avenida 68,3648,1987,1926,7561
21690,2020-03-03,(09110) Avenida Jimenez,4962,3384,2901,11247
21691,2020-02-12,(09123) Calle 76,5920,3948,3196,13064
21692,2020-02-18,(02102) Calle 161,2041,1251,1148,4440
21693,2020-03-17,(07102) NQS - CALLE 75,1116,727,597,2440
21694,2020-08-12,(03013) RIO NEGRO,242,146,138,526
21695,2020-02-06,(02304) Heroes,4527,3345,2376,10248
21696,2020-03-12,(09103) Olaya,312,965,697,1974
21697,2020-03-18,(02103) Mazurén,1063,664,602,2329
21698,2020-09-02,(02103) Mazurén,201,139,187,527
21699,2020-02-14,(05100) Banderas P. Central - alimentacion,16543,8828,8816,34187
21700,2020-10-08,(09103) Olaya,1138,605,828,2571
21701,2020-07-09,(14001) La Sabana,181,119,108,408
21702,2020-09-09,(07111) NQS - RICAURTE,1242,741,576,2559
21703,2020-07-01,(08000) Portal Tunal - alimentacion,6740,3741,3785,14266
21704,2020-02-06,(04102) Avenida Boyaca,3153,1841,1673,6667
21705,2020-02-26,(04102) Avenida Boyaca,3124,1815,1642,6581
21706,2020-02-21,(03003) 21 ANGELES,1716,802,880,3398
21707,2020-03-15,(05000) Portal Américas,2200,1004,1920,5124
21708,2020-05-29,(05000) Portal Américas,2249,1463,1652,5364
21709,2020-09-12,(09114) Calle 26,170,137,259,566
21710,2020-07-02,(04002) Carrera 90,801,451,474,1726
21711,2020-08-13,(04100) Carrera 77,1040,575,738,2353
21712,2020-03-13,(10006) San Victorino,1023,116,267,1406
21713,2020-07-09,(10006) San Victorino,784,321,345,1450
21714,2020-09-03,(10006) San Victorino,753,378,406,1537
21715,2020-06-17,(03000) Portal Suba,1231,804,774,2809
21716,2020-04-22,(40003) Mirador del Paraiso,776,488,583,1847
21717,2020-01-22,(12001) Carrera 43,1528,953,995,3476
21718,2020-06-03,(12001) Carrera 43,378,224,197,799
21719,2020-04-03,(10002) Av. Primero de Mayo,1096,618,678,2392
21720,2020-01-17,(02502) Terminal,4166,2500,2836,9502
21721,2020-02-22,(09101) Quiroga,982,526,979,2487
21722,2020-07-11,(09101) Quiroga,512,228,412,1152
21723,2020-08-24,(09101) Quiroga,431,227,311,969
21724,2020-02-20,(06100) Av. Rojas,2738,1467,1206,5411
21725,2020-02-24,(08002) Biblioteca,1049,657,714,2420
21726,2020-07-10,(10000) Portal 20 de Julio,2441,1213,1180,4834
21727,2020-04-03,(09116) Avenida 39,187,165,142,494
21728,2020-01-30,(04003) Avenida Ciudad de Cali,5409,3178,3353,11940
21729,2020-06-27,(02101) Toberín,1040,616,791,2447
21730,2020-09-14,(06108) Concejo de Bogotá,146,75,84,305
21731,2020-03-01,(09116) Avenida 39,224,213,440,877
21732,2020-09-17,(14004) Museo del Oro,416,274,302,992
21733,2020-02-03,(05103) Marsella,3118,1846,1463,6427
21734,2020-07-25,(08001) Parque el Tunal,281,147,186,614
21735,2020-08-22,(08001) Parque el Tunal,349,170,238,757
21736,2020-01-19,(06002) Normandía,269,180,355,804
21737,2020-01-27,(10007) Las Nieves,1939,1168,1078,4185
21738,2020-03-01,(09000) Cabecera Usme,1244,543,1350,3137
21739,2020-05-10,(09107) Hortúa,181,114,106,401
21740,2020-07-23,(09107) Hortúa,481,292,265,1038
21741,2020-08-10,(09107) Hortúa,595,358,338,1291
21742,2020-08-20,(09107) Hortúa,564,323,326,1213
21743,2020-10-09,(02204) Pepe Sierra,919,635,687,2241
21744,2020-01-17,(05105) Pradera,2120,1282,1127,4529
21745,2020-06-25,(05100) Banderas P. Central - alimentacion,3071,1671,1770,6512
21746,2020-05-26,(10000) Portal 20 de Julio,2107,1069,1031,4207
21747,2020-01-02,(02300) Calle 100,3342,2051,2116,7509
21748,2020-04-15,(02300) Calle 100,725,523,361,1609
21749,2020-07-20,(02300) Calle 100,256,229,188,673
21750,2020-09-23,(02300) Calle 100,1297,911,904,3112
21751,2020-03-25,(09001) Molinos,1131,678,811,2620
21752,2020-08-08,(09123) Calle 76,618,422,441,1481
21753,2020-09-15,(07006) General Santander,580,345,372,1297
21754,2020-07-25,(05005) Transversal 86,179,98,141,418
21755,2020-07-14,(05001) Patio Bonito,1456,809,888,3153
21756,2020-03-10,(08000) Portal Tunal,681,327,323,1331
21757,2020-02-10,(06109) Centro Memoria,1221,689,609,2519
21758,2020-01-02,(09121) Las Flores,1454,926,1030,3410
21759,2020-08-04,(05107) Américas - Cr.53,349,213,239,801
21760,2020-01-14,(03006) NIZA - CALLE 127,1913,1182,1354,4449
21761,2020-02-25,(03006) NIZA - CALLE 127,2456,1555,1479,5490
21762,2020-09-03,(04003) Avenida Ciudad de Cali,1124,618,813,2555
21763,2020-05-01,(04108) El Polo,109,77,60,246
21764,2020-07-07,(04108) El Polo,512,318,275,1105
21765,2020-05-30,(07101) CASTELLANA,88,62,90,240
21766,2020-02-08,(06102) Salitre El Greco,689,474,582,1745
21767,2020-03-05,(09121) Las Flores,3325,2159,2108,7592
21768,2020-06-29,(03007) HUMEDAL CORDOBA,50,39,25,114
21769,2020-07-06,(04104) Avenida 68,701,327,330,1358
21770,2020-01-02,(04000) Cabecera Calle 80,3007,1852,2459,7318
21771,2020-06-26,(07000) Portal Sur,2039,1244,1237,4520
21772,2020-04-29,(10000) Portal 20 de Julio,1385,709,702,2796
21773,2020-09-25,(14005) Las Aguas,275,190,347,812
21774,2020-08-02,(02101) Toberín,191,151,259,601
21775,2020-05-29,(10005) Bicentenario - alimentacion,212,91,192,495
21776,2020-08-18,(04107) Escuela Militar,140,79,89,308
21777,2020-08-03,(09000) Cabecera Usme,1493,910,1134,3537
21778,2020-03-15,(03000) Portal Suba - alimentacion,4789,2191,3960,10940
21779,2020-01-14,(05103) Marsella,2313,1313,1274,4900
21780,2020-04-27,(05103) Marsella,110,33,22,165
21781,2020-09-03,(09109) Tercer Milenio,391,239,287,917
21782,2020-02-01,(07004) VENECIA,2899,1494,1949,6342
21783,2020-07-27,(02202) Calle 127,1019,728,495,2242
21784,2020-10-04,(09121) Las Flores,188,146,290,624
21785,2020-08-20,(02304) Heroes,699,496,423,1618
21786,2020-07-19,(03001) LA CAMPIÑA,251,140,168,559
21787,2020-10-01,(07109) CAD,702,486,404,1592
21788,2020-01-26,(06100) Av. Rojas,191,145,309,645
21789,2020-08-17,(02302) Virrey,191,139,127,457
21790,2020-08-23,(07009) SENA,170,105,140,415
21791,2020-09-07,(03013) RIO NEGRO,296,174,209,679
21792,2020-03-15,(06103) CAN,239,173,259,671
21793,2020-06-30,(03002) SUBA - TV- 91,832,481,499,1812
21794,2020-10-01,(03002) SUBA - TV- 91,947,548,737,2232
21795,2020-02-16,(50003) Corral Molinos,878,513,1214,2605
21796,2020-09-29,(10010) San Bernardo,673,337,534,1544
21797,2020-07-06,(04103) Las Ferias,387,218,193,798
21798,2020-02-26,(40002) Manitas,1347,692,738,2777
21799,2020-02-13,(07006) General Santander,3008,1636,1657,6301
21800,2020-09-16,(10008) San Diego,321,189,200,710
21801,2020-06-21,(06000) Portal Eldorado - alimentacion,1310,601,782,2693
21802,2020-01-15,(07107) U. NACIONAL,1255,879,1024,3158
21803,2020-06-23,(09120) Calle 63,1204,806,733,2743
21804,2020-07-14,(05105) Pradera,578,334,214,1126
21805,2020-06-24,(12007) Zona Industrial,366,240,163,769
21806,2020-02-29,(07003) SEVILLANA,1198,570,871,2639
21807,2020-07-29,(03006) NIZA - CALLE 127,478,260,232,970
21808,2020-10-08,(07006) General Santander,647,383,457,1487
21809,2020-08-07,(09117) Calle 45,287,193,203,683
21810,2020-03-03,(40002) Manitas,1317,740,801,2858
21811,2019-12-31,(02000) Cabecera Autopista Norte - alimentacion,388,197,265,850
21812,2020-06-07,(09111) Calle 19,169,123,181,473
21813,2020-05-04,(02201) Prado,528,356,301,1185
21814,2020-02-16,(04105) Carrera 53,307,174,315,796
21815,2020-01-16,(07200) Tygua-San José,681,382,561,1624
21816,2020-06-12,(07001) PERDOMO,899,510,529,1938
21817,2020-07-17,(02303) Calle 85,556,405,265,1226
21818,2020-09-27,(50003) Corral Molinos,509,242,593,1344
21819,2020-10-01,(07201) Guatoque -Veraguas,243,142,179,564
21820,2020-07-13,(07105) MOVISTAR ARENA,234,145,103,482
21821,2020-05-27,(09121) Las Flores,628,424,396,1448
21822,2020-07-25,(07000) Portal Sur,1113,655,753,2521
21823,2020-10-02,(07008) NQS - Calle 30 Sur,431,213,316,960
21824,2020-09-26,(07004) VENECIA,885,493,718,2096
21825,2020-09-06,(07004) VENECIA,307,159,288,754
21826,2020-04-22,(02104) Calle 146,413,289,250,952
21827,2020-10-02,(03011) SUBA - CALLE 100,644,317,390,1351
21828,2020-09-28,(03013) RIO NEGRO,305,172,268,745
21829,2020-06-01,(09110) Avenida Jimenez,980,657,701,2338
21830,2020-09-19,(09107) Hortúa,449,276,411,1136
21831,2020-06-23,(07109) CAD,640,392,275,1307
21832,2020-04-25,(02102) Calle 161,84,45,51,180
21833,2020-08-26,(09111) Calle 19,646,371,427,1444
21834,2020-09-01,(06106) Recinto Ferial,253,163,143,559
21835,2020-07-11,(07005) ALQUERIA,512,274,347,1133
21836,2020-10-11,(10009) Museo Nacional,104,103,204,411
21837,2020-08-23,(03006) NIZA - CALLE 127,153,85,107,345
21838,2020-06-20,(10004) Policarpa,195,86,130,411
21839,2020-07-13,(08001) Parque el Tunal,299,190,147,636
21840,2020-03-27,(02300) Calle 100,740,531,404,1675
21841,2020-10-01,(03010) PUENTE LARGO,404,237,317,958
21842,2020-09-15,(06106) Recinto Ferial,272,166,144,582
21843,2020-04-09,(02001) Centro Comercial Santa Fe,63,44,53,160
21844,2020-08-28,(04000) Cabecera Calle 80 - intermunicipal,333,181,331,845
21845,2020-02-23,(04000) Cabecera Calle 80 - intermunicipal,339,201,397,937
21846,2020-04-04,(06001) Modelia,153,115,94,362
21847,2020-08-23,(03009) Av. Suba- Calle 116,139,94,77,310
21848,2020-09-22,(04106) Carrera 47,363,177,193,733
21849,2020-05-31,(03011) SUBA - CALLE 100,129,85,97,311
21850,2020-07-14,(07008) NQS - Calle 30 Sur,283,152,159,594
21851,2020-05-01,(04000) Cabecera Calle 80,264,151,202,617
21852,2020-09-13,(05107) Américas - Cr.53,88,78,139,305
21853,2020-08-29,(10009) Museo Nacional,261,205,335,801
21854,2020-09-08,(06100) Av. Rojas,295,177,154,626
21855,2020-06-26,(10004) Policarpa,260,127,179,566
21856,2020-01-01,(12004) Carrera 22,16,34,72,122
21857,2020-03-09,(10004) Policarpa,96,171,129,396
21858,2020-08-11,(04001) Quirigua,303,194,238,735
21859,2020-01-06,(07008) NQS - Calle 30 Sur,281,129,283,693
21860,2020-05-06,(03004) GRATAMIRA,21,16,23,60
21861,2020-10-12,(05100) Banderas P. Central,237,104,274,615
21862,2020-08-13,(06105) Quinta Paredes,135,76,74,285
21863,2020-03-23,(06108) Concejo de Bogotá,51,38,28,117
21864,2020-01-08,(03014) SAN MARTIN,194,117,142,453
21865,2020-06-20,(02103) Mazurén,150,85,116,351
21866,2020-05-25,(07007) NQS - Calle 38A Sur,116,83,66,265
21867,2020-04-05,(03006) NIZA - CALLE 127,111,85,59,255
21868,2020-05-24,(03004) GRATAMIRA,14,7,10,31
21869,2020-05-31,(03004) GRATAMIRA,11,6,12,29
21870,2020-04-27,(09106) Nariño,120,45,35,200
21871,2020-07-05,(04001) Quirigua,145,73,114,332
21872,2020-04-29,(06106) Recinto Ferial,171,104,76,351
21873,2020-05-03,(10003) Ciudad Jardín,40,19,19,78
21874,2020-09-20,(07003) SEVILLANA,119,59,153,331
21875,2020-05-23,(10005) Bicentenario,77,34,63,174
21876,2020-05-23,(12007) Zona Industrial,190,128,104,422
21877,2020-07-28,(07101) CASTELLANA,176,118,99,393
21878,2020-03-30,(06105) Quinta Paredes,65,58,45,168
21879,2020-09-20,(07008) NQS - Calle 30 Sur,136,64,119,319
21880,2020-06-28,(07105) MOVISTAR ARENA,58,42,61,161
21881,2020-05-09,(05102) Av. Américas - Av. Boyacá,105,56,78,239
21882,2020-05-01,(05101) Mandalay - Cr.73,35,20,18,73
21883,2020-03-19,(50006) Corral Carrera 77,16,8,14,38
21884,2020-07-13,(03004) GRATAMIRA,37,11,19,67
21885,2020-06-30,(04000) Cabecera Calle 80 - alimentacion,4333,2487,2842,9662
21886,2020-07-31,(04000) Cabecera Calle 80 - alimentacion,3008,1734,2027,6769
21887,2020-01-27,(07005) ALQUERIA,2434,1433,1388,5255
21888,2020-08-03,(09002) Consuelo,446,221,241,908
21889,2020-08-10,(09002) Consuelo,477,261,271,1009
21890,2020-07-29,(02502) Terminal,378,252,297,927
21891,2020-08-11,(02502) Terminal,384,259,321,964
21892,2020-08-29,(02502) Terminal,242,190,314,746
21893,2020-02-17,(09118) Marly,8482,5447,4073,18002
21894,2020-09-07,(09119) Calle 57,591,354,392,1337
21895,2020-02-27,(08000) Portal Tunal - alimentacion,24716,13435,11714,49865
21896,2020-01-16,(04106) Carrera 47,1228,648,753,2629
21897,2020-01-08,(03000) Portal Suba - alimentacion,19640,10741,12017,42398
21898,2020-02-22,(02303) Calle 85,1545,1155,1355,4055
21899,2020-02-17,(09122) Calle 72,8807,5598,4270,18675
21900,2020-03-04,(07503) SAN MATEO,40028,22565,17714,80307
21901,2020-01-08,(09100) Calle 40 Sur,5319,2778,3344,11441
21902,2020-02-01,(09100) Calle 40 Sur,4261,2101,3233,9595
21903,2020-02-06,(09100) Calle 40 Sur,7464,4374,4289,16127
21904,2020-01-04,(06104) Gobernación,169,155,228,552
21905,2020-01-26,(06104) Gobernación,116,100,193,409
21906,2020-02-14,(06104) Gobernación,1389,847,682,2918
21907,2020-08-16,(04000) Cabecera Calle 80 - alimentacion,1050,489,859,2398
21908,2020-03-01,(09003) Socorro,554,217,437,1208
21909,2020-10-11,(04000) Cabecera Calle 80 - alimentacion,1601,597,1715,3913
21910,2020-03-04,(09001) Molinos,7735,4503,5880,18118
21911,2020-03-10,(07010) Bosa,69,591,519,1179
21912,2020-02-26,(02000) Cabecera Autopista Norte - intermunicipal,5081,3266,3189,11536
21913,2020-01-23,(02201) Prado,5441,3385,2913,11739
21914,2020-03-10,(05005) Transversal 86,59,795,478,1332
21915,2020-01-17,(04100) Carrera 77,5740,3059,3816,12615
21916,2020-06-06,(08000) Portal Tunal - alimentacion,4814,2463,2509,9786
21917,2020-09-23,(10000) Portal 20 de Julio - alimentacion,4559,2047,2958,9564
21918,2020-09-07,(05100) Banderas P. Central,925,554,619,2098
21919,2020-01-13,(09113) Calle 22,1044,706,955,2705
21920,2020-03-30,(06000) Portal Eldorado - alimentacion,2225,1057,941,4223
21921,2020-01-31,(02205) Calle 106,2492,1627,1408,5527
21922,2020-03-16,(09104) Restrepo,3875,2419,2996,9290
21923,2020-07-21,(09104) Restrepo,1243,727,845,2815
21924,2020-01-28,(04101) Minuto de Dios,2717,1631,1572,5920
21925,2020-08-17,(04101) Minuto de Dios,77,53,92,222
21926,2020-01-13,(07505) LEON XIII,7349,3944,3646,14939
21927,2020-02-14,(10006) San Victorino,2329,1363,1473,5165
21928,2020-02-10,(04104) Avenida 68,3942,2009,1761,7712
21929,2020-01-24,(06002) Normandía,2333,1345,1236,4914
21930,2020-01-17,(05002) Tintal,9247,5337,5837,20421
21931,2020-08-04,(05002) Tintal,2017,1138,1247,4402
21932,2020-02-28,(07110) PALOQUEMAO,2706,1629,1303,5638
21933,2020-04-09,(09118) Marly,480,324,201,1005
21934,2020-08-07,(09118) Marly,567,347,363,1277
21935,2020-03-24,(09110) Avenida Jimenez,465,453,642,1560
21936,2020-03-06,(07110) PALOQUEMAO,2631,1569,1302,5502
21937,2020-06-25,(03001) LA CAMPIÑA,1141,669,590,2400
21938,2020-01-28,(07106) EL CAMPIN,2055,1310,1138,4503
21939,2020-06-05,(09103) Olaya,930,510,501,1941
21940,2020-05-15,(14001) La Sabana,116,82,76,274
21941,2020-09-11,(07111) NQS - RICAURTE,1155,658,560,2373
21942,2020-07-30,(02000) Cabecera Autopista Norte,1243,792,800,2835
21943,2020-09-14,(02000) Cabecera Autopista Norte,1579,973,1031,3583
21944,2020-01-17,(07107) U. NACIONAL,1784,1185,1247,4216
21945,2020-02-23,(10002) Av. Primero de Mayo,1536,737,1623,3896
21946,2020-08-27,(08000) Portal Tunal - alimentacion,6070,3274,3522,12866
21947,2020-01-11,(50003) Corral Molinos,2309,1198,2194,5701
21948,2020-09-19,(05000) Portal Américas,2923,1436,2389,6748
21949,2020-03-05,(10001) Country Sur,5093,2308,2804,10205
21950,2020-04-16,(04002) Carrera 90,374,195,164,733
21951,2020-07-23,(04100) Carrera 77,1053,614,628,2295
21952,2020-01-06,(03000) Portal Suba,1005,520,1120,2645
21953,2020-01-31,(03000) Portal Suba,8957,4808,5232,18997
21954,2020-07-01,(12001) Carrera 43,437,249,311,997
21955,2020-08-22,(12001) Carrera 43,279,150,211,640
21956,2020-06-26,(10002) Av. Primero de Mayo,2323,1197,1421,4941
21957,2020-01-17,(02105) Calle 142,6062,3362,3502,12926
21958,2020-02-03,(06101) El Tiempo,3021,1630,1342,5993
21959,2020-02-04,(06101) El Tiempo,3056,1712,1448,6216
21960,2020-05-31,(03000) Portal Suba - alimentacion,1667,833,1084,3584
21961,2020-06-20,(03000) Portal Suba - alimentacion,4798,2688,3030,10516
21962,2020-04-28,(10000) Portal 20 de Julio - alimentacion,1414,1291,2165,4870
21963,2020-02-05,(06100) Av. Rojas,2947,1584,1316,5847
21964,2020-01-20,(10000) Portal 20 de Julio,8139,3792,3833,15764
21965,2020-09-16,(10000) Portal 20 de Julio,2384,1219,1441,5044
21966,2020-01-01,(08002) Biblioteca,96,35,129,260
21967,2020-02-21,(08002) Biblioteca,977,530,671,2178
21968,2020-08-22,(10000) Portal 20 de Julio,1657,790,1009,3456
21969,2020-05-19,(07112) COMUNEROS,611,373,286,1270
21970,2020-08-01,(02303) Calle 85,428,283,231,942
21971,2020-07-06,(09003) Socorro,645,346,359,1350
21972,2020-10-09,(09003) Socorro,670,325,482,1477
21973,2020-07-05,(07503) SAN MATEO,3211,1749,1890,6850
21974,2020-08-04,(08001) Parque el Tunal,427,233,250,910
21975,2020-09-27,(09000) Cabecera Usme - alimentacion,2834,1211,2489,6534
21976,2020-05-13,(09116) Avenida 39,243,164,177,584
21977,2020-08-22,(09116) Avenida 39,173,138,200,511
21978,2020-02-22,(02302) Virrey,1343,1067,1332,3742
21979,2020-02-05,(06103) CAN,2698,1532,1235,5465
21980,2020-05-14,(06108) Concejo de Bogotá,127,62,75,264
21981,2020-07-18,(10002) Av. Primero de Mayo,1180,579,833,2592
21982,2020-07-21,(10002) Av. Primero de Mayo,1656,826,975,3457
21983,2020-02-22,(02200) Alcalá,6348,3442,4166,13956
21984,2020-04-08,(02201) Prado,403,262,245,910
21985,2020-09-26,(03012) SUBA - CALLE 95,230,160,199,589
21986,2020-06-13,(10000) Portal 20 de Julio,1793,840,1036,3669
21987,2020-08-18,(09119) Calle 57,415,298,315,1028
21988,2020-02-08,(05107) Américas - Cr.53,1359,814,1141,3314
21989,2020-06-06,(09001) Molinos,1843,955,1271,4069
21990,2020-09-23,(05001) Patio Bonito,2354,1227,1461,5042
21991,2020-05-05,(05105) Pradera,472,301,157,930
21992,2020-02-11,(08000) Portal Tunal,2345,1321,1149,4815
21993,2020-07-07,(06109) Centro Memoria,303,165,144,612
21994,2020-01-30,(09121) Las Flores,3123,1943,1870,6936
21995,2020-02-10,(09106) Nariño,2094,1287,1325,4706
21996,2020-06-30,(08000) Portal Tunal,808,329,280,1417
21997,2020-09-15,(03009) Av. Suba- Calle 116,524,319,289,1132
21998,2020-05-08,(04003) Avenida Ciudad de Cali,741,441,482,1664
21999,2020-03-14,(04108) El Polo,923,613,841,2377
22000,2020-02-13,(12007) Zona Industrial,1293,806,642,2741
22001,2020-01-15,(06000) Portal Eldorado,5489,3293,2652,11434
22002,2020-10-12,(10006) San Victorino,183,128,189,500
22003,2020-07-13,(09000) Cabecera Usme,1061,704,808,2573
22004,2020-07-21,(02101) Toberín,1316,864,809,2989
22005,2020-09-19,(10003) Ciudad Jardín,216,96,175,487
22006,2020-07-04,(04107) Escuela Militar,114,77,106,297
22007,2020-04-10,(05000) Portal Américas,405,291,289,985
22008,2020-09-08,(07102) NQS - CALLE 75,483,323,235,1041
22009,2020-06-23,(04107) Escuela Militar,148,100,107,355
22010,2020-08-19,(09109) Tercer Milenio,327,207,228,762
22011,2020-03-13,(04002) Carrera 90,166,749,578,1493
22012,2020-08-13,(04002) Carrera 90,595,344,345,1284
22013,2020-03-08,(07002) MADELENA,857,328,785,1970
22014,2020-01-06,(06101) El Tiempo,235,156,307,698
22015,2020-10-06,(04104) Avenida 68,753,374,505,1632
22016,2020-10-02,(02104) Calle 146,1109,638,929,2676
22017,2020-02-08,(06100) Av. Rojas,833,528,831,2192
22018,2020-09-06,(09101) Quiroga,223,92,204,519
22019,2020-03-13,(04003) Avenida Ciudad de Cali,182,1058,882,2122
22020,2020-10-06,(07109) CAD,784,479,465,1728
22021,2020-04-08,(07113) SANTA ISABEL,199,130,139,468
22022,2020-07-01,(02105) Calle 142,812,488,527,1827
22023,2020-06-18,(06000) Portal Eldorado,975,659,523,2157
22024,2020-06-02,(02302) Virrey,599,370,268,1237
22025,2020-07-05,(02302) Virrey,161,111,122,394
22026,2020-08-06,(02302) Virrey,610,422,301,1333
22027,2020-05-27,(06000) Portal Eldorado - alimentacion,3606,1752,1656,7014
22028,2020-09-24,(12003) Ricaurte,434,311,237,982
22029,2020-02-15,(03010) PUENTE LARGO,888,590,856,2334
22030,2020-06-18,(10010) San Bernardo,593,328,391,1312
22031,2020-04-09,(07005) ALQUERIA,109,63,49,221
22032,2020-07-26,(09100) Calle 40 Sur,417,228,341,986
22033,2020-07-28,(07007) NQS - Calle 38A Sur,287,185,227,699
22034,2020-06-03,(05107) Américas - Cr.53,429,236,215,880
22035,2020-08-16,(02104) Calle 146,202,145,171,518
22036,2020-06-18,(02103) Mazurén,216,124,174,514
22037,2020-08-01,(07103) AV. CHILE,395,287,325,1007
22038,2020-07-02,(07004) VENECIA,1062,670,666,2398
22039,2020-02-15,(07105) MOVISTAR ARENA,731,488,664,1883
22040,2020-08-01,(10005) Bicentenario,68,42,58,168
22041,2020-03-19,(40002) Manitas,847,428,561,1836
22042,2020-09-05,(02200) Alcalá,1570,1006,996,3572
22043,2020-03-24,(06103) CAN,491,378,246,1115
22044,2020-08-18,(07003) SEVILLANA,402,214,213,829
22045,2020-09-22,(08002) Biblioteca,338,186,236,760
22046,2020-09-12,(04107) Escuela Militar,114,78,112,304
22047,2020-01-16,(09003) Socorro,1480,790,871,3141
22048,2020-08-13,(09003) Socorro,567,295,323,1185
22049,2020-04-28,(40003) Mirador del Paraiso,973,590,683,2246
22050,2020-08-05,(09115) Calle 34,606,350,335,1291
22051,2020-06-27,(10009) Museo Nacional,236,204,276,716
22052,2020-03-15,(03001) LA CAMPIÑA,849,362,794,2005
22053,2020-06-25,(10003) Ciudad Jardín,205,108,149,462
22054,2020-01-07,(14005) Las Aguas,1115,763,1019,2897
22055,2020-05-07,(12002) CDS - Carrera 32,194,126,63,383
22056,2020-09-10,(06109) Centro Memoria,250,165,156,571
22057,2020-07-24,(02303) Calle 85,578,381,264,1223
22058,2020-08-11,(06104) Gobernación,248,145,91,484
22059,2020-10-12,(09002) Consuelo,168,76,184,428
22060,2020-03-22,(03000) Portal Suba,211,152,145,508
22061,2020-07-31,(02200) Alcalá,1466,1045,834,3345
22062,2020-07-20,(09113) Calle 22,162,94,145,401
22063,2020-05-01,(07110) PALOQUEMAO,198,139,85,422
22064,2020-08-05,(04103) Las Ferias,297,165,187,649
22065,2020-05-20,(09110) Avenida Jimenez,872,648,600,2120
22066,2020-09-10,(05005) Transversal 86,406,205,259,870
22067,2020-04-27,(09122) Calle 72,179,291,155,625
22068,2020-02-06,(07006) General Santander - alimentacion,1443,821,1019,3283
22069,2020-05-14,(06002) Normandía,246,146,140,532
22070,2020-08-20,(12001) Carrera 43,370,202,203,775
22071,2020-07-11,(50003) Corral Molinos,1406,728,1059,3193
22072,2020-04-18,(03005) SUBA - AV. BOYACA,153,104,104,361
22073,2020-07-28,(02102) Calle 161,232,128,145,505
22074,2020-04-29,(03011) SUBA - CALLE 100,311,170,130,611
22075,2020-09-02,(12004) Carrera 22,293,166,145,604
22076,2020-10-02,(04106) Carrera 47,397,208,289,894
22077,2020-04-28,(07006) General Santander - alimentacion,229,124,131,484
22078,2020-05-11,(07008) NQS - Calle 30 Sur,182,90,108,380
22079,2020-09-08,(07008) NQS - Calle 30 Sur,341,211,241,793
22080,2020-08-08,(02502) Terminal,224,144,236,604
22081,2020-08-30,(02001) Centro Comercial Santa Fe,127,83,170,380
22082,2020-02-02,(04102) Avenida Boyaca,619,305,565,1489
22083,2020-09-24,(12002) CDS - Carrera 32,198,130,106,434
22084,2020-08-13,(07006) General Santander,549,316,326,1191
22085,2020-08-30,(03003) 21 ANGELES,77,46,83,206
22086,2020-09-11,(07108) Av. El Dorado,162,97,104,363
22087,2020-04-16,(06103) CAN,276,211,167,654
22088,2020-09-14,(06002) Normandía,357,192,229,778
22089,2020-07-13,(07200) Tygua-San José,128,69,113,310
22090,2020-08-16,(03009) Av. Suba- Calle 116,134,83,94,311
22091,2020-07-07,(07006) General Santander - alimentacion,386,237,286,909
22092,2020-01-11,(10008) San Diego,517,362,503,1382
22093,2020-05-29,(06104) Gobernación,218,160,89,467
22094,2020-07-07,(07506) DESPENSA,541,280,298,1119
22095,2020-08-31,(07506) DESPENSA,472,264,284,1020
22096,2020-03-25,(07006) General Santander - alimentacion,201,106,157,464
22097,2020-05-28,(10005) Bicentenario,87,44,48,179
22098,2020-04-27,(06102) Salitre El Greco,18,63,24,105
22099,2020-05-09,(06102) Salitre El Greco,113,79,63,255
22100,2020-04-29,(09117) Calle 45,506,315,218,1039
22101,2020-05-02,(09111) Calle 19,247,167,221,635
22102,2020-04-16,(40002) Manitas,187,86,113,386
22103,2020-03-13,(10004) Policarpa,93,116,130,339
22104,2020-03-22,(06002) Normandía,58,29,40,127
22105,2020-09-27,(06101) El Tiempo,102,72,144,318
22106,2020-04-26,(07112) COMUNEROS,130,89,87,306
22107,2020-04-17,(06106) Recinto Ferial,168,110,77,355
22108,2020-02-20,(12000) Puente Aranda,299,173,180,652
22109,2020-07-10,(07007) NQS - Calle 38A Sur,418,254,269,941
22110,2020-04-28,(07006) General Santander,298,170,115,583
22111,2020-01-19,(10005) Bicentenario,73,55,132,260
22112,2020-08-01,(09106) Nariño,275,140,201,616
22113,2020-09-26,(09106) Nariño,395,223,361,979
22114,2020-05-15,(07007) NQS - Calle 38A Sur,274,162,171,607
22115,2020-05-23,(14005) Las Aguas,0,39,132,171
22116,2020-07-18,(09114) Calle 26,146,93,152,391
22117,2020-06-21,(10008) San Diego,91,59,65,215
22118,2020-04-13,(07008) NQS - Calle 30 Sur,147,92,83,322
22119,2020-03-13,(10003) Ciudad Jardín,54,158,159,371
22120,2020-07-10,(06106) Recinto Ferial,270,148,163,581
22121,2020-10-08,(05102) Av. Américas - Av. Boyacá,286,160,233,679
22122,2020-07-05,(04102) Avenida Boyaca,132,76,103,311
22123,2020-05-03,(09106) Nariño,84,46,69,199
22124,2020-10-11,(12001) Carrera 43,81,71,139,291
22125,2020-04-14,(09105) Río Fucha,73,44,52,169
22126,2020-06-01,(14005) Las Aguas,0,71,151,222
22127,2020-08-27,(14005) Las Aguas,184,119,170,473
22128,2020-08-02,(12002) CDS - Carrera 32,39,31,21,91
22129,2020-04-12,(07113) SANTA ISABEL,61,33,45,139
22130,2020-08-18,(10003) Ciudad Jardín,170,91,122,383
22131,2020-04-03,(07101) CASTELLANA,61,56,69,186
22132,2020-07-29,(09105) Río Fucha,70,41,79,190
22133,2020-05-25,(07200) Tygua-San José,70,38,56,164
22134,2020-07-26,(02102) Calle 161,40,34,38,112
22135,2020-04-04,(14004) Museo del Oro,0,19,48,67
22136,2020-07-20,(14001) La Sabana,23,20,34,77
22137,2020-03-22,(09108) Hospital,14,6,11,31
22138,2020-03-31,(06104) Gobernación,122,121,61,304
22139,2020-05-03,(07113) SANTA ISABEL,68,50,74,192
22140,2020-08-23,(10006) San Victorino,66,51,89,206
22141,2020-06-05,(03014) SAN MARTIN,23,11,29,63
22142,2020-04-19,(12007) Zona Industrial,26,26,23,75
22143,2020-08-20,(50006) Corral Carrera 77,2,2,4,8
22144,2020-08-07,(04000) Cabecera Calle 80 - alimentacion,1259,684,794,2737
22145,2020-08-31,(07005) ALQUERIA,510,317,335,1162
22146,2020-02-23,(09002) Consuelo,414,164,334,912
22147,2020-09-16,(02502) Terminal,455,328,471,1254
22148,2020-01-14,(07504) TERREROS,15597,9251,8478,33326
22149,2020-10-06,(07504) TERREROS,7275,3574,4185,15034
22150,2020-10-07,(07504) TERREROS,7147,3636,4241,15024
22151,2020-02-03,(08000) Portal Tunal - alimentacion,23890,13365,12109,49364
22152,2020-02-25,(08000) Portal Tunal - alimentacion,24937,13939,11820,50696
22153,2020-02-20,(03000) Portal Suba - alimentacion,28941,17129,15296,61366
22154,2020-02-10,(03002) SUBA - TV- 91,4755,2846,2494,10095
22155,2020-03-02,(09100) Calle 40 Sur,7251,4247,4270,15768
22156,2020-01-22,(09114) Calle 26,2539,1788,1559,5886
22157,2020-02-24,(04002) Carrera 90,3764,2278,1992,8034
22158,2020-09-04,(07503) SAN MATEO,12728,7061,6590,26379
22159,2020-01-26,(04000) Cabecera Calle 80 - alimentacion,4632,2045,4894,11571
22160,2020-02-05,(05001) Patio Bonito,7395,4204,3866,15465
22161,2020-02-29,(08000) Portal Tunal - alimentacion,16090,7901,9752,33743
22162,2020-01-15,(07000) Portal Sur - alimentacion,25139,14200,13449,52788
22163,2020-02-25,(05005) Transversal 86,2882,1706,1328,5916
22164,2020-01-16,(03000) Portal Suba,7637,4317,4754,16708
22165,2020-03-06,(07002) MADELENA,4977,2628,2731,10336
22166,2020-02-10,(10003) Ciudad Jardín,1148,603,687,2438
22167,2020-10-08,(07005) ALQUERIA,635,350,505,1490
22168,2020-01-31,(07001) PERDOMO,4627,2524,2777,9928
22169,2020-02-06,(02000) Cabecera Autopista Norte,11036,7057,6467,24560
22170,2020-08-20,(10000) Portal 20 de Julio - alimentacion,3730,1705,2275,7710
22171,2020-09-10,(09104) Restrepo,1592,856,1196,3644
22172,2020-09-02,(04101) Minuto de Dios,318,215,269,802
22173,2020-08-21,(07505) LEON XIII,2619,1397,1116,5132
22174,2020-09-18,(07505) LEON XIII,3107,1593,1678,6378
22175,2020-01-05,(07504) TERREROS,3523,1436,2697,7656
22176,2020-05-25,(07504) TERREROS,1296,776,687,2759
22177,2020-09-30,(02204) Pepe Sierra,902,629,581,2112
22178,2020-01-17,(06002) Normandía,2054,1158,1240,4452
22179,2020-01-13,(09110) Avenida Jimenez,3703,2607,2437,8747
22180,2020-05-03,(05002) Tintal,373,245,250,868
22181,2020-09-24,(03000) Portal Suba - alimentacion,7304,4023,4832,16159
22182,2020-09-25,(03000) Portal Suba - alimentacion,7609,4096,5159,16864
22183,2020-08-08,(08000) Portal Tunal - alimentacion,4460,2317,2669,9446
22184,2020-07-07,(10000) Portal 20 de Julio - alimentacion,4358,2037,2708,9103
22185,2020-09-09,(05000) Portal Américas - alimentacion,11934,6451,6834,25219
22186,2020-08-18,(07102) NQS - CALLE 75,430,287,193,910
22187,2020-02-27,(03013) RIO NEGRO,1246,854,830,2930
22188,2020-03-12,(03013) RIO NEGRO,372,128,206,706
22189,2020-06-26,(03013) RIO NEGRO,301,190,211,702
22190,2020-05-28,(09000) Cabecera Usme - alimentacion,7268,4003,3997,15268
22191,2020-01-31,(09103) Olaya,4071,2167,2411,8649
22192,2020-09-23,(09103) Olaya,1164,636,743,2543
22193,2020-02-07,(03007) HUMEDAL CORDOBA,1034,618,561,2213
22194,2020-04-04,(02103) Mazurén,49,34,51,134
22195,2020-05-05,(02103) Mazurén,122,75,101,298
22196,2020-07-02,(07000) Portal Sur - alimentacion,8338,4772,4186,17296
22197,2020-04-25,(09103) Olaya,397,233,217,847
22198,2020-03-06,(14001) La Sabana,592,362,397,1351
22199,2020-05-08,(07111) NQS - RICAURTE,703,462,274,1439
22200,2020-08-26,(07111) NQS - RICAURTE,1143,674,454,2271
22201,2020-10-05,(02200) Alcalá,2207,1483,1489,5179
22202,2020-03-25,(04105) Carrera 53,189,143,87,419
22203,2020-02-17,(50003) Corral Molinos,3391,2345,3668,9404
22204,2020-03-05,(50003) Corral Molinos,3346,2249,3544,9139
22205,2020-04-27,(50003) Corral Molinos,629,67,136,832
22206,2020-05-27,(04000) Cabecera Calle 80,902,585,654,2141
22207,2020-08-05,(04000) Cabecera Calle 80,886,562,706,2154
22208,2020-08-12,(04000) Cabecera Calle 80,896,553,712,2161
22209,2020-01-01,(07010) Bosa,144,85,249,478
22210,2020-09-19,(09110) Avenida Jimenez,1432,991,913,3336
22211,2020-01-22,(07506) DESPENSA,1535,952,875,3362
22212,2020-06-04,(04100) Carrera 77,1197,676,712,2585
22213,2020-01-01,(07504) TERREROS,1399,693,1872,3964
22214,2020-08-28,(10006) San Victorino,677,324,333,1334
22215,2020-09-10,(06000) Portal Eldorado,784,486,558,1828
22216,2020-02-14,(10008) San Diego,1452,831,835,3118
22217,2020-03-04,(10008) San Diego,1519,842,800,3161
22218,2020-09-22,(40003) Mirador del Paraiso,1718,992,1306,4016
22219,2020-10-04,(50003) Corral Molinos,540,241,613,1394
22220,2020-05-19,(10005) Bicentenario - alimentacion,199,87,152,438
22221,2020-01-19,(09000) Cabecera Usme - alimentacion,5961,2499,5052,13512
22222,2020-01-31,(10000) Portal 20 de Julio,8720,3763,4003,16486
22223,2020-07-25,(06105) Quinta Paredes,83,55,53,191
22224,2020-09-23,(06105) Quinta Paredes,157,113,123,393
22225,2020-02-22,(05001) Patio Bonito,4945,2552,3020,10517
22226,2020-05-30,(03000) Portal Suba,756,434,601,1791
22227,2020-09-07,(03000) Portal Suba,1442,920,1029,3391
22228,2020-06-09,(02000) Cabecera Autopista Norte - intermunicipal,519,351,361,1231
22229,2020-02-26,(10010) San Bernardo,1842,1057,1287,4186
22230,2020-03-18,(06111) Universidades,1244,717,838,2799
22231,2020-07-26,(07000) Portal Sur - alimentacion,1916,923,1018,3857
22232,2020-03-01,(08002) Biblioteca,206,99,200,505
22233,2020-03-29,(08002) Biblioteca,69,43,28,140
22234,2020-07-08,(10002) Av. Primero de Mayo,2297,1186,1350,4833
22235,2020-03-07,(09004) Santa Lucía,5358,2519,3607,11484
22236,2020-09-25,(07505) LEON XIII,3209,1545,1694,6448
22237,2020-07-16,(02302) Virrey,476,362,261,1099
22238,2020-03-26,(10000) Portal 20 de Julio - alimentacion,2375,868,1199,4442
22239,2020-08-05,(10001) Country Sur,1176,543,687,2406
22240,2020-03-10,(09120) Calle 63,3394,479,971,4844
22241,2020-09-14,(14004) Museo del Oro,341,227,301,869
22242,2020-07-29,(02101) Toberín,1374,891,855,3120
22243,2020-01-02,(10007) Las Nieves,913,626,655,2194
22244,2020-02-06,(06001) Modelia,2583,1614,1350,5547
22245,2020-07-21,(09123) Calle 76,834,585,487,1906
22246,2020-06-13,(40003) Mirador del Paraiso,1526,887,981,3394
22247,2020-01-18,(02103) Mazurén,947,418,961,2326
22248,2020-05-27,(50003) Corral Molinos,1308,648,868,2824
22249,2020-02-09,(02300) Calle 100,861,762,1265,2888
22250,2020-08-24,(02300) Calle 100,1062,709,566,2337
22251,2020-08-22,(03012) SUBA - CALLE 95,205,125,139,469
22252,2020-07-07,(50002) Corral Calle 40 Sur,26,13,33,72
22253,2020-03-16,(02200) Alcalá,8351,5281,3861,17493
22254,2020-02-28,(07006) General Santander,2849,1567,1589,6005
22255,2020-08-24,(02202) Calle 127,940,704,561,2205
22256,2020-06-07,(10008) San Diego,73,48,66,187
22257,2020-03-19,(07009) SENA,1724,966,951,3641
22258,2020-01-16,(09121) Las Flores,2748,1741,1687,6176
22259,2020-01-27,(09121) Las Flores,3129,1984,1874,6987
22260,2020-04-23,(08000) Portal Tunal,468,208,160,836
22261,2020-08-06,(02205) Calle 106,327,213,190,730
22262,2020-02-24,(03006) NIZA - CALLE 127,2387,1547,1465,5399
22263,2020-02-06,(04101) Minuto de Dios,3501,2065,1858,7424
22264,2020-08-12,(04003) Avenida Ciudad de Cali,819,490,687,1996
22265,2020-01-09,(12007) Zona Industrial,1000,694,530,2224
22266,2020-01-28,(12007) Zona Industrial,1279,798,560,2637
22267,2020-01-25,(10009) Museo Nacional,982,804,1243,3029
22268,2020-01-14,(02202) Calle 127,4862,3288,2627,10777
22269,2020-04-24,(07201) Guatoque -Veraguas,102,63,61,226
22270,2020-08-11,(05001) Patio Bonito,1819,967,1061,3847
22271,2020-03-25,(06106) Recinto Ferial,153,103,72,328
22272,2020-01-11,(03007) HUMEDAL CORDOBA,322,192,244,758
22273,2020-09-15,(10006) San Victorino,618,313,324,1255
22274,2020-08-05,(04104) Avenida 68,492,268,260,1020
22275,2020-01-10,(07000) Portal Sur,6207,3443,3825,13475
22276,2020-01-07,(06101) El Tiempo,1866,1029,981,3876
22277,2020-02-29,(02105) Calle 142,3005,1399,2419,6823
22278,2020-01-13,(04107) Escuela Militar,505,337,382,1224
22279,2020-05-20,(04107) Escuela Militar,104,71,64,239
22280,2020-08-31,(04107) Escuela Militar,140,92,106,338
22281,2020-07-07,(05000) Portal Américas,2749,1894,2055,6698
22282,2020-06-05,(09000) Cabecera Usme,1571,1045,1079,3695
22283,2020-09-27,(10006) San Victorino,206,137,180,523
22284,2020-04-07,(05103) Marsella,173,93,99,365
22285,2020-06-19,(09109) Tercer Milenio,366,208,253,827
22286,2020-07-01,(09109) Tercer Milenio,369,193,280,842
22287,2020-03-10,(06105) Quinta Paredes,256,145,120,521
22288,2020-02-01,(14005) Las Aguas,987,687,1242,2916
22289,2020-04-01,(40003) Mirador del Paraiso,761,440,550,1751
22290,2020-09-17,(02104) Calle 146,934,579,688,2201
22291,2020-01-14,(06100) Av. Rojas,1983,1106,1061,4150
22292,2020-09-26,(03003) 21 ANGELES,288,112,223,623
22293,2020-04-11,(02202) Calle 127,530,377,189,1096
22294,2020-05-13,(03011) SUBA - CALLE 100,364,180,170,714
22295,2020-08-01,(07109) CAD,333,248,185,766
22296,2020-04-02,(09002) Consuelo,253,111,143,507
22297,2020-07-16,(02105) Calle 142,675,445,400,1520
22298,2020-07-24,(02105) Calle 142,669,405,396,1470
22299,2020-09-04,(02105) Calle 142,886,536,639,2061
22300,2020-06-12,(02001) Centro Comercial Santa Fe,474,317,333,1124
22301,2020-07-11,(02001) Centro Comercial Santa Fe,382,230,303,915
22302,2020-02-01,(07008) NQS - Calle 30 Sur,1121,473,774,2368
22303,2020-05-02,(09120) Calle 63,497,347,298,1142
22304,2020-03-24,(09122) Calle 72,1015,755,785,2555
22305,2020-07-30,(10010) San Bernardo,591,310,410,1311
22306,2020-09-05,(10010) San Bernardo,475,257,448,1180
22307,2020-01-07,(05005) Transversal 86,1663,939,986,3588
22308,2020-09-28,(03006) NIZA - CALLE 127,558,343,339,1240
22309,2020-10-12,(03006) NIZA - CALLE 127,180,120,160,460
22310,2020-05-27,(09002) Consuelo,405,216,237,858
22311,2020-01-19,(07007) NQS - Calle 38A Sur,641,326,470,1437
22312,2020-08-02,(03002) SUBA - TV- 91,162,93,169,424
22313,2020-01-21,(05107) Américas - Cr.53,852,828,895,2575
22314,2020-05-06,(05107) Américas - Cr.53,325,220,179,724
22315,2020-08-28,(12007) Zona Industrial,377,224,163,764
22316,2020-09-04,(10005) Bicentenario,100,66,78,244
22317,2020-02-20,(40002) Manitas,1306,755,707,2768
22318,2020-01-27,(07006) General Santander - alimentacion,1420,855,896,3171
22319,2020-01-31,(07006) General Santander - alimentacion,1429,829,1014,3272
22320,2020-06-25,(02200) Alcalá,1947,1324,1041,4312
22321,2020-06-26,(02200) Alcalá,2043,1356,1053,4452
22322,2020-07-11,(10008) San Diego,224,150,177,551
22323,2020-05-20,(03011) SUBA - CALLE 100,370,198,162,730
22324,2020-03-21,(03000) Portal Suba - alimentacion,2090,1123,1079,4292
22325,2020-08-22,(09003) Socorro,460,214,266,940
22326,2020-07-06,(05105) Pradera,590,321,311,1222
22327,2020-10-07,(05105) Pradera,649,400,435,1484
22328,2020-09-10,(06111) Universidades,404,225,367,996
22329,2020-07-14,(40003) Mirador del Paraiso,975,657,604,2236
22330,2020-05-13,(40001) Juan Pablo II,433,264,241,938
22331,2020-09-08,(03006) NIZA - CALLE 127,489,282,261,1032
22332,2020-06-16,(07005) ALQUERIA,594,349,343,1286
22333,2020-09-26,(05105) Pradera,491,341,348,1180
22334,2020-01-12,(07110) PALOQUEMAO,344,283,378,1005
22335,2020-10-12,(14004) Museo del Oro,40,28,109,177
22336,2020-04-18,(02200) Alcalá,705,508,334,1547
22337,2020-01-04,(07101) CASTELLANA,183,152,249,584
22338,2020-03-31,(02200) Alcalá,803,604,443,1850
22339,2020-06-15,(07000) Portal Sur,533,322,394,1249
22340,2020-07-17,(12002) CDS - Carrera 32,173,112,77,362
22341,2020-03-29,(06109) Centro Memoria,57,43,28,128
22342,2020-09-05,(06109) Centro Memoria,200,140,179,519
22343,2020-04-23,(07001) PERDOMO,386,253,271,910
22344,2020-06-08,(10007) Las Nieves,579,313,340,1232
22345,2020-07-14,(05103) Marsella,384,195,191,770
22346,2020-07-25,(06102) Salitre El Greco,158,87,97,342
22347,2020-09-18,(06104) Gobernación,301,163,183,647
22348,2020-06-24,(50003) Corral Molinos,1570,827,1135,3532
22349,2020-06-18,(07105) MOVISTAR ARENA,277,166,155,598
22350,2020-04-10,(06109) Centro Memoria,49,32,24,105
22351,2020-05-02,(06109) Centro Memoria,128,85,61,274
22352,2020-02-23,(07105) MOVISTAR ARENA,220,145,275,640
22353,2020-02-23,(02000) Cabecera Autopista Norte - intermunicipal,637,399,712,1748
22354,2020-08-09,(02104) Calle 146,215,151,163,529
22355,2020-04-28,(09119) Calle 57,297,212,196,705
22356,2020-02-20,(07108) Av. El Dorado,992,617,584,2193
22357,2020-04-22,(09119) Calle 57,264,194,156,614
22358,2020-09-05,(40001) Juan Pablo II,536,275,387,1198
22359,2020-04-13,(10007) Las Nieves,209,168,136,513
22360,2020-09-20,(10007) Las Nieves,141,109,175,425
22361,2020-05-11,(09122) Calle 72,867,586,520,1973
22362,2020-05-15,(12000) Puente Aranda,66,36,22,124
22363,2020-03-29,(07103) AV. CHILE,111,83,69,263
22364,2020-07-23,(12004) Carrera 22,118,75,73,266
22365,2020-06-07,(07111) NQS - RICAURTE,127,122,115,364
22366,2020-07-11,(02103) Mazurén,147,90,147,384
22367,2020-06-05,(06001) Modelia,400,244,187,831
22368,2020-07-07,(06001) Modelia,372,244,237,853
22369,2020-09-22,(07101) CASTELLANA,266,152,185,603
22370,2020-05-22,(07102) NQS - CALLE 75,344,236,191,771
22371,2020-02-24,(07200) Tygua-San José,839,532,562,1933
22372,2020-07-18,(07200) Tygua-San José,115,73,98,286
22373,2020-05-14,(04104) Avenida 68,478,276,215,969
22374,2020-07-15,(07103) AV. CHILE,913,561,415,1889
22375,2020-01-11,(05101) Mandalay - Cr.73,345,134,244,723
22376,2020-04-11,(09115) Calle 34,174,122,90,386
22377,2020-05-08,(02200) Alcalá,1215,840,596,2651
22378,2020-05-06,(02001) Centro Comercial Santa Fe,260,169,176,605
22379,2020-05-02,(40001) Juan Pablo II,251,134,142,527
22380,2020-01-12,(14001) La Sabana,81,70,148,299
22381,2020-07-08,(04000) Cabecera Calle 80 - intermunicipal,337,198,293,828
22382,2020-07-21,(04102) Avenida Boyaca,307,170,192,669
22383,2020-07-10,(09111) Calle 19,836,534,559,1929
22384,2020-03-12,(07003) SEVILLANA,157,461,354,972
22385,2020-06-15,(03003) 21 ANGELES,110,49,56,215
22386,2020-05-13,(09117) Calle 45,578,391,321,1290
22387,2020-02-15,(03004) GRATAMIRA,135,64,122,321
22388,2020-07-05,(09117) Calle 45,249,158,211,618
22389,2020-03-01,(04102) Avenida Boyaca,678,328,551,1557
22390,2020-07-18,(05101) Mandalay - Cr.73,66,29,41,136
22391,2020-05-26,(09106) Nariño,355,223,226,804
22392,2020-03-13,(07506) DESPENSA,63,320,262,645
22393,2020-01-12,(09002) Consuelo,370,136,325,831
22394,2020-01-19,(09002) Consuelo,390,120,316,826
22395,2020-05-03,(04000) Cabecera Calle 80,145,107,124,376
22396,2020-03-23,(05107) Américas - Cr.53,115,114,95,324
22397,2020-04-26,(04104) Avenida 68,136,96,73,305
22398,2020-03-29,(04001) Quirigua,64,47,38,149
22399,2020-06-22,(04001) Quirigua,143,86,85,314
22400,2020-06-26,(03004) GRATAMIRA,43,15,31,89
22401,2020-04-22,(06111) Universidades,0,82,204,286
22402,2020-10-06,(03004) GRATAMIRA,0,28,51,79
22403,2020-08-25,(04000) Cabecera Calle 80 - intermunicipal,332,162,329,823
22404,2020-10-11,(07110) PALOQUEMAO,136,120,189,445
22405,2020-04-04,(07506) DESPENSA,150,79,117,346
22406,2020-08-23,(12007) Zona Industrial,34,37,41,112
22407,2019-12-31,(09121) Las Flores,29,20,35,84
22408,2020-02-03,(03014) SAN MARTIN,269,168,153,590
22409,2020-01-19,(12002) CDS - Carrera 32,56,65,92,213
22410,2020-03-22,(07008) NQS - Calle 30 Sur,65,27,37,129
22411,2020-04-12,(03009) Av. Suba- Calle 116,146,106,86,338
22412,2020-04-16,(06100) Av. Rojas,114,82,83,279
22413,2020-05-20,(07101) CASTELLANA,168,102,103,373
22414,2020-04-25,(06111) Universidades,0,66,178,244
22415,2020-06-06,(05101) Mandalay - Cr.73,70,28,30,128
22416,2020-05-11,(09105) Río Fucha,86,44,69,199
22417,2020-04-26,(09101) Quiroga,99,56,81,236
22418,2020-07-21,(07101) CASTELLANA,207,103,99,409
22419,2020-05-30,(12004) Carrera 22,145,83,107,335
22420,2020-04-13,(07006) General Santander,243,176,131,550
22421,2020-05-13,(03004) GRATAMIRA,31,23,14,68
22422,2020-07-15,(10005) Bicentenario - alimentacion,181,84,135,400
22423,2020-04-23,(07106) EL CAMPIN,205,138,119,462
22424,2019-12-31,(06104) Gobernación,6,4,13,23
22425,2019-12-31,(08000) Portal Tunal,42,16,39,97
22426,2020-08-30,(10009) Museo Nacional,99,74,135,308
22427,2020-03-29,(03005) SUBA - AV. BOYACA,58,51,50,159
22428,2020-04-19,(09108) Hospital,21,15,30,66
22429,2020-04-01,(50002) Corral Calle 40 Sur,8,5,11,24
22430,2020-05-05,(03014) SAN MARTIN,24,13,25,62
22431,2020-09-19,(50006) Corral Carrera 77,2,2,7,11
22432,2020-06-20,(03014) SAN MARTIN,23,20,24,67
22433,2020-07-02,(03004) GRATAMIRA,34,19,16,69
22434,2020-05-23,(07504) TERREROS,2996,1734,1533,6263
22435,2020-10-09,(07504) TERREROS,7363,3586,4529,15478
22436,2020-08-06,(09119) Calle 57,524,342,388,1254
22437,2020-05-07,(07111) NQS - RICAURTE,749,468,271,1488
22438,2020-02-20,(02101) Toberín,14583,9182,7018,30783
22439,2020-03-13,(02101) Toberín,965,2467,1841,5273
22440,2020-01-08,(07503) SAN MATEO,31261,16883,14703,62847
22441,2020-07-30,(07503) SAN MATEO,11093,6314,5192,22599
22442,2020-01-19,(06104) Gobernación,104,98,196,398
22443,2020-02-07,(03010) PUENTE LARGO,2148,1440,1315,4903
22444,2020-02-10,(09003) Socorro,1705,1024,1098,3827
22445,2020-03-06,(09003) Socorro,1673,910,1113,3696
22446,2020-06-30,(05000) Portal Américas - alimentacion,11002,5922,5619,22543
22447,2020-07-03,(05000) Portal Américas - alimentacion,11392,6188,5859,23439
22448,2020-09-25,(05000) Portal Américas - alimentacion,12758,6581,7606,26945
22449,2020-04-24,(04000) Cabecera Calle 80 - alimentacion,2150,1256,1244,4650
22450,2020-09-01,(09001) Molinos,2682,1387,1797,5866
22451,2020-09-21,(09001) Molinos,2433,1032,1568,5033
22452,2020-01-14,(07010) Bosa,1978,1141,1341,4460
22453,2020-01-10,(05000) Portal Américas,11186,6090,6624,23900
22454,2020-06-03,(07112) COMUNEROS,756,443,367,1566
22455,2020-08-11,(07112) COMUNEROS,781,447,435,1663
22456,2020-03-01,(10000) Portal 20 de Julio - alimentacion,3577,1272,3095,7944
22457,2020-10-08,(09004) Santa Lucía,2831,1337,1855,6023
22458,2020-01-17,(05100) Banderas P. Central,6476,3438,3590,13504
22459,2020-08-05,(09100) Calle 40 Sur,1626,938,1060,3624
22460,2020-04-04,(06000) Portal Eldorado - alimentacion,1536,736,641,2913
22461,2020-07-11,(09115) Calle 34,443,312,365,1120
22462,2020-02-27,(02000) Cabecera Autopista Norte,11677,6965,6033,24675
22463,2020-02-20,(04000) Cabecera Calle 80,6996,4431,4926,16353
22464,2020-05-31,(08000) Portal Tunal - alimentacion,1863,834,1106,3803
22465,2020-05-30,(03000) Portal Suba - alimentacion,4078,2245,2340,8663
22466,2020-06-26,(03000) Portal Suba - alimentacion,6553,3943,3880,14376
22467,2020-10-07,(02101) Toberín,1831,1153,1626,4610
22468,2020-02-25,(10006) San Victorino,2554,1271,1232,5057
22469,2020-03-11,(09117) Calle 45,6208,4102,3065,13375
22470,2020-03-12,(07111) NQS - RICAURTE,1364,164,414,1942
22471,2020-02-22,(09004) Santa Lucía,5295,2636,3365,11296
22472,2020-08-10,(08000) Portal Tunal - alimentacion,5834,3304,3379,12517
22473,2020-06-14,(09000) Cabecera Usme,438,219,367,1024
22474,2020-02-05,(07102) NQS - CALLE 75,1519,1017,943,3479
22475,2020-08-12,(07102) NQS - CALLE 75,336,226,196,758
22476,2020-01-28,(09103) Olaya,3970,2421,2322,8713
22477,2020-03-04,(09103) Olaya,4162,2554,2436,9152
22478,2020-07-21,(07000) Portal Sur - alimentacion,7307,4231,3460,14998
22479,2020-09-26,(07002) MADELENA,811,358,650,1819
22480,2020-03-18,(02000) Cabecera Autopista Norte - alimentacion,12091,6592,6433,25116
22481,2020-02-03,(02104) Calle 146,9243,6124,4976,20343
22482,2020-08-11,(09113) Calle 22,400,230,270,900
22483,2020-02-12,(03003) 21 ANGELES,1834,954,928,3716
22484,2020-05-17,(02000) Cabecera Autopista Norte,289,217,187,693
22485,2020-01-15,(02104) Calle 146,7559,4592,4349,16500
22486,2020-03-08,(08000) Portal Tunal - alimentacion,5309,2383,3814,11506
22487,2020-05-18,(50003) Corral Molinos,1210,623,792,2625
22488,2020-07-18,(07010) Bosa,520,217,338,1075
22489,2020-01-07,(06106) Recinto Ferial,917,532,521,1970
22490,2020-06-05,(04100) Carrera 77,1214,623,705,2542
22491,2020-07-02,(12001) Carrera 43,444,255,235,934
22492,2020-09-19,(50003) Corral Molinos,1394,677,1253,3324
22493,2020-08-29,(09000) Cabecera Usme - alimentacion,7067,3428,4554,15049
22494,2020-07-31,(06105) Quinta Paredes,122,81,76,279
22495,2020-08-03,(03000) Portal Suba,895,596,621,2112
22496,2020-08-03,(02000) Cabecera Autopista Norte - alimentacion,4040,2240,2264,8544
22497,2020-02-17,(06100) Av. Rojas,2796,1623,1236,5655
22498,2020-04-25,(09108) Hospital,45,27,43,115
22499,2020-04-04,(07000) Portal Sur - alimentacion,2917,1458,1152,5527
22500,2020-02-22,(02201) Prado,3030,1675,2163,6868
22501,2020-02-04,(07004) VENECIA,4834,2696,2590,10120
22502,2020-09-22,(09004) Santa Lucía,2639,1400,1682,5721
22503,2020-03-17,(06102) Salitre El Greco,886,480,386,1752
22504,2020-05-04,(09003) Socorro,376,194,206,776
22505,2020-02-13,(09116) Avenida 39,3432,2113,1605,7150
22506,2020-09-16,(02101) Toberín,1729,1025,1299,4053
22507,2020-02-13,(06108) Concejo de Bogotá,895,494,438,1827
22508,2020-04-20,(14004) Museo del Oro,0,61,100,161
22509,2020-05-05,(02000) Cabecera Autopista Norte,771,530,478,1779
22510,2020-03-12,(07001) PERDOMO,131,1223,897,2251
22511,2020-01-02,(02304) Heroes,1868,1358,1154,4380
22512,2020-06-01,(09000) Cabecera Usme,1505,989,1071,3565
22513,2020-01-23,(05105) Pradera,2274,1361,1137,4772
22514,2020-01-04,(05103) Marsella,617,329,460,1406
22515,2020-09-28,(02103) Mazurén,274,175,269,718
22516,2020-05-11,(03012) SUBA - CALLE 95,239,143,123,505
22517,2020-06-09,(03012) SUBA - CALLE 95,325,220,197,742
22518,2020-01-22,(06000) Portal Eldorado,6029,3531,2809,12369
22519,2020-06-04,(05005) Transversal 86,302,165,182,649
22520,2020-05-26,(02202) Calle 127,1003,719,508,2230
22521,2020-07-04,(05105) Pradera,489,245,290,1024
22522,2020-03-18,(04105) Carrera 53,673,391,375,1439
22523,2020-06-23,(03009) Av. Suba- Calle 116,515,340,254,1109
22524,2020-07-07,(03009) Av. Suba- Calle 116,530,324,256,1110
22525,2020-03-24,(10002) Av. Primero de Mayo,1839,980,1241,4060
22526,2020-09-17,(09101) Quiroga,606,298,430,1334
22527,2020-02-12,(03006) NIZA - CALLE 127,2511,1604,1489,5604
22528,2020-09-09,(07113) SANTA ISABEL,419,249,319,987
22529,2020-09-30,(04101) Minuto de Dios,404,245,370,1019
22530,2020-09-03,(09101) Quiroga,566,292,431,1289
22531,2020-09-25,(09101) Quiroga,613,303,500,1416
22532,2020-07-20,(06000) Portal Eldorado - alimentacion,1254,542,650,2446
22533,2020-07-17,(04108) El Polo,444,266,202,912
22534,2020-07-12,(07106) EL CAMPIN,120,109,103,332
22535,2020-07-13,(07106) EL CAMPIN,413,253,160,826
22536,2020-06-25,(07103) AV. CHILE,992,600,454,2046
22537,2020-08-12,(07113) SANTA ISABEL,346,185,244,775
22538,2020-01-25,(03007) HUMEDAL CORDOBA,431,242,274,947
22539,2020-02-02,(03007) HUMEDAL CORDOBA,150,100,142,392
22540,2020-03-30,(07000) Portal Sur,821,468,546,1835
22541,2020-09-12,(02101) Toberín,1030,613,994,2637
22542,2020-03-14,(07103) AV. CHILE,1811,1298,1400,4509
22543,2020-08-27,(06000) Portal Eldorado,949,568,452,1969
22544,2020-09-28,(06000) Portal Eldorado,910,637,685,2232
22545,2020-03-12,(06101) El Tiempo,1012,227,312,1551
22546,2020-03-31,(40003) Mirador del Paraiso,714,392,492,1598
22547,2020-05-15,(04104) Avenida 68,480,253,229,962
22548,2020-07-16,(09110) Avenida Jimenez,495,436,522,1453
22549,2020-08-23,(09110) Avenida Jimenez,174,181,247,602
22550,2020-05-10,(10002) Av. Primero de Mayo,405,249,311,965
22551,2020-07-08,(02204) Pepe Sierra,853,606,456,1915
22552,2020-03-29,(06100) Av. Rojas,38,25,19,82
22553,2020-06-22,(06100) Av. Rojas,46,37,60,143
22554,2020-08-29,(06000) Portal Eldorado,627,461,529,1617
22555,2020-06-02,(09104) Restrepo,1388,802,908,3098
22556,2020-09-17,(04106) Carrera 47,365,181,228,774
22557,2020-05-27,(06103) CAN,337,222,148,707
22558,2020-05-12,(02105) Calle 142,565,356,314,1235
22559,2020-08-30,(09116) Avenida 39,81,59,107,247
22560,2020-08-02,(07005) ALQUERIA,128,71,126,325
22561,2020-09-17,(03002) SUBA - TV- 91,913,521,598,2032
22562,2020-07-10,(07103) AV. CHILE,990,605,493,2088
22563,2020-06-16,(07004) VENECIA,975,600,563,2138
22564,2020-07-17,(10005) Bicentenario,87,54,71,212
22565,2020-06-18,(09117) Calle 45,720,439,422,1581
22566,2020-05-06,(09106) Nariño,260,150,145,555
22567,2020-05-27,(06108) Concejo de Bogotá,147,67,71,285
22568,2020-05-23,(02001) Centro Comercial Santa Fe,237,149,181,567
22569,2020-07-27,(07003) SEVILLANA,396,239,220,855
22570,2020-05-15,(05100) Banderas P. Central,485,290,301,1076
22571,2020-03-07,(07107) U. NACIONAL,969,763,1064,2796
22572,2020-09-27,(09101) Quiroga,156,84,227,467
22573,2020-07-18,(07000) Portal Sur,1219,688,789,2696
22574,2020-08-01,(02200) Alcalá,1114,734,660,2508
22575,2020-07-01,(03011) SUBA - CALLE 100,568,251,262,1081
22576,2020-07-16,(05107) Américas - Cr.53,367,218,210,795
22577,2020-04-07,(09115) Calle 34,337,247,192,776
22578,2020-06-09,(03006) NIZA - CALLE 127,378,236,223,837
22579,2020-06-17,(03006) NIZA - CALLE 127,486,276,214,976
22580,2020-03-01,(07005) ALQUERIA,655,304,570,1529
22581,2020-04-03,(07000) Portal Sur,888,525,559,1972
22582,2020-05-10,(07110) PALOQUEMAO,132,101,92,325
22583,2020-05-09,(07002) MADELENA,323,174,178,675
22584,2020-03-14,(09106) Nariño,1031,569,966,2566
22585,2020-04-16,(06109) Centro Memoria,157,106,85,348
22586,2020-04-25,(06109) Centro Memoria,124,103,74,301
22587,2020-02-16,(10008) San Diego,190,162,286,638
22588,2020-10-12,(07110) PALOQUEMAO,170,133,186,489
22589,2020-10-01,(06104) Gobernación,294,183,180,657
22590,2020-06-17,(07201) Guatoque -Veraguas,208,122,116,446
22591,2020-04-04,(03000) Portal Suba,396,235,270,901
22592,2020-05-18,(07105) MOVISTAR ARENA,206,138,117,461
22593,2020-02-24,(07506) DESPENSA,1552,964,919,3435
22594,2020-08-21,(07107) U. NACIONAL,330,211,177,718
22595,2020-07-10,(06109) Centro Memoria,316,165,135,616
22596,2020-03-21,(07000) Portal Sur,526,293,272,1091
22597,2020-09-04,(03003) 21 ANGELES,395,172,209,776
22598,2020-07-28,(09122) Calle 72,1065,741,708,2514
22599,2020-03-12,(07004) VENECIA,455,909,659,2023
22600,2020-03-30,(07109) CAD,399,279,246,924
22601,2020-02-23,(09104) Restrepo,1130,678,1372,3180
22602,2020-08-15,(07107) U. NACIONAL,237,133,191,561
22603,2020-04-05,(07505) LEON XIII,544,262,222,1028
22604,2020-09-10,(06001) Modelia,361,182,242,785
22605,2020-06-04,(03013) RIO NEGRO,271,182,174,627
22606,2020-10-03,(03013) RIO NEGRO,218,137,246,601
22607,2020-07-17,(10009) Museo Nacional,382,233,227,842
22608,2020-06-28,(06000) Portal Eldorado,207,179,204,590
22609,2020-07-18,(08001) Parque el Tunal,257,151,157,565
22610,2020-01-01,(07200) Tygua-San José,46,31,129,206
22611,2020-07-25,(02000) Cabecera Autopista Norte - intermunicipal,296,176,229,701
22612,2020-08-25,(10007) Las Nieves,548,361,321,1230
22613,2020-06-17,(06002) Normandía,317,198,200,715
22614,2020-06-22,(06002) Normandía,76,63,81,220
22615,2020-04-30,(04101) Minuto de Dios,186,109,120,415
22616,2020-01-19,(03009) Av. Suba- Calle 116,390,264,427,1081
22617,2020-04-08,(09002) Consuelo,246,110,142,498
22618,2020-08-25,(03010) PUENTE LARGO,341,194,191,726
22619,2020-03-22,(03001) LA CAMPIÑA,166,80,95,341
22620,2020-06-26,(09108) Hospital,60,51,54,165
22621,2019-12-31,(09120) Calle 63,55,35,79,169
22622,2020-10-04,(03014) SAN MARTIN,0,6,21,27
22623,2020-07-23,(09117) Calle 45,598,360,355,1313
22624,2020-03-28,(02502) Terminal,65,70,89,224
22625,2020-02-02,(07006) General Santander - alimentacion,282,172,415,869
22626,2020-03-15,(09111) Calle 19,381,244,447,1072
22627,2020-05-21,(09003) Socorro,483,257,272,1012
22628,2020-04-28,(09116) Avenida 39,186,149,138,473
22629,2020-04-18,(09117) Calle 45,315,217,188,720
22630,2020-08-16,(09122) Calle 72,306,209,299,814
22631,2020-03-20,(04104) Avenida 68,342,231,145,718
22632,2020-06-14,(04104) Avenida 68,195,121,108,424
22633,2020-10-01,(07108) Av. El Dorado,183,117,127,427
22634,2020-01-18,(07200) Tygua-San José,426,254,437,1117
22635,2020-06-16,(06103) CAN,397,258,162,817
22636,2020-05-25,(06001) Modelia,101,61,59,221
22637,2020-03-31,(04106) Carrera 47,161,101,85,347
22638,2020-08-02,(12004) Carrera 22,56,41,39,136
22639,2020-03-22,(04108) El Polo,40,37,28,105
22640,2020-06-13,(07113) SANTA ISABEL,285,168,222,675
22641,2020-08-01,(07008) NQS - Calle 30 Sur,186,84,145,415
22642,2020-05-24,(03002) SUBA - TV- 91,189,76,139,404
22643,2020-04-03,(10008) San Diego,135,113,100,348
22644,2020-06-15,(09111) Calle 19,222,147,218,587
22645,2020-05-24,(05105) Pradera,94,85,82,261
22646,2020-05-03,(04101) Minuto de Dios,62,40,50,152
22647,2020-05-18,(03007) HUMEDAL CORDOBA,114,79,50,243
22648,2020-08-30,(04103) Las Ferias,110,50,77,237
22649,2020-04-09,(40002) Manitas,73,41,55,169
22650,2020-06-11,(10005) Bicentenario,106,54,72,232
22651,2020-06-29,(12007) Zona Industrial,62,76,52,190
22652,2020-06-09,(07003) SEVILLANA,397,224,192,813
22653,2020-07-16,(07101) CASTELLANA,189,124,93,406
22654,2020-07-09,(06105) Quinta Paredes,142,86,70,298
22655,2020-09-17,(09105) Río Fucha,0,84,189,273
22656,2020-08-07,(07101) CASTELLANA,40,29,48,117
22657,2020-04-15,(06106) Recinto Ferial,164,118,85,367
22658,2020-04-12,(06103) CAN,145,101,57,303
22659,2020-04-18,(03003) 21 ANGELES,102,52,49,203
22660,2020-10-07,(03014) SAN MARTIN,0,19,66,85
22661,2020-09-25,(50006) Corral Carrera 77,5,2,9,16
22662,2020-09-04,(12000) Puente Aranda,82,41,47,170
22663,2020-04-04,(08002) Biblioteca,118,62,52,232
22664,2020-01-09,(50006) Corral Carrera 77,24,12,33,69
22665,2020-04-03,(50002) Corral Calle 40 Sur,11,3,11,25
22666,2020-04-02,(50006) Corral Carrera 77,6,4,4,14
22667,2020-05-06,(50006) Corral Carrera 77,4,3,10,17
22668,2020-09-15,(03004) GRATAMIRA,0,19,46,65
22669,2020-10-13,(12001) Carrera 43,0,1,0,1
22670,2020-03-05,(07005) ALQUERIA,2595,1416,1436,5447
22671,2020-09-13,(07005) ALQUERIA,187,95,202,484
22672,2020-02-15,(09002) Consuelo,1024,498,753,2275
22673,2020-03-19,(09002) Consuelo,815,461,523,1799
22674,2020-06-30,(02502) Terminal,436,346,364,1146
22675,2020-10-07,(02502) Terminal,504,387,519,1410
22676,2020-10-05,(05000) Portal Américas - alimentacion,12361,6612,8049,27022
22677,2020-02-12,(10000) Portal 20 de Julio - alimentacion,11010,5892,7653,24555
22678,2020-05-21,(09119) Calle 57,447,306,293,1046
22679,2020-09-28,(09119) Calle 57,704,433,546,1683
22680,2020-01-17,(07111) NQS - RICAURTE,2789,1806,1709,6304
22681,2020-02-24,(03000) Portal Suba - alimentacion,29477,17808,16477,63762
22682,2020-08-14,(02303) Calle 85,698,468,402,1568
22683,2020-02-06,(09122) Calle 72,8112,5445,4396,17953
22684,2020-05-10,(05000) Portal Américas - alimentacion,2625,1258,1109,4992
22685,2020-02-04,(05001) Patio Bonito,7035,4119,3777,14931
22686,2020-02-29,(05001) Patio Bonito,4936,2397,3046,10379
22687,2020-01-06,(04100) Carrera 77,982,493,987,2462
22688,2020-01-30,(07002) MADELENA,4859,2675,2546,10080
22689,2020-07-28,(05100) Banderas P. Central,608,357,412,1377
22690,2020-02-26,(05100) Banderas P. Central - alimentacion,16276,8524,8879,33679
22691,2020-06-23,(05100) Banderas P. Central - alimentacion,2914,1710,1874,6498
22692,2020-01-20,(02000) Cabecera Autopista Norte,9729,6089,5763,21581
22693,2020-03-06,(02000) Cabecera Autopista Norte,11155,6373,6479,24007
22694,2020-01-16,(02205) Calle 106,2263,1465,1250,4978
22695,2020-06-27,(09000) Cabecera Usme - alimentacion,7308,3816,4483,15607
22696,2020-09-21,(03000) Portal Suba - alimentacion,6044,3030,3741,12815
22697,2020-05-10,(07504) TERREROS,1073,620,520,2213
22698,2020-01-06,(02204) Pepe Sierra,530,386,537,1453
22699,2020-02-21,(06002) Normandía,2522,1338,1336,5196
22700,2020-02-26,(09117) Calle 45,6425,4358,3188,13971
22701,2020-09-17,(05000) Portal Américas,3687,2179,2571,8437
22702,2020-02-10,(09103) Olaya,4329,2601,2470,9400
22703,2020-09-03,(03001) LA CAMPIÑA,1253,749,786,2788
22704,2020-01-08,(09116) Avenida 39,1588,1099,1061,3748
22705,2020-02-24,(09116) Avenida 39,3380,2024,1571,6975
22706,2020-03-02,(05100) Banderas P. Central - alimentacion,15458,9123,8716,33297
22707,2020-07-07,(05100) Banderas P. Central - alimentacion,3119,1742,1862,6723
22708,2020-08-21,(05100) Banderas P. Central - alimentacion,2911,1468,1674,6053
22709,2020-08-30,(09103) Olaya,377,194,270,841
22710,2020-07-21,(14001) La Sabana,123,76,79,278
22711,2020-07-29,(07111) NQS - RICAURTE,995,612,422,2029
22712,2020-08-04,(07111) NQS - RICAURTE,985,586,373,1944
22713,2020-09-12,(07002) MADELENA,694,311,574,1579
22714,2020-09-18,(07002) MADELENA,1033,598,743,2374
22715,2020-08-10,(09113) Calle 22,392,217,306,915
22716,2020-03-15,(02201) Prado,786,452,814,2052
22717,2020-03-30,(04105) Carrera 53,162,110,87,359
22718,2020-07-29,(04000) Cabecera Calle 80,1038,658,691,2387
22719,2020-07-09,(09110) Avenida Jimenez,1479,1048,862,3389
22720,2020-06-23,(06000) Portal Eldorado,1007,702,498,2207
22721,2020-08-06,(40003) Mirador del Paraiso,1581,1000,1023,3604
22722,2020-01-11,(07113) SANTA ISABEL,984,514,877,2375
22723,2020-01-02,(06105) Quinta Paredes,322,176,225,723
22724,2020-01-10,(09119) Calle 57,2169,1493,1611,5273
22725,2020-07-25,(03000) Portal Suba,704,384,503,1591
22726,2020-09-24,(03000) Portal Suba,1621,1035,1247,3903
22727,2020-08-18,(02000) Cabecera Autopista Norte - intermunicipal,523,329,361,1213
22728,2020-03-19,(09101) Quiroga,813,532,669,2014
22729,2020-03-12,(09114) Calle 26,1469,149,348,1966
22730,2020-03-29,(07000) Portal Sur - alimentacion,1459,760,577,2796
22731,2020-09-17,(02303) Calle 85,823,542,476,1841
22732,2020-06-16,(09004) Santa Lucía,2616,1428,1300,5344
22733,2020-01-20,(07008) NQS - Calle 30 Sur,1769,956,1029,3754
22734,2020-04-03,(07503) SAN MATEO,5606,3121,2877,11604
22735,2020-05-06,(08001) Parque el Tunal,272,152,135,559
22736,2020-06-03,(02101) Toberín,1332,839,763,2934
22737,2020-08-20,(02101) Toberín,1224,787,852,2863
22738,2020-08-05,(09116) Avenida 39,330,196,192,718
22739,2020-02-01,(10001) Country Sur,2949,1183,2338,6470
22740,2020-04-18,(10002) Av. Primero de Mayo,820,440,514,1774
22741,2020-07-09,(10002) Av. Primero de Mayo,2266,1151,1365,4782
22742,2020-02-12,(02202) Calle 127,6199,4143,2903,13245
22743,2020-01-13,(07007) NQS - Calle 38A Sur,1717,1010,1040,3767
22744,2020-01-06,(06002) Normandía,239,137,262,638
22745,2020-04-20,(06001) Modelia,266,182,139,587
22746,2020-02-10,(03005) SUBA - AV. BOYACA,2934,1737,1554,6225
22747,2020-05-19,(09107) Hortúa,551,337,260,1148
22748,2020-01-22,(05105) Pradera,2222,1350,1160,4732
22749,2020-09-11,(02300) Calle 100,1132,781,787,2700
22750,2020-05-04,(03012) SUBA - CALLE 95,208,142,114,464
22751,2020-06-09,(10000) Portal 20 de Julio,2148,1091,1006,4245
22752,2020-07-18,(09119) Calle 57,341,196,270,807
22753,2020-01-25,(05100) Banderas P. Central,2973,1343,2269,6585
22754,2020-01-25,(02103) Mazurén,1001,437,931,2369
22755,2020-08-29,(07104) Simon Bolivar,472,310,294,1076
22756,2020-08-09,(09104) Restrepo,414,253,379,1046
22757,2020-05-29,(05005) Transversal 86,320,168,196,684
22758,2020-10-09,(05005) Transversal 86,545,249,418,1212
22759,2020-06-01,(02202) Calle 127,1078,745,537,2360
22760,2020-02-24,(09121) Las Flores,3433,2102,2033,7568
22761,2020-04-07,(02205) Calle 106,178,128,97,403
22762,2020-07-22,(09101) Quiroga,418,210,294,922
22763,2020-01-21,(04108) El Polo,1147,866,891,2904
22764,2020-06-25,(04108) El Polo,506,299,243,1048
22765,2020-07-01,(04108) El Polo,515,324,260,1099
22766,2020-05-15,(07201) Guatoque -Veraguas,143,101,132,376
22767,2020-03-04,(07113) SANTA ISABEL,2153,1304,1390,4847
22768,2020-03-01,(02101) Toberín,1803,883,2356,5042
22769,2020-01-15,(02202) Calle 127,5011,3280,2660,10951
22770,2020-06-22,(09100) Calle 40 Sur,624,325,459,1408
22771,2020-05-29,(07104) Simon Bolivar,556,360,255,1171
22772,2020-08-13,(10005) Bicentenario - alimentacion,197,102,192,491
22773,2020-08-06,(04107) Escuela Militar,94,49,69,212
22774,2020-02-29,(10001) Country Sur,3049,1177,2345,6571
22775,2020-08-18,(09109) Tercer Milenio,320,199,229,748
22776,2020-09-22,(03002) SUBA - TV- 91,950,557,675,2182
22777,2020-02-04,(04001) Quirigua,2100,1257,1203,4560
22778,2020-02-10,(04001) Quirigua,2171,1372,1218,4761
22779,2020-06-21,(02205) Calle 106,74,65,54,193
22780,2020-05-26,(05001) Patio Bonito,1605,859,945,3409
22781,2020-09-14,(06106) Recinto Ferial,268,168,152,588
22782,2020-06-11,(06000) Portal Eldorado,982,666,434,2082
22783,2020-09-17,(02302) Virrey,727,485,393,1605
22784,2020-07-02,(07009) SENA,712,430,477,1619
22785,2020-07-11,(09122) Calle 72,908,648,773,2329
22786,2020-04-26,(03010) PUENTE LARGO,76,58,47,181
22787,2020-08-17,(05100) Banderas P. Central,172,92,156,420
22788,2020-05-25,(03009) Av. Suba- Calle 116,142,104,93,339
22789,2020-09-30,(07009) SENA,751,430,589,1770
22790,2020-10-06,(06001) Modelia,408,264,300,972
22791,2020-01-12,(06103) CAN,228,166,289,683
22792,2020-09-02,(06103) CAN,391,237,243,871
22793,2020-01-19,(06108) Concejo de Bogotá,113,73,176,362
22794,2020-08-09,(03002) SUBA - TV- 91,146,89,148,383
22795,2020-06-25,(07007) NQS - Calle 38A Sur,425,257,278,960
22796,2020-06-15,(08000) Portal Tunal - alimentacion,2286,1068,1288,4642
22797,2020-07-06,(10005) Bicentenario,115,60,76,251
22798,2020-06-08,(09106) Nariño,382,231,276,889
22799,2020-08-19,(02001) Centro Comercial Santa Fe,425,283,290,998
22800,2020-01-28,(07006) General Santander,2794,1612,1525,5931
22801,2020-04-24,(04100) Carrera 77,685,388,422,1495
22802,2020-07-05,(07102) NQS - CALLE 75,78,58,98,234
22803,2020-04-12,(09101) Quiroga,80,44,52,176
22804,2020-05-26,(07000) Portal Sur,1647,1017,975,3639
22805,2020-05-28,(09120) Calle 63,943,665,576,2184
22806,2020-10-07,(08000) Portal Tunal,785,413,421,1619
22807,2020-10-10,(05102) Av. Américas - Av. Boyacá,199,99,230,528
22808,2020-06-18,(09003) Socorro,576,319,328,1223
22809,2020-06-18,(05105) Pradera,626,369,260,1255
22810,2020-10-06,(05105) Pradera,636,411,421,1468
22811,2020-06-24,(09122) Calle 72,1218,836,695,2749
22812,2020-04-30,(02001) Centro Comercial Santa Fe,254,158,181,593
22813,2020-09-18,(05102) Av. Américas - Av. Boyacá,303,166,201,670
22814,2020-02-22,(06109) Centro Memoria,549,347,551,1447
22815,2020-08-17,(07105) MOVISTAR ARENA,57,43,65,165
22816,2020-09-28,(09121) Las Flores,791,496,616,1903
22817,2020-08-31,(07003) SEVILLANA,440,233,296,969
22818,2020-07-16,(07107) U. NACIONAL,318,200,154,672
22819,2020-01-20,(07102) NQS - CALLE 75,1399,925,893,3217
22820,2020-05-31,(07110) PALOQUEMAO,164,113,81,358
22821,2020-05-14,(09110) Avenida Jimenez,792,557,578,1927
22822,2020-06-28,(07004) VENECIA,278,161,217,656
22823,2020-05-18,(40002) Manitas,325,161,227,713
22824,2020-05-07,(04103) Las Ferias,246,152,111,509
22825,2020-09-29,(06102) Salitre El Greco,288,163,170,621
22826,2020-09-26,(05102) Av. Américas - Av. Boyacá,209,107,166,482
22827,2020-04-26,(09004) Santa Lucía,470,240,297,1007
22828,2020-04-02,(03005) SUBA - AV. BOYACA,181,131,134,446
22829,2020-03-25,(02102) Calle 161,103,63,79,245
22830,2020-02-02,(14001) La Sabana,107,93,152,352
22831,2020-05-12,(07111) NQS - RICAURTE,843,541,329,1713
22832,2020-04-02,(07505) LEON XIII,1115,690,628,2433
22833,2020-04-28,(04107) Escuela Militar,74,56,53,183
22834,2020-06-06,(03013) RIO NEGRO,169,121,143,433
22835,2020-07-09,(09114) Calle 26,332,189,207,728
22836,2020-01-01,(03000) Portal Suba,432,255,780,1467
22837,2020-05-11,(06101) El Tiempo,261,166,141,568
22838,2020-07-24,(02300) Calle 100,981,648,550,2179
22839,2020-10-11,(06001) Modelia,89,68,133,290
22840,2020-04-12,(02302) Virrey,165,109,76,350
22841,2020-07-04,(02000) Cabecera Autopista Norte - intermunicipal,403,220,304,927
22842,2020-04-05,(14001) La Sabana,38,26,21,85
22843,2020-07-02,(04102) Avenida Boyaca,365,251,257,873
22844,2020-07-21,(04000) Cabecera Calle 80 - intermunicipal,327,163,269,759
22845,2020-06-25,(04102) Avenida Boyaca,365,217,237,819
22846,2020-08-01,(07108) Av. El Dorado,81,47,50,178
22847,2020-09-16,(06002) Normandía,353,201,228,782
22848,2020-06-29,(03003) 21 ANGELES,105,53,80,238
22849,2020-07-24,(04000) Cabecera Calle 80 - intermunicipal,306,164,247,717
22850,2020-06-05,(06107) Ciudad Universitaria,168,93,115,376
22851,2020-08-28,(07006) General Santander,554,346,327,1227
22852,2020-05-18,(09121) Las Flores,567,413,283,1263
22853,2020-01-25,(03004) GRATAMIRA,143,60,102,305
22854,2020-07-05,(12001) Carrera 43,55,46,70,171
22855,2020-10-05,(07105) MOVISTAR ARENA,279,173,225,677
22856,2020-07-25,(07506) DESPENSA,245,166,170,581
22857,2020-09-22,(09003) Socorro,612,304,405,1321
22858,2020-03-25,(09117) Calle 45,557,384,286,1227
22859,2020-09-21,(12002) CDS - Carrera 32,150,109,80,339
22860,2020-01-18,(07108) Av. El Dorado,323,237,391,951
22861,2020-05-08,(07002) MADELENA,475,285,290,1050
22862,2020-08-30,(06000) Portal Eldorado,155,167,257,579
22863,2020-08-22,(06101) El Tiempo,218,142,168,528
22864,2020-07-03,(03004) GRATAMIRA,37,19,25,81
22865,2020-04-06,(06111) Universidades,0,76,207,283
22866,2020-04-29,(03002) SUBA - TV- 91,459,282,250,991
22867,2020-09-25,(09106) Nariño,517,304,437,1258
22868,2020-03-22,(06101) El Tiempo,89,62,58,209
22869,2020-07-25,(09111) Calle 19,380,251,316,947
22870,2020-05-25,(09117) Calle 45,258,170,164,592
22871,2020-08-17,(04108) El Polo,88,69,79,236
22872,2020-05-22,(07007) NQS - Calle 38A Sur,277,186,185,648
22873,2020-06-28,(06103) CAN,139,95,68,302
22874,2020-07-05,(07101) CASTELLANA,24,13,52,89
22875,2020-07-26,(14001) La Sabana,26,24,25,75
22876,2020-08-02,(03004) GRATAMIRA,12,3,5,20
22877,2020-09-15,(03005) SUBA - AV. BOYACA,526,282,351,1159
22878,2020-04-29,(02102) Calle 161,119,78,83,280
22879,2020-08-10,(04107) Escuela Militar,93,60,69,222
22880,2020-07-05,(02304) Heroes,224,184,165,573
22881,2020-05-14,(07008) NQS - Calle 30 Sur,199,108,112,419
22882,2020-04-02,(09003) Socorro,304,123,185,612
22883,2020-04-08,(40002) Manitas,166,90,137,393
22884,2020-05-14,(06107) Ciudad Universitaria,150,102,71,323
22885,2020-09-22,(09105) Río Fucha,0,82,172,254
22886,2020-04-23,(07108) Av. El Dorado,58,44,37,139
22887,2020-04-07,(07002) MADELENA,356,176,224,756
22888,2020-06-08,(07003) SEVILLANA,401,207,191,799
22889,2020-07-12,(05102) Av. Américas - Av. Boyacá,70,39,48,157
22890,2020-05-29,(14004) Museo del Oro,0,107,237,344
22891,2020-05-31,(10003) Ciudad Jardín,49,22,33,104
22892,2020-03-27,(07101) CASTELLANA,32,54,86,172
22893,2020-05-09,(05103) Marsella,138,77,89,304
22894,2020-04-05,(03005) SUBA - AV. BOYACA,73,50,40,163
22895,2020-06-21,(09101) Quiroga,203,74,141,418
22896,2020-05-01,(07105) MOVISTAR ARENA,63,49,46,158
22897,2020-09-14,(50006) Corral Carrera 77,4,5,8,17
22898,2020-03-28,(10005) Bicentenario - alimentacion,102,57,57,216
22899,2020-07-12,(06104) Gobernación,46,32,43,121
22900,2020-07-19,(14001) La Sabana,35,22,31,88
22901,2020-02-14,(50006) Corral Carrera 77,27,20,38,85
22902,2020-04-14,(03007) HUMEDAL CORDOBA,72,47,27,146
22903,2020-03-24,(50002) Corral Calle 40 Sur,20,12,22,54
22904,2020-01-01,(50002) Corral Calle 40 Sur,6,5,17,28
22905,2020-05-08,(04000) Cabecera Calle 80 - alimentacion,2696,1518,1552,5766
22906,2020-07-05,(04000) Cabecera Calle 80 - alimentacion,1254,588,1053,2895
22907,2020-09-08,(04000) Cabecera Calle 80 - alimentacion,4355,2413,3125,9893
22908,2020-09-24,(02502) Terminal,506,348,500,1354
22909,2020-09-14,(05000) Portal Américas - alimentacion,11492,6229,6426,24147
22910,2020-02-19,(03000) Portal Suba - alimentacion,30190,17829,16753,64772
22911,2020-03-04,(02303) Calle 85,3854,2540,1978,8372
22912,2020-03-02,(02101) Toberín,14566,9413,7486,31465
22913,2020-07-29,(07505) LEON XIII,2590,1384,1088,5062
22914,2020-02-17,(14005) Las Aguas,3536,2112,1790,7438
22915,2020-07-10,(05000) Portal Américas,2819,1886,2052,6757
22916,2020-01-14,(09114) Calle 26,2343,1631,1408,5382
22917,2020-08-01,(04002) Carrera 90,451,222,247,920
22918,2020-07-07,(05000) Portal Américas - alimentacion,11527,6335,5895,23757
22919,2020-06-17,(05000) Portal Américas - alimentacion,11060,6064,5201,22325
22920,2020-01-23,(07002) MADELENA,4492,2472,2526,9490
22921,2020-07-09,(10001) Country Sur,1369,644,738,2751
22922,2020-07-31,(09100) Calle 40 Sur,1596,924,1020,3540
22923,2020-04-28,(06000) Portal Eldorado - alimentacion,2621,1287,1142,5050
22924,2020-01-20,(09115) Calle 34,3808,2486,2249,8543
22925,2020-02-17,(05100) Banderas P. Central - alimentacion,16421,9678,8360,34459
22926,2020-02-29,(05100) Banderas P. Central - alimentacion,8819,4087,6115,19021
22927,2020-02-08,(02105) Calle 142,3003,1359,2381,6743
22928,2020-03-07,(04000) Cabecera Calle 80,3700,1785,3654,9139
22929,2020-03-17,(06000) Portal Eldorado - alimentacion,10908,5463,5330,21701
22930,2020-01-03,(07001) PERDOMO,2357,1244,1579,5180
22931,2020-07-02,(40003) Mirador del Paraiso,1827,1149,1106,4082
22932,2020-09-14,(40003) Mirador del Paraiso,592,921,1634,3147
22933,2020-09-09,(07505) LEON XIII,2908,1554,1472,5934
22934,2020-04-18,(09000) Cabecera Usme,576,369,460,1405
22935,2020-01-30,(10006) San Victorino,2355,1261,1267,4883
22936,2020-02-11,(09110) Avenida Jimenez,5319,3571,3082,11972
22937,2020-01-16,(05001) Patio Bonito,6010,3259,3324,12593
22938,2020-02-17,(09123) Calle 76,5905,3854,3170,12929
22939,2020-04-25,(09118) Marly,733,583,333,1649
22940,2020-06-04,(09118) Marly,1392,893,617,2902
22941,2020-04-24,(50003) Corral Molinos,833,407,575,1815
22942,2020-07-22,(09100) Calle 40 Sur,1316,750,869,2935
22943,2020-05-11,(02103) Mazurén,142,99,100,341
22944,2020-09-18,(07000) Portal Sur - alimentacion,9405,5078,5599,20082
22945,2020-07-15,(05100) Banderas P. Central - alimentacion,2712,1446,1299,5457
22946,2020-09-03,(14001) La Sabana,170,102,110,382
22947,2020-04-17,(02200) Alcalá,921,660,471,2052
22948,2020-09-28,(09113) Calle 22,408,250,406,1064
22949,2020-02-18,(09004) Santa Lucía,7767,4484,4165,16416
22950,2020-07-13,(50003) Corral Molinos,946,543,705,2194
22951,2020-07-02,(04000) Cabecera Calle 80,1207,714,927,2848
22952,2020-09-11,(04000) Cabecera Calle 80,1097,651,970,2718
22953,2020-01-27,(09123) Calle 76,5244,3480,2803,11527
22954,2020-07-08,(09110) Avenida Jimenez,1469,1036,936,3441
22955,2020-07-30,(09110) Avenida Jimenez,1336,940,801,3077
22956,2020-07-06,(07112) COMUNEROS,848,505,525,1878
22957,2020-08-23,(09001) Molinos,707,334,526,1567
22958,2020-08-15,(10006) San Victorino,475,269,285,1029
22959,2020-06-20,(03000) Portal Suba,903,508,714,2125
22960,2020-03-13,(09123) Calle 76,1997,155,644,2796
22961,2020-08-18,(12001) Carrera 43,370,205,213,788
22962,2020-06-10,(10002) Av. Primero de Mayo,2057,1067,1148,4272
22963,2020-02-27,(10005) Bicentenario - alimentacion,746,341,525,1612
22964,2020-02-07,(40001) Juan Pablo II,1734,1020,1026,3780
22965,2020-05-05,(03000) Portal Suba,790,475,502,1767
22966,2020-07-09,(02303) Calle 85,762,512,403,1677
22967,2020-06-27,(02201) Prado,790,501,468,1759
22968,2020-03-16,(06102) Salitre El Greco,1053,607,450,2110
22969,2020-04-14,(08001) Parque el Tunal,226,137,124,487
22970,2020-09-01,(08001) Parque el Tunal,476,245,285,1006
22971,2020-07-15,(09116) Avenida 39,309,192,182,683
22972,2020-01-21,(05102) Av. Américas - Av. Boyacá,1026,392,494,1912
22973,2020-09-01,(06108) Concejo de Bogotá,134,77,75,286
22974,2020-09-10,(14004) Museo del Oro,377,241,270,888
22975,2020-03-13,(07001) PERDOMO,124,992,844,1960
22976,2020-09-18,(09118) Marly,1570,1016,1044,3630
22977,2020-09-06,(09107) Hortúa,218,149,201,568
22978,2020-06-17,(05002) Tintal,2568,1473,1353,5394
22979,2020-05-05,(02300) Calle 100,886,589,457,1932
22980,2020-07-15,(02300) Calle 100,1088,695,553,2336
22981,2020-08-04,(02300) Calle 100,1029,697,548,2274
22982,2020-09-21,(02300) Calle 100,1011,782,708,2501
22983,2020-08-20,(03012) SUBA - CALLE 95,306,169,173,648
22984,2020-07-29,(50002) Corral Calle 40 Sur,19,12,24,55
22985,2020-04-20,(02000) Cabecera Autopista Norte - alimentacion,2864,1576,1311,5751
22986,2020-01-07,(02104) Calle 146,5294,3320,3279,11893
22987,2020-06-06,(08000) Portal Tunal,573,273,211,1057
22988,2020-03-03,(07104) Simon Bolivar,2403,1498,1233,5134
22989,2020-04-05,(05005) Transversal 86,60,36,28,124
22990,2020-07-08,(05005) Transversal 86,0,198,495,693
22991,2020-08-01,(05005) Transversal 86,218,114,154,486
22992,2020-07-29,(08000) Portal Tunal,736,290,270,1296
22993,2020-01-22,(04101) Minuto de Dios,2347,1418,1586,5351
22994,2020-02-04,(07000) Portal Sur,7991,4879,4420,17290
22995,2020-07-27,(07201) Guatoque -Veraguas,175,97,116,388
22996,2020-01-26,(06000) Portal Eldorado,696,546,984,2226
22997,2020-02-19,(06101) El Tiempo,2956,1681,1415,6052
22998,2020-04-28,(10006) San Victorino,237,148,181,566
22999,2020-09-14,(10006) San Victorino,564,329,348,1241
23000,2020-09-12,(08002) Biblioteca,239,112,181,532
23001,2020-01-30,(07108) Av. El Dorado,941,582,545,2068
23002,2020-05-29,(02101) Toberín,1247,778,784,2809
23003,2020-03-12,(09115) Calle 34,1739,265,510,2514
23004,2020-05-03,(10000) Portal 20 de Julio,520,230,271,1021
23005,2020-05-09,(02101) Toberín,532,319,415,1266
23006,2020-08-14,(07104) Simon Bolivar,364,251,283,898
23007,2020-02-01,(06000) Portal Eldorado,2627,1903,2315,6845
23008,2020-08-05,(09121) Las Flores,604,382,404,1390
23009,2020-08-24,(09109) Tercer Milenio,241,185,250,676
23010,2020-10-08,(09109) Tercer Milenio,369,252,305,926
23011,2020-09-18,(12001) Carrera 43,522,281,316,1119
23012,2020-07-09,(09117) Calle 45,773,486,431,1690
23013,2020-04-03,(40003) Mirador del Paraiso,735,441,461,1637
23014,2020-10-08,(02202) Calle 127,1137,820,839,2796
23015,2020-02-08,(04001) Quirigua,1167,611,891,2669
23016,2020-03-08,(02205) Calle 106,210,206,450,866
23017,2020-08-08,(08000) Portal Tunal,518,238,244,1000
23018,2020-09-23,(07109) CAD,723,472,443,1638
23019,2020-05-07,(07113) SANTA ISABEL,269,168,184,621
23020,2020-06-01,(09118) Marly,1384,952,656,2992
23021,2020-05-12,(07009) SENA,466,290,296,1052
23022,2020-06-22,(07009) SENA,244,128,169,541
23023,2020-04-29,(12003) Ricaurte,196,155,108,459
23024,2020-07-24,(12003) Ricaurte,256,159,116,531
23025,2020-08-17,(03010) PUENTE LARGO,79,54,67,200
23026,2020-03-27,(03009) Av. Suba- Calle 116,347,265,203,815
23027,2020-08-07,(05100) Banderas P. Central,225,120,174,519
23028,2020-01-17,(05107) Américas - Cr.53,2145,1192,1241,4578
23029,2020-05-15,(02105) Calle 142,630,380,353,1363
23030,2020-07-19,(05002) Tintal,555,260,336,1151
23031,2020-05-01,(09109) Tercer Milenio,112,72,74,258
23032,2020-05-10,(09109) Tercer Milenio,66,44,74,184
23033,2020-02-27,(40002) Manitas,1333,782,737,2852
23034,2020-09-16,(02001) Centro Comercial Santa Fe,549,333,432,1314
23035,2020-08-15,(10008) San Diego,207,146,157,510
23036,2020-02-29,(08002) Biblioteca,609,336,537,1482
23037,2020-01-19,(03011) SUBA - CALLE 100,412,267,467,1146
23038,2020-09-01,(10009) Museo Nacional,552,312,358,1222
23039,2020-02-24,(09113) Calle 22,1571,875,1062,3508
23040,2020-08-04,(06111) Universidades,289,181,244,714
23041,2020-08-02,(08000) Portal Tunal - alimentacion,1958,880,1280,4118
23042,2020-06-09,(40001) Juan Pablo II,550,313,339,1202
23043,2020-03-08,(10005) Bicentenario - alimentacion,109,99,243,451
23044,2020-10-10,(04000) Cabecera Calle 80,905,461,1039,2405
23045,2020-06-02,(07201) Guatoque -Veraguas,183,111,126,420
23046,2020-09-22,(07200) Tygua-San José,265,152,193,610
23047,2020-03-12,(07110) PALOQUEMAO,1052,143,236,1431
23048,2020-06-03,(07201) Guatoque -Veraguas,189,95,135,419
23049,2020-08-22,(07201) Guatoque -Veraguas,130,82,126,338
23050,2020-07-27,(06108) Concejo de Bogotá,129,78,69,276
23051,2020-09-20,(03009) Av. Suba- Calle 116,137,110,143,390
23052,2020-02-07,(07506) DESPENSA,1567,963,960,3490
23053,2020-06-29,(02200) Alcalá,618,459,400,1477
23054,2020-09-21,(07107) U. NACIONAL,352,211,226,789
23055,2020-07-04,(09114) Calle 26,181,133,183,497
23056,2020-08-16,(03003) 21 ANGELES,80,35,66,181
23057,2020-08-29,(03003) 21 ANGELES,260,102,193,555
23058,2020-09-15,(10007) Las Nieves,647,408,412,1467
23059,2020-08-26,(40001) Juan Pablo II,532,297,348,1177
23060,2020-10-09,(10004) Policarpa,285,138,263,686
23061,2020-05-06,(02104) Calle 146,477,339,301,1117
23062,2020-06-12,(04103) Las Ferias,375,196,184,755
23063,2020-08-14,(04103) Las Ferias,327,164,185,676
23064,2020-08-31,(08000) Portal Tunal,798,330,293,1421
23065,2020-01-12,(09121) Las Flores,540,358,671,1569
23066,2020-05-17,(06000) Portal Eldorado - alimentacion,1003,419,514,1936
23067,2020-02-23,(40002) Manitas,306,147,286,739
23068,2020-10-08,(09107) Hortúa,638,390,525,1553
23069,2020-07-13,(09122) Calle 72,942,647,556,2145
23070,2020-03-15,(14005) Las Aguas,206,159,409,774
23071,2020-07-08,(12000) Puente Aranda,100,47,56,203
23072,2020-06-05,(07109) CAD,611,387,286,1284
23073,2020-06-22,(14001) La Sabana,56,35,49,140
23074,2020-04-02,(07107) U. NACIONAL,168,150,106,424
23075,2020-10-09,(03013) RIO NEGRO,318,191,283,792
23076,2020-02-02,(12003) Ricaurte,151,129,203,483
23077,2020-06-15,(10009) Museo Nacional,88,64,97,249
23078,2020-08-12,(07101) CASTELLANA,207,97,105,409
23079,2020-05-21,(03010) PUENTE LARGO,272,179,147,598
23080,2020-10-05,(04106) Carrera 47,380,183,320,883
23081,2020-05-10,(02201) Prado,196,131,134,461
23082,2020-06-02,(04103) Las Ferias,336,189,168,693
23083,2020-09-30,(07008) NQS - Calle 30 Sur,381,218,284,883
23084,2020-09-01,(09117) Calle 45,681,419,443,1543
23085,2020-05-05,(09120) Calle 63,712,490,475,1677
23086,2020-08-19,(03010) PUENTE LARGO,339,199,193,731
23087,2020-07-15,(12003) Ricaurte,206,161,154,521
23088,2020-04-24,(04003) Avenida Ciudad de Cali,584,384,353,1321
23089,2020-05-21,(06002) Normandía,255,135,120,510
23090,2020-08-11,(06002) Normandía,271,165,168,604
23091,2020-03-27,(04000) Cabecera Calle 80 - intermunicipal,75,58,95,228
23092,2020-05-06,(06001) Modelia,311,209,140,660
23093,2020-02-08,(09108) Hospital,192,92,160,444
23094,2020-04-22,(06101) El Tiempo,203,157,102,462
23095,2020-04-14,(03006) NIZA - CALLE 127,274,177,106,557
23096,2020-04-01,(09104) Restrepo,618,472,646,1736
23097,2020-08-24,(09003) Socorro,519,245,286,1050
23098,2020-07-31,(04000) Cabecera Calle 80 - intermunicipal,297,136,266,699
23099,2020-06-07,(04000) Cabecera Calle 80,230,148,214,592
23100,2020-06-19,(02304) Heroes,876,638,501,2015
23101,2020-07-14,(40002) Manitas,256,157,165,578
23102,2020-04-16,(10008) San Diego,151,106,81,338
23103,2020-04-16,(14004) Museo del Oro,0,53,124,177
23104,2020-06-25,(07005) ALQUERIA,609,339,378,1326
23105,2020-02-06,(07200) Tygua-San José,818,497,617,1932
23106,2020-04-21,(06001) Modelia,262,191,169,622
23107,2020-06-12,(06102) Salitre El Greco,219,128,108,455
23108,2020-04-29,(06111) Universidades,0,101,233,334
23109,2020-06-16,(07106) EL CAMPIN,368,257,181,806
23110,2020-08-09,(09122) Calle 72,277,180,278,735
23111,2020-04-28,(07506) DESPENSA,259,146,162,567
23112,2020-07-20,(04108) El Polo,90,62,68,220
23113,2020-04-30,(07006) General Santander,302,178,124,604
23114,2020-06-15,(09002) Consuelo,177,81,93,351
23115,2020-03-15,(07201) Guatoque -Veraguas,68,59,202,329
23116,2020-05-30,(03003) 21 ANGELES,222,99,113,434
23117,2020-10-04,(03003) 21 ANGELES,118,50,115,283
23118,2020-04-17,(07005) ALQUERIA,283,169,161,613
23119,2020-07-25,(07200) Tygua-San José,97,59,100,256
23120,2020-03-30,(07104) Simon Bolivar,164,141,121,426
23121,2020-05-08,(12004) Carrera 22,137,84,97,318
23122,2020-07-23,(06100) Av. Rojas,162,105,111,378
23123,2020-07-20,(04103) Las Ferias,109,57,62,228
23124,2020-07-25,(03011) SUBA - CALLE 100,307,187,151,645
23125,2020-05-13,(10005) Bicentenario,94,50,50,194
23126,2020-05-02,(14005) Las Aguas,0,24,76,100
23127,2020-04-12,(08000) Portal Tunal,150,66,67,283
23128,2020-08-03,(09105) Río Fucha,0,47,118,165
23129,2020-05-30,(05101) Mandalay - Cr.73,68,40,35,143
23130,2020-03-23,(14005) Las Aguas,0,19,55,74
23131,2020-08-16,(06106) Recinto Ferial,56,45,56,157
23132,2020-03-22,(08002) Biblioteca,65,33,31,129
23133,2020-09-18,(12000) Puente Aranda,93,63,59,215
23134,2020-05-10,(10004) Policarpa,62,30,54,146
23135,2020-04-23,(04107) Escuela Militar,58,36,37,131
23136,2020-03-14,(50006) Corral Carrera 77,20,15,26,61
23137,2020-01-08,(50006) Corral Carrera 77,17,15,35,67
23138,2020-03-28,(50002) Corral Calle 40 Sur,6,6,6,18
23139,2020-04-10,(12007) Zona Industrial,15,16,15,46
23140,2020-04-09,(02102) Calle 161,28,29,20,77
23141,2020-08-10,(04000) Cabecera Calle 80 - alimentacion,3304,1975,2273,7552
23142,2020-08-26,(07005) ALQUERIA,509,286,319,1114
23143,2020-07-09,(09002) Consuelo,503,281,277,1061
23144,2020-08-19,(02502) Terminal,356,243,318,917
23145,2020-01-12,(09118) Marly,1138,716,1217,3071
23146,2020-01-14,(03000) Portal Suba - alimentacion,23509,13044,13953,50506
23147,2020-07-11,(04002) Carrera 90,609,318,398,1325
23148,2020-07-31,(04002) Carrera 90,552,316,268,1136
23149,2020-03-04,(07111) NQS - RICAURTE,3189,2033,1756,6978
23150,2020-07-13,(05000) Portal Américas - alimentacion,9821,5162,4584,19567
23151,2020-01-28,(04000) Cabecera Calle 80 - alimentacion,22628,13559,13976,50163
23152,2020-10-03,(09001) Molinos,2562,1104,2246,5912
23153,2020-06-27,(05001) Patio Bonito,1633,857,940,3430
23154,2020-08-20,(05001) Patio Bonito,1650,924,880,3454
23155,2020-01-07,(04103) Las Ferias,1032,557,732,2321
23156,2020-02-12,(04103) Las Ferias,1664,946,908,3518
23157,2020-01-28,(02000) Cabecera Autopista Norte - intermunicipal,4864,3298,2979,11141
23158,2020-09-11,(10000) Portal 20 de Julio - alimentacion,4282,1791,2560,8633
23159,2020-02-26,(03009) Av. Suba- Calle 116,2607,1633,1469,5709
23160,2020-02-24,(10001) Country Sur,5202,2425,2696,10323
23161,2020-02-13,(09113) Calle 22,1677,939,1091,3707
23162,2020-01-14,(07113) SANTA ISABEL,1790,1060,1218,4068
23163,2020-03-06,(07113) SANTA ISABEL,2092,1228,1454,4774
23164,2020-01-27,(40003) Mirador del Paraiso,4706,2647,2658,10011
23165,2020-07-08,(40003) Mirador del Paraiso,1824,1161,1133,4118
23166,2020-02-11,(09115) Calle 34,4633,2890,2524,10047
23167,2020-02-03,(06002) Normandía,2507,1554,1376,5437
23168,2020-02-11,(06002) Normandía,2796,1641,1330,5767
23169,2020-07-10,(05002) Tintal,2391,1349,1619,5359
23170,2020-09-03,(05002) Tintal,2742,1575,1658,5975
23171,2020-02-27,(09117) Calle 45,6705,4349,3063,14117
23172,2020-02-12,(02502) Terminal,5575,3631,3065,12271
23173,2020-01-25,(09123) Calle 76,2009,1569,2017,5595
23174,2020-02-06,(09123) Calle 76,5557,3991,3321,12869
23175,2020-01-14,(02304) Heroes,3713,2624,2052,8389
23176,2020-02-28,(07106) EL CAMPIN,2135,1367,1255,4757
23177,2020-05-08,(02103) Mazurén,147,80,100,327
23178,2020-05-29,(14001) La Sabana,131,97,91,319
23179,2020-06-22,(09113) Calle 22,206,118,176,500
23180,2020-04-06,(07109) CAD,404,277,179,860
23181,2020-02-11,(09114) Calle 26,3467,2217,1826,7510
23182,2020-04-07,(50003) Corral Molinos,801,362,488,1651
23183,2020-10-08,(04000) Cabecera Calle 80,1265,762,1131,3158
23184,2020-02-13,(04104) Avenida 68,3874,1992,1856,7722
23185,2020-03-19,(02201) Prado,2364,1498,1357,5219
23186,2020-02-19,(04003) Avenida Ciudad de Cali,5730,3450,3611,12791
23187,2020-01-07,(04002) Carrera 90,2392,1393,1545,5330
23188,2020-05-08,(04002) Carrera 90,481,281,242,1004
23189,2020-05-16,(09111) Calle 19,488,312,327,1127
23190,2020-03-03,(10000) Portal 20 de Julio,9087,4242,4050,17379
23191,2020-01-07,(09004) Santa Lucía,5164,2792,3569,11525
23192,2020-06-26,(12001) Carrera 43,441,268,270,979
23193,2020-01-28,(10002) Av. Primero de Mayo,8219,4127,4540,16886
23194,2020-03-12,(02000) Cabecera Autopista Norte - alimentacion,1979,4743,3346,10068
23195,2020-07-04,(06105) Quinta Paredes,118,70,62,250
23196,2020-03-08,(05001) Patio Bonito,1581,689,1361,3631
23197,2020-02-13,(02302) Virrey,3952,2698,1788,8438
23198,2020-08-06,(03000) Portal Suba,947,594,729,2270
23199,2020-08-28,(03000) Portal Suba,1282,795,913,2990
23200,2020-02-07,(09119) Calle 57,3757,2250,2232,8239
23201,2020-02-07,(04001) Quirigua,2113,1245,1279,4637
23202,2020-07-21,(08002) Biblioteca,235,132,145,512
23203,2020-01-11,(02303) Calle 85,1282,989,1115,3386
23204,2020-10-08,(02303) Calle 85,859,572,585,2016
23205,2020-09-10,(07000) Portal Sur,1961,1164,1201,4326
23206,2020-03-18,(09118) Marly,3262,2258,1793,7313
23207,2020-09-23,(08001) Parque el Tunal,539,295,378,1212
23208,2020-03-14,(09116) Avenida 39,777,605,966,2348
23209,2020-09-19,(02101) Toberín,1119,607,1153,2879
23210,2020-05-21,(10002) Av. Primero de Mayo,1743,890,1019,3652
23211,2020-01-10,(02300) Calle 100,5366,3409,3056,11831
23212,2020-01-21,(07001) PERDOMO,3441,1671,1711,6823
23213,2020-05-05,(02201) Prado,530,327,331,1188
23214,2020-07-01,(02000) Cabecera Autopista Norte,1413,902,898,3213
23215,2020-09-05,(08001) Parque el Tunal,431,216,338,985
23216,2020-02-15,(07007) NQS - Calle 38A Sur,1471,813,910,3194
23217,2020-01-07,(10007) Las Nieves,1411,887,943,3241
23218,2020-03-19,(06001) Modelia,1043,631,611,2285
23219,2020-09-03,(06102) Salitre El Greco,236,128,159,523
23220,2020-02-21,(10009) Museo Nacional,3967,2347,1958,8272
23221,2020-02-18,(09107) Hortúa,2545,1551,1557,5653
23222,2020-04-28,(09107) Hortúa,460,270,262,992
23223,2020-05-11,(09107) Hortúa,487,289,297,1073
23224,2020-08-03,(09107) Hortúa,546,355,313,1214
23225,2020-03-08,(05103) Marsella,430,206,419,1055
23226,2020-05-03,(02300) Calle 100,288,183,149,620
23227,2020-07-30,(10000) Portal 20 de Julio,2183,1105,1097,4385
23228,2020-06-16,(50002) Corral Calle 40 Sur,19,15,26,60
23229,2020-02-16,(10010) San Bernardo,435,254,544,1233
23230,2020-06-12,(02205) Calle 106,310,227,239,776
23231,2020-08-14,(02205) Calle 106,253,229,280,762
23232,2020-02-20,(03006) NIZA - CALLE 127,2402,1501,1407,5310
23233,2020-07-21,(04101) Minuto de Dios,303,177,200,680
23234,2020-08-28,(04101) Minuto de Dios,306,205,260,771
23235,2020-07-23,(06000) Portal Eldorado - alimentacion,2984,1581,1386,5951
23236,2020-09-11,(04108) El Polo,493,300,299,1092
23237,2020-07-08,(07000) Portal Sur,1982,1286,1171,4439
23238,2020-02-05,(07101) CASTELLANA,972,603,609,2184
23239,2020-06-15,(07505) LEON XIII,785,456,425,1666
23240,2020-06-28,(07106) EL CAMPIN,120,77,73,270
23241,2020-01-07,(07103) AV. CHILE,2329,1447,1452,5228
23242,2020-09-24,(06106) Recinto Ferial,297,199,184,680
23243,2020-02-07,(09121) Las Flores,3192,2047,2069,7308
23244,2020-02-14,(06101) El Tiempo,2962,1652,1511,6125
23245,2020-10-10,(03007) HUMEDAL CORDOBA,115,87,106,308
23246,2020-01-18,(09121) Las Flores,1510,999,1309,3818
23247,2020-05-08,(09100) Calle 40 Sur,1192,748,762,2702
23248,2020-07-12,(09100) Calle 40 Sur,689,354,553,1596
23249,2020-05-05,(07104) Simon Bolivar,327,221,182,730
23250,2020-08-13,(07104) Simon Bolivar,347,269,278,894
23251,2020-04-17,(10005) Bicentenario - alimentacion,162,74,119,355
23252,2020-10-01,(04107) Escuela Militar,175,109,111,395
23253,2020-04-21,(05103) Marsella,195,104,99,398
23254,2020-06-08,(05103) Marsella,329,183,198,710
23255,2020-09-29,(09109) Tercer Milenio,386,225,275,886
23256,2020-02-08,(10009) Museo Nacional,1096,867,1371,3334
23257,2020-06-14,(07000) Portal Sur,412,216,331,959
23258,2020-04-12,(40003) Mirador del Paraiso,296,172,210,678
23259,2020-09-06,(04104) Avenida 68,201,125,193,519
23260,2020-07-25,(02104) Calle 146,448,291,296,1035
23261,2020-01-05,(04001) Quirigua,314,151,306,771
23262,2020-02-23,(03011) SUBA - CALLE 100,402,243,429,1074
23263,2020-03-03,(06104) Gobernación,1453,825,671,2949
23264,2020-05-28,(02204) Pepe Sierra,658,484,333,1475
23265,2020-09-10,(07005) ALQUERIA,465,247,341,1053
23266,2020-10-02,(06106) Recinto Ferial,318,212,200,730
23267,2020-10-02,(06100) Av. Rojas,314,189,281,784
23268,2020-08-24,(12003) Ricaurte,390,242,141,773
23269,2020-05-14,(03010) PUENTE LARGO,264,196,151,611
23270,2020-07-12,(07103) AV. CHILE,197,145,207,549
23271,2020-05-03,(09002) Consuelo,93,50,47,190
23272,2020-09-02,(07007) NQS - Calle 38A Sur,430,286,303,1019
23273,2020-09-03,(05107) Américas - Cr.53,411,284,314,1009
23274,2020-07-03,(02104) Calle 146,850,538,599,1987
23275,2020-07-28,(02103) Mazurén,173,113,153,439
23276,2020-06-14,(07103) AV. CHILE,173,129,147,449
23277,2020-03-19,(12007) Zona Industrial,837,517,370,1724
23278,2020-08-11,(10005) Bicentenario,106,63,75,244
23279,2020-03-18,(40002) Manitas,868,479,513,1860
23280,2020-05-27,(06109) Centro Memoria,282,159,117,558
23281,2020-01-29,(12002) CDS - Carrera 32,581,350,314,1245
23282,2020-06-24,(09106) Nariño,432,266,298,996
23283,2020-06-03,(06108) Concejo de Bogotá,120,72,81,273
23284,2020-01-19,(10006) San Victorino,295,280,418,993
23285,2020-05-14,(08002) Biblioteca,233,121,111,465
23286,2020-08-19,(08000) Portal Tunal,787,284,275,1346
23287,2020-09-13,(04107) Escuela Militar,35,26,51,112
23288,2020-09-26,(04107) Escuela Militar,97,77,93,267
23289,2020-09-23,(10009) Museo Nacional,606,364,433,1403
23290,2020-07-23,(05107) Américas - Cr.53,322,194,183,699
23291,2020-03-21,(05105) Pradera,248,157,102,507
23292,2020-04-18,(05105) Pradera,304,215,109,628
23293,2020-07-06,(40001) Juan Pablo II,563,344,367,1274
23294,2020-05-29,(02104) Calle 146,643,421,410,1474
23295,2020-04-19,(02200) Alcalá,353,266,202,821
23296,2020-06-17,(02105) Calle 142,770,490,450,1710
23297,2020-10-11,(06100) Av. Rojas,40,40,121,201
23298,2020-04-16,(10000) Portal 20 de Julio,1209,655,641,2505
23299,2020-08-15,(06104) Gobernación,138,84,98,320
23300,2020-02-22,(07006) General Santander - alimentacion,937,525,729,2191
23301,2020-01-18,(07105) MOVISTAR ARENA,552,426,625,1603
23302,2020-07-12,(07003) SEVILLANA,130,59,135,324
23303,2020-08-03,(14005) Las Aguas,151,77,173,401
23304,2020-05-04,(03003) 21 ANGELES,194,92,87,373
23305,2020-01-05,(07001) PERDOMO,740,290,661,1691
23306,2020-10-03,(09121) Las Flores,485,368,587,1440
23307,2020-07-07,(10004) Policarpa,286,136,191,613
23308,2020-07-17,(05102) Av. Américas - Av. Boyacá,198,91,119,408
23309,2020-05-19,(10007) Las Nieves,467,280,280,1027
23310,2020-06-17,(09114) Calle 26,309,241,207,757
23311,2020-07-19,(12000) Puente Aranda,11,11,18,40
23312,2020-04-17,(07103) AV. CHILE,489,355,262,1106
23313,2020-01-14,(09003) Socorro,1441,759,908,3108
23314,2020-08-30,(02102) Calle 161,63,38,72,173
23315,2020-05-09,(09115) Calle 34,294,195,173,662
23316,2020-05-16,(04107) Escuela Militar,60,55,57,172
23317,2020-05-05,(10009) Museo Nacional,366,226,222,814
23318,2020-06-05,(04106) Carrera 47,311,164,172,647
23319,2020-03-26,(09119) Calle 57,231,156,170,557
23320,2020-07-07,(04001) Quirigua,456,270,288,1014
23321,2020-01-30,(07200) Tygua-San José,813,491,580,1884
23322,2020-08-12,(10007) Las Nieves,711,425,390,1526
23323,2020-07-20,(07003) SEVILLANA,116,61,76,253
23324,2020-01-02,(05101) Mandalay - Cr.73,369,211,206,786
23325,2020-05-26,(12002) CDS - Carrera 32,215,128,77,420
23326,2020-08-25,(12002) CDS - Carrera 32,209,123,78,410
23327,2020-05-04,(09106) Nariño,246,145,161,552
23328,2020-04-30,(06001) Modelia,299,194,159,652
23329,2020-09-26,(09108) Hospital,65,38,70,173
23330,2020-05-15,(03009) Av. Suba- Calle 116,393,264,186,843
23331,2020-03-20,(02502) Terminal,159,121,130,410
23332,2020-04-06,(02502) Terminal,123,100,127,350
23333,2020-09-04,(03004) GRATAMIRA,0,19,44,63
23334,2020-03-15,(04107) Escuela Militar,82,49,128,259
23335,2020-01-04,(06100) Av. Rojas,351,233,406,990
23336,2020-08-07,(03009) Av. Suba- Calle 116,155,122,95,372
23337,2020-06-25,(07506) DESPENSA,507,263,273,1043
23338,2020-02-02,(09108) Hospital,80,55,109,244
23339,2020-08-26,(07006) General Santander - alimentacion,367,194,250,811
23340,2020-08-17,(40002) Manitas,138,77,94,309
23341,2020-03-28,(07005) ALQUERIA,170,97,92,359
23342,2020-09-14,(06102) Salitre El Greco,231,126,159,516
23343,2020-04-13,(03010) PUENTE LARGO,211,150,110,471
23344,2020-08-22,(03011) SUBA - CALLE 100,322,181,193,696
23345,2020-06-21,(07506) DESPENSA,141,70,97,308
23346,2020-08-23,(04103) Las Ferias,91,51,73,215
23347,2020-03-31,(14004) Museo del Oro,0,44,98,142
23348,2020-04-03,(07002) MADELENA,357,188,226,771
23349,2020-07-05,(09116) Avenida 39,80,73,80,233
23350,2020-09-08,(10003) Ciudad Jardín,215,124,138,477
23351,2020-07-12,(07010) Bosa,241,92,178,511
23352,2020-07-14,(07109) CAD,600,378,271,1249
23353,2020-06-22,(12004) Carrera 22,65,42,53,160
23354,2020-02-09,(04105) Carrera 53,320,178,302,800
23355,2020-07-20,(07506) DESPENSA,140,82,66,288
23356,2020-09-07,(06107) Ciudad Universitaria,196,109,149,454
23357,2020-10-12,(12007) Zona Industrial,63,56,68,187
23358,2020-05-10,(10008) San Diego,68,41,51,160
23359,2020-07-10,(05101) Mandalay - Cr.73,163,89,82,334
23360,2020-04-19,(09003) Socorro,128,67,65,260
23361,2020-04-08,(12007) Zona Industrial,129,108,60,297
23362,2020-06-10,(04105) Carrera 53,269,148,161,578
23363,2020-05-13,(04105) Carrera 53,225,118,107,450
23364,2020-04-27,(09114) Calle 26,37,92,43,172
23365,2020-06-30,(09105) Río Fucha,126,62,96,284
23366,2020-09-15,(07108) Av. El Dorado,167,109,96,372
23367,2020-10-05,(07108) Av. El Dorado,195,122,156,473
23368,2020-07-10,(09106) Nariño,473,256,344,1073
23369,2020-06-22,(06001) Modelia,98,67,68,233
23370,2020-04-10,(12001) Carrera 43,35,29,30,94
23371,2020-05-30,(07003) SEVILLANA,291,152,177,620
23372,2020-04-03,(06104) Gobernación,141,112,92,345
23373,2020-09-06,(03012) SUBA - CALLE 95,84,62,79,225
23374,2020-08-08,(14005) Las Aguas,125,78,139,342
23375,2020-08-12,(14005) Las Aguas,170,102,151,423
23376,2020-08-30,(08002) Biblioteca,105,58,94,257
23377,2020-08-23,(14004) Museo del Oro,17,15,47,79
23378,2020-04-11,(05101) Mandalay - Cr.73,32,21,14,67
23379,2020-06-04,(10005) Bicentenario,111,42,68,221
23380,2020-04-09,(07102) NQS - CALLE 75,49,29,32,110
23381,2020-09-30,(03004) GRATAMIRA,0,25,42,67
23382,2020-01-14,(04000) Cabecera Calle 80 - alimentacion,19042,10933,12479,42454
23383,2020-05-29,(04000) Cabecera Calle 80 - alimentacion,3507,1952,2209,7668
23384,2020-09-23,(07005) ALQUERIA,669,373,448,1490
23385,2020-03-12,(07504) TERREROS,393,4624,2958,7975
23386,2020-07-25,(10000) Portal 20 de Julio - alimentacion,2616,1184,1659,5459
23387,2020-01-24,(08000) Portal Tunal - alimentacion,23139,11796,11292,46227
23388,2020-02-04,(03000) Portal Suba - alimentacion,28685,17211,16976,62872
23389,2020-01-17,(03002) SUBA - TV- 91,3866,2089,2222,8177
23390,2020-01-30,(03002) SUBA - TV- 91,4423,2561,2362,9346
23391,2020-02-14,(02101) Toberín,15180,8835,7891,31906
23392,2020-07-10,(07503) SAN MATEO,12021,7105,6161,25287
23393,2020-03-07,(09001) Molinos,5713,2537,4410,12660
23394,2020-08-01,(07112) COMUNEROS,530,305,339,1174
23395,2020-05-29,(08000) Portal Tunal - alimentacion,5761,3117,2995,11873
23396,2020-01-08,(09000) Cabecera Usme - alimentacion,19679,10252,12965,42896
23397,2020-09-30,(10000) Portal 20 de Julio - alimentacion,4714,2000,3094,9808
23398,2020-02-14,(07002) MADELENA,5195,2798,2721,10714
23399,2020-05-20,(10001) Country Sur,957,403,522,1882
23400,2020-06-01,(09100) Calle 40 Sur,1601,984,911,3496
23401,2020-08-13,(09000) Cabecera Usme,1603,951,1119,3673
23402,2020-08-28,(09000) Cabecera Usme,1812,1113,1336,4261
23403,2020-01-02,(06000) Portal Eldorado - alimentacion,7903,4013,5107,17023
23404,2020-01-24,(09115) Calle 34,3780,2572,2390,8742
23405,2020-07-02,(09115) Calle 34,695,429,420,1544
23406,2020-01-13,(10003) Ciudad Jardín,805,453,577,1835
23407,2020-01-27,(10003) Ciudad Jardín,1005,549,702,2256
23408,2020-09-03,(09000) Cabecera Usme - alimentacion,9221,4850,5591,19662
23409,2020-07-01,(40003) Mirador del Paraiso,1858,1142,1161,4161
23410,2020-05-22,(04101) Minuto de Dios,278,164,155,597
23411,2020-03-10,(04104) Avenida 68,1434,454,524,2412
23412,2020-03-31,(07102) NQS - CALLE 75,145,113,103,361
23413,2020-04-03,(09118) Marly,1002,757,513,2272
23414,2020-09-01,(05100) Banderas P. Central - alimentacion,3092,1684,1859,6635
23415,2020-09-17,(05100) Banderas P. Central - alimentacion,3616,1968,2216,7800
23416,2020-09-21,(05100) Banderas P. Central - alimentacion,2803,1060,1513,5376
23417,2020-03-23,(09103) Olaya,230,127,125,482
23418,2020-07-29,(02000) Cabecera Autopista Norte,1202,759,726,2687
23419,2020-06-25,(09001) Molinos,2562,1411,1706,5679
23420,2020-01-03,(07009) SENA,1689,926,1145,3760
23421,2020-06-23,(07112) COMUNEROS,819,465,490,1774
23422,2020-01-05,(09114) Calle 26,167,146,324,637
23423,2020-02-15,(04002) Carrera 90,2091,1004,1524,4619
23424,2020-04-13,(04002) Carrera 90,355,206,170,731
23425,2020-02-15,(03000) Portal Suba,4570,2228,3706,10504
23426,2020-07-01,(06000) Portal Eldorado,969,688,546,2203
23427,2020-09-06,(06000) Portal Eldorado,150,181,327,658
23428,2020-06-11,(40003) Mirador del Paraiso,1639,1050,927,3616
23429,2020-02-26,(12001) Carrera 43,1760,936,1113,3809
23430,2020-08-15,(10002) Av. Primero de Mayo,1685,800,1279,3764
23431,2020-02-12,(09107) Hortúa,2533,1578,1476,5587
23432,2020-01-17,(10005) Bicentenario - alimentacion,637,266,516,1419
23433,2019-12-31,(07503) SAN MATEO,399,332,439,1170
23434,2020-03-26,(09000) Cabecera Usme - alimentacion,4148,1986,2402,8536
23435,2020-01-23,(06111) Universidades,4983,3040,2323,10346
23436,2020-01-25,(10000) Portal 20 de Julio,5323,2165,3279,10767
23437,2020-06-05,(07112) COMUNEROS,750,468,390,1608
23438,2020-03-07,(02303) Calle 85,1481,1177,1409,4067
23439,2020-09-09,(07000) Portal Sur,2151,1353,1437,4941
23440,2020-10-01,(02001) Centro Comercial Santa Fe,632,367,554,1553
23441,2020-10-05,(07004) VENECIA,1186,709,809,2704
23442,2020-05-06,(07503) SAN MATEO,6626,4184,3048,13858
23443,2020-09-26,(09116) Avenida 39,243,193,293,729
23444,2020-09-29,(09116) Avenida 39,422,288,343,1053
23445,2020-02-01,(07001) PERDOMO,2527,1182,1918,5627
23446,2020-01-20,(07001) PERDOMO,4247,2507,2484,9238
23447,2020-02-14,(02304) Heroes,4604,3355,2373,10332
23448,2020-02-13,(10009) Museo Nacional,4779,2503,1956,9238
23449,2020-01-15,(03007) HUMEDAL CORDOBA,767,487,454,1708
23450,2020-07-09,(02300) Calle 100,1296,837,672,2805
23451,2020-05-29,(03012) SUBA - CALLE 95,292,178,172,642
23452,2020-09-30,(03012) SUBA - CALLE 95,357,223,244,824
23453,2020-05-22,(04000) Cabecera Calle 80,886,549,592,2027
23454,2020-03-13,(09000) Cabecera Usme - alimentacion,815,4738,4019,9572
23455,2020-04-28,(09104) Restrepo,878,558,638,2074
23456,2020-02-07,(08000) Portal Tunal,2193,1244,1104,4541
23457,2020-02-04,(03006) NIZA - CALLE 127,2439,1577,1642,5658
23458,2020-02-06,(07101) CASTELLANA,876,602,596,2074
23459,2020-05-27,(07106) EL CAMPIN,315,193,190,698
23460,2020-07-21,(07113) SANTA ISABEL,344,199,269,812
23461,2020-03-05,(03007) HUMEDAL CORDOBA,1022,620,580,2222
23462,2020-10-05,(03007) HUMEDAL CORDOBA,167,133,132,432
23463,2020-05-02,(05000) Portal Américas - alimentacion,5293,2486,2322,10101
23464,2020-02-29,(10003) Ciudad Jardín,543,276,582,1401
23465,2020-01-10,(05107) Américas - Cr.53,1876,1044,1174,4094
23466,2020-04-14,(02304) Heroes,427,353,279,1059
23467,2020-08-31,(06000) Portal Eldorado,887,584,500,1971
23468,2020-08-21,(09121) Las Flores,649,415,408,1472
23469,2020-01-02,(09001) Molinos,3860,2039,3337,9236
23470,2020-01-05,(09100) Calle 40 Sur,1348,586,1214,3148
23471,2020-02-16,(02502) Terminal,351,319,834,1504
23472,2020-06-05,(05103) Marsella,308,166,173,647
23473,2020-06-16,(04003) Avenida Ciudad de Cali,984,589,704,2277
23474,2020-04-14,(09000) Cabecera Usme - alimentacion,4674,2356,2639,9669
23475,2020-09-30,(09109) Tercer Milenio,371,244,268,883
23476,2020-01-27,(03003) 21 ANGELES,1603,815,863,3281
23477,2020-10-02,(07004) VENECIA,1248,716,897,2861
23478,2020-09-05,(07002) MADELENA,674,335,535,1544
23479,2020-03-26,(02104) Calle 146,388,283,227,898
23480,2020-04-16,(02202) Calle 127,666,492,361,1519
23481,2020-01-12,(06101) El Tiempo,284,199,401,884
23482,2020-03-15,(02205) Calle 106,142,161,303,606
23483,2020-10-06,(08000) Portal Tunal,816,380,468,1664
23484,2020-03-09,(03003) 21 ANGELES,55,392,334,781
23485,2020-07-15,(06106) Recinto Ferial,233,132,98,463
23486,2020-02-01,(06100) Av. Rojas,794,482,833,2109
23487,2020-06-17,(07009) SENA,652,412,422,1486
23488,2020-08-03,(03012) SUBA - CALLE 95,224,129,138,491
23489,2020-03-31,(03010) PUENTE LARGO,200,152,108,460
23490,2020-06-15,(03010) PUENTE LARGO,91,74,89,254
23491,2020-04-20,(07009) SENA,317,205,173,695
23492,2020-01-12,(02502) Terminal,289,260,669,1218
23493,2020-05-04,(02105) Calle 142,475,336,287,1098
23494,2020-04-13,(07009) SENA,306,207,175,688
23495,2020-08-25,(05107) Américas - Cr.53,389,235,257,881
23496,2020-10-12,(09100) Calle 40 Sur,628,335,673,1636
23497,2020-03-24,(10005) Bicentenario,101,55,94,250
23498,2020-02-12,(40002) Manitas,1364,822,789,2975
23499,2020-03-27,(06109) Centro Memoria,157,112,90,359
23500,2020-04-02,(05002) Tintal,1139,625,625,2389
23501,2020-03-26,(06103) CAN,354,277,162,793
23502,2020-05-05,(02104) Calle 146,495,323,334,1152
23503,2020-02-28,(09106) Nariño,2066,1209,1422,4697
23504,2020-03-07,(08002) Biblioteca,638,334,548,1520
23505,2020-06-09,(09120) Calle 63,1065,678,614,2357
23506,2020-04-29,(02200) Alcalá,1007,724,483,2214
23507,2020-09-05,(04107) Escuela Militar,111,70,106,287
23508,2020-10-11,(05107) Américas - Cr.53,88,82,184,354
23509,2020-06-13,(06111) Universidades,136,122,284,542
23510,2020-10-09,(06100) Av. Rojas,299,202,284,785
23511,2020-09-12,(07110) PALOQUEMAO,492,289,322,1103
23512,2020-06-23,(09111) Calle 19,801,505,478,1784
23513,2020-02-01,(12004) Carrera 22,450,311,401,1162
23514,2020-08-04,(09122) Calle 72,1009,683,654,2346
23515,2020-08-17,(09106) Nariño,144,75,123,342
23516,2020-04-07,(10006) San Victorino,183,146,148,477
23517,2020-04-18,(02001) Centro Comercial Santa Fe,129,100,101,330
23518,2020-06-30,(09122) Calle 72,1302,818,879,2999
23519,2020-08-15,(09122) Calle 72,835,571,703,2109
23520,2020-09-11,(09111) Calle 19,785,447,492,1724
23521,2020-04-29,(06104) Gobernación,164,112,69,345
23522,2020-09-23,(06109) Centro Memoria,298,186,181,665
23523,2020-09-19,(06104) Gobernación,162,107,133,402
23524,2020-04-06,(04000) Cabecera Calle 80,518,345,369,1232
23525,2020-05-29,(07201) Guatoque -Veraguas,170,86,108,364
23526,2020-08-09,(07105) MOVISTAR ARENA,43,36,53,132
23527,2020-08-21,(07105) MOVISTAR ARENA,228,128,140,496
23528,2020-06-14,(02200) Alcalá,523,374,306,1203
23529,2020-08-18,(02200) Alcalá,1588,1107,879,3574
23530,2020-03-21,(02303) Calle 85,215,140,124,479
23531,2020-03-22,(04003) Avenida Ciudad de Cali,154,109,114,377
23532,2020-08-05,(14004) Museo del Oro,279,155,190,624
23533,2020-08-05,(40001) Juan Pablo II,511,300,302,1113
23534,2020-04-15,(40002) Manitas,173,86,120,379
23535,2020-04-11,(10007) Las Nieves,90,75,80,245
23536,2020-04-08,(12003) Ricaurte,101,85,86,272
23537,2020-09-14,(09114) Calle 26,354,213,275,842
23538,2020-07-16,(08002) Biblioteca,215,113,123,451
23539,2020-09-11,(08002) Biblioteca,326,147,220,693
23540,2020-03-04,(12000) Puente Aranda,246,167,204,617
23541,2020-05-26,(12000) Puente Aranda,80,42,30,152
23542,2020-05-07,(07109) CAD,459,305,200,964
23543,2020-05-28,(07109) CAD,583,358,254,1195
23544,2020-02-16,(40002) Manitas,362,154,316,832
23545,2020-06-24,(12004) Carrera 22,264,153,136,553
23546,2020-03-14,(04107) Escuela Militar,304,213,294,811
23547,2020-06-30,(07005) ALQUERIA,597,341,369,1307
23548,2020-07-18,(04106) Carrera 47,241,115,112,468
23549,2020-05-01,(07006) General Santander - alimentacion,105,57,59,221
23550,2020-07-14,(07009) SENA,610,350,341,1301
23551,2020-04-09,(02300) Calle 100,272,236,195,703
23552,2020-07-20,(40003) Mirador del Paraiso,487,296,328,1111
23553,2020-08-13,(03010) PUENTE LARGO,281,171,183,635
23554,2020-08-29,(03010) PUENTE LARGO,239,177,186,602
23555,2020-08-24,(07009) SENA,520,330,325,1175
23556,2020-01-15,(12002) CDS - Carrera 32,513,329,318,1160
23557,2020-08-13,(05107) Américas - Cr.53,406,218,225,849
23558,2020-08-29,(04001) Quirigua,307,162,250,719
23559,2020-01-22,(07200) Tygua-San José,780,445,602,1827
23560,2020-03-30,(09108) Hospital,35,27,27,89
23561,2020-09-24,(09108) Hospital,60,44,52,156
23562,2020-06-04,(03009) Av. Suba- Calle 116,462,306,216,984
23563,2020-09-14,(09105) Río Fucha,0,75,162,237
23564,2020-04-13,(02502) Terminal,147,116,131,394
23565,2020-05-09,(07200) Tygua-San José,122,58,89,269
23566,2020-06-14,(07108) Av. El Dorado,35,18,26,79
23567,2020-06-13,(12002) CDS - Carrera 32,112,79,56,247
23568,2020-04-01,(09108) Hospital,39,21,43,103
23569,2020-06-17,(10004) Policarpa,236,112,146,494
23570,2020-07-30,(06102) Salitre El Greco,218,141,126,485
23571,2020-04-07,(12007) Zona Industrial,144,109,74,327
23572,2020-03-24,(07200) Tygua-San José,117,97,179,393
23573,2020-05-02,(08001) Parque el Tunal,187,110,106,403
23574,2020-05-14,(06111) Universidades,0,103,304,407
23575,2020-08-17,(09121) Las Flores,185,133,187,505
23576,2020-05-28,(03005) SUBA - AV. BOYACA,389,222,197,808
23577,2020-07-20,(03002) SUBA - TV- 91,200,114,169,483
23578,2020-09-17,(03005) SUBA - AV. BOYACA,548,315,322,1185
23579,2020-04-14,(05100) Banderas P. Central,350,178,213,741
23580,2020-04-04,(09106) Nariño,132,84,107,323
23581,2020-09-09,(09106) Nariño,449,261,346,1056
23582,2020-04-21,(07007) NQS - Calle 38A Sur,165,121,100,386
23583,2020-04-25,(03002) SUBA - TV- 91,299,159,174,632
23584,2020-08-20,(06106) Recinto Ferial,211,132,110,453
23585,2020-04-28,(05103) Marsella,219,115,102,436
23586,2020-08-11,(04102) Avenida Boyaca,282,167,196,645
23587,2020-04-05,(09110) Avenida Jimenez,96,105,115,316
23588,2020-04-24,(08002) Biblioteca,192,118,114,424
23589,2020-03-28,(12002) CDS - Carrera 32,69,64,44,177
23590,2020-07-19,(03009) Av. Suba- Calle 116,144,97,70,311
23591,2020-07-19,(03013) RIO NEGRO,81,38,54,173
23592,2020-06-21,(12007) Zona Industrial,55,41,57,153
23593,2020-04-26,(06001) Modelia,68,48,48,164
23594,2020-06-16,(07108) Av. El Dorado,138,92,80,310
23595,2020-09-12,(07101) CASTELLANA,138,76,117,331
23596,2020-08-16,(09105) Río Fucha,0,12,41,53
23597,2020-04-26,(08001) Parque el Tunal,85,37,63,185
23598,2020-06-15,(07200) Tygua-San José,82,34,82,198
23599,2020-08-30,(10005) Bicentenario - alimentacion,46,36,103,185
23600,2020-06-14,(03005) SUBA - AV. BOYACA,101,63,110,274
23601,2020-09-13,(06002) Normandía,94,65,113,272
23602,2020-03-22,(50002) Corral Calle 40 Sur,1,8,5,14
23603,2020-07-15,(06108) Concejo de Bogotá,113,76,67,256
23604,2020-05-02,(02102) Calle 161,84,57,42,183
23605,2020-07-18,(03014) SAN MARTIN,1,10,30,41
23606,2020-04-21,(05101) Mandalay - Cr.73,56,35,28,119
23607,2020-10-10,(12000) Puente Aranda,59,46,59,164
23608,2020-05-09,(06104) Gobernación,87,55,46,188
23609,2020-04-19,(06102) Salitre El Greco,60,41,36,137
23610,2019-12-31,(05103) Marsella,24,16,21,61
23611,2020-07-26,(04107) Escuela Militar,29,25,37,91
23612,2020-06-28,(03014) SAN MARTIN,10,3,8,21
23613,2020-05-23,(04000) Cabecera Calle 80 - alimentacion,2220,1211,1435,4866
23614,2020-10-08,(04000) Cabecera Calle 80 - alimentacion,4884,2678,4135,11697
23615,2020-06-24,(07005) ALQUERIA,604,320,321,1245
23616,2020-07-16,(09118) Marly,1254,871,636,2761
23617,2020-09-21,(09118) Marly,1083,832,763,2678
23618,2020-06-24,(07504) TERREROS,6072,3504,2892,12468
23619,2020-08-07,(07504) TERREROS,2329,1097,1197,4623
23620,2020-05-22,(07111) NQS - RICAURTE,948,595,366,1909
23621,2020-03-03,(08000) Portal Tunal - alimentacion,24494,13518,12135,50147
23622,2020-04-04,(08000) Portal Tunal - alimentacion,2579,1257,1289,5125
23623,2020-01-29,(04106) Carrera 47,1503,803,852,3158
23624,2020-01-21,(03000) Portal Suba - alimentacion,3117,6777,11164,21058
23625,2020-01-28,(03002) SUBA - TV- 91,4386,2550,2387,9323
23626,2020-02-19,(07505) LEON XIII,8707,4865,3797,17369
23627,2020-02-21,(09122) Calle 72,7382,5202,4509,17093
23628,2020-03-12,(09003) Socorro,128,356,285,769
23629,2020-02-03,(50003) Corral Molinos,3220,2148,3579,8947
23630,2020-01-27,(04002) Carrera 90,3500,2116,1957,7573
23631,2020-01-29,(04002) Carrera 90,3552,2103,1970,7625
23632,2020-10-01,(05000) Portal Américas - alimentacion,12437,6440,8013,26890
23633,2020-02-19,(06107) Ciudad Universitaria,1568,987,895,3450
23634,2020-01-23,(08000) Portal Tunal - alimentacion,22574,11919,11129,45622
23635,2020-03-04,(07010) Bosa,2145,1187,1420,4752
23636,2020-03-09,(07000) Portal Sur - alimentacion,969,7861,4633,13463
23637,2020-03-17,(14004) Museo del Oro,1690,1123,1002,3815
23638,2020-09-08,(07112) COMUNEROS,908,508,591,2007
23639,2020-09-02,(10000) Portal 20 de Julio - alimentacion,4426,1948,2729,9103
23640,2020-10-10,(10000) Portal 20 de Julio - alimentacion,3785,1496,3095,8376
23641,2020-01-21,(09004) Santa Lucía,5899,2691,2966,11556
23642,2020-02-20,(10001) Country Sur,5141,2272,2540,9953
23643,2020-07-28,(10001) Country Sur,1177,526,691,2394
23644,2020-05-18,(06000) Portal Eldorado - alimentacion,3365,1737,1629,6731
23645,2020-01-11,(05100) Banderas P. Central - alimentacion,6635,2984,4209,13828
23646,2020-02-03,(02502) Terminal,5284,3443,2899,11626
23647,2020-02-22,(07005) ALQUERIA,1661,904,1050,3615
23648,2020-02-25,(02105) Calle 142,7189,4622,3794,15605
23649,2020-02-26,(02205) Calle 106,2743,1739,1342,5824
23650,2020-03-07,(10005) Bicentenario - alimentacion,405,231,525,1161
23651,2020-09-29,(10005) Bicentenario - alimentacion,214,120,198,532
23652,2020-07-10,(07001) PERDOMO,949,530,598,2077
23653,2020-09-15,(40003) Mirador del Paraiso,1639,992,1180,3811
23654,2020-09-24,(40003) Mirador del Paraiso,1785,1048,1210,4043
23655,2020-02-29,(09109) Tercer Milenio,834,480,724,2038
23656,2020-02-13,(04000) Cabecera Calle 80 - intermunicipal,2465,1742,2192,6399
23657,2020-01-18,(07505) LEON XIII,5606,2700,3020,11326
23658,2020-07-30,(07505) LEON XIII,2706,1456,1108,5270
23659,2020-04-26,(07504) TERREROS,886,575,417,1878
23660,2020-01-02,(02101) Toberín,4997,3078,3236,11311
23661,2020-02-04,(04104) Avenida 68,3857,2039,1836,7732
23662,2020-02-28,(06002) Normandía,2576,1410,1434,5420
23663,2020-03-10,(07110) PALOQUEMAO,1238,178,319,1735
23664,2020-02-19,(07111) NQS - RICAURTE,3244,2092,1814,7150
23665,2020-10-09,(10000) Portal 20 de Julio - alimentacion,4637,1990,3528,10155
23666,2020-01-04,(09101) Quiroga,699,333,639,1671
23667,2020-05-30,(09101) Quiroga,315,164,268,747
23668,2020-02-08,(07102) NQS - CALLE 75,761,582,770,2113
23669,2020-01-24,(09119) Calle 57,3008,1895,1999,6902
23670,2020-09-10,(09103) Olaya,1026,551,621,2198
23671,2020-01-20,(14001) La Sabana,330,270,343,943
23672,2020-04-30,(14001) La Sabana,91,66,55,212
23673,2020-06-02,(14001) La Sabana,152,101,90,343
23674,2020-08-13,(14001) La Sabana,163,101,89,353
23675,2020-06-14,(07002) MADELENA,182,81,150,413
23676,2020-02-27,(07112) COMUNEROS,3932,2296,2167,8395
23677,2020-01-11,(02000) Cabecera Autopista Norte,3594,1829,2922,8345
23678,2020-01-03,(03003) 21 ANGELES,789,351,468,1608
23679,2020-03-03,(10007) Las Nieves,2088,1227,1182,4497
23680,2020-04-16,(04105) Carrera 53,149,93,79,321
23681,2020-03-15,(10002) Av. Primero de Mayo,1283,644,1357,3284
23682,2020-06-05,(10002) Av. Primero de Mayo,2008,1002,1171,4181
23683,2020-03-19,(07109) CAD,1470,990,728,3188
23684,2020-03-12,(50003) Corral Molinos,74,736,767,1577
23685,2020-06-08,(09001) Molinos,2338,1320,1589,5247
23686,2020-01-30,(07506) DESPENSA,1666,922,984,3572
23687,2020-07-08,(04100) Carrera 77,1345,777,917,3039
23688,2020-02-27,(03000) Portal Suba,9806,5630,5074,20510
23689,2020-02-06,(06000) Portal Eldorado,6469,4103,2940,13512
23690,2020-03-16,(04001) Quirigua,1264,857,848,2969
23691,2020-10-03,(08000) Portal Tunal - alimentacion,5740,2750,4471,12961
23692,2020-01-31,(12001) Carrera 43,1619,900,1071,3590
23693,2020-03-18,(12001) Carrera 43,1032,602,573,2207
23694,2020-01-17,(10002) Av. Primero de Mayo,7263,3418,4409,15090
23695,2020-01-23,(09107) Hortúa,2203,1330,1409,4942
23696,2020-01-25,(10006) San Victorino,1023,755,984,2762
23697,2020-02-05,(06101) El Tiempo,3074,1667,1422,6163
23698,2020-05-25,(03000) Portal Suba - alimentacion,1762,1019,977,3758
23699,2020-08-27,(10000) Portal 20 de Julio - alimentacion,4009,1833,2360,8202
23700,2020-07-02,(10000) Portal 20 de Julio,2394,1209,1198,4801
23701,2020-06-16,(02303) Calle 85,734,530,365,1629
23702,2020-01-03,(09116) Avenida 39,922,701,744,2367
23703,2020-07-25,(09116) Avenida 39,166,111,135,412
23704,2020-08-13,(07004) VENECIA,937,560,529,2026
23705,2020-03-02,(02104) Calle 146,9254,5919,5012,20185
23706,2020-01-08,(07108) Av. El Dorado,564,379,439,1382
23707,2020-01-02,(02502) Terminal,1685,1150,1311,4146
23708,2020-01-31,(04003) Avenida Ciudad de Cali,5326,2964,3540,11830
23709,2020-04-13,(08001) Parque el Tunal,230,127,125,482
23710,2020-06-19,(08001) Parque el Tunal,503,284,308,1095
23711,2020-07-07,(08001) Parque el Tunal,536,305,303,1144
23712,2020-01-27,(05102) Av. Américas - Av. Boyacá,1709,1042,875,3626
23713,2020-02-10,(05102) Av. Américas - Av. Boyacá,1995,1208,974,4177
23714,2020-08-05,(06108) Concejo de Bogotá,132,69,82,283
23715,2020-01-23,(02300) Calle 100,6819,4314,3635,14768
23716,2020-08-29,(02201) Prado,709,464,471,1644
23717,2020-09-15,(02000) Cabecera Autopista Norte - alimentacion,4892,2592,3184,10668
23718,2020-01-11,(04003) Avenida Ciudad de Cali,2408,1195,1953,5556
23719,2020-03-23,(40003) Mirador del Paraiso,338,172,215,725
23720,2020-05-28,(09123) Calle 76,841,593,486,1920
23721,2020-07-15,(09123) Calle 76,866,603,482,1951
23722,2020-03-23,(05002) Tintal,432,265,268,965
23723,2020-03-23,(05105) Pradera,113,73,66,252
23724,2020-09-28,(10000) Portal 20 de Julio,2491,1173,1558,5222
23725,2020-01-28,(02300) Calle 100,7250,4512,3785,15547
23726,2020-09-13,(02300) Calle 100,237,214,335,786
23727,2020-02-07,(07006) General Santander,2972,1675,1618,6265
23728,2020-02-17,(05105) Pradera,2694,1637,1169,5500
23729,2020-03-17,(02101) Toberín,7074,4473,3621,15168
23730,2020-01-25,(08000) Portal Tunal,1318,773,802,2893
23731,2020-05-18,(04000) Cabecera Calle 80,847,544,563,1954
23732,2020-05-22,(09001) Molinos,2061,1191,1385,4637
23733,2020-04-06,(05005) Transversal 86,174,90,91,355
23734,2020-10-01,(05105) Pradera,652,422,353,1427
23735,2020-06-27,(08000) Portal Tunal,651,288,314,1253
23736,2020-06-17,(03009) Av. Suba- Calle 116,519,355,230,1104
23737,2020-07-02,(03009) Av. Suba- Calle 116,525,324,266,1115
23738,2020-09-05,(02205) Calle 106,197,174,273,644
23739,2020-03-02,(03006) NIZA - CALLE 127,2390,1541,1411,5342
23740,2020-08-19,(04003) Avenida Ciudad de Cali,871,482,640,1993
23741,2020-06-10,(06000) Portal Eldorado - alimentacion,3814,1863,1829,7506
23742,2020-01-22,(07103) AV. CHILE,3501,2119,1798,7418
23743,2020-02-09,(07113) SANTA ISABEL,460,251,534,1245
23744,2020-03-17,(03007) HUMEDAL CORDOBA,442,301,253,996
23745,2020-10-07,(03007) HUMEDAL CORDOBA,166,118,142,426
23746,2020-08-19,(05101) Mandalay - Cr.73,102,64,71,237
23747,2020-06-18,(05103) Marsella,433,237,251,921
23748,2020-04-07,(07000) Portal Sur,841,489,511,1841
23749,2020-01-23,(04102) Avenida Boyaca,2751,1636,1539,5926
23750,2020-05-11,(05103) Marsella,211,109,139,459
23751,2020-10-02,(05001) Patio Bonito,2454,1174,1537,5165
23752,2020-07-27,(07002) MADELENA,738,448,444,1630
23753,2020-02-08,(07109) CAD,1327,915,1126,3368
23754,2020-09-18,(09117) Calle 45,747,482,558,1787
23755,2020-04-03,(02202) Calle 127,642,467,351,1460
23756,2020-03-05,(09107) Hortúa,2396,1476,1491,5363
23757,2020-06-22,(02304) Heroes,231,199,169,599
23758,2020-01-03,(07004) VENECIA,2339,1291,1520,5150
23759,2020-05-13,(07113) SANTA ISABEL,304,210,189,703
23760,2020-06-29,(09118) Marly,525,346,326,1197
23761,2020-08-05,(09120) Calle 63,1007,672,617,2296
23762,2020-06-29,(06100) Av. Rojas,48,37,55,140
23763,2020-08-31,(06100) Av. Rojas,243,149,160,552
23764,2020-03-16,(12007) Zona Industrial,1029,645,478,2152
23765,2020-05-21,(02302) Virrey,513,351,256,1120
23766,2020-05-23,(05100) Banderas P. Central,361,200,252,813
23767,2020-07-18,(05002) Tintal,1683,845,990,3518
23768,2020-04-01,(09109) Tercer Milenio,130,86,102,318
23769,2020-07-25,(09109) Tercer Milenio,182,111,156,449
23770,2020-06-12,(03006) NIZA - CALLE 127,468,264,244,976
23771,2020-06-20,(05107) Américas - Cr.53,337,197,238,772
23772,2020-03-22,(09000) Cabecera Usme - alimentacion,1649,822,871,3342
23773,2020-01-31,(07105) MOVISTAR ARENA,1298,775,745,2818
23774,2020-07-23,(10005) Bicentenario,90,51,64,205
23775,2020-02-17,(07111) NQS - RICAURTE,3180,2066,1791,7037
23776,2020-05-26,(09117) Calle 45,675,402,382,1459
23777,2020-03-13,(05107) Américas - Cr.53,535,231,328,1094
23778,2020-03-19,(02001) Centro Comercial Santa Fe,1537,914,977,3428
23779,2020-04-26,(05100) Banderas P. Central - alimentacion,516,287,237,1040
23780,2020-09-22,(04103) Las Ferias,380,194,211,785
23781,2020-07-31,(07004) VENECIA,897,555,462,1914
23782,2020-02-14,(40001) Juan Pablo II,1703,953,1055,3711
23783,2020-10-11,(10008) San Diego,72,58,112,242
23784,2020-06-12,(09120) Calle 63,1096,780,638,2514
23785,2020-10-08,(09120) Calle 63,1250,874,1099,3223
23786,2020-09-06,(04107) Escuela Militar,29,32,65,126
23787,2020-06-11,(05105) Pradera,529,332,234,1095
23788,2020-05-19,(09004) Santa Lucía,2055,1057,1095,4207
23789,2020-07-26,(05002) Tintal,464,249,273,986
23790,2020-02-02,(12001) Carrera 43,173,134,374,681
23791,2020-04-14,(02204) Pepe Sierra,415,331,258,1004
23792,2020-02-04,(09121) Las Flores,3398,2093,2050,7541
23793,2020-01-12,(03007) HUMEDAL CORDOBA,132,82,135,349
23794,2020-06-28,(09111) Calle 19,216,142,201,559
23795,2020-07-07,(02105) Calle 142,804,504,534,1842
23796,2020-01-18,(14005) Las Aguas,739,513,955,2207
23797,2020-10-05,(09107) Hortúa,633,381,563,1577
23798,2020-07-24,(09122) Calle 72,937,626,645,2208
23799,2020-09-21,(09122) Calle 72,1118,751,822,2691
23800,2020-09-23,(03002) SUBA - TV- 91,984,569,660,2213
23801,2020-04-07,(02303) Calle 85,316,231,202,749
23802,2020-10-01,(50003) Corral Molinos,1623,853,1454,3930
23803,2020-05-03,(40003) Mirador del Paraiso,369,234,248,851
23804,2020-05-27,(07201) Guatoque -Veraguas,164,94,106,364
23805,2020-08-27,(10007) Las Nieves,670,411,311,1392
23806,2020-09-03,(10007) Las Nieves,708,467,396,1571
23807,2020-05-23,(02104) Calle 146,457,282,282,1021
23808,2020-10-08,(03005) SUBA - AV. BOYACA,564,330,426,1320
23809,2020-07-19,(04104) Avenida 68,183,95,103,381
23810,2020-07-29,(40001) Juan Pablo II,514,290,310,1114
23811,2020-07-30,(12000) Puente Aranda,77,50,32,159
23812,2020-08-21,(12000) Puente Aranda,81,48,37,166
23813,2020-05-17,(08001) Parque el Tunal,99,66,62,227
23814,2020-06-03,(08001) Parque el Tunal,449,243,236,928
23815,2020-07-05,(05102) Av. Américas - Av. Boyacá,79,34,54,167
23816,2020-03-15,(14001) La Sabana,73,70,105,248
23817,2020-09-14,(12004) Carrera 22,248,148,139,535
23818,2020-05-22,(06001) Modelia,362,255,165,782
23819,2020-08-05,(06001) Modelia,286,189,179,654
23820,2020-04-30,(10004) Policarpa,156,78,107,341
23821,2020-10-10,(07200) Tygua-San José,197,111,204,512
23822,2020-04-22,(09120) Calle 63,593,437,349,1379
23823,2020-08-13,(09120) Calle 63,1044,681,721,2446
23824,2020-08-08,(40001) Juan Pablo II,410,202,288,900
23825,2020-07-30,(07008) NQS - Calle 30 Sur,264,120,171,555
23826,2020-03-25,(09113) Calle 22,164,101,126,391
23827,2020-07-20,(09114) Calle 26,51,45,60,156
23828,2020-01-01,(07008) NQS - Calle 30 Sur,133,65,203,401
23829,2020-08-18,(03002) SUBA - TV- 91,685,426,453,1564
23830,2020-07-15,(04001) Quirigua,349,225,177,751
23831,2020-08-22,(04001) Quirigua,272,139,217,628
23832,2020-06-05,(04000) Cabecera Calle 80 - intermunicipal,265,153,259,677
23833,2020-03-01,(40002) Manitas,310,126,278,714
23834,2020-07-29,(09108) Hospital,64,37,55,156
23835,2020-07-13,(07010) Bosa,654,314,357,1325
23836,2020-06-29,(10005) Bicentenario - alimentacion,69,40,77,186
23837,2020-03-27,(09122) Calle 72,569,407,358,1334
23838,2020-04-30,(07009) SENA,352,216,201,769
23839,2020-03-21,(04100) Carrera 77,323,197,182,702
23840,2020-02-08,(04106) Carrera 47,896,474,704,2074
23841,2020-07-21,(09113) Calle 22,308,200,257,765
23842,2020-03-15,(04101) Minuto de Dios,325,210,403,938
23843,2020-07-04,(03005) SUBA - AV. BOYACA,358,202,261,821
23844,2020-04-23,(07006) General Santander - alimentacion,196,122,119,437
23845,2020-06-07,(07006) General Santander - alimentacion,67,47,77,191
23846,2020-05-16,(07107) U. NACIONAL,160,105,91,356
23847,2020-07-20,(04104) Avenida 68,202,91,128,421
23848,2020-04-22,(10004) Policarpa,129,80,85,294
23849,2020-04-27,(10004) Policarpa,65,20,17,102
23850,2020-01-19,(09106) Nariño,399,206,505,1110
23851,2020-05-29,(06101) El Tiempo,300,199,166,665
23852,2020-09-13,(03013) RIO NEGRO,78,53,98,229
23853,2020-09-15,(05103) Marsella,466,237,325,1028
23854,2020-05-11,(02000) Cabecera Autopista Norte - intermunicipal,337,274,217,828
23855,2020-02-05,(03014) SAN MARTIN,260,166,157,583
23856,2020-08-30,(06103) CAN,119,87,83,289
23857,2020-06-13,(09106) Nariño,315,184,237,736
23858,2020-05-30,(14005) Las Aguas,0,57,144,201
23859,2020-04-01,(10008) San Diego,140,110,109,359
23860,2020-04-27,(06100) Av. Rojas,34,36,25,95
23861,2020-03-29,(09119) Calle 57,83,66,75,224
23862,2020-06-14,(09110) Avenida Jimenez,208,197,284,689
23863,2020-10-09,(07101) CASTELLANA,273,158,185,616
23864,2020-08-02,(02000) Cabecera Autopista Norte - intermunicipal,88,66,82,236
23865,2020-05-07,(04107) Escuela Militar,76,63,59,198
23866,2020-03-29,(09110) Avenida Jimenez,90,85,92,267
23867,2020-06-22,(06105) Quinta Paredes,43,29,34,106
23868,2020-04-30,(06106) Recinto Ferial,177,114,96,387
23869,2020-05-12,(06106) Recinto Ferial,179,129,102,410
23870,2020-03-22,(03013) RIO NEGRO,48,35,27,110
23871,2020-04-29,(06107) Ciudad Universitaria,119,68,82,269
23872,2020-05-08,(07200) Tygua-San José,144,76,100,320
23873,2020-08-08,(07201) Guatoque -Veraguas,130,74,113,317
23874,2020-08-03,(06100) Av. Rojas,186,110,137,433
23875,2020-06-27,(05101) Mandalay - Cr.73,106,35,42,183
23876,2020-06-22,(12007) Zona Industrial,69,69,49,187
23877,2020-08-23,(07200) Tygua-San José,65,36,72,173
23878,2020-04-12,(09110) Avenida Jimenez,110,99,112,321
23879,2020-06-25,(50006) Corral Carrera 77,5,3,7,15
23880,2020-06-13,(50002) Corral Calle 40 Sur,12,4,13,29
23881,2020-07-26,(50002) Corral Calle 40 Sur,3,5,9,17
23882,2020-09-08,(07005) ALQUERIA,552,331,377,1260
23883,2020-01-15,(02502) Terminal,4161,2673,2612,9446
23884,2020-08-03,(09118) Marly,1363,891,682,2936
23885,2020-05-18,(10000) Portal 20 de Julio - alimentacion,3289,1570,2111,6970
23886,2020-02-05,(03000) Portal Suba - alimentacion,29092,17408,17199,63699
23887,2020-01-17,(02303) Calle 85,3205,2221,1873,7299
23888,2020-02-04,(02101) Toberín,15497,9758,7961,33216
23889,2020-02-26,(02101) Toberín,15092,9098,7824,32014
23890,2020-02-14,(09122) Calle 72,8265,5436,4350,18051
23891,2020-01-23,(09003) Socorro,1550,855,996,3401
23892,2020-06-13,(09003) Socorro,506,228,278,1012
23893,2020-02-17,(09001) Molinos,7644,4806,5907,18357
23894,2020-01-04,(07503) SAN MATEO,16796,8260,8658,33714
23895,2020-06-02,(07503) SAN MATEO,9695,5925,4642,20262
23896,2020-09-04,(09001) Molinos,2906,1488,2032,6426
23897,2020-01-03,(09118) Marly,2593,1794,2048,6435
23898,2020-02-18,(02201) Prado,6179,3956,3055,13190
23899,2020-01-17,(14004) Museo del Oro,2503,1693,1611,5807
23900,2020-01-06,(08000) Portal Tunal - alimentacion,4855,2056,3281,10192
23901,2020-01-26,(09000) Cabecera Usme - alimentacion,5989,2619,4745,13353
23902,2020-02-18,(07002) MADELENA,5311,3092,2600,11003
23903,2020-09-25,(09104) Restrepo,1897,988,1539,4424
23904,2020-08-10,(05100) Banderas P. Central,764,451,509,1724
23905,2020-05-01,(06000) Portal Eldorado - alimentacion,1342,620,566,2528
23906,2020-01-18,(05100) Banderas P. Central - alimentacion,7716,3437,5009,16162
23907,2020-03-11,(09113) Calle 22,1459,846,972,3277
23908,2020-02-24,(10002) Av. Primero de Mayo,8424,4430,4675,17529
23909,2020-06-13,(08000) Portal Tunal - alimentacion,5100,2637,2819,10556
23910,2020-02-22,(10005) Bicentenario - alimentacion,442,224,465,1131
23911,2020-02-23,(10005) Bicentenario - alimentacion,160,83,240,483
23912,2020-02-05,(07001) PERDOMO,4672,2848,2608,10128
23913,2020-05-04,(40003) Mirador del Paraiso,1091,667,692,2450
23914,2020-06-14,(07504) TERREROS,1382,699,915,2996
23915,2020-03-06,(06002) Normandía,2580,1434,1338,5352
23916,2020-02-26,(07111) NQS - RICAURTE,3217,2113,1683,7013
23917,2020-01-13,(09004) Santa Lucía,6155,3399,3946,13500
23918,2020-05-30,(05000) Portal Américas,1718,1062,1216,3996
23919,2020-03-03,(04100) Carrera 77,7005,4073,4214,15292
23920,2020-02-01,(07102) NQS - CALLE 75,799,613,765,2177
23921,2020-09-04,(07102) NQS - CALLE 75,473,332,313,1118
23922,2020-02-06,(09103) Olaya,4296,2596,2483,9375
23923,2020-08-25,(06000) Portal Eldorado - alimentacion,3597,1813,1858,7268
23924,2020-09-03,(06000) Portal Eldorado - alimentacion,4097,2071,2352,8520
23925,2020-01-24,(03007) HUMEDAL CORDOBA,984,553,519,2056
23926,2020-03-24,(10000) Portal 20 de Julio - alimentacion,3798,1456,2347,7601
23927,2020-07-14,(07000) Portal Sur - alimentacion,7033,4039,3185,14257
23928,2020-03-27,(09103) Olaya,437,282,268,987
23929,2020-06-18,(07002) MADELENA,832,476,509,1817
23930,2020-08-13,(07002) MADELENA,738,434,509,1681
23931,2020-09-28,(07002) MADELENA,1008,605,714,2327
23932,2020-06-26,(05000) Portal Américas,2781,1906,2219,6906
23933,2020-02-13,(04000) Cabecera Calle 80,7809,4596,5138,17543
23934,2020-05-11,(04000) Cabecera Calle 80,785,507,511,1803
23935,2020-05-08,(08000) Portal Tunal - alimentacion,4297,2315,2293,8905
23936,2020-01-14,(10001) Country Sur,4390,1924,2503,8817
23937,2020-05-06,(09000) Cabecera Usme - alimentacion,5010,2833,2988,10831
23938,2020-10-03,(10006) San Victorino,585,341,455,1381
23939,2019-12-31,(03000) Portal Suba,67,46,91,204
23940,2020-06-06,(40003) Mirador del Paraiso,1431,801,923,3155
23941,2020-10-01,(02101) Toberín,1860,1148,1460,4468
23942,2020-06-09,(04000) Cabecera Calle 80 - alimentacion,3654,2102,2223,7979
23943,2020-03-06,(09004) Santa Lucía,7598,4069,4243,15910
23944,2020-03-01,(08000) Portal Tunal - alimentacion,5693,2528,4092,12313
23945,2020-02-08,(12001) Carrera 43,844,506,816,2166
23946,2020-07-09,(07505) LEON XIII,2868,1526,1214,5608
23947,2020-07-31,(10002) Av. Primero de Mayo,2035,978,1212,4225
23948,2020-02-23,(04104) Avenida 68,622,341,578,1541
23949,2020-08-22,(03000) Portal Suba,859,480,621,1960
23950,2020-02-12,(02000) Cabecera Autopista Norte - intermunicipal,5390,3734,3150,12274
23951,2020-03-17,(10000) Portal 20 de Julio,5956,2638,2581,11175
23952,2020-05-25,(07010) Bosa,203,104,113,420
23953,2020-06-15,(07000) Portal Sur - alimentacion,2769,1321,1366,5456
23954,2020-06-17,(09004) Santa Lucía,2671,1449,1345,5465
23955,2020-09-06,(09004) Santa Lucía,998,395,782,2175
23956,2020-05-27,(10007) Las Nieves,515,299,311,1125
23957,2020-01-12,(07505) LEON XIII,1976,863,1315,4154
23958,2020-02-17,(06103) CAN,2809,1624,1159,5592
23959,2020-05-16,(07503) SAN MATEO,5500,3361,2650,11511
23960,2020-01-15,(03003) 21 ANGELES,1486,697,805,2988
23961,2020-08-05,(05001) Patio Bonito,1594,856,946,3396
23962,2020-05-15,(14004) Museo del Oro,0,77,142,219
23963,2020-01-24,(03001) LA CAMPIÑA,6204,3347,3830,13381
23964,2020-06-19,(03001) LA CAMPIÑA,1157,622,735,2514
23965,2020-01-20,(03005) SUBA - AV. BOYACA,2561,1536,1479,5576
23966,2020-08-30,(09107) Hortúa,193,124,185,502
23967,2020-08-03,(09123) Calle 76,904,636,480,2020
23968,2020-05-08,(40003) Mirador del Paraiso,1102,731,700,2533
23969,2020-01-12,(05105) Pradera,450,327,444,1221
23970,2020-01-20,(05105) Pradera,2219,1362,1102,4683
23971,2020-03-15,(05103) Marsella,307,157,334,798
23972,2020-07-01,(03012) SUBA - CALLE 95,361,222,231,814
23973,2020-10-05,(03012) SUBA - CALLE 95,383,220,314,917
23974,2020-08-12,(50002) Corral Calle 40 Sur,19,11,24,54
23975,2020-10-06,(50002) Corral Calle 40 Sur,29,18,30,77
23976,2020-07-24,(02000) Cabecera Autopista Norte - alimentacion,4130,2281,2162,8573
23977,2020-03-04,(07006) General Santander,2898,1618,1616,6132
23978,2020-09-01,(05001) Patio Bonito,1919,1023,1085,4027
23979,2020-05-12,(08000) Portal Tunal,604,257,202,1063
23980,2020-07-03,(07007) NQS - Calle 38A Sur,420,242,271,933
23981,2020-03-04,(03009) Av. Suba- Calle 116,2714,1602,1361,5677
23982,2020-08-15,(02205) Calle 106,0,161,373,534
23983,2020-08-25,(02205) Calle 106,328,222,204,754
23984,2020-09-04,(02205) Calle 106,427,296,276,999
23985,2020-09-11,(09101) Quiroga,556,289,412,1257
23986,2020-08-29,(07201) Guatoque -Veraguas,137,93,117,347
23987,2020-10-06,(05001) Patio Bonito,2317,1181,1485,4983
23988,2020-02-29,(06000) Portal Eldorado,2633,1936,2531,7100
23989,2020-07-28,(03001) LA CAMPIÑA,1059,632,574,2265
23990,2020-03-22,(09116) Avenida 39,79,71,45,195
23991,2020-04-05,(09004) Santa Lucía,391,198,216,805
23992,2020-02-11,(09121) Las Flores,3514,2223,2080,7817
23993,2020-06-08,(02101) Toberín,1394,877,872,3143
23994,2020-04-13,(09100) Calle 40 Sur,882,500,521,1903
23995,2020-08-22,(07104) Simon Bolivar,470,309,256,1035
23996,2020-08-15,(10005) Bicentenario - alimentacion,163,87,185,435
23997,2020-02-23,(03006) NIZA - CALLE 127,505,315,416,1236
23998,2020-07-12,(09121) Las Flores,199,146,221,566
23999,2020-03-14,(04105) Carrera 53,729,395,509,1633
24000,2020-08-08,(04104) Avenida 68,330,159,260,749
24001,2020-09-12,(03002) SUBA - TV- 91,672,320,497,1489
24002,2020-01-23,(14004) Museo del Oro,3085,2012,1732,6829
24003,2020-05-06,(02202) Calle 127,807,553,432,1792
24004,2020-02-19,(04001) Quirigua,2137,1337,1180,4654
24005,2020-05-01,(09001) Molinos,724,417,468,1609
24006,2020-05-10,(02205) Calle 106,52,49,60,161
24007,2020-05-11,(05001) Patio Bonito,1184,631,695,2510
24008,2020-04-06,(03001) LA CAMPIÑA,516,305,294,1115
24009,2020-01-12,(04003) Avenida Ciudad de Cali,867,444,999,2310
24010,2020-10-05,(40001) Juan Pablo II,604,367,447,1418
24011,2020-03-08,(06106) Recinto Ferial,297,159,309,765
24012,2020-03-29,(02001) Centro Comercial Santa Fe,37,40,52,129
24013,2020-03-31,(09120) Calle 63,522,373,297,1192
24014,2020-06-24,(09117) Calle 45,765,453,453,1671
24015,2020-09-05,(03010) PUENTE LARGO,253,163,225,641
24016,2020-08-18,(04106) Carrera 47,319,149,164,632
24017,2020-08-03,(09109) Tercer Milenio,346,192,254,792
24018,2020-02-24,(10005) Bicentenario,811,419,361,1591
24019,2020-06-23,(07007) NQS - Calle 38A Sur,442,239,280,961
24020,2020-03-08,(07505) LEON XIII,2007,862,1382,4251
24021,2020-06-18,(04003) Avenida Ciudad de Cali,1007,611,700,2318
24022,2020-03-14,(12007) Zona Industrial,657,475,452,1584
24023,2020-08-31,(03010) PUENTE LARGO,372,221,199,792
24024,2020-03-25,(40002) Manitas,158,81,111,350
24025,2020-04-07,(05002) Tintal,1049,626,655,2330
24026,2020-03-17,(12002) CDS - Carrera 32,440,296,232,968
24027,2020-06-17,(09106) Nariño,404,235,275,914
24028,2020-06-22,(04000) Cabecera Calle 80,329,213,297,839
24029,2020-02-09,(04101) Minuto de Dios,430,227,576,1233
24030,2020-03-20,(09101) Quiroga,158,110,106,374
24031,2020-01-09,(09002) Consuelo,1094,551,727,2372
24032,2020-10-04,(03001) LA CAMPIÑA,346,163,436,945
24033,2020-08-15,(08002) Biblioteca,227,128,152,507
24034,2020-01-19,(02205) Calle 106,204,211,401,816
24035,2020-03-14,(06105) Quinta Paredes,351,205,327,883
24036,2020-03-30,(09115) Calle 34,309,247,202,758
24037,2020-05-21,(03006) NIZA - CALLE 127,327,224,186,737
24038,2020-01-27,(03004) GRATAMIRA,279,165,163,607
24039,2020-03-09,(12004) Carrera 22,319,53,79,451
24040,2020-04-02,(06109) Centro Memoria,148,129,121,398
24041,2020-04-14,(03002) SUBA - TV- 91,460,254,209,923
24042,2020-10-12,(07111) NQS - RICAURTE,231,183,217,631
24043,2020-05-18,(06104) Gobernación,262,151,105,518
24044,2020-04-11,(10001) Country Sur,368,157,206,731
24045,2020-05-14,(02302) Virrey,486,349,223,1058
24046,2020-03-21,(04000) Cabecera Calle 80 - alimentacion,1038,573,553,2164
24047,2020-05-17,(07105) MOVISTAR ARENA,46,35,39,120
24048,2020-08-03,(07105) MOVISTAR ARENA,198,121,116,435
24049,2020-08-12,(07105) MOVISTAR ARENA,203,119,112,434
24050,2020-09-11,(07105) MOVISTAR ARENA,236,124,136,496
24051,2020-02-23,(07506) DESPENSA,293,172,326,791
24052,2020-08-26,(10002) Av. Primero de Mayo,1967,1012,1346,4325
24053,2020-07-27,(02200) Alcalá,1661,1164,908,3733
24054,2020-05-23,(02303) Calle 85,339,281,245,865
24055,2020-07-14,(03003) 21 ANGELES,300,153,171,624
24056,2020-07-11,(14004) Museo del Oro,150,124,187,461
24057,2020-05-29,(07004) VENECIA,878,519,478,1875
24058,2020-05-23,(04001) Quirigua,230,130,139,499
24059,2020-06-08,(06107) Ciudad Universitaria,185,101,104,390
24060,2020-08-10,(06107) Ciudad Universitaria,161,97,94,352
24061,2020-01-12,(02000) Cabecera Autopista Norte - intermunicipal,591,350,669,1610
24062,2020-09-26,(03005) SUBA - AV. BOYACA,378,217,337,932
24063,2020-07-15,(05102) Av. Américas - Av. Boyacá,192,104,121,417
24064,2020-04-01,(07109) CAD,378,285,188,851
24065,2020-08-08,(07109) CAD,292,210,246,748
24066,2020-07-24,(12004) Carrera 22,146,86,98,330
24067,2020-04-01,(09115) Calle 34,331,247,239,817
24068,2020-06-18,(09111) Calle 19,774,483,498,1755
24069,2020-07-13,(09111) Calle 19,374,248,300,922
24070,2020-09-26,(04106) Carrera 47,290,134,216,640
24071,2020-04-18,(09118) Marly,768,548,382,1698
24072,2020-09-06,(08001) Parque el Tunal,158,70,152,380
24073,2020-06-27,(04001) Quirigua,353,189,247,789
24074,2020-03-07,(07200) Tygua-San José,435,265,496,1196
24075,2020-05-26,(07200) Tygua-San José,227,112,136,475
24076,2020-09-06,(09000) Cabecera Usme,520,270,560,1350
24077,2020-08-06,(40001) Juan Pablo II,530,307,325,1162
24078,2020-01-05,(02103) Mazurén,210,89,296,595
24079,2020-04-19,(14001) La Sabana,32,24,24,80
24080,2020-07-14,(07001) PERDOMO,707,436,413,1556
24081,2020-04-05,(02001) Centro Comercial Santa Fe,45,40,58,143
24082,2020-06-26,(09113) Calle 22,452,260,351,1063
24083,2020-03-25,(07108) Av. El Dorado,60,54,44,158
24084,2020-02-09,(05107) Américas - Cr.53,417,282,493,1192
24085,2020-08-05,(04001) Quirigua,279,189,184,652
24086,2020-09-29,(03010) PUENTE LARGO,402,248,274,924
24087,2020-06-16,(06001) Modelia,375,250,178,803
24088,2020-09-20,(09108) Hospital,32,27,31,90
24089,2020-03-29,(06000) Portal Eldorado,167,132,96,395
24090,2020-09-18,(07006) General Santander - alimentacion,425,237,361,1023
24091,2020-04-25,(02502) Terminal,109,74,91,274
24092,2020-01-25,(12002) CDS - Carrera 32,259,198,254,711
24093,2020-04-14,(07101) CASTELLANA,84,70,84,238
24094,2020-03-26,(07108) Av. El Dorado,58,54,49,161
24095,2020-10-08,(06100) Av. Rojas,297,188,244,729
24096,2020-04-10,(09116) Avenida 39,76,65,54,195
24097,2020-10-11,(05005) Transversal 86,157,55,174,386
24098,2020-04-15,(09121) Las Flores,404,303,245,952
24099,2020-05-19,(09121) Las Flores,573,393,322,1288
24100,2020-07-10,(04106) Carrera 47,359,182,192,733
24101,2020-03-22,(05107) Américas - Cr.53,91,93,77,261
24102,2020-04-16,(12001) Carrera 43,254,171,118,543
24103,2020-05-27,(09106) Nariño,352,217,210,779
24104,2020-06-22,(40001) Juan Pablo II,188,99,132,419
24105,2020-05-07,(07506) DESPENSA,304,179,168,651
24106,2020-06-06,(02000) Cabecera Autopista Norte - intermunicipal,278,175,210,663
24107,2020-05-18,(07006) General Santander - alimentacion,302,160,165,627
24108,2020-06-28,(04104) Avenida 68,227,119,140,486
24109,2020-04-15,(06102) Salitre El Greco,148,88,80,316
24110,2020-08-24,(10004) Policarpa,194,83,134,411
24111,2020-06-30,(04001) Quirigua,465,274,251,990
24112,2020-06-02,(12007) Zona Industrial,312,210,137,659
24113,2020-08-24,(10003) Ciudad Jardín,185,74,118,377
24114,2020-09-30,(07201) Guatoque -Veraguas,234,141,156,531
24115,2020-09-27,(06102) Salitre El Greco,93,57,90,240
24116,2020-07-19,(04103) Las Ferias,98,48,46,192
24117,2020-06-17,(03002) SUBA - TV- 91,748,470,430,1648
24118,2020-04-01,(07200) Tygua-San José,63,49,65,177
24119,2020-06-03,(10003) Ciudad Jardín,177,101,99,377
24120,2020-10-12,(04106) Carrera 47,136,74,134,344
24121,2020-04-21,(04000) Cabecera Calle 80 - intermunicipal,115,68,106,289
24122,2020-04-23,(04000) Cabecera Calle 80 - intermunicipal,116,77,112,305
24123,2020-08-15,(04103) Las Ferias,260,138,173,571
24124,2020-04-15,(09003) Socorro,289,151,192,632
24125,2020-08-03,(05101) Mandalay - Cr.73,110,60,63,233
24126,2020-09-30,(09105) Río Fucha,0,74,179,253
24127,2020-05-24,(04102) Avenida Boyaca,69,37,66,172
24128,2020-03-15,(07108) Av. El Dorado,120,88,159,367
24129,2020-08-08,(07101) CASTELLANA,95,50,98,243
24130,2020-04-16,(12003) Ricaurte,107,101,78,286
24131,2020-05-22,(14005) Las Aguas,0,56,185,241
24132,2020-05-20,(07506) DESPENSA,392,221,201,814
24133,2020-05-23,(06107) Ciudad Universitaria,115,73,76,264
24134,2020-08-02,(07008) NQS - Calle 30 Sur,85,27,71,183
24135,2020-09-19,(07101) CASTELLANA,143,84,164,391
24136,2020-04-23,(40002) Manitas,177,104,123,404
24137,2020-03-23,(06109) Centro Memoria,57,36,37,130
24138,2020-04-23,(09105) Río Fucha,73,41,49,163
24139,2020-06-28,(07003) SEVILLANA,118,58,102,278
24140,2020-05-27,(12004) Carrera 22,213,102,121,436
24141,2020-08-07,(09108) Hospital,40,26,25,91
24142,2020-09-06,(04101) Minuto de Dios,103,50,147,300
24143,2020-08-09,(08002) Biblioteca,95,50,64,209
24144,2020-04-27,(07200) Tygua-San José,49,39,17,105
24145,2020-03-21,(09110) Avenida Jimenez,132,101,127,360
24146,2020-09-27,(06104) Gobernación,46,45,59,150
24147,2020-07-25,(03014) SAN MARTIN,0,11,28,39
24148,2020-03-26,(04000) Cabecera Calle 80 - alimentacion,1801,1066,966,3833
24149,2020-07-25,(04000) Cabecera Calle 80 - alimentacion,2463,1308,1608,5379
24150,2020-05-16,(07504) TERREROS,2833,1636,1557,6026
24151,2020-03-16,(10000) Portal 20 de Julio - alimentacion,8420,4162,5963,18545
24152,2020-01-14,(02200) Alcalá,11417,7129,6005,24551
24153,2020-01-21,(03010) PUENTE LARGO,1319,799,862,2980
24154,2020-03-07,(10000) Portal 20 de Julio - alimentacion,8403,3680,6430,18513
24155,2020-02-02,(05000) Portal Américas - alimentacion,9603,4113,7306,21022
24156,2020-01-26,(07503) SAN MATEO,9662,4240,6100,20002
24157,2020-05-06,(05000) Portal Américas - alimentacion,7763,3919,3382,15064
24158,2020-07-29,(05001) Patio Bonito,1522,839,871,3232
24159,2020-01-17,(07010) Bosa,2082,1182,1392,4656
24160,2020-09-28,(07000) Portal Sur - alimentacion,9189,4854,5330,19373
24161,2020-02-19,(05005) Transversal 86,2912,1670,1354,5936
24162,2020-01-03,(08000) Portal Tunal - alimentacion,13591,6716,7971,28278
24163,2020-01-12,(05000) Portal Américas - alimentacion,8712,3560,6093,18365
24164,2020-09-17,(10001) Country Sur,1400,604,930,2934
24165,2020-02-29,(07503) SAN MATEO,27523,13228,14801,55552
24166,2020-01-20,(05100) Banderas P. Central - alimentacion,13361,7525,7770,28656
24167,2020-02-20,(07009) SENA,3792,2157,1903,7852
24168,2020-01-20,(07002) MADELENA,4417,2582,2444,9443
24169,2020-06-11,(07000) Portal Sur - alimentacion,7490,4199,3383,15072
24170,2020-09-02,(10005) Bicentenario - alimentacion,245,102,214,561
24171,2020-03-11,(09000) Cabecera Usme - alimentacion,24421,13542,15117,53080
24172,2020-03-27,(09000) Cabecera Usme - alimentacion,4173,1945,2387,8505
24173,2020-04-29,(07001) PERDOMO,549,291,299,1139
24174,2020-05-16,(07001) PERDOMO,485,279,285,1049
24175,2020-06-30,(07001) PERDOMO,870,538,602,2010
24176,2020-08-24,(07001) PERDOMO,826,462,522,1810
24177,2020-06-03,(09109) Tercer Milenio,333,181,215,729
24178,2020-01-27,(04100) Carrera 77,6170,3824,3824,13818
24179,2020-03-25,(07504) TERREROS,2812,1559,1468,5839
24180,2020-01-20,(04104) Avenida 68,3321,1710,1735,6766
24181,2020-02-12,(09117) Calle 45,6874,4360,3070,14304
24182,2020-08-31,(03000) Portal Suba - alimentacion,6243,3573,3817,13633
24183,2020-01-11,(09123) Calle 76,1650,1380,1640,4670
24184,2020-03-01,(09123) Calle 76,538,499,872,1909
24185,2020-05-28,(02000) Cabecera Autopista Norte - alimentacion,4229,2428,2220,8877
24186,2020-10-01,(07000) Portal Sur - alimentacion,9500,4896,5722,20118
24187,2020-01-02,(09000) Cabecera Usme,2855,1718,2459,7032
24188,2020-04-28,(07102) NQS - CALLE 75,222,174,159,555
24189,2020-10-04,(07102) NQS - CALLE 75,98,72,155,325
24190,2020-08-03,(03013) RIO NEGRO,221,121,167,509
24191,2020-06-22,(09118) Marly,521,365,314,1200
24192,2020-10-11,(06000) Portal Eldorado - alimentacion,1594,613,1394,3601
24193,2020-01-22,(03001) LA CAMPIÑA,6134,3530,3847,13511
24194,2020-07-02,(03001) LA CAMPIÑA,1217,632,713,2562
24195,2020-03-17,(09100) Calle 40 Sur,4609,2542,2650,9801
24196,2020-01-10,(02303) Calle 85,2681,1885,1656,6222
24197,2020-06-08,(14001) La Sabana,143,91,97,331
24198,2020-09-29,(02000) Cabecera Autopista Norte - alimentacion,5244,2788,3600,11632
24199,2020-06-10,(07002) MADELENA,773,447,450,1670
24200,2020-01-03,(07106) EL CAMPIN,927,582,639,2148
24201,2020-04-15,(02000) Cabecera Autopista Norte,508,355,357,1220
24202,2020-09-23,(09113) Calle 22,434,249,416,1099
24203,2020-10-03,(04105) Carrera 53,259,142,229,630
24204,2020-09-14,(08000) Portal Tunal - alimentacion,6294,3484,3839,13617
24205,2020-10-02,(07010) Bosa,0,405,1008,1413
24206,2020-09-23,(07506) DESPENSA,466,299,337,1102
24207,2020-02-07,(10001) Country Sur,5304,2197,2879,10380
24208,2020-06-10,(03000) Portal Suba,1220,759,748,2727
24209,2020-03-16,(40003) Mirador del Paraiso,3790,2154,2146,8090
24210,2020-01-29,(09107) Hortúa,2351,1442,1504,5297
24211,2020-02-19,(10005) Bicentenario - alimentacion,713,336,522,1571
24212,2020-03-02,(07106) EL CAMPIN,2064,1329,1161,4554
24213,2020-06-27,(06101) El Tiempo,222,145,214,581
24214,2020-07-23,(03000) Portal Suba,1057,647,649,2353
24215,2020-07-21,(02000) Cabecera Autopista Norte - intermunicipal,516,332,399,1247
24216,2020-06-27,(03000) Portal Suba - alimentacion,5006,2709,3178,10893
24217,2020-05-05,(10000) Portal 20 de Julio - alimentacion,2862,1251,1840,5953
24218,2020-02-25,(06100) Av. Rojas,2881,1592,1268,5741
24219,2020-08-31,(04001) Quirigua,371,237,253,861
24220,2020-01-24,(10000) Portal 20 de Julio,8438,3754,3850,16042
24221,2020-02-03,(09116) Avenida 39,3210,1906,1662,6778
24222,2020-01-15,(02001) Centro Comercial Santa Fe,4005,2409,2474,8888
24223,2020-03-19,(09107) Hortúa,1287,739,767,2793
24224,2020-04-22,(08001) Parque el Tunal,199,127,140,466
24225,2020-07-24,(08001) Parque el Tunal,348,199,217,764
24226,2020-03-11,(09116) Avenida 39,3080,2030,1677,6787
24227,2020-06-21,(09116) Avenida 39,89,63,76,228
24228,2020-09-04,(09116) Avenida 39,417,240,305,962
24229,2020-01-23,(05102) Av. Américas - Av. Boyacá,1566,920,852,3338
24230,2020-02-03,(02202) Calle 127,5963,3847,2913,12723
24231,2020-02-24,(05101) Mandalay - Cr.73,1243,682,548,2473
24232,2020-09-05,(40003) Mirador del Paraiso,1581,854,1151,3586
24233,2020-10-12,(05103) Marsella,158,73,146,377
24234,2020-04-23,(10000) Portal 20 de Julio,1287,686,609,2582
24235,2020-03-03,(02300) Calle 100,7026,4574,3810,15410
24236,2020-07-19,(02300) Calle 100,240,202,177,619
24237,2020-08-02,(02300) Calle 100,250,192,213,655
24238,2020-03-09,(10000) Portal 20 de Julio,304,1921,1245,3470
24239,2020-08-31,(50002) Corral Calle 40 Sur,33,14,31,78
24240,2020-06-01,(09001) Molinos,2244,1307,1565,5116
24241,2020-05-09,(09104) Restrepo,797,478,559,1834
24242,2020-07-01,(09001) Molinos,2598,1452,1842,5892
24243,2020-05-29,(02202) Calle 127,1016,701,497,2214
24244,2020-01-25,(05105) Pradera,1420,937,905,3262
24245,2020-05-21,(05100) Banderas P. Central - alimentacion,2297,1133,1122,4552
24246,2020-09-03,(07113) SANTA ISABEL,416,255,317,988
24247,2020-01-11,(07101) CASTELLANA,303,220,331,854
24248,2020-04-19,(07505) LEON XIII,474,295,190,959
24249,2020-07-30,(07113) SANTA ISABEL,347,227,255,829
24250,2020-10-12,(06111) Universidades,143,92,229,464
24251,2020-08-13,(03007) HUMEDAL CORDOBA,118,76,64,258
24252,2020-08-17,(03007) HUMEDAL CORDOBA,42,29,22,93
24253,2020-09-14,(03007) HUMEDAL CORDOBA,175,103,80,358
24254,2020-06-08,(04104) Avenida 68,590,297,312,1199
24255,2020-08-04,(03001) LA CAMPIÑA,851,508,512,1871
24256,2020-04-09,(09004) Santa Lucía,461,247,222,930
24257,2020-04-12,(09004) Santa Lucía,380,227,209,816
24258,2020-10-01,(08002) Biblioteca,347,179,270,796
24259,2020-07-06,(04000) Cabecera Calle 80,1204,723,933,2860
24260,2020-03-05,(03011) SUBA - CALLE 100,2599,1351,1525,5475
24261,2020-02-06,(03010) PUENTE LARGO,2138,1452,1340,4930
24262,2020-03-06,(03010) PUENTE LARGO,1979,1326,1281,4586
24263,2020-01-16,(06101) El Tiempo,2321,1330,1309,4960
24264,2020-01-23,(02202) Calle 127,5667,3692,2836,12195
24265,2020-04-24,(09100) Calle 40 Sur,936,575,602,2113
24266,2020-08-12,(10005) Bicentenario - alimentacion,210,101,205,516
24267,2020-01-19,(10010) San Bernardo,410,247,516,1173
24268,2020-03-08,(09121) Las Flores,558,357,713,1628
24269,2020-01-11,(05103) Marsella,1077,482,766,2325
24270,2020-03-19,(05103) Marsella,1160,599,569,2328
24271,2020-05-07,(05103) Marsella,229,125,126,480
24272,2020-05-27,(05103) Marsella,363,174,213,750
24273,2020-02-01,(09109) Tercer Milenio,839,508,653,2000
24274,2020-09-08,(09109) Tercer Milenio,363,229,248,840
24275,2020-01-17,(06105) Quinta Paredes,849,469,491,1809
24276,2020-04-30,(06101) El Tiempo,214,162,97,473
24277,2020-10-02,(04104) Avenida 68,751,381,504,1636
24278,2020-10-08,(04104) Avenida 68,730,386,539,1655
24279,2020-09-18,(02104) Calle 146,975,575,715,2265
24280,2020-03-21,(09000) Cabecera Usme - alimentacion,2494,1273,1442,5209
24281,2020-04-11,(05002) Tintal,734,428,379,1541
24282,2020-03-19,(04003) Avenida Ciudad de Cali,2553,1389,1656,5598
24283,2020-07-31,(08000) Portal Tunal - alimentacion,5798,3242,3222,12262
24284,2020-05-19,(03001) LA CAMPIÑA,855,490,462,1807
24285,2020-04-07,(08000) Portal Tunal - alimentacion,3232,1639,1779,6650
24286,2020-07-24,(04108) El Polo,435,275,209,919
24287,2020-02-03,(04101) Minuto de Dios,2661,1604,1745,6010
24288,2020-05-10,(06100) Av. Rojas,38,17,28,83
24289,2020-08-21,(02302) Virrey,566,413,355,1334
24290,2020-06-26,(07009) SENA,699,424,435,1558
24291,2020-05-13,(12003) Ricaurte,287,203,150,640
24292,2020-03-07,(03013) RIO NEGRO,717,431,677,1825
24293,2020-06-27,(03010) PUENTE LARGO,234,155,187,576
24294,2020-05-28,(02302) Virrey,543,352,279,1174
24295,2020-04-23,(03009) Av. Suba- Calle 116,344,241,142,727
24296,2020-03-09,(09109) Tercer Milenio,328,248,232,808
24297,2020-04-29,(09109) Tercer Milenio,203,137,142,482
24298,2020-04-02,(10010) San Bernardo,340,235,264,839
24299,2020-05-05,(02105) Calle 142,528,346,293,1167
24300,2020-07-26,(07103) AV. CHILE,164,117,148,429
24301,2020-09-09,(07103) AV. CHILE,1012,584,521,2117
24302,2020-03-05,(40002) Manitas,1320,697,822,2839
24303,2020-08-19,(07004) VENECIA,929,551,507,1987
24304,2020-09-14,(07004) VENECIA,1049,624,649,2322
24305,2020-02-22,(09003) Socorro,1311,626,863,2800
24306,2020-08-25,(05105) Pradera,586,313,262,1161
24307,2020-06-05,(03002) SUBA - TV- 91,721,389,447,1557
24308,2020-05-28,(09115) Calle 34,545,405,323,1273
24309,2020-08-24,(03006) NIZA - CALLE 127,440,273,192,905
24310,2020-07-26,(07005) ALQUERIA,115,56,113,284
24311,2020-03-13,(07006) General Santander,190,465,454,1109
24312,2020-07-09,(10003) Ciudad Jardín,210,107,146,463
24313,2020-03-18,(09111) Calle 19,1515,954,981,3450
24314,2020-05-15,(12004) Carrera 22,152,88,97,337
24315,2020-09-01,(07201) Guatoque -Veraguas,180,118,151,449
24316,2020-04-15,(02202) Calle 127,661,466,337,1464
24317,2020-05-16,(12002) CDS - Carrera 32,124,81,43,248
24318,2020-09-26,(06109) Centro Memoria,202,125,203,530
24319,2020-07-02,(09114) Calle 26,313,204,230,747
24320,2020-07-25,(07105) MOVISTAR ARENA,154,93,93,340
24321,2020-04-13,(09121) Las Flores,406,315,228,949
24322,2020-10-06,(09121) Las Flores,798,489,580,1867
24323,2020-07-03,(14005) Las Aguas,199,133,217,549
24324,2020-08-13,(14005) Las Aguas,187,113,185,485
24325,2020-08-01,(09123) Calle 76,623,443,389,1455
24326,2020-03-15,(06109) Centro Memoria,139,93,187,419
24327,2020-05-08,(03003) 21 ANGELES,220,99,97,416
24328,2020-03-19,(04101) Minuto de Dios,941,551,651,2143
24329,2020-04-20,(02104) Calle 146,386,300,229,915
24330,2020-07-16,(09122) Calle 72,953,642,653,2248
24331,2020-07-15,(08002) Biblioteca,199,118,135,452
24332,2020-05-12,(12000) Puente Aranda,69,39,29,137
24333,2020-04-07,(07103) AV. CHILE,410,312,277,999
24334,2020-04-13,(07103) AV. CHILE,452,334,233,1019
24335,2020-08-31,(06001) Modelia,370,228,238,836
24336,2020-06-15,(04106) Carrera 47,126,70,76,272
24337,2020-07-17,(09113) Calle 22,290,174,312,776
24338,2020-07-24,(07109) CAD,511,323,276,1110
24339,2020-03-27,(09002) Consuelo,215,109,121,445
24340,2020-10-10,(06002) Normandía,270,160,282,712
24341,2020-03-19,(09120) Calle 63,2732,1843,1778,6353
24342,2020-08-25,(07009) SENA,613,349,358,1320
24343,2020-08-02,(10010) San Bernardo,195,112,181,488
24344,2020-04-07,(14001) La Sabana,63,50,52,165
24345,2020-04-05,(09115) Calle 34,113,79,80,272
24346,2020-04-17,(09115) Calle 34,357,268,220,845
24347,2020-09-28,(07004) VENECIA,1137,671,775,2583
24348,2020-03-20,(02103) Mazurén,92,63,52,207
24349,2020-09-05,(09105) Río Fucha,0,58,136,194
24350,2020-06-17,(04102) Avenida Boyaca,379,222,250,851
24351,2020-06-18,(04101) Minuto de Dios,335,198,212,745
24352,2020-06-21,(06108) Concejo de Bogotá,32,15,33,80
24353,2020-09-17,(04000) Cabecera Calle 80 - intermunicipal,414,209,418,1041
24354,2020-07-30,(06001) Modelia,342,210,184,736
24355,2020-03-20,(09003) Socorro,246,124,107,477
24356,2020-04-02,(07009) SENA,278,168,142,588
24357,2020-05-08,(07007) NQS - Calle 38A Sur,212,129,142,483
24358,2020-06-09,(07006) General Santander - alimentacion,353,195,219,767
24359,2020-10-09,(04106) Carrera 47,392,197,267,856
24360,2020-09-26,(12003) Ricaurte,280,239,228,747
24361,2020-07-01,(05101) Mandalay - Cr.73,142,77,83,302
24362,2020-06-15,(07005) ALQUERIA,166,96,108,370
24363,2020-01-26,(07506) DESPENSA,334,184,354,872
24364,2020-04-03,(07506) DESPENSA,187,97,154,438
24365,2020-07-22,(07008) NQS - Calle 30 Sur,288,155,189,632
24366,2020-04-28,(04003) Avenida Ciudad de Cali,632,386,357,1375
24367,2020-04-19,(07006) General Santander - alimentacion,57,40,36,133
24368,2020-04-07,(09101) Quiroga,188,120,151,459
24369,2020-08-14,(03010) PUENTE LARGO,271,179,197,647
24370,2020-08-22,(07108) Av. El Dorado,81,60,74,215
24371,2020-05-17,(04000) Cabecera Calle 80 - intermunicipal,32,24,29,85
24372,2020-03-11,(03004) GRATAMIRA,293,152,153,598
24373,2020-07-24,(09106) Nariño,291,187,209,687
24374,2020-02-20,(09105) Río Fucha,843,437,442,1722
24375,2020-07-15,(14004) Museo del Oro,288,143,149,580
24376,2020-07-19,(09105) Río Fucha,32,10,28,70
24377,2020-05-02,(07007) NQS - Calle 38A Sur,132,86,74,292
24378,2020-04-22,(07007) NQS - Calle 38A Sur,163,106,101,370
24379,2020-04-19,(05100) Banderas P. Central,91,50,59,200
24380,2020-01-17,(03014) SAN MARTIN,219,133,150,502
24381,2020-09-13,(08001) Parque el Tunal,143,54,126,323
24382,2020-08-09,(04107) Escuela Militar,23,15,22,60
24383,2020-06-24,(04001) Quirigua,409,248,285,942
24384,2020-03-24,(14005) Las Aguas,0,107,281,388
24385,2020-07-05,(12004) Carrera 22,71,41,72,184
24386,2020-08-13,(07113) SANTA ISABEL,323,194,213,730
24387,2020-09-19,(03004) GRATAMIRA,0,13,38,51
24388,2020-08-03,(06106) Recinto Ferial,198,130,107,435
24389,2020-07-08,(09105) Río Fucha,116,60,101,277
24390,2020-04-28,(40002) Manitas,215,115,158,488
24391,2020-03-26,(09003) Socorro,245,111,140,496
24392,2020-01-14,(50002) Corral Calle 40 Sur,110,59,123,292
24393,2020-04-27,(09117) Calle 45,129,195,81,405
24394,2020-05-17,(12002) CDS - Carrera 32,25,30,20,75
24395,2020-07-05,(09106) Nariño,143,74,121,338
24396,2020-07-17,(07101) CASTELLANA,192,115,102,409
24397,2020-04-22,(07003) SEVILLANA,231,136,118,485
24398,2020-03-31,(07105) MOVISTAR ARENA,134,103,88,325
24399,2020-05-25,(10007) Las Nieves,89,56,107,252
24400,2020-08-17,(04000) Cabecera Calle 80 - intermunicipal,61,32,70,163
24401,2020-05-02,(03007) HUMEDAL CORDOBA,71,40,31,142
24402,2020-04-10,(06102) Salitre El Greco,58,41,24,123
24403,2020-04-12,(02102) Calle 161,23,34,19,76
24404,2020-01-27,(50004) Corral Avenida Ciudad de Cali,0,0,1,1
24405,2020-07-06,(09002) Consuelo,496,277,290,1063
24406,2020-07-10,(02502) Terminal,452,317,376,1145
24407,2020-10-04,(07111) NQS - RICAURTE,224,188,252,664
24408,2020-01-22,(04106) Carrera 47,1435,746,853,3034
24409,2020-01-08,(02200) Alcalá,8784,5584,4786,19154
24410,2020-02-20,(10000) Portal 20 de Julio - alimentacion,11090,5630,7212,23932
24411,2020-09-29,(05000) Portal Américas - alimentacion,12353,6558,7439,26350
24412,2020-08-13,(05000) Portal Américas - alimentacion,10433,5603,5407,21443
24413,2020-01-18,(06107) Ciudad Universitaria,461,330,591,1382
24414,2020-03-09,(06107) Ciudad Universitaria,570,170,196,936
24415,2020-08-29,(09001) Molinos,2211,1061,1650,4922
24416,2020-09-17,(09001) Molinos,2900,1501,2130,6531
24417,2020-09-29,(09001) Molinos,2905,1529,2207,6641
24418,2020-01-19,(05000) Portal Américas,2605,1214,2557,6376
24419,2020-03-10,(09118) Marly,3076,638,979,4693
24420,2020-02-26,(09104) Restrepo,5290,3118,3933,12341
24421,2020-09-30,(09000) Cabecera Usme,2004,1158,1544,4706
24422,2020-02-20,(10003) Ciudad Jardín,1064,544,595,2203
24423,2020-05-13,(07005) ALQUERIA,387,255,227,869
24424,2020-09-22,(07001) PERDOMO,1114,612,847,2573
24425,2020-01-31,(07113) SANTA ISABEL,2090,1247,1453,4790
24426,2020-07-21,(04100) Carrera 77,1075,613,671,2359
24427,2020-04-12,(07504) TERREROS,937,560,449,1946
24428,2020-05-12,(09000) Cabecera Usme,1224,818,885,2927
24429,2020-02-15,(10006) San Victorino,1113,928,1072,3113
24430,2020-01-09,(04104) Avenida 68,2393,1235,1345,4973
24431,2020-05-08,(09101) Quiroga,370,184,285,839
24432,2020-07-29,(04100) Carrera 77,1210,682,771,2663
24433,2020-05-01,(09118) Marly,530,371,281,1182
24434,2020-09-20,(07000) Portal Sur - alimentacion,3152,1331,2127,6610
24435,2020-07-07,(03001) LA CAMPIÑA,1241,710,733,2684
24436,2020-02-03,(06001) Modelia,2539,1561,1223,5323
24437,2020-01-23,(02303) Calle 85,3413,2344,1737,7494
24438,2020-05-27,(07000) Portal Sur - alimentacion,6829,3835,3013,13677
24439,2020-03-11,(14001) La Sabana,614,365,365,1344
24440,2020-03-17,(02000) Cabecera Autopista Norte - alimentacion,13511,7261,7347,28119
24441,2020-07-01,(07002) MADELENA,837,520,530,1887
24442,2020-07-27,(08000) Portal Tunal - alimentacion,5790,3337,3140,12267
24443,2020-08-10,(09110) Avenida Jimenez,1369,974,763,3106
24444,2020-09-03,(09110) Avenida Jimenez,1485,1085,932,3502
24445,2020-06-30,(04002) Carrera 90,816,433,447,1696
24446,2020-07-08,(10006) San Victorino,798,348,349,1495
24447,2020-02-13,(12001) Carrera 43,1827,1017,1033,3877
24448,2020-06-19,(12001) Carrera 43,437,269,271,977
24449,2020-08-19,(12001) Carrera 43,385,212,222,819
24450,2020-10-11,(10005) Bicentenario - alimentacion,43,44,115,202
24451,2020-02-01,(02000) Cabecera Autopista Norte - intermunicipal,2025,1113,1861,4999
24452,2020-09-28,(02000) Cabecera Autopista Norte - intermunicipal,642,440,551,1633
24453,2020-03-01,(05001) Patio Bonito,1632,719,1394,3745
24454,2020-01-07,(02302) Virrey,2732,1768,1439,5939
24455,2020-02-27,(07106) EL CAMPIN,2155,1394,1226,4775
24456,2020-07-08,(03000) Portal Suba,1327,825,898,3050
24457,2020-04-27,(03000) Portal Suba - alimentacion,2587,262,359,3208
24458,2020-08-08,(10000) Portal 20 de Julio,1619,761,972,3352
24459,2020-04-17,(07112) COMUNEROS,428,272,236,936
24460,2020-08-17,(07000) Portal Sur - alimentacion,2668,1250,1422,5340
24461,2020-01-25,(04002) Carrera 90,1901,870,1381,4152
24462,2020-10-01,(10002) Av. Primero de Mayo,2547,1229,1847,5623
24463,2020-01-28,(05102) Av. Américas - Av. Boyacá,1798,1090,958,3846
24464,2020-02-10,(07007) NQS - Calle 38A Sur,2254,1327,1199,4780
24465,2020-02-06,(06103) CAN,2619,1623,1244,5486
24466,2020-04-15,(02201) Prado,453,295,242,990
24467,2020-06-01,(05002) Tintal,1551,951,1056,3558
24468,2020-03-13,(02103) Mazurén,162,461,357,980
24469,2020-01-31,(04102) Avenida Boyaca,2947,1677,1608,6232
24470,2020-10-08,(02300) Calle 100,1324,939,1008,3271
24471,2020-01-20,(10010) San Bernardo,1565,898,1341,3804
24472,2020-04-06,(09001) Molinos,1180,645,872,2697
24473,2020-09-16,(07006) General Santander,596,349,389,1334
24474,2020-04-08,(05005) Transversal 86,175,76,95,346
24475,2020-04-13,(05005) Transversal 86,179,103,91,373
24476,2020-05-25,(06109) Centro Memoria,84,54,65,203
24477,2020-08-27,(07007) NQS - Calle 38A Sur,418,258,310,986
24478,2020-03-26,(02205) Calle 106,192,149,118,459
24479,2020-04-23,(02205) Calle 106,169,123,98,390
24480,2020-09-23,(02205) Calle 106,444,329,321,1094
24481,2020-07-18,(03000) Portal Suba - alimentacion,4139,2165,2449,8753
24482,2020-09-16,(09101) Quiroga,618,326,478,1422
24483,2020-08-19,(06000) Portal Eldorado - alimentacion,3641,1846,1878,7365
24484,2020-02-11,(12007) Zona Industrial,1337,806,666,2809
24485,2020-01-08,(02202) Calle 127,3771,2569,2168,8508
24486,2020-01-16,(02202) Calle 127,4905,3216,2699,10820
24487,2020-05-28,(07101) CASTELLANA,172,110,93,375
24488,2020-06-11,(07101) CASTELLANA,190,124,118,432
24489,2020-09-12,(06000) Portal Eldorado - alimentacion,3181,1433,2162,6776
24490,2020-02-01,(07113) SANTA ISABEL,1211,636,1137,2984
24491,2020-03-08,(02300) Calle 100,766,697,1218,2681
24492,2020-04-21,(03007) HUMEDAL CORDOBA,78,47,35,160
24493,2020-06-09,(03007) HUMEDAL CORDOBA,133,103,69,305
24494,2020-06-03,(04104) Avenida 68,579,315,306,1200
24495,2020-08-11,(04104) Avenida 68,479,252,307,1038
24496,2020-01-03,(07000) Portal Sur,4160,2333,2741,9234
24497,2020-05-30,(10010) San Bernardo,441,207,301,949
24498,2020-02-07,(07109) CAD,2893,1737,1581,6211
24499,2020-09-30,(07109) CAD,753,443,460,1656
24500,2020-07-10,(07002) MADELENA,917,524,569,2010
24501,2020-07-01,(04105) Carrera 53,309,153,171,633
24502,2020-01-09,(06100) Av. Rojas,1455,861,936,3252
24503,2020-08-21,(04003) Avenida Ciudad de Cali,895,482,741,2118
24504,2020-07-22,(07003) SEVILLANA,400,199,230,829
24505,2020-08-23,(07003) SEVILLANA,97,50,79,226
24506,2020-08-27,(07113) SANTA ISABEL,373,210,249,832
24507,2020-09-06,(02302) Virrey,156,138,176,470
24508,2020-02-14,(12003) Ricaurte,1323,802,663,2788
24509,2020-08-03,(12003) Ricaurte,349,226,201,776
24510,2020-09-02,(12003) Ricaurte,436,291,180,907
24511,2019-12-31,(03000) Portal Suba - alimentacion,258,204,331,793
24512,2020-06-28,(05100) Banderas P. Central,186,95,142,423
24513,2020-02-22,(06103) CAN,702,560,824,2086
24514,2020-01-01,(06103) CAN,173,115,169,457
24515,2020-06-30,(02105) Calle 142,807,528,528,1863
24516,2020-03-02,(09109) Tercer Milenio,1315,836,863,3014
24517,2020-06-26,(03002) SUBA - TV- 91,819,463,509,1791
24518,2020-09-19,(07007) NQS - Calle 38A Sur,434,237,304,975
24519,2020-05-23,(05107) Américas - Cr.53,254,160,146,560
24520,2020-06-15,(10002) Av. Primero de Mayo,620,335,481,1436
24521,2020-09-19,(04000) Cabecera Calle 80 - intermunicipal,244,131,350,725
24522,2020-09-22,(04000) Cabecera Calle 80 - intermunicipal,427,208,379,1014
24523,2020-09-07,(02103) Mazurén,211,142,209,562
24524,2020-07-09,(12007) Zona Industrial,395,228,192,815
24525,2020-01-04,(10005) Bicentenario,106,79,153,338
24526,2020-06-27,(02304) Heroes,557,443,426,1426
24527,2020-04-04,(05100) Banderas P. Central - alimentacion,961,443,452,1856
24528,2020-01-12,(04103) Las Ferias,258,143,295,696
24529,2020-07-03,(07003) SEVILLANA,476,259,275,1010
24530,2020-01-06,(10009) Museo Nacional,254,225,406,885
24531,2020-05-07,(10008) San Diego,186,123,146,455
24532,2020-08-15,(03011) SUBA - CALLE 100,308,182,265,755
24533,2020-02-14,(10004) Policarpa,904,461,590,1955
24534,2020-07-17,(09115) Calle 34,555,351,340,1246
24535,2020-08-01,(09115) Calle 34,348,238,326,912
24536,2020-06-04,(03006) NIZA - CALLE 127,373,220,171,764
24537,2020-02-02,(09122) Calle 72,1100,811,1530,3441
24538,2020-08-12,(02204) Pepe Sierra,716,505,399,1620
24539,2020-03-01,(07110) PALOQUEMAO,367,306,440,1113
24540,2020-09-30,(07110) PALOQUEMAO,745,479,393,1617
24541,2020-03-01,(12004) Carrera 22,110,101,199,410
24542,2020-09-13,(07008) NQS - Calle 30 Sur,100,45,107,252
24543,2020-01-12,(04101) Minuto de Dios,389,212,511,1112
24544,2020-06-11,(04105) Carrera 53,277,150,134,561
24545,2020-09-10,(04105) Carrera 53,281,133,181,595
24546,2020-05-26,(06104) Gobernación,244,141,99,484
24547,2020-05-28,(06104) Gobernación,226,141,76,443
24548,2020-03-19,(07105) MOVISTAR ARENA,689,458,378,1525
24549,2020-06-22,(50003) Corral Molinos,569,293,415,1277
24550,2020-01-05,(50002) Corral Calle 40 Sur,15,5,19,39
24551,2020-09-06,(07107) U. NACIONAL,114,72,107,293
24552,2020-04-07,(10007) Las Nieves,186,149,136,471
24553,2020-09-19,(03003) 21 ANGELES,276,140,213,629
24554,2020-04-17,(06107) Ciudad Universitaria,103,64,90,257
24555,2020-08-04,(06107) Ciudad Universitaria,158,85,107,350
24556,2020-08-05,(07110) PALOQUEMAO,602,348,217,1167
24557,2020-07-31,(06102) Salitre El Greco,229,130,101,460
24558,2020-03-02,(40002) Manitas,1350,744,801,2895
24559,2020-03-14,(10004) Policarpa,553,240,499,1292
24560,2020-07-04,(10007) Las Nieves,534,342,359,1235
24561,2020-07-23,(03005) SUBA - AV. BOYACA,400,207,218,825
24562,2020-07-10,(14005) Las Aguas,191,126,224,541
24563,2020-10-06,(02102) Calle 161,298,173,271,742
24564,2020-06-22,(07107) U. NACIONAL,107,71,82,260
24565,2020-09-26,(02103) Mazurén,188,100,195,483
24566,2020-08-21,(09111) Calle 19,679,384,447,1510
24567,2020-09-30,(06001) Modelia,428,278,264,970
24568,2020-07-20,(10009) Museo Nacional,65,34,77,176
24569,2020-07-09,(04106) Carrera 47,333,159,168,660
24570,2020-09-21,(07101) CASTELLANA,219,130,139,488
24571,2020-04-29,(07102) NQS - CALLE 75,237,173,120,530
24572,2020-05-31,(02201) Prado,230,177,175,582
24573,2020-05-30,(04001) Quirigua,253,153,187,593
24574,2020-06-09,(04001) Quirigua,394,241,231,866
24575,2020-01-06,(08000) Portal Tunal,493,290,287,1070
24576,2020-07-03,(09120) Calle 63,1210,766,791,2767
24577,2020-09-26,(02204) Pepe Sierra,577,423,453,1453
24578,2020-03-13,(06102) Salitre El Greco,477,81,123,681
24579,2020-03-28,(06000) Portal Eldorado - alimentacion,1555,694,591,2840
24580,2020-10-07,(04002) Carrera 90,904,464,622,1990
24581,2020-04-27,(09115) Calle 34,87,204,81,372
24582,2020-04-03,(09110) Avenida Jimenez,253,234,279,766
24583,2020-02-08,(12002) CDS - Carrera 32,258,187,286,731
24584,2020-04-08,(12002) CDS - Carrera 32,118,89,53,260
24585,2020-08-12,(12002) CDS - Carrera 32,191,104,56,351
24586,2020-01-11,(09105) Río Fucha,355,172,327,854
24587,2020-05-12,(04101) Minuto de Dios,256,146,150,552
24588,2020-09-14,(07006) General Santander,586,352,371,1309
24589,2020-07-23,(04000) Cabecera Calle 80 - intermunicipal,289,142,259,690
24590,2020-06-04,(06001) Modelia,385,252,175,812
24591,2020-05-01,(07200) Tygua-San José,77,44,66,187
24592,2020-07-28,(07506) DESPENSA,403,235,216,854
24593,2020-03-27,(14005) Las Aguas,0,40,109,149
24594,2020-09-05,(06105) Quinta Paredes,107,56,85,248
24595,2020-06-29,(03011) SUBA - CALLE 100,174,107,86,367
24596,2020-05-06,(05100) Banderas P. Central,429,247,281,957
24597,2020-06-04,(10004) Policarpa,216,105,140,461
24598,2020-08-07,(07107) U. NACIONAL,115,86,74,275
24599,2020-05-28,(10004) Policarpa,186,107,118,411
24600,2020-05-06,(07006) General Santander - alimentacion,234,145,124,503
24601,2020-04-09,(09003) Socorro,111,66,79,256
24602,2020-08-29,(10004) Policarpa,204,88,157,449
24603,2020-06-07,(06002) Normandía,60,54,53,167
24604,2020-06-11,(06108) Concejo de Bogotá,139,78,66,283
24605,2020-07-20,(07010) Bosa,192,105,105,402
24606,2019-12-31,(12001) Carrera 43,6,9,19,34
24607,2020-06-06,(06103) CAN,229,158,148,535
24608,2020-04-29,(10008) San Diego,177,117,90,384
24609,2020-10-10,(04107) Escuela Militar,97,89,112,298
24610,2020-04-28,(07106) EL CAMPIN,197,138,108,443
24611,2020-03-29,(05100) Banderas P. Central,82,44,59,185
24612,2020-04-11,(06102) Salitre El Greco,105,68,53,226
24613,2020-08-09,(14001) La Sabana,42,28,51,121
24614,2020-04-13,(09114) Calle 26,163,133,135,431
24615,2020-04-02,(07008) NQS - Calle 30 Sur,132,70,71,273
24616,2020-07-05,(09115) Calle 34,159,113,167,439
24617,2020-09-14,(03004) GRATAMIRA,0,26,29,55
24618,2020-04-03,(04107) Escuela Militar,56,40,47,143
24619,2020-04-12,(12004) Carrera 22,16,7,13,36
24620,2020-08-09,(10008) San Diego,90,45,65,200
24621,2020-07-04,(04105) Carrera 53,225,127,132,484
24622,2020-07-29,(03005) SUBA - AV. BOYACA,421,246,240,907
24623,2020-03-31,(06107) Ciudad Universitaria,105,82,73,260
24624,2020-04-19,(09113) Calle 22,146,84,120,350
24625,2020-05-25,(09111) Calle 19,181,116,167,464
24626,2020-06-27,(10003) Ciudad Jardín,188,85,151,424
24627,2020-07-14,(06100) Av. Rojas,180,107,117,404
24628,2020-06-21,(06102) Salitre El Greco,86,50,55,191
24629,2020-06-14,(04103) Las Ferias,118,55,64,237
24630,2019-12-31,(05005) Transversal 86,21,8,22,51
24631,2020-04-27,(03011) SUBA - CALLE 100,32,105,48,185
24632,2020-04-05,(12000) Puente Aranda,12,11,9,32
24633,2020-05-10,(10005) Bicentenario,10,5,21,36
24634,2019-12-31,(03014) SAN MARTIN,3,2,4,9
24635,2020-06-17,(50002) Corral Calle 40 Sur,17,7,24,48
24636,2020-08-01,(03004) GRATAMIRA,21,9,19,49
24637,2019-12-31,(03004) GRATAMIRA,1,1,3,5
24638,2020-01-29,(04000) Cabecera Calle 80 - alimentacion,22900,13530,14097,50527
24639,2020-02-23,(04000) Cabecera Calle 80 - alimentacion,4651,2026,4797,11474
24640,2020-05-28,(04000) Cabecera Calle 80 - alimentacion,3387,1889,2047,7323
24641,2020-08-31,(09002) Consuelo,485,262,286,1033
24642,2020-07-11,(09118) Marly,1153,726,721,2600
24643,2020-07-28,(10000) Portal 20 de Julio - alimentacion,4059,1817,2259,8135
24644,2020-03-05,(04106) Carrera 47,1520,790,925,3235
24645,2020-01-17,(03000) Portal Suba - alimentacion,24741,13179,14689,52609
24646,2020-02-04,(02200) Alcalá,15310,9635,6923,31868
24647,2020-08-27,(06000) Portal Eldorado - alimentacion,3746,1895,2073,7714
24648,2020-01-08,(06104) Gobernación,909,562,502,1973
24649,2020-01-31,(03010) PUENTE LARGO,2119,1369,1270,4758
24650,2020-01-04,(50003) Corral Molinos,1690,930,1820,4440
24651,2020-10-08,(06107) Ciudad Universitaria,208,133,179,520
24652,2020-10-10,(06107) Ciudad Universitaria,131,89,182,402
24653,2020-02-03,(07000) Portal Sur - alimentacion,28114,16439,14544,59097
24654,2020-08-15,(07112) COMUNEROS,667,362,411,1440
24655,2020-09-25,(05100) Banderas P. Central,1176,642,839,2657
24656,2020-03-15,(10001) Country Sur,692,301,754,1747
24657,2020-08-31,(09100) Calle 40 Sur,1776,1007,1239,4022
24658,2020-02-29,(09000) Cabecera Usme,3935,1986,3412,9333
24659,2020-08-27,(09000) Cabecera Usme,1756,1075,1196,4027
24660,2020-09-17,(09000) Cabecera Usme,1950,1190,1476,4616
24661,2020-02-04,(09113) Calle 22,1546,909,1126,3581
24662,2020-10-08,(10005) Bicentenario - alimentacion,232,123,261,616
24663,2020-10-03,(03000) Portal Suba - alimentacion,5734,2622,4803,13159
24664,2020-02-05,(09109) Tercer Milenio,1498,901,884,3283
24665,2020-02-26,(05107) Américas - Cr.53,2746,1486,1386,5618
24666,2020-01-08,(09104) Restrepo,3708,2297,3133,9138
24667,2020-10-07,(03000) Portal Suba - alimentacion,7537,4026,5456,17019
24668,2020-01-04,(02204) Pepe Sierra,1194,792,927,2913
24669,2020-02-05,(10006) San Victorino,2645,1365,1311,5321
24670,2020-01-24,(04104) Avenida 68,3322,1658,1754,6734
24671,2020-01-31,(09110) Avenida Jimenez,4407,3078,2779,10264
24672,2020-02-28,(02000) Cabecera Autopista Norte - alimentacion,23769,13211,13667,50647
24673,2020-04-21,(03000) Portal Suba - alimentacion,3301,1966,1751,7018
24674,2020-02-25,(09103) Olaya,4356,2699,2302,9357
24675,2020-04-13,(09110) Avenida Jimenez,276,269,293,838
24676,2020-01-24,(06001) Modelia,2265,1357,1275,4897
24677,2020-03-26,(09104) Restrepo,652,500,580,1732
24678,2020-01-31,(02303) Calle 85,3368,2421,1925,7714
24679,2020-06-09,(14001) La Sabana,160,101,115,376
24680,2020-05-02,(04102) Avenida Boyaca,133,81,84,298
24681,2020-02-04,(07107) U. NACIONAL,2734,1606,1367,5707
24682,2020-06-25,(04105) Carrera 53,297,170,159,626
24683,2020-03-27,(50003) Corral Molinos,727,340,440,1507
24684,2020-01-22,(04000) Cabecera Calle 80,6835,4080,4562,15477
24685,2020-01-19,(07009) SENA,835,379,832,2046
24686,2020-06-10,(07112) COMUNEROS,773,437,396,1606
24687,2020-02-07,(05002) Tintal,11507,6483,6149,24139
24688,2020-10-08,(02201) Prado,1002,656,802,2460
24689,2020-01-03,(09111) Calle 19,1041,674,918,2633
24690,2020-03-24,(08000) Portal Tunal - alimentacion,6105,2596,3318,12019
24691,2020-02-20,(12001) Carrera 43,1752,998,1037,3787
24692,2020-05-21,(12001) Carrera 43,371,205,182,758
24693,2020-09-10,(10002) Av. Primero de Mayo,2145,1019,1401,4565
24694,2020-01-23,(10005) Bicentenario - alimentacion,638,281,486,1405
24695,2020-01-06,(05100) Banderas P. Central - alimentacion,2232,901,1662,4795
24696,2020-10-01,(02000) Cabecera Autopista Norte - intermunicipal,624,415,546,1585
24697,2020-05-07,(10000) Portal 20 de Julio - alimentacion,2830,1350,1695,5875
24698,2020-02-03,(09115) Calle 34,4309,2728,2371,9408
24699,2020-06-12,(02303) Calle 85,684,478,327,1489
24700,2020-07-04,(02303) Calle 85,527,347,319,1193
24701,2020-08-25,(02303) Calle 85,658,416,356,1430
24702,2020-09-02,(02303) Calle 85,821,536,430,1787
24703,2020-07-31,(09116) Avenida 39,298,178,211,687
24704,2020-10-10,(09116) Avenida 39,230,159,306,695
24705,2020-02-24,(09123) Calle 76,5767,3741,3212,12720
24706,2020-04-14,(03003) 21 ANGELES,164,92,106,362
24707,2020-09-26,(14004) Museo del Oro,154,143,281,578
24708,2020-04-07,(02201) Prado,374,249,221,844
24709,2020-02-17,(02304) Heroes,4901,3400,2262,10563
24710,2020-01-09,(05105) Pradera,1672,1081,937,3690
24711,2020-01-19,(05100) Banderas P. Central - alimentacion,3112,1110,2328,6550
24712,2020-04-30,(02300) Calle 100,883,618,458,1959
24713,2020-01-07,(03012) SUBA - CALLE 95,953,629,711,2293
24714,2020-08-13,(03012) SUBA - CALLE 95,250,165,159,574
24715,2020-08-25,(03012) SUBA - CALLE 95,318,177,168,663
24716,2020-01-20,(06000) Portal Eldorado,5948,3517,2742,12207
24717,2020-08-31,(05101) Mandalay - Cr.73,125,72,63,260
24718,2020-05-25,(09001) Molinos,724,351,531,1606
24719,2020-06-11,(09001) Molinos,2340,1350,1526,5216
24720,2020-06-16,(09001) Molinos,2478,1413,1669,5560
24721,2020-04-30,(09104) Restrepo,878,548,628,2054
24722,2020-08-22,(05001) Patio Bonito,1406,732,889,3027
24723,2020-04-15,(10008) San Diego,156,101,90,347
24724,2020-03-15,(08000) Portal Tunal,443,311,328,1082
24725,2020-01-20,(09121) Las Flores,2954,1817,1837,6608
24726,2020-03-14,(04104) Avenida 68,1556,881,1260,3697
24727,2020-09-25,(03009) Av. Suba- Calle 116,576,351,352,1279
24728,2020-03-28,(02205) Calle 106,134,105,75,314
24729,2020-07-01,(05002) Tintal,0,1029,2683,3712
24730,2020-04-04,(04000) Cabecera Calle 80 - alimentacion,1205,642,676,2523
24731,2020-05-03,(09101) Quiroga,97,57,83,237
24732,2020-09-29,(04108) El Polo,563,344,343,1250
24733,2020-05-26,(02300) Calle 100,1224,761,586,2571
24734,2020-01-20,(12007) Zona Industrial,1182,747,596,2525
24735,2020-02-04,(07201) Guatoque -Veraguas,1090,568,672,2330
24736,2020-03-06,(07201) Guatoque -Veraguas,1002,489,641,2132
24737,2020-05-04,(06000) Portal Eldorado - alimentacion,2749,1369,1250,5368
24738,2020-04-06,(06000) Portal Eldorado,734,549,365,1648
24739,2020-06-30,(10006) San Victorino,735,347,367,1449
24740,2020-03-22,(09004) Santa Lucía,421,205,192,818
24741,2020-04-29,(07000) Portal Sur,1073,680,606,2359
24742,2020-05-11,(02101) Toberín,1006,658,656,2320
24743,2020-01-25,(04103) Las Ferias,824,445,629,1898
24744,2020-04-11,(07110) PALOQUEMAO,196,154,99,449
24745,2020-06-09,(10005) Bicentenario - alimentacion,208,107,168,483
24746,2020-03-16,(04003) Avenida Ciudad de Cali,3677,2155,2416,8248
24747,2020-06-17,(09000) Cabecera Usme,1687,1069,1191,3947
24748,2020-02-29,(05103) Marsella,1425,712,1066,3203
24749,2020-03-14,(09109) Tercer Milenio,738,424,595,1757
24750,2020-01-14,(09117) Calle 45,3163,2211,2385,7759
24751,2020-03-06,(03003) 21 ANGELES,1685,804,933,3422
24752,2020-06-22,(04105) Carrera 53,97,58,72,227
24753,2020-10-02,(06101) El Tiempo,399,266,321,986
24754,2020-09-02,(02104) Calle 146,816,529,597,1942
24755,2020-09-09,(02104) Calle 146,878,538,659,2075
24756,2020-02-28,(04001) Quirigua,2139,1185,1312,4636
24757,2020-01-24,(06104) Gobernación,1260,766,667,2693
24758,2020-05-12,(09001) Molinos,1853,1081,1141,4075
24759,2020-03-02,(07101) CASTELLANA,924,588,625,2137
24760,2020-03-09,(02000) Cabecera Autopista Norte - intermunicipal,390,1367,906,2663
24761,2020-03-31,(03001) LA CAMPIÑA,495,282,275,1052
24762,2020-01-16,(07103) AV. CHILE,2847,1976,1867,6690
24763,2020-09-09,(07109) CAD,698,402,386,1486
24764,2020-04-30,(04108) El Polo,269,191,169,629
24765,2020-03-21,(02001) Centro Comercial Santa Fe,107,76,98,281
24766,2020-02-08,(07008) NQS - Calle 30 Sur,1169,522,856,2547
24767,2020-04-26,(06100) Av. Rojas,34,20,19,73
24768,2020-07-15,(06000) Portal Eldorado,842,531,370,1743
24769,2020-09-25,(02302) Virrey,795,552,495,1842
24770,2020-05-02,(09001) Molinos,1090,600,729,2419
24771,2020-01-29,(07001) PERDOMO,4461,2707,2573,9741
24772,2020-02-22,(04106) Carrera 47,910,445,696,2051
24773,2020-09-30,(06103) CAN,449,262,245,956
24774,2020-07-15,(06103) CAN,348,203,128,679
24775,2020-06-14,(04100) Carrera 77,348,176,282,806
24776,2020-08-03,(07005) ALQUERIA,449,261,300,1010
24777,2020-07-28,(07103) AV. CHILE,904,521,393,1818
24778,2020-10-02,(03006) NIZA - CALLE 127,617,335,409,1361
24779,2020-08-07,(03002) SUBA - TV- 91,254,130,187,571
24780,2020-04-02,(05107) Américas - Cr.53,250,218,191,659
24781,2020-09-03,(12007) Zona Industrial,431,257,185,873
24782,2020-08-30,(40002) Manitas,139,62,93,294
24783,2019-12-31,(09004) Santa Lucía,120,60,112,292
24784,2020-02-29,(02103) Mazurén,1072,500,1118,2690
24785,2020-08-31,(09114) Calle 26,308,200,236,744
24786,2020-01-16,(07006) General Santander,2495,1330,1431,5256
24787,2020-02-21,(07003) SEVILLANA,2095,1107,1115,4317
24788,2020-02-10,(40001) Juan Pablo II,1649,963,1011,3623
24789,2020-03-04,(03005) SUBA - AV. BOYACA,2761,1671,1623,6055
24790,2020-07-29,(05002) Tintal,1993,1141,1198,4332
24791,2020-06-11,(10009) Museo Nacional,482,272,257,1011
24792,2020-07-28,(10009) Museo Nacional,435,279,274,988
24793,2020-07-13,(05107) Américas - Cr.53,394,231,212,837
24794,2020-06-27,(06111) Universidades,252,163,341,756
24795,2020-07-24,(06111) Universidades,288,143,240,671
24796,2020-06-01,(40001) Juan Pablo II,532,334,324,1190
24797,2020-07-22,(07111) NQS - RICAURTE,849,574,371,1794
24798,2020-02-29,(05102) Av. Américas - Av. Boyacá,855,398,656,1909
24799,2020-05-22,(02200) Alcalá,1488,1027,736,3251
24800,2020-03-12,(02205) Calle 106,981,175,235,1391
24801,2020-05-14,(12004) Carrera 22,159,90,85,334
24802,2020-07-22,(07201) Guatoque -Veraguas,142,71,119,332
24803,2020-08-13,(07200) Tygua-San José,227,116,141,484
24804,2020-02-09,(07005) ALQUERIA,630,305,532,1467
24805,2020-04-11,(09122) Calle 72,345,252,241,838
24806,2020-02-02,(04002) Carrera 90,763,348,785,1896
24807,2020-06-23,(03010) PUENTE LARGO,373,266,209,848
24808,2020-04-28,(02303) Calle 85,381,269,274,924
24809,2020-06-17,(07105) MOVISTAR ARENA,263,167,164,594
24810,2020-08-22,(07107) U. NACIONAL,228,131,157,516
24811,2020-05-30,(02303) Calle 85,403,286,238,927
24812,2020-05-28,(05102) Av. Américas - Av. Boyacá,183,92,102,377
24813,2020-08-23,(04003) Avenida Ciudad de Cali,242,127,249,618
24814,2020-05-09,(09119) Calle 57,304,181,178,663
24815,2020-04-29,(09121) Las Flores,475,320,268,1063
24816,2020-04-15,(10007) Las Nieves,220,182,148,550
24817,2020-08-18,(03005) SUBA - AV. BOYACA,422,252,266,940
24818,2020-01-06,(03011) SUBA - CALLE 100,368,231,345,944
24819,2020-03-20,(05100) Banderas P. Central,385,251,283,919
24820,2020-04-24,(12000) Puente Aranda,52,24,28,104
24821,2020-08-08,(12000) Puente Aranda,45,36,33,114
24822,2020-08-11,(12000) Puente Aranda,92,53,44,189
24823,2020-08-28,(02102) Calle 161,249,145,189,583
24824,2020-07-13,(04106) Carrera 47,315,146,163,624
24825,2020-05-10,(02000) Cabecera Autopista Norte,272,198,141,611
24826,2020-08-19,(09110) Avenida Jimenez,772,623,720,2115
24827,2020-06-23,(10004) Policarpa,246,141,152,539
24828,2020-09-11,(07008) NQS - Calle 30 Sur,334,170,246,750
24829,2020-04-07,(07200) Tygua-San José,70,51,73,194
24830,2020-09-26,(02000) Cabecera Autopista Norte - intermunicipal,440,264,438,1142
24831,2020-10-03,(09120) Calle 63,1003,763,1012,2778
24832,2020-07-31,(09117) Calle 45,631,395,369,1395
24833,2020-04-06,(14001) La Sabana,70,53,65,188
24834,2020-03-25,(02502) Terminal,149,117,146,412
24835,2020-03-24,(02502) Terminal,284,223,281,788
24836,2020-03-21,(09001) Molinos,676,388,412,1476
24837,2020-03-21,(06002) Normandía,86,56,56,198
24838,2020-09-24,(07006) General Santander,660,385,420,1465
24839,2020-04-14,(04000) Cabecera Calle 80 - intermunicipal,122,76,78,276
24840,2020-05-11,(07005) ALQUERIA,405,232,214,851
24841,2020-09-30,(09108) Hospital,68,43,76,187
24842,2020-02-02,(05100) Banderas P. Central,902,361,930,2193
24843,2020-04-17,(03003) 21 ANGELES,157,82,84,323
24844,2020-05-24,(04103) Las Ferias,95,52,44,191
24845,2020-04-14,(09003) Socorro,296,151,203,650
24846,2020-03-23,(09117) Calle 45,283,188,145,616
24847,2020-08-18,(05101) Mandalay - Cr.73,117,57,52,226
24848,2020-05-08,(10008) San Diego,173,109,110,392
24849,2020-03-22,(07005) ALQUERIA,90,50,76,216
24850,2020-03-12,(04103) Las Ferias,297,216,220,733
24851,2020-04-06,(04001) Quirigua,174,100,117,391
24852,2020-07-20,(04001) Quirigua,118,65,70,253
24853,2020-05-18,(06111) Universidades,0,112,336,448
24854,2020-08-30,(08001) Parque el Tunal,129,65,115,309
24855,2020-08-19,(07113) SANTA ISABEL,359,208,263,830
24856,2020-07-01,(14004) Museo del Oro,308,165,230,703
24857,2020-04-05,(12001) Carrera 43,53,36,22,111
24858,2020-10-02,(07105) MOVISTAR ARENA,277,166,223,666
24859,2020-09-09,(09116) Avenida 39,408,227,294,929
24860,2020-09-28,(12004) Carrera 22,324,176,185,685
24861,2020-04-01,(07007) NQS - Calle 38A Sur,152,107,111,370
24862,2020-01-06,(07108) Av. El Dorado,98,71,142,311
24863,2020-05-25,(14001) La Sabana,48,34,36,118
24864,2020-01-15,(03014) SAN MARTIN,225,136,191,552
24865,2020-05-04,(02103) Mazurén,118,82,90,290
24866,2020-05-10,(02000) Cabecera Autopista Norte - intermunicipal,45,49,38,132
24867,2020-08-16,(02000) Cabecera Autopista Norte - intermunicipal,98,73,109,280
24868,2020-04-01,(04107) Escuela Militar,43,34,32,109
24869,2020-04-22,(04107) Escuela Militar,60,38,36,134
24870,2020-04-03,(14004) Museo del Oro,0,42,98,140
24871,2020-10-11,(07200) Tygua-San José,83,54,127,264
24872,2020-07-19,(40002) Manitas,104,62,69,235
24873,2020-08-16,(07003) SEVILLANA,87,55,116,258
24874,2020-04-19,(07104) Simon Bolivar,93,48,67,208
24875,2020-07-10,(07101) CASTELLANA,225,127,147,499
24876,2020-04-19,(04107) Escuela Militar,16,16,13,45
24877,2020-04-26,(02000) Cabecera Autopista Norte - intermunicipal,34,30,23,87
24878,2019-12-31,(09105) Río Fucha,18,2,9,29
24879,2020-03-20,(10008) San Diego,137,71,86,294
24880,2020-07-19,(06001) Modelia,72,50,52,174
24881,2020-05-03,(05101) Mandalay - Cr.73,19,12,9,40
24882,2020-04-07,(12000) Puente Aranda,35,34,37,106
24883,2020-04-10,(12004) Carrera 22,13,10,6,29
24884,2020-05-02,(03004) GRATAMIRA,21,12,9,42
24885,2020-06-15,(12003) Ricaurte,68,62,40,170
24886,2020-05-24,(04000) Cabecera Calle 80 - alimentacion,858,448,570,1876
24887,2020-02-19,(07005) ALQUERIA,2800,1524,1400,5724
24888,2020-09-18,(07005) ALQUERIA,606,349,469,1424
24889,2020-02-06,(09118) Marly,7946,5316,4182,17444
24890,2020-09-17,(09118) Marly,1528,969,939,3436
24891,2020-03-04,(07504) TERREROS,17310,10554,9192,37056
24892,2020-07-17,(07504) TERREROS,5631,3043,2604,11278
24893,2020-06-05,(09119) Calle 57,504,344,327,1175
24894,2020-06-12,(05000) Portal Américas - alimentacion,10735,5767,5205,21707
24895,2020-01-08,(09003) Socorro,1274,641,828,2743
24896,2020-02-03,(09003) Socorro,1682,1002,1073,3757
24897,2020-05-28,(05000) Portal Américas - alimentacion,9580,4732,4393,18705
24898,2020-05-21,(07503) SAN MATEO,8469,5230,3883,17582
24899,2020-09-10,(09001) Molinos,2631,1257,1681,5569
24900,2020-02-07,(02000) Cabecera Autopista Norte - alimentacion,24298,13475,13953,51726
24901,2020-01-25,(05000) Portal Américas,8777,4051,5852,18680
24902,2020-01-27,(07000) Portal Sur - alimentacion,27055,15972,13896,56923
24903,2020-02-04,(07000) Portal Sur - alimentacion,29236,16711,14473,60420
24904,2020-02-11,(05100) Banderas P. Central,8619,5016,4006,17641
24905,2020-10-08,(07503) SAN MATEO,13731,6962,7831,28524
24906,2020-04-19,(06000) Portal Eldorado - alimentacion,832,379,369,1580
24907,2020-01-16,(07009) SENA,2962,1697,1824,6483
24908,2020-01-08,(02502) Terminal,3227,2120,2102,7449
24909,2020-02-04,(02204) Pepe Sierra,5139,3326,2508,10973
24910,2020-03-17,(09000) Cabecera Usme - alimentacion,18427,9632,10641,38700
24911,2020-05-07,(07001) PERDOMO,585,315,362,1262
24912,2020-10-02,(09000) Cabecera Usme - alimentacion,10111,4960,6937,22008
24913,2020-06-23,(09104) Restrepo,1619,1001,1169,3789
24914,2020-07-29,(09104) Restrepo,1368,869,1075,3312
24915,2020-01-27,(07505) LEON XIII,8164,4578,3729,16471
24916,2020-03-07,(12003) Ricaurte,743,593,588,1924
24917,2020-04-20,(07102) NQS - CALLE 75,182,144,110,436
24918,2020-02-04,(03013) RIO NEGRO,1311,849,902,3062
24919,2020-03-24,(03013) RIO NEGRO,226,159,175,560
24920,2020-06-26,(09000) Cabecera Usme - alimentacion,9054,4984,5386,19424
24921,2020-06-27,(06000) Portal Eldorado - alimentacion,3274,1620,1832,6726
24922,2020-05-11,(07000) Portal Sur - alimentacion,5705,3155,2416,11276
24923,2020-01-07,(02303) Calle 85,2516,1718,1431,5665
24924,2020-06-12,(07000) Portal Sur - alimentacion,7866,4523,3751,16140
24925,2020-07-16,(09103) Olaya,721,420,400,1541
24926,2020-08-12,(09103) Olaya,978,540,519,2037
24927,2020-09-28,(07111) NQS - RICAURTE,1182,773,655,2610
24928,2020-10-02,(07111) NQS - RICAURTE,1239,767,749,2755
24929,2020-08-07,(02000) Cabecera Autopista Norte - alimentacion,2080,1014,1148,4242
24930,2020-03-27,(02000) Cabecera Autopista Norte,508,318,329,1155
24931,2020-05-15,(02000) Cabecera Autopista Norte,973,622,551,2146
24932,2020-07-18,(02000) Cabecera Autopista Norte,903,543,562,2008
24933,2020-08-28,(02000) Cabecera Autopista Norte,1366,806,870,3042
24934,2020-09-22,(04102) Avenida Boyaca,448,268,362,1078
24935,2020-09-24,(09004) Santa Lucía,2703,1402,1620,5725
24936,2020-02-28,(02104) Calle 146,9465,5352,5042,19859
24937,2020-05-12,(50003) Corral Molinos,1124,594,747,2465
24938,2020-07-09,(50003) Corral Molinos,1580,871,1091,3542
24939,2020-04-23,(05000) Portal Américas,1349,993,1033,3375
24940,2020-05-01,(05000) Portal Américas,687,454,497,1638
24941,2020-05-15,(05000) Portal Américas,1859,1257,1380,4496
24942,2020-10-11,(05000) Portal Américas,1042,500,1073,2615
24943,2020-01-15,(09123) Calle 76,4129,2798,2497,9424
24944,2020-05-18,(08000) Portal Tunal - alimentacion,5342,2821,2771,10934
24945,2020-03-25,(04002) Carrera 90,352,200,193,745
24946,2020-08-08,(04002) Carrera 90,405,232,288,925
24947,2020-08-14,(04100) Carrera 77,1072,570,810,2452
24948,2020-02-28,(06000) Portal Eldorado,6332,3837,2994,13163
24949,2020-01-23,(10008) San Diego,1351,754,705,2810
24950,2020-02-11,(10000) Portal 20 de Julio,9497,4479,4057,18033
24951,2020-08-04,(12001) Carrera 43,362,188,189,739
24952,2020-01-28,(10006) San Victorino,2358,1198,1188,4744
24953,2020-09-18,(02000) Cabecera Autopista Norte - intermunicipal,652,396,528,1576
24954,2020-03-05,(06100) Av. Rojas,2713,1522,1306,5541
24955,2020-03-01,(04106) Carrera 47,381,188,351,920
24956,2020-06-08,(02303) Calle 85,651,456,308,1415
24957,2020-03-01,(04002) Carrera 90,730,313,723,1766
24958,2020-08-11,(10001) Country Sur,1226,559,709,2494
24959,2020-07-27,(09116) Avenida 39,327,207,202,736
24960,2020-03-11,(07007) NQS - Calle 38A Sur,2067,1177,1172,4416
24961,2020-07-23,(09000) Cabecera Usme - alimentacion,6004,3325,3402,12731
24962,2020-02-11,(09116) Avenida 39,3466,2152,1623,7241
24963,2020-02-09,(05103) Marsella,478,200,501,1179
24964,2020-03-12,(05100) Banderas P. Central - alimentacion,687,3300,2210,6197
24965,2020-09-15,(09107) Hortúa,613,388,421,1422
24966,2020-09-18,(09123) Calle 76,1111,771,807,2689
24967,2020-09-25,(02204) Pepe Sierra,910,629,573,2112
24968,2020-03-15,(03000) Portal Suba,1132,532,1034,2698
24969,2020-03-06,(03012) SUBA - CALLE 95,1421,887,1040,3348
24970,2020-06-20,(07104) Simon Bolivar,465,318,258,1041
24971,2020-04-30,(05005) Transversal 86,237,126,128,491
24972,2020-08-13,(05005) Transversal 86,356,197,260,813
24973,2020-09-05,(05001) Patio Bonito,1862,877,1156,3895
24974,2020-07-10,(09001) Molinos,2560,1507,1948,6015
24975,2020-08-21,(02202) Calle 127,1035,733,557,2325
24976,2020-03-19,(08000) Portal Tunal,1338,700,604,2642
24977,2020-03-17,(06109) Centro Memoria,769,422,357,1548
24978,2020-08-01,(08000) Portal Tunal - alimentacion,4592,2340,2671,9603
24979,2020-04-15,(08000) Portal Tunal,441,231,212,884
24980,2020-02-21,(07113) SANTA ISABEL,2117,1207,1394,4718
24981,2020-07-03,(04003) Avenida Ciudad de Cali,1130,626,846,2602
24982,2020-05-25,(03000) Portal Suba,284,143,223,650
24983,2020-03-02,(04108) El Polo,1908,1179,1197,4284
24984,2020-05-11,(02304) Heroes,596,415,315,1326
24985,2020-03-09,(07103) AV. CHILE,1424,310,413,2147
24986,2020-09-01,(07103) AV. CHILE,917,600,500,2017
24987,2020-07-31,(07113) SANTA ISABEL,301,186,239,726
24988,2020-08-21,(04104) Avenida 68,626,308,349,1283
24989,2020-08-31,(07000) Portal Sur,1985,1237,1248,4470
24990,2020-04-10,(09100) Calle 40 Sur,246,158,151,555
24991,2020-04-14,(09100) Calle 40 Sur,848,527,564,1939
24992,2020-07-14,(10005) Bicentenario - alimentacion,179,77,117,373
24993,2020-08-18,(06000) Portal Eldorado,893,571,455,1919
24994,2020-08-30,(09109) Tercer Milenio,122,65,109,296
24995,2020-09-15,(09109) Tercer Milenio,367,204,237,808
24996,2020-05-07,(05001) Patio Bonito,1298,671,674,2643
24997,2020-09-15,(05001) Patio Bonito,2046,1093,1223,4362
24998,2020-03-21,(10001) Country Sur,361,135,190,686
24999,2020-08-10,(08000) Portal Tunal,798,303,255,1356
25000,2020-01-03,(40001) Juan Pablo II,993,507,658,2158
25001,2020-02-12,(07101) CASTELLANA,1002,650,600,2252
25002,2020-08-13,(07109) CAD,574,364,298,1236
25003,2020-10-05,(07109) CAD,719,481,440,1640
25004,2020-03-01,(02202) Calle 127,1023,711,1009,2743
25005,2020-09-07,(02302) Virrey,716,493,401,1610
25006,2020-08-17,(12003) Ricaurte,64,55,56,175
25007,2020-08-29,(12003) Ricaurte,268,208,204,680
25008,2020-09-14,(03013) RIO NEGRO,307,171,211,689
25009,2020-08-28,(04106) Carrera 47,351,167,202,720
25010,2020-05-08,(02105) Calle 142,571,350,300,1221
25011,2020-05-07,(09116) Avenida 39,210,150,157,517
25012,2020-07-13,(03002) SUBA - TV- 91,701,418,399,1518
25013,2020-07-16,(02103) Mazurén,176,104,140,420
25014,2020-04-19,(09000) Cabecera Usme - alimentacion,1566,905,1044,3515
25015,2020-10-10,(12007) Zona Industrial,204,168,190,562
25016,2020-10-09,(10005) Bicentenario,129,74,100,303
25017,2020-10-06,(02001) Centro Comercial Santa Fe,663,373,549,1585
25018,2020-03-15,(02102) Calle 161,178,105,246,529
25019,2020-09-28,(10008) San Diego,352,201,213,766
25020,2020-08-06,(03011) SUBA - CALLE 100,401,206,216,823
25021,2020-09-09,(03011) SUBA - CALLE 100,586,258,297,1141
25022,2020-06-26,(10006) San Victorino,752,371,351,1474
25023,2020-01-02,(06111) Universidades,993,618,950,2561
25024,2020-06-26,(12007) Zona Industrial,376,249,180,805
25025,2020-05-11,(09004) Santa Lucía,1793,918,924,3635
25026,2020-06-24,(40001) Juan Pablo II,585,355,393,1333
25027,2020-09-14,(07111) NQS - RICAURTE,1119,668,530,2317
25028,2020-08-20,(09115) Calle 34,600,377,370,1347
25029,2020-10-12,(10002) Av. Primero de Mayo,749,329,776,1854
25030,2020-08-11,(09120) Calle 63,1043,682,654,2379
25031,2020-03-27,(05102) Av. Américas - Av. Boyacá,136,69,80,285
25032,2020-05-22,(05001) Patio Bonito,1466,777,832,3075
25033,2020-09-08,(09122) Calle 72,1268,829,874,2971
25034,2020-03-07,(06103) CAN,678,562,941,2181
25035,2020-04-20,(06109) Centro Memoria,172,119,107,398
25036,2020-06-06,(09111) Calle 19,571,381,379,1331
25037,2020-08-30,(02000) Cabecera Autopista Norte,410,264,370,1044
25038,2020-09-08,(07201) Guatoque -Veraguas,208,119,118,445
25039,2020-06-23,(07105) MOVISTAR ARENA,264,186,158,608
25040,2020-07-19,(07105) MOVISTAR ARENA,58,37,52,147
25041,2020-06-23,(14005) Las Aguas,191,112,217,520
25042,2020-03-11,(04102) Avenida Boyaca,2829,1726,1478,6033
25043,2020-07-13,(04003) Avenida Ciudad de Cali,882,495,550,1927
25044,2020-07-15,(03003) 21 ANGELES,288,152,146,586
25045,2020-07-28,(07001) PERDOMO,818,510,494,1822
25046,2020-09-24,(10007) Las Nieves,735,454,459,1648
25047,2020-01-01,(02000) Cabecera Autopista Norte - intermunicipal,170,113,323,606
25048,2020-06-23,(06102) Salitre El Greco,252,130,123,505
25049,2020-05-05,(02200) Alcalá,1090,794,580,2464
25050,2020-04-29,(02104) Calle 146,452,300,283,1035
25051,2020-06-06,(07007) NQS - Calle 38A Sur,290,134,176,600
25052,2020-06-12,(12000) Puente Aranda,86,55,37,178
25053,2020-09-17,(06002) Normandía,351,193,254,798
25054,2020-10-06,(07107) U. NACIONAL,407,255,296,958
25055,2020-04-06,(07505) LEON XIII,1184,658,605,2447
25056,2020-06-25,(06001) Modelia,394,271,248,913
25057,2020-07-26,(10009) Museo Nacional,76,63,80,219
25058,2020-09-07,(08000) Portal Tunal,777,334,321,1432
25059,2020-04-07,(03013) RIO NEGRO,133,84,87,304
25060,2020-07-16,(07109) CAD,580,366,254,1200
25061,2020-06-13,(02502) Terminal,231,171,240,642
25062,2020-01-15,(05101) Mandalay - Cr.73,952,521,502,1975
25063,2020-04-30,(07112) COMUNEROS,478,303,231,1012
25064,2020-03-31,(12002) CDS - Carrera 32,135,107,64,306
25065,2020-08-12,(04105) Carrera 53,217,126,135,478
25066,2020-04-25,(06002) Normandía,124,79,91,294
25067,2020-06-26,(06002) Normandía,341,212,200,753
25068,2020-03-26,(04101) Minuto de Dios,137,110,109,356
25069,2020-09-03,(09108) Hospital,33,35,94,162
25070,2020-03-21,(09121) Las Flores,298,198,157,653
25071,2020-01-07,(07006) General Santander - alimentacion,957,591,804,2352
25072,2020-06-06,(07006) General Santander - alimentacion,255,143,166,564
25073,2020-08-09,(10005) Bicentenario - alimentacion,44,33,83,160
25074,2020-05-02,(09116) Avenida 39,103,89,109,301
25075,2020-01-01,(09121) Las Flores,225,150,397,772
25076,2020-05-05,(05101) Mandalay - Cr.73,81,51,36,168
25077,2020-05-16,(10008) San Diego,163,106,114,383
25078,2020-04-22,(12001) Carrera 43,298,196,129,623
25079,2020-08-29,(07010) Bosa,554,229,419,1202
25080,2020-07-31,(12007) Zona Industrial,245,150,130,525
25081,2020-05-18,(07003) SEVILLANA,346,201,172,719
25082,2020-08-29,(03007) HUMEDAL CORDOBA,93,71,72,236
25083,2020-01-06,(09108) Hospital,45,33,81,159
25084,2020-08-29,(07006) General Santander,478,251,312,1041
25085,2020-05-23,(07008) NQS - Calle 30 Sur,164,87,86,337
25086,2020-06-08,(06103) CAN,362,242,167,771
25087,2020-06-29,(40001) Juan Pablo II,200,101,156,457
25088,2020-07-26,(06101) El Tiempo,85,51,71,207
25089,2020-06-30,(03004) GRATAMIRA,29,21,28,78
25090,2020-01-06,(07102) NQS - CALLE 75,161,138,234,533
25091,2020-08-16,(09101) Quiroga,182,60,147,389
25092,2020-04-23,(04106) Carrera 47,185,95,84,364
25093,2020-01-29,(03014) SAN MARTIN,275,164,169,608
25094,2020-03-18,(03014) SAN MARTIN,107,71,87,265
25095,2020-04-26,(02103) Mazurén,28,28,21,77
25096,2020-01-07,(12000) Puente Aranda,193,118,135,446
25097,2020-04-07,(07201) Guatoque -Veraguas,62,51,88,201
25098,2020-05-30,(06106) Recinto Ferial,183,108,76,367
25099,2020-03-21,(04101) Minuto de Dios,103,69,66,238
25100,2020-09-17,(50002) Corral Calle 40 Sur,22,15,29,66
25101,2020-08-17,(02102) Calle 161,54,31,41,126
25102,2020-04-03,(50006) Corral Carrera 77,7,3,4,14
25103,2020-04-30,(14004) Museo del Oro,0,70,120,190
25104,2020-03-29,(07106) EL CAMPIN,45,42,37,124
25105,2020-10-13,(02304) Heroes,0,0,1,1
25106,2020-10-01,(02502) Terminal,509,389,556,1454
25107,2020-02-23,(09118) Marly,1385,878,1339,3602
25108,2020-03-13,(07504) TERREROS,344,3924,2910,7178
25109,2020-09-23,(07504) TERREROS,7161,3718,3828,14707
25110,2020-03-18,(10000) Portal 20 de Julio - alimentacion,7182,3654,4898,15734
25111,2020-02-06,(07111) NQS - RICAURTE,3010,2180,1929,7119
25112,2020-10-05,(07111) NQS - RICAURTE,1225,760,670,2655
25113,2020-02-18,(03000) Portal Suba - alimentacion,30069,17980,16645,64694
25114,2020-03-06,(04002) Carrera 90,3774,2149,2073,7996
25115,2020-01-30,(07111) NQS - RICAURTE,3145,1961,1810,6916
25116,2020-04-01,(09001) Molinos,1222,628,929,2779
25117,2020-01-20,(02000) Cabecera Autopista Norte - alimentacion,21171,11815,12608,45594
25118,2020-01-22,(05001) Patio Bonito,6283,3635,3518,13436
25119,2020-03-05,(07112) COMUNEROS,3802,2191,2308,8301
25120,2020-09-01,(05100) Banderas P. Central,914,492,579,1985
25121,2020-08-06,(10001) Country Sur,1208,583,722,2513
25122,2020-01-22,(02105) Calle 142,6671,4015,3638,14324
25123,2020-04-15,(06000) Portal Eldorado - alimentacion,2355,1140,1034,4529
25124,2020-02-17,(10003) Ciudad Jardín,1074,582,674,2330
25125,2020-02-19,(02502) Terminal,5525,3575,2886,11986
25126,2020-02-01,(09000) Cabecera Usme - alimentacion,17617,8653,12719,38989
25127,2020-04-14,(07001) PERDOMO,451,264,276,991
25128,2020-01-20,(40003) Mirador del Paraiso,4506,2542,2672,9720
25129,2020-06-18,(07505) LEON XIII,2772,1540,1230,5542
25130,2020-08-15,(07505) LEON XIII,2276,1137,1111,4524
25131,2020-10-08,(02101) Toberín,1879,1156,1542,4577
25132,2020-03-30,(06002) Normandía,157,103,99,359
25133,2020-09-25,(10000) Portal 20 de Julio - alimentacion,4578,2051,3141,9770
25134,2020-01-02,(03009) Av. Suba- Calle 116,1183,723,675,2581
25135,2020-09-29,(05000) Portal Américas,3992,2184,2702,8878
25136,2020-01-13,(07110) PALOQUEMAO,2029,1208,1005,4242
25137,2020-01-27,(50003) Corral Molinos,3187,2057,3295,8539
25138,2020-02-24,(02103) Mazurén,3373,2156,1838,7367
25139,2020-04-13,(09104) Restrepo,744,501,595,1840
25140,2020-06-23,(02103) Mazurén,231,144,181,556
25141,2020-07-21,(05100) Banderas P. Central - alimentacion,2728,1462,1429,5619
25142,2020-01-22,(14001) La Sabana,394,312,343,1049
25143,2020-06-10,(14001) La Sabana,150,92,94,336
25144,2020-09-02,(14001) La Sabana,162,101,114,377
25145,2020-03-12,(07002) MADELENA,178,1173,853,2204
25146,2020-06-05,(02000) Cabecera Autopista Norte,1241,766,689,2696
25147,2020-09-28,(02000) Cabecera Autopista Norte,1618,1020,1241,3879
25148,2020-08-01,(09113) Calle 22,365,198,273,836
25149,2020-05-12,(04000) Cabecera Calle 80,799,529,509,1837
25150,2020-08-03,(04000) Cabecera Calle 80,815,568,613,1996
25151,2020-08-04,(04000) Cabecera Calle 80,855,585,733,2173
25152,2020-05-15,(08000) Portal Tunal - alimentacion,5128,2777,2671,10576
25153,2020-01-16,(05002) Tintal,9794,5264,5466,20524
25154,2020-09-17,(07506) DESPENSA,479,277,319,1075
25155,2020-02-19,(10008) San Diego,1700,868,781,3349
25156,2020-01-23,(40003) Mirador del Paraiso,4615,2630,2397,9642
25157,2020-09-17,(06000) Portal Eldorado - alimentacion,4270,2118,2555,8943
25158,2020-01-28,(02001) Centro Comercial Santa Fe,4698,2951,2602,10251
25159,2020-03-16,(02201) Prado,3634,2364,1970,7968
25160,2020-03-11,(02304) Heroes,4621,3218,2266,10105
25161,2020-02-07,(03000) Portal Suba,9718,5298,5440,20456
25162,2020-05-04,(02000) Cabecera Autopista Norte - intermunicipal,283,192,183,658
25163,2020-05-13,(02000) Cabecera Autopista Norte - intermunicipal,357,238,224,819
25164,2020-07-15,(02000) Cabecera Autopista Norte - intermunicipal,500,297,349,1146
25165,2020-08-04,(02000) Cabecera Autopista Norte - intermunicipal,475,332,305,1112
25166,2020-09-17,(02000) Cabecera Autopista Norte - intermunicipal,599,388,482,1469
25167,2020-07-11,(09000) Cabecera Usme - alimentacion,7247,3895,5150,16292
25168,2020-03-16,(08001) Parque el Tunal,1313,737,721,2771
25169,2020-03-11,(09119) Calle 57,3574,2156,2091,7821
25170,2020-03-05,(09108) Hospital,245,171,214,630
25171,2020-09-11,(07000) Portal Sur,2080,1267,1384,4731
25172,2020-07-19,(07503) SAN MATEO,2575,1490,1333,5398
25173,2020-01-25,(09118) Marly,3180,2049,2537,7766
25174,2020-01-09,(07007) NQS - Calle 38A Sur,1482,887,992,3361
25175,2020-10-02,(06108) Concejo de Bogotá,163,91,135,389
25176,2020-09-25,(14004) Museo del Oro,417,281,345,1043
25177,2020-07-03,(02201) Prado,982,645,633,2260
25178,2020-01-02,(06001) Modelia,910,642,690,2242
25179,2020-02-20,(06001) Modelia,2521,1491,1210,5222
25180,2020-01-06,(07110) PALOQUEMAO,310,218,331,859
25181,2020-01-08,(04003) Avenida Ciudad de Cali,3900,2179,2507,8586
25182,2020-01-01,(09107) Hortúa,272,135,326,733
25183,2020-01-11,(05105) Pradera,1183,807,798,2788
25184,2020-03-13,(05105) Pradera,756,212,298,1266
25185,2020-08-13,(02300) Calle 100,1083,698,597,2378
25186,2020-10-02,(03012) SUBA - CALLE 95,413,244,292,949
25187,2020-02-05,(06109) Centro Memoria,1233,696,622,2551
25188,2020-06-18,(03000) Portal Suba - alimentacion,6052,3703,3338,13093
25189,2020-01-06,(10002) Av. Primero de Mayo,1292,627,1386,3305
25190,2020-07-09,(04101) Minuto de Dios,357,202,282,841
25191,2020-07-15,(04003) Avenida Ciudad de Cali,860,497,593,1950
25192,2020-08-10,(04003) Avenida Ciudad de Cali,819,487,621,1927
25193,2020-09-10,(04003) Avenida Ciudad de Cali,981,526,694,2201
25194,2020-02-14,(04108) El Polo,1931,1269,1241,4441
25195,2020-06-10,(04108) El Polo,450,278,220,948
25196,2020-02-06,(12007) Zona Industrial,1330,799,690,2819
25197,2020-02-22,(12007) Zona Industrial,692,439,469,1600
25198,2020-07-26,(08000) Portal Tunal - alimentacion,1666,772,1074,3512
25199,2020-01-04,(05001) Patio Bonito,2714,1367,1739,5820
25200,2020-03-14,(09100) Calle 40 Sur,3909,1928,2881,8718
25201,2020-07-22,(03000) Portal Suba - alimentacion,5566,3143,3099,11808
25202,2020-04-16,(03007) HUMEDAL CORDOBA,78,54,28,160
25203,2020-09-21,(03007) HUMEDAL CORDOBA,151,98,78,327
25204,2020-03-02,(03010) PUENTE LARGO,2087,1349,1206,4642
25205,2020-02-20,(05101) Mandalay - Cr.73,1203,673,503,2379
25206,2020-04-13,(02101) Toberín,594,434,389,1417
25207,2020-07-05,(05100) Banderas P. Central,212,74,182,468
25208,2020-06-11,(05100) Banderas P. Central - alimentacion,2236,1166,1498,4900
25209,2020-06-05,(07104) Simon Bolivar,583,359,258,1200
25210,2020-01-23,(04107) Escuela Militar,590,403,418,1411
25211,2020-06-20,(07109) CAD,413,304,231,948
25212,2020-01-22,(06111) Universidades,4972,3120,2418,10510
25213,2020-04-25,(09001) Molinos,900,556,655,2111
25214,2020-03-19,(07108) Av. El Dorado,399,278,268,945
25215,2020-04-14,(05103) Marsella,175,100,85,360
25216,2020-06-12,(05103) Marsella,355,203,187,745
25217,2020-06-17,(05103) Marsella,448,222,250,920
25218,2020-05-14,(09118) Marly,1277,822,573,2672
25219,2020-09-20,(09100) Calle 40 Sur,642,333,637,1612
25220,2020-05-27,(04002) Carrera 90,610,346,300,1256
25221,2020-09-23,(06101) El Tiempo,402,256,275,933
25222,2020-05-28,(05002) Tintal,2089,1059,1140,4288
25223,2020-04-14,(05001) Patio Bonito,938,525,549,2012
25224,2020-04-07,(04108) El Polo,189,132,138,459
25225,2020-08-10,(04108) El Polo,370,239,185,794
25226,2020-09-08,(03013) RIO NEGRO,297,169,201,667
25227,2020-01-09,(06103) CAN,1734,970,869,3573
25228,2020-06-04,(06103) CAN,355,213,151,719
25229,2020-08-05,(07009) SENA,507,280,351,1138
25230,2020-07-14,(06103) CAN,335,204,142,681
25231,2020-01-06,(05001) Patio Bonito,1210,615,1053,2878
25232,2020-02-05,(07107) U. NACIONAL,2720,1652,1403,5775
25233,2020-02-02,(03000) Portal Suba,1430,668,1564,3662
25234,2020-08-13,(07103) AV. CHILE,702,466,410,1578
25235,2020-08-21,(04001) Quirigua,357,230,262,849
25236,2020-05-02,(07103) AV. CHILE,353,225,205,783
25237,2020-03-09,(06109) Centro Memoria,539,100,144,783
25238,2020-02-25,(07105) MOVISTAR ARENA,1374,843,687,2904
25239,2020-03-16,(10005) Bicentenario,628,320,248,1196
25240,2020-02-11,(40002) Manitas,1360,820,832,3012
25241,2020-09-28,(09106) Nariño,464,287,373,1124
25242,2020-07-13,(05105) Pradera,569,308,202,1079
25243,2020-06-16,(02001) Centro Comercial Santa Fe,499,336,303,1138
25244,2020-09-05,(09118) Marly,1097,741,816,2654
25245,2020-09-05,(14001) La Sabana,136,84,115,335
25246,2020-06-03,(09004) Santa Lucía,2392,1255,1307,4954
25247,2020-03-22,(09115) Calle 34,122,85,83,290
25248,2020-04-09,(07110) PALOQUEMAO,121,107,54,282
25249,2020-04-28,(07110) PALOQUEMAO,538,320,207,1065
25250,2020-07-06,(07110) PALOQUEMAO,675,414,337,1426
25251,2020-05-19,(03006) NIZA - CALLE 127,343,222,158,723
25252,2020-04-02,(07006) General Santander,251,147,147,545
25253,2020-01-10,(14005) Las Aguas,1232,845,1138,3215
25254,2020-10-10,(05002) Tintal,2209,1055,1951,5215
25255,2020-02-17,(09111) Calle 19,2459,1435,1559,5453
25256,2020-09-13,(09122) Calle 72,370,227,492,1089
25257,2020-05-27,(12002) CDS - Carrera 32,209,137,75,421
25258,2020-06-05,(12002) CDS - Carrera 32,197,140,64,401
25259,2020-08-26,(04003) Avenida Ciudad de Cali,896,536,647,2079
25260,2020-09-24,(07001) PERDOMO,1096,622,808,2526
25261,2020-04-09,(09103) Olaya,190,124,109,423
25262,2020-08-17,(09002) Consuelo,167,74,114,355
25263,2020-03-26,(09121) Las Flores,437,293,252,982
25264,2020-07-21,(07003) SEVILLANA,372,226,214,812
25265,2020-10-06,(07000) Portal Sur,2315,1356,1751,5422
25266,2020-03-12,(03006) NIZA - CALLE 127,682,301,346,1329
25267,2020-05-23,(07110) PALOQUEMAO,423,254,179,856
25268,2020-07-21,(04001) Quirigua,331,204,190,725
25269,2020-04-02,(06107) Ciudad Universitaria,110,70,77,257
25270,2020-06-20,(07001) PERDOMO,686,374,495,1555
25271,2020-06-25,(05102) Av. Américas - Av. Boyacá,270,149,139,558
25272,2020-07-18,(40001) Juan Pablo II,324,184,211,719
25273,2020-05-18,(09114) Calle 26,214,163,166,543
25274,2020-08-11,(08002) Biblioteca,297,172,169,638
25275,2020-05-25,(50003) Corral Molinos,460,249,361,1070
25276,2020-06-17,(12000) Puente Aranda,88,46,48,182
25277,2020-05-15,(03005) SUBA - AV. BOYACA,319,190,198,707
25278,2020-06-18,(03005) SUBA - AV. BOYACA,448,279,256,983
25279,2020-05-11,(07506) DESPENSA,313,200,195,708
25280,2020-04-30,(07002) MADELENA,399,228,228,855
25281,2020-09-13,(04106) Carrera 47,129,63,129,321
25282,2020-05-16,(09109) Tercer Milenio,218,139,163,520
25283,2020-08-01,(07110) PALOQUEMAO,411,271,224,906
25284,2020-04-12,(09119) Calle 57,105,79,71,255
25285,2020-10-11,(06002) Normandía,104,57,131,292
25286,2020-06-14,(07104) Simon Bolivar,124,86,110,320
25287,2020-09-15,(07008) NQS - Calle 30 Sur,365,182,254,801
25288,2020-09-22,(07008) NQS - Calle 30 Sur,393,189,259,841
25289,2020-10-03,(07008) NQS - Calle 30 Sur,354,159,284,797
25290,2020-03-21,(02200) Alcalá,642,440,293,1375
25291,2020-06-28,(09122) Calle 72,322,244,310,876
25292,2020-05-10,(02001) Centro Comercial Santa Fe,65,57,50,172
25293,2020-04-15,(02502) Terminal,172,122,148,442
25294,2020-06-28,(07005) ALQUERIA,184,100,126,410
25295,2020-07-30,(04105) Carrera 53,303,147,148,598
25296,2020-07-18,(07108) Av. El Dorado,97,58,60,215
25297,2020-06-21,(07000) Portal Sur,447,287,422,1156
25298,2020-06-30,(06002) Normandía,343,166,221,730
25299,2020-01-06,(03009) Av. Suba- Calle 116,353,237,331,921
25300,2020-06-26,(07008) NQS - Calle 30 Sur,335,190,204,729
25301,2020-08-24,(04001) Quirigua,344,208,203,755
25302,2020-06-30,(04000) Cabecera Calle 80 - intermunicipal,352,196,335,883
25303,2020-07-11,(04103) Las Ferias,296,162,173,631
25304,2020-03-03,(03014) SAN MARTIN,261,149,171,581
25305,2020-08-31,(05103) Marsella,370,224,275,869
25306,2020-06-27,(07005) ALQUERIA,516,274,285,1075
25307,2020-04-19,(03009) Av. Suba- Calle 116,124,90,67,281
25308,2020-05-29,(07200) Tygua-San José,224,101,139,464
25309,2020-10-10,(06100) Av. Rojas,144,113,213,470
25310,2020-08-04,(07109) CAD,512,325,261,1098
25311,2020-04-13,(12001) Carrera 43,282,188,129,599
25312,2020-07-26,(09123) Calle 76,195,143,160,498
25313,2020-07-08,(07008) NQS - Calle 30 Sur,330,174,203,707
25314,2020-07-18,(09108) Hospital,53,27,55,135
25315,2020-05-20,(06102) Salitre El Greco,168,89,91,348
25316,2020-09-24,(03007) HUMEDAL CORDOBA,172,117,119,408
25317,2020-06-21,(09109) Tercer Milenio,96,54,100,250
25318,2020-05-19,(03004) GRATAMIRA,20,11,19,50
25319,2020-06-11,(03002) SUBA - TV- 91,740,462,401,1603
25320,2020-05-15,(07008) NQS - Calle 30 Sur,215,115,116,446
25321,2020-05-18,(14005) Las Aguas,0,57,163,220
25322,2020-03-23,(12003) Ricaurte,41,40,23,104
25323,2020-08-15,(04107) Escuela Militar,89,64,66,219
25324,2020-02-11,(03014) SAN MARTIN,267,163,173,603
25325,2020-08-20,(06103) CAN,324,200,166,690
25326,2020-02-02,(05101) Mandalay - Cr.73,137,55,134,326
25327,2020-03-09,(50002) Corral Calle 40 Sur,10,35,37,82
25328,2020-09-12,(05101) Mandalay - Cr.73,111,57,87,255
25329,2020-07-20,(05101) Mandalay - Cr.73,25,11,29,65
25330,2020-10-11,(02304) Heroes,200,183,267,650
25331,2020-04-06,(04107) Escuela Militar,47,41,49,137
25332,2020-05-01,(07506) DESPENSA,148,81,80,309
25333,2020-07-24,(04105) Carrera 53,251,142,142,535
25334,2020-08-16,(05103) Marsella,114,47,80,241
25335,2020-05-24,(40002) Manitas,122,44,74,240
25336,2020-03-20,(10005) Bicentenario,34,24,15,73
25337,2020-05-06,(04001) Quirigua,227,154,135,516
25338,2020-06-08,(07108) Av. El Dorado,112,85,69,266
25339,2020-03-26,(12000) Puente Aranda,32,20,23,75
25340,2020-07-20,(06108) Concejo de Bogotá,53,33,31,117
25341,2020-08-17,(06105) Quinta Paredes,38,35,28,101
25342,2020-05-24,(07008) NQS - Calle 30 Sur,64,35,37,136
25343,2020-03-23,(10009) Museo Nacional,94,61,85,240
25344,2020-10-01,(05102) Av. Américas - Av. Boyacá,295,171,240,706
25345,2020-09-06,(50002) Corral Calle 40 Sur,6,3,10,19
25346,2020-05-10,(07008) NQS - Calle 30 Sur,46,23,29,98
25347,2020-01-15,(50006) Corral Carrera 77,27,16,34,77
25348,2020-05-17,(09108) Hospital,27,19,20,66
25349,2020-03-25,(14005) Las Aguas,0,50,98,148
25350,2020-09-10,(03014) SAN MARTIN,0,13,36,49
25351,2020-06-04,(03014) SAN MARTIN,18,11,27,56
25352,2020-04-09,(07101) CASTELLANA,21,15,23,59
25353,2019-12-31,(07108) Av. El Dorado,8,7,8,23
25354,2020-03-08,(04000) Cabecera Calle 80 - alimentacion,4690,2022,4887,11599
25355,2020-05-04,(04000) Cabecera Calle 80 - alimentacion,2455,1417,1520,5392
25356,2020-03-12,(09002) Consuelo,80,255,267,602
25357,2020-07-13,(02502) Terminal,385,282,263,930
25358,2020-09-22,(09118) Marly,1515,1001,1022,3538
25359,2020-02-02,(03013) RIO NEGRO,249,150,373,772
25360,2020-01-17,(09119) Calle 57,2574,1769,1873,6216
25361,2020-01-08,(07111) NQS - RICAURTE,2184,1458,1301,4943
25362,2020-09-23,(02303) Calle 85,886,591,507,1984
25363,2020-01-23,(07503) SAN MATEO,38809,21521,17342,77672
25364,2020-01-14,(02101) Toberín,12112,7447,6735,26294
25365,2020-08-09,(04002) Carrera 90,157,96,115,368
25366,2020-09-18,(04002) Carrera 90,850,441,528,1819
25367,2020-06-22,(10000) Portal 20 de Julio - alimentacion,1632,731,989,3352
25368,2020-01-11,(09100) Calle 40 Sur,3711,1769,2623,8103
25369,2020-08-03,(07503) SAN MATEO,10457,5810,4882,21149
25370,2020-08-05,(07503) SAN MATEO,10550,5881,4923,21354
25371,2020-08-14,(05000) Portal Américas - alimentacion,10776,5728,5654,22158
25372,2020-02-29,(09001) Molinos,5611,2577,4573,12761
25373,2020-01-02,(05000) Portal Américas,6484,3758,4635,14877
25374,2020-02-28,(07000) Portal Sur - alimentacion,29707,16150,14761,60618
25375,2020-10-03,(09000) Cabecera Usme,1588,786,1554,3928
25376,2020-02-25,(05100) Banderas P. Central - alimentacion,16441,9631,8439,34511
25377,2020-01-07,(02205) Calle 106,1685,1052,1045,3782
25378,2020-02-24,(02205) Calle 106,2788,1704,1328,5820
25379,2020-09-16,(40003) Mirador del Paraiso,1783,1038,1287,4108
25380,2020-01-11,(09109) Tercer Milenio,726,406,628,1760
25381,2020-05-21,(09109) Tercer Milenio,295,192,172,659
25382,2020-01-01,(09000) Cabecera Usme,498,248,780,1526
25383,2020-02-05,(09117) Calle 45,6584,4202,3035,13821
25384,2020-02-04,(09123) Calle 76,5827,3802,3275,12904
25385,2020-02-29,(07102) NQS - CALLE 75,749,590,776,2115
25386,2020-09-28,(07102) NQS - CALLE 75,473,348,289,1110
25387,2020-04-23,(03000) Portal Suba - alimentacion,3319,1930,1768,7017
25388,2020-10-10,(09118) Marly,1069,702,983,2754
25389,2020-01-27,(09103) Olaya,3806,2264,2303,8373
25390,2020-02-12,(02103) Mazurén,3655,2264,1893,7812
25391,2020-04-22,(09104) Restrepo,778,507,617,1902
25392,2020-03-10,(02303) Calle 85,2211,147,419,2777
25393,2020-07-07,(07000) Portal Sur - alimentacion,8610,5013,4282,17905
25394,2020-01-17,(09103) Olaya,3553,1894,2316,7763
25395,2020-02-28,(09103) Olaya,4303,2364,2460,9127
25396,2020-09-30,(09103) Olaya,1157,626,778,2561
25397,2020-02-28,(14001) La Sabana,621,394,399,1414
25398,2020-07-18,(02200) Alcalá,1279,801,677,2757
25399,2020-09-16,(07002) MADELENA,941,566,678,2185
25400,2020-07-16,(02000) Cabecera Autopista Norte,1197,744,692,2633
25401,2020-07-15,(09113) Calle 22,251,164,249,664
25402,2020-02-05,(04105) Carrera 53,1531,852,784,3167
25403,2020-01-02,(02000) Cabecera Autopista Norte - alimentacion,9663,5195,6657,21515
25404,2020-06-11,(07112) COMUNEROS,773,439,419,1631
25405,2020-06-24,(04002) Carrera 90,819,419,431,1669
25406,2020-07-07,(04002) Carrera 90,836,459,446,1741
25407,2020-07-06,(10001) Country Sur,1338,642,788,2768
25408,2020-01-07,(06109) Centro Memoria,747,433,482,1662
25409,2020-09-12,(10006) San Victorino,329,324,390,1043
25410,2020-09-13,(10006) San Victorino,179,144,166,489
25411,2020-06-21,(03000) Portal Suba,355,180,284,819
25412,2020-01-08,(04001) Quirigua,1323,765,948,3036
25413,2020-06-02,(09107) Hortúa,583,364,329,1276
25414,2020-02-17,(02302) Virrey,4016,2586,1798,8400
25415,2020-03-08,(07106) EL CAMPIN,458,317,426,1201
25416,2020-08-24,(06101) El Tiempo,322,182,204,708
25417,2020-08-08,(03000) Portal Suba,629,357,564,1550
25418,2020-10-05,(02000) Cabecera Autopista Norte - intermunicipal,679,446,607,1732
25419,2020-04-30,(10000) Portal 20 de Julio - alimentacion,2513,1239,1765,5517
25420,2020-03-25,(09101) Quiroga,182,117,147,446
25421,2020-02-10,(08001) Parque el Tunal,1720,1019,1010,3749
25422,2020-01-20,(06100) Av. Rojas,2298,1354,1135,4787
25423,2020-02-18,(06100) Av. Rojas,2969,1610,1320,5899
25424,2020-01-21,(06111) Universidades,3689,2148,1563,7400
25425,2020-03-15,(09108) Hospital,59,41,84,184
25426,2020-09-23,(04001) Quirigua,449,268,355,1072
25427,2020-07-25,(10000) Portal 20 de Julio,1324,690,786,2800
25428,2020-08-02,(07112) COMUNEROS,196,100,156,452
25429,2020-04-22,(07000) Portal Sur - alimentacion,4331,2311,1738,8380
25430,2020-01-19,(04002) Carrera 90,747,300,727,1774
25431,2020-03-16,(07008) NQS - Calle 30 Sur,1258,673,662,2593
25432,2020-02-14,(06108) Concejo de Bogotá,864,469,472,1805
25433,2020-09-18,(06108) Concejo de Bogotá,155,80,105,340
25434,2020-06-17,(07010) Bosa,754,378,423,1555
25435,2020-09-07,(04000) Cabecera Calle 80,1110,689,935,2734
25436,2020-02-14,(09116) Avenida 39,3065,2093,1644,6802
25437,2020-10-02,(08000) Portal Tunal - alimentacion,7165,3738,5137,16040
25438,2020-06-09,(02201) Prado,910,592,571,2073
25439,2020-06-24,(02201) Prado,943,636,565,2144
25440,2020-07-06,(02201) Prado,932,611,602,2145
25441,2020-07-16,(09004) Santa Lucía,1724,943,966,3633
25442,2020-06-30,(09107) Hortúa,615,382,396,1393
25443,2020-08-28,(09107) Hortúa,599,361,412,1372
25444,2020-09-14,(02204) Pepe Sierra,815,558,510,1883
25445,2020-09-15,(05002) Tintal,2785,1611,1769,6165
25446,2020-09-23,(05002) Tintal,3003,1797,2043,6843
25447,2020-04-02,(02201) Prado,393,313,227,933
25448,2020-08-16,(02201) Prado,248,148,210,606
25449,2020-03-03,(03011) SUBA - CALLE 100,2638,1386,1525,5549
25450,2020-05-18,(03012) SUBA - CALLE 95,281,172,156,609
25451,2020-09-28,(03012) SUBA - CALLE 95,368,212,293,873
25452,2020-02-09,(10000) Portal 20 de Julio,2157,838,1650,4645
25453,2020-05-27,(09119) Calle 57,473,327,300,1100
25454,2020-03-18,(07007) NQS - Calle 38A Sur,1045,616,599,2260
25455,2020-02-26,(05105) Pradera,2707,1493,1209,5409
25456,2020-09-30,(07104) Simon Bolivar,587,387,399,1373
25457,2020-07-23,(05005) Transversal 86,223,128,197,548
25458,2020-07-25,(06109) Centro Memoria,152,94,97,343
25459,2020-07-07,(05107) Américas - Cr.53,495,248,305,1048
25460,2020-08-01,(12000) Puente Aranda,39,40,28,107
25461,2020-08-01,(09101) Quiroga,384,181,294,859
25462,2020-09-08,(07113) SANTA ISABEL,393,236,316,945
25463,2020-06-04,(06000) Portal Eldorado - alimentacion,3756,1878,1737,7371
25464,2020-03-06,(07000) Portal Sur,7927,4321,4531,16779
25465,2020-01-30,(07201) Guatoque -Veraguas,999,518,627,2144
25466,2020-04-27,(07201) Guatoque -Veraguas,30,34,23,87
25467,2020-03-06,(07103) AV. CHILE,3497,2191,2073,7761
25468,2020-06-11,(07103) AV. CHILE,950,536,398,1884
25469,2020-06-15,(06000) Portal Eldorado - alimentacion,1415,679,805,2899
25470,2020-02-29,(09119) Calle 57,1715,1059,1611,4385
25471,2020-06-11,(03007) HUMEDAL CORDOBA,144,102,65,311
25472,2020-06-17,(03007) HUMEDAL CORDOBA,146,100,74,320
25473,2020-06-09,(04104) Avenida 68,609,318,305,1232
25474,2020-04-30,(08002) Biblioteca,180,104,112,396
25475,2020-06-06,(09100) Calle 40 Sur,1253,679,808,2740
25476,2020-05-27,(07104) Simon Bolivar,541,356,229,1126
25477,2020-01-29,(04107) Escuela Militar,641,376,440,1457
25478,2020-07-13,(04107) Escuela Militar,115,72,72,259
25479,2020-01-11,(05107) Américas - Cr.53,1158,702,866,2726
25480,2020-03-11,(03006) NIZA - CALLE 127,2257,1482,1432,5171
25481,2020-06-20,(05103) Marsella,307,163,183,653
25482,2020-08-28,(12001) Carrera 43,460,218,240,918
25483,2020-09-02,(05001) Patio Bonito,2205,1185,1271,4661
25484,2020-05-02,(06101) El Tiempo,140,103,81,324
25485,2020-01-05,(05001) Patio Bonito,1203,567,1179,2949
25486,2020-08-29,(03001) LA CAMPIÑA,848,405,602,1855
25487,2020-09-10,(06101) El Tiempo,312,177,207,696
25488,2020-03-21,(04104) Avenida 68,174,128,113,415
25489,2020-07-04,(04104) Avenida 68,491,299,344,1134
25490,2020-08-26,(02104) Calle 146,729,446,461,1636
25491,2020-04-06,(03002) SUBA - TV- 91,429,247,236,912
25492,2020-01-05,(12003) Ricaurte,97,91,144,332
25493,2020-03-08,(02202) Calle 127,1017,663,954,2634
25494,2020-06-10,(02202) Calle 127,1107,741,520,2368
25495,2020-05-15,(05002) Tintal,1627,855,911,3393
25496,2020-07-30,(02204) Pepe Sierra,734,507,407,1648
25497,2020-05-09,(09116) Avenida 39,161,99,108,368
25498,2020-03-08,(09002) Consuelo,371,136,320,827
25499,2020-10-01,(40001) Juan Pablo II,615,372,448,1435
25500,2020-04-01,(02001) Centro Comercial Santa Fe,171,114,143,428
25501,2020-07-21,(02001) Centro Comercial Santa Fe,447,317,282,1046
25502,2020-09-27,(05001) Patio Bonito,723,292,608,1623
25503,2020-01-12,(06100) Av. Rojas,164,94,246,504
25504,2020-04-15,(03009) Av. Suba- Calle 116,338,202,147,687
25505,2020-08-29,(04106) Carrera 47,276,126,194,596
25506,2020-08-17,(02105) Calle 142,186,130,181,497
25507,2020-01-14,(09109) Tercer Milenio,1157,705,768,2630
25508,2020-07-23,(09109) Tercer Milenio,233,146,181,560
25509,2020-09-02,(09116) Avenida 39,370,248,257,875
25510,2020-04-02,(07005) ALQUERIA,234,143,147,524
25511,2020-02-02,(03006) NIZA - CALLE 127,503,326,457,1286
25512,2020-03-02,(10005) Bicentenario,807,427,355,1589
25513,2020-03-27,(05107) Américas - Cr.53,266,230,168,664
25514,2020-09-21,(07103) AV. CHILE,846,535,490,1871
25515,2020-09-22,(12007) Zona Industrial,387,259,200,846
25516,2020-01-19,(14005) Las Aguas,261,199,547,1007
25517,2020-09-25,(02304) Heroes,1029,735,688,2452
25518,2020-08-03,(02001) Centro Comercial Santa Fe,385,247,259,891
25519,2020-02-09,(02102) Calle 161,266,151,336,753
25520,2020-02-22,(02102) Calle 161,773,370,732,1875
25521,2020-04-04,(07001) PERDOMO,311,172,206,689
25522,2020-01-05,(07102) NQS - CALLE 75,139,124,216,479
25523,2020-04-13,(10008) San Diego,145,116,88,349
25524,2020-09-18,(10008) San Diego,332,191,210,733
25525,2020-09-12,(09120) Calle 63,994,622,834,2450
25526,2020-06-03,(10009) Museo Nacional,465,272,276,1013
25527,2020-03-19,(09003) Socorro,986,548,608,2142
25528,2020-03-29,(05105) Pradera,91,67,54,212
25529,2020-08-20,(05105) Pradera,536,294,287,1117
25530,2020-05-20,(06111) Universidades,0,110,305,415
25531,2020-05-08,(09004) Santa Lucía,1700,907,889,3496
25532,2020-08-20,(40001) Juan Pablo II,505,306,349,1160
25533,2020-03-28,(05002) Tintal,688,414,372,1474
25534,2020-05-22,(09115) Calle 34,548,372,299,1219
25535,2020-10-05,(03006) NIZA - CALLE 127,557,331,386,1274
25536,2020-01-09,(07105) MOVISTAR ARENA,1002,602,549,2153
25537,2020-09-05,(07110) PALOQUEMAO,488,334,329,1151
25538,2020-06-21,(06000) Portal Eldorado,194,159,194,547
25539,2020-01-24,(12004) Carrera 22,632,408,473,1513
25540,2020-01-27,(12004) Carrera 22,697,398,457,1552
25541,2020-02-01,(07201) Guatoque -Veraguas,464,270,530,1264
25542,2020-07-13,(09106) Nariño,332,182,252,766
25543,2020-10-10,(06109) Centro Memoria,194,136,202,532
25544,2020-05-10,(09123) Calle 76,165,117,114,396
25545,2020-05-04,(07105) MOVISTAR ARENA,141,121,115,377
25546,2020-07-13,(07201) Guatoque -Veraguas,103,53,75,231
25547,2020-06-09,(07105) MOVISTAR ARENA,262,147,124,533
25548,2020-05-20,(07001) PERDOMO,707,408,452,1567
25549,2020-03-13,(09111) Calle 19,823,122,318,1263
25550,2020-08-15,(06107) Ciudad Universitaria,133,86,99,318
25551,2020-07-23,(03011) SUBA - CALLE 100,476,236,221,933
25552,2020-04-23,(05102) Av. Américas - Av. Boyacá,123,66,84,273
25553,2020-09-17,(05102) Av. Américas - Av. Boyacá,328,182,189,699
25554,2020-02-09,(10004) Policarpa,261,122,265,648
25555,2020-09-24,(03005) SUBA - AV. BOYACA,545,322,379,1246
25556,2020-04-03,(08002) Biblioteca,161,93,86,340
25557,2020-05-06,(12000) Puente Aranda,56,28,25,109
25558,2020-04-12,(07109) CAD,171,116,79,366
25559,2020-04-25,(14005) Las Aguas,0,28,100,128
25560,2020-06-14,(07506) DESPENSA,150,71,95,316
25561,2020-08-20,(02102) Calle 161,206,120,144,470
25562,2020-06-02,(02502) Terminal,360,245,310,915
25563,2020-07-29,(03013) RIO NEGRO,273,148,172,593
25564,2020-05-30,(04106) Carrera 47,231,124,143,498
25565,2020-03-05,(07200) Tygua-San José,784,498,573,1855
25566,2020-09-24,(02000) Cabecera Autopista Norte - intermunicipal,628,409,521,1558
25567,2020-07-10,(50003) Corral Molinos,1569,878,1189,3636
25568,2020-07-26,(40003) Mirador del Paraiso,464,261,383,1108
25569,2020-05-17,(09110) Avenida Jimenez,133,139,202,474
25570,2020-07-12,(09115) Calle 34,168,146,185,499
25571,2019-12-31,(03013) RIO NEGRO,17,11,24,52
25572,2020-07-17,(06101) El Tiempo,336,186,151,673
25573,2020-06-27,(04000) Cabecera Calle 80 - intermunicipal,207,116,249,572
25574,2020-08-13,(06100) Av. Rojas,199,135,128,462
25575,2020-05-23,(09105) Río Fucha,91,44,66,201
25576,2020-04-04,(05105) Pradera,242,186,128,556
25577,2020-04-22,(09117) Calle 45,468,317,222,1007
25578,2020-05-30,(12007) Zona Industrial,195,140,106,441
25579,2020-09-30,(07107) U. NACIONAL,399,258,317,974
25580,2020-07-19,(07006) General Santander,141,72,90,303
25581,2020-03-27,(07506) DESPENSA,206,91,137,434
25582,2020-03-27,(04001) Quirigua,161,93,91,345
25583,2020-07-13,(06103) CAN,339,201,140,680
25584,2020-01-01,(07002) MADELENA,248,125,372,745
25585,2020-06-06,(14004) Museo del Oro,0,62,148,210
25586,2020-07-16,(14004) Museo del Oro,271,154,167,592
25587,2020-06-14,(05105) Pradera,129,93,101,323
25588,2020-03-23,(06101) El Tiempo,120,73,58,251
25589,2020-04-02,(09121) Las Flores,398,285,241,924
25590,2020-04-18,(04106) Carrera 47,131,77,52,260
25591,2020-03-29,(07506) DESPENSA,77,42,64,183
25592,2020-04-16,(07506) DESPENSA,232,134,119,485
25593,2020-04-26,(09121) Las Flores,132,98,103,333
25594,2020-09-05,(04001) Quirigua,350,179,268,797
25595,2020-03-23,(03013) RIO NEGRO,65,49,39,153
25596,2020-09-20,(07200) Tygua-San José,85,55,89,229
25597,2020-05-14,(06106) Recinto Ferial,202,134,71,407
25598,2020-04-24,(04102) Avenida Boyaca,166,82,105,353
25599,2020-08-17,(09111) Calle 19,175,124,199,498
25600,2020-05-31,(06104) Gobernación,49,30,33,112
25601,2020-06-22,(04107) Escuela Militar,47,38,47,132
25602,2020-04-07,(06105) Quinta Paredes,74,55,25,154
25603,2020-04-04,(03005) SUBA - AV. BOYACA,144,100,94,338
25604,2020-04-10,(06100) Av. Rojas,26,21,25,72
25605,2020-04-06,(03010) PUENTE LARGO,188,159,120,467
25606,2020-05-03,(07008) NQS - Calle 30 Sur,53,37,35,125
25607,2020-04-26,(02104) Calle 146,149,122,80,351
25608,2020-08-01,(03014) SAN MARTIN,0,9,29,38
25609,2020-06-22,(05101) Mandalay - Cr.73,41,20,29,90
25610,2020-04-19,(04108) El Polo,44,35,39,118
25611,2020-08-21,(03004) GRATAMIRA,0,15,31,46
25612,2020-08-21,(50006) Corral Carrera 77,4,1,3,8
25613,2020-09-30,(04000) Cabecera Calle 80 - alimentacion,5009,2697,3919,11625
25614,2020-02-24,(03013) RIO NEGRO,1236,798,892,2926
25615,2020-09-10,(03013) RIO NEGRO,268,140,193,601
25616,2020-07-27,(10000) Portal 20 de Julio - alimentacion,3949,1817,2318,8084
25617,2020-07-17,(05000) Portal Américas - alimentacion,10158,5423,5030,20611
25618,2020-09-04,(05000) Portal Américas - alimentacion,12090,6573,7281,25944
25619,2020-02-01,(03002) SUBA - TV- 91,2302,1028,1696,5026
25620,2020-02-25,(07505) LEON XIII,8744,5024,3793,17561
25621,2020-03-06,(09122) Calle 72,7643,5149,4691,17483
25622,2020-02-19,(07503) SAN MATEO,41888,23745,17584,83217
25623,2020-03-09,(10000) Portal 20 de Julio - alimentacion,365,1952,1855,4172
25624,2020-03-13,(10000) Portal 20 de Julio - alimentacion,338,1489,1652,3479
25625,2020-08-04,(07503) SAN MATEO,10506,5801,4895,21202
25626,2020-02-25,(09001) Molinos,7647,4784,5857,18288
25627,2020-05-06,(09001) Molinos,1556,853,1031,3440
25628,2020-09-23,(09001) Molinos,3008,1489,2187,6684
25629,2020-01-26,(05001) Patio Bonito,1564,718,1378,3660
25630,2020-02-10,(05001) Patio Bonito,7390,4288,3871,15549
25631,2020-03-11,(05001) Patio Bonito,6986,3745,3443,14174
25632,2020-02-07,(04100) Carrera 77,6946,3915,4305,15166
25633,2020-06-06,(10001) Country Sur,777,373,552,1702
25634,2020-09-02,(10001) Country Sur,1323,618,808,2749
25635,2020-08-21,(09100) Calle 40 Sur,1636,894,1147,3677
25636,2020-03-05,(02102) Calle 161,1899,1149,1152,4200
25637,2020-01-14,(09000) Cabecera Usme,4972,2905,3705,11582
25638,2020-01-02,(10003) Ciudad Jardín,460,267,384,1111
25639,2020-02-10,(02205) Calle 106,2868,1762,1430,6060
25640,2020-01-06,(09109) Tercer Milenio,246,132,245,623
25641,2020-01-06,(09104) Restrepo,895,608,1075,2578
25642,2020-05-15,(07110) PALOQUEMAO,593,354,216,1163
25643,2020-02-21,(09004) Santa Lucía,7464,3923,4092,15479
25644,2020-07-29,(03002) SUBA - TV- 91,714,439,432,1585
25645,2020-07-22,(04100) Carrera 77,1061,618,738,2417
25646,2020-08-10,(07102) NQS - CALLE 75,334,214,188,736
25647,2020-09-10,(07102) NQS - CALLE 75,422,244,287,953
25648,2020-06-12,(09110) Avenida Jimenez,1000,785,806,2591
25649,2020-03-16,(03001) LA CAMPIÑA,4457,2586,2406,9449
25650,2020-07-08,(03001) LA CAMPIÑA,1246,725,694,2665
25651,2020-07-09,(03001) LA CAMPIÑA,1150,714,774,2638
25652,2020-06-06,(50003) Corral Molinos,1190,596,864,2650
25653,2020-03-07,(02103) Mazurén,1156,520,1217,2893
25654,2020-02-13,(02303) Calle 85,3900,2629,1822,8351
25655,2020-02-11,(14001) La Sabana,626,374,396,1396
25656,2020-09-11,(02000) Cabecera Autopista Norte,1410,831,1025,3266
25657,2020-05-23,(09113) Calle 22,372,204,257,833
25658,2020-01-10,(10007) Las Nieves,1432,956,1060,3448
25659,2020-01-29,(07109) CAD,2887,1730,1644,6261
25660,2020-08-31,(08000) Portal Tunal - alimentacion,6172,3374,3681,13227
25661,2020-03-24,(05000) Portal Américas,2120,1419,2013,5552
25662,2020-01-06,(07010) Bosa,386,217,478,1081
25663,2020-08-29,(08000) Portal Tunal - alimentacion,5172,2694,3147,11013
25664,2020-07-08,(09001) Molinos,2694,1489,1709,5892
25665,2020-04-20,(10001) Country Sur,598,256,358,1212
25666,2020-01-13,(04002) Carrera 90,2981,1736,1797,6514
25667,2020-03-14,(04100) Carrera 77,3404,1602,2635,7641
25668,2020-06-25,(40003) Mirador del Paraiso,1763,1135,1137,4035
25669,2020-05-02,(07000) Portal Sur - alimentacion,3481,1842,1461,6784
25670,2020-01-22,(09107) Hortúa,2188,1359,1380,4927
25671,2020-01-29,(06111) Universidades,5601,3436,2471,11508
25672,2020-06-05,(05100) Banderas P. Central - alimentacion,1983,1057,1369,4409
25673,2020-03-17,(02000) Cabecera Autopista Norte - intermunicipal,2098,1431,1371,4900
25674,2020-05-20,(03000) Portal Suba,985,600,635,2220
25675,2020-07-01,(03000) Portal Suba,1374,852,911,3137
25676,2020-04-23,(02000) Cabecera Autopista Norte - intermunicipal,172,120,117,409
25677,2020-04-02,(08001) Parque el Tunal,210,124,141,475
25678,2020-09-02,(10000) Portal 20 de Julio,2246,1174,1284,4704
25679,2020-02-06,(10000) Portal 20 de Julio,9029,4377,4197,17603
25680,2020-08-15,(07000) Portal Sur,1499,814,1129,3442
25681,2020-03-18,(10007) Las Nieves,1341,917,787,3045
25682,2020-04-15,(08001) Parque el Tunal,244,121,147,512
25683,2020-03-12,(09123) Calle 76,2717,211,638,3566
25684,2020-02-21,(07001) PERDOMO,4800,2542,2533,9875
25685,2020-03-02,(02304) Heroes,4685,3164,2211,10060
25686,2020-03-06,(09107) Hortúa,2417,1435,1526,5378
25687,2020-05-17,(09107) Hortúa,194,123,136,453
25688,2020-07-24,(09123) Calle 76,790,569,500,1859
25689,2020-06-09,(05002) Tintal,1934,1079,1107,4120
25690,2020-10-03,(05103) Marsella,450,180,344,974
25691,2020-09-12,(05002) Tintal,2304,1029,1592,4925
25692,2020-05-23,(03012) SUBA - CALLE 95,191,125,127,443
25693,2020-06-01,(03012) SUBA - CALLE 95,306,197,178,681
25694,2020-09-16,(03012) SUBA - CALLE 95,355,205,231,791
25695,2020-05-23,(10000) Portal 20 de Julio,1522,721,810,3053
25696,2020-01-14,(09001) Molinos,6430,3728,5441,15599
25697,2020-09-02,(08000) Portal Tunal,858,338,355,1551
25698,2020-03-05,(04105) Carrera 53,1424,790,786,3000
25699,2020-05-18,(03009) Av. Suba- Calle 116,450,281,211,942
25700,2020-03-30,(02205) Calle 106,178,141,112,431
25701,2020-05-05,(02205) Calle 106,214,159,115,488
25702,2020-01-08,(12007) Zona Industrial,980,670,512,2162
25703,2020-06-10,(07106) EL CAMPIN,335,218,207,760
25704,2020-10-01,(07106) EL CAMPIN,498,327,357,1182
25705,2020-09-11,(05101) Mandalay - Cr.73,147,89,98,334
25706,2020-03-11,(05103) Marsella,2882,1637,1424,5943
25707,2020-10-05,(02204) Pepe Sierra,901,648,636,2185
25708,2020-02-19,(07102) NQS - CALLE 75,1580,1038,943,3561
25709,2020-06-08,(07104) Simon Bolivar,583,366,236,1185
25710,2020-02-20,(04107) Escuela Militar,670,414,413,1497
25711,2020-02-10,(03010) PUENTE LARGO,2191,1442,1136,4769
25712,2020-01-09,(09109) Tercer Milenio,1037,621,725,2383
25713,2020-01-18,(09117) Calle 45,1626,1122,1816,4564
25714,2020-05-20,(04002) Carrera 90,577,337,292,1206
25715,2020-09-29,(04002) Carrera 90,854,496,619,1969
25716,2020-10-09,(03001) LA CAMPIÑA,1533,742,1090,3365
25717,2020-05-06,(03011) SUBA - CALLE 100,320,178,159,657
25718,2020-10-01,(06002) Normandía,361,234,306,901
25719,2020-01-28,(07101) CASTELLANA,948,572,549,2069
25720,2020-08-06,(05001) Patio Bonito,1651,854,931,3436
25721,2020-05-26,(03001) LA CAMPIÑA,946,563,507,2016
25722,2020-04-09,(08000) Portal Tunal - alimentacion,1540,769,682,2991
25723,2020-05-19,(07009) SENA,537,322,329,1188
25724,2020-09-14,(07009) SENA,656,397,459,1512
25725,2020-04-29,(06000) Portal Eldorado,888,579,355,1822
25726,2020-07-17,(03010) PUENTE LARGO,347,209,173,729
25727,2020-01-03,(10008) San Diego,773,455,508,1736
25728,2020-01-23,(07003) SEVILLANA,1945,1074,1082,4101
25729,2020-05-17,(06001) Modelia,82,59,69,210
25730,2020-04-19,(04100) Carrera 77,203,113,117,433
25731,2020-02-02,(03012) SUBA - CALLE 95,316,197,373,886
25732,2020-09-30,(02105) Calle 142,963,582,687,2232
25733,2020-03-21,(06000) Portal Eldorado,582,431,322,1335
25734,2020-05-01,(09002) Consuelo,154,67,85,306
25735,2020-07-17,(10002) Av. Primero de Mayo,1631,816,974,3421
25736,2020-06-06,(09117) Calle 45,511,279,376,1166
25737,2020-06-16,(06108) Concejo de Bogotá,150,81,66,297
25738,2020-06-09,(05100) Banderas P. Central,519,319,426,1264
25739,2020-06-17,(09120) Calle 63,1113,758,705,2576
25740,2020-07-11,(02200) Alcalá,1541,980,909,3430
25741,2020-05-20,(09003) Socorro,468,258,251,977
25742,2020-07-17,(06111) Universidades,267,169,239,675
25743,2020-02-02,(06000) Portal Eldorado,728,627,1086,2441
25744,2020-03-18,(40001) Juan Pablo II,1129,603,637,2369
25745,2020-09-06,(09115) Calle 34,160,113,213,486
25746,2020-10-12,(09115) Calle 34,179,123,274,576
25747,2020-06-10,(03002) SUBA - TV- 91,714,423,418,1555
25748,2020-07-15,(03006) NIZA - CALLE 127,460,220,197,877
25749,2020-04-22,(02201) Prado,483,324,241,1048
25750,2020-06-13,(10009) Museo Nacional,227,172,256,655
25751,2020-04-22,(06109) Centro Memoria,167,106,106,379
25752,2020-09-16,(09111) Calle 19,803,512,528,1843
25753,2020-05-14,(06104) Gobernación,200,143,77,420
25754,2020-07-14,(06104) Gobernación,229,136,89,454
25755,2020-03-26,(04000) Cabecera Calle 80,518,349,346,1213
25756,2020-05-14,(07006) General Santander - alimentacion,266,142,148,556
25757,2020-03-26,(02200) Alcalá,835,617,467,1919
25758,2020-06-16,(05105) Pradera,614,353,281,1248
25759,2020-07-28,(07107) U. NACIONAL,315,173,176,664
25760,2020-02-19,(07506) DESPENSA,1424,1011,875,3310
25761,2020-01-04,(02303) Calle 85,810,639,716,2165
25762,2020-03-15,(09119) Calle 57,471,299,584,1354
25763,2020-06-05,(07001) PERDOMO,891,513,474,1878
25764,2020-07-03,(10007) Las Nieves,705,401,452,1558
25765,2020-07-12,(07004) VENECIA,355,179,284,818
25766,2020-02-01,(40001) Juan Pablo II,1259,617,843,2719
25767,2020-09-24,(05103) Marsella,496,316,352,1164
25768,2020-04-15,(09119) Calle 57,285,199,184,668
25769,2020-05-20,(09121) Las Flores,591,368,300,1259
25770,2020-06-05,(03005) SUBA - AV. BOYACA,420,253,240,913
25771,2020-04-11,(02304) Heroes,190,174,119,483
25772,2020-08-11,(09122) Calle 72,1061,705,689,2455
25773,2020-09-30,(09122) Calle 72,1393,887,1048,3328
25774,2020-07-07,(08002) Biblioteca,319,177,158,654
25775,2020-04-01,(12000) Puente Aranda,41,34,34,109
25776,2020-08-16,(12000) Puente Aranda,11,10,13,34
25777,2020-05-31,(09000) Cabecera Usme,391,230,339,960
25778,2020-05-20,(07111) NQS - RICAURTE,945,578,346,1869
25779,2020-03-26,(07107) U. NACIONAL,181,167,123,471
25780,2020-06-02,(02103) Mazurén,171,113,159,443
25781,2020-09-12,(06000) Portal Eldorado,616,464,602,1682
25782,2020-04-28,(04106) Carrera 47,191,105,104,400
25783,2019-12-31,(40003) Mirador del Paraiso,111,81,113,305
25784,2020-05-29,(07102) NQS - CALLE 75,372,250,201,823
25785,2020-05-19,(04106) Carrera 47,267,156,143,566
25786,2020-04-17,(06002) Normandía,175,92,112,379
25787,2020-10-09,(07200) Tygua-San José,276,158,226,660
25788,2020-09-15,(04102) Avenida Boyaca,370,214,262,846
25789,2020-06-05,(07008) NQS - Calle 30 Sur,269,127,160,556
25790,2020-03-19,(40001) Juan Pablo II,1053,588,635,2276
25791,2020-09-04,(02304) Heroes,915,633,601,2149
25792,2020-05-08,(07108) Av. El Dorado,85,56,64,205
25793,2020-10-01,(04102) Avenida Boyaca,478,275,389,1142
25794,2020-06-08,(09108) Hospital,71,42,48,161
25795,2020-02-20,(03014) SAN MARTIN,258,156,150,564
25796,2020-05-25,(02502) Terminal,92,69,71,232
25797,2020-05-20,(07006) General Santander,385,259,211,855
25798,2020-06-28,(12002) CDS - Carrera 32,34,19,24,77
25799,2020-04-23,(03011) SUBA - CALLE 100,253,160,122,535
25800,2020-04-10,(03006) NIZA - CALLE 127,108,78,55,241
25801,2020-04-15,(07104) Simon Bolivar,209,171,119,499
25802,2020-07-02,(07006) General Santander - alimentacion,393,240,269,902
25803,2020-04-09,(05100) Banderas P. Central,88,47,41,176
25804,2020-05-17,(03007) HUMEDAL CORDOBA,35,21,22,78
25805,2020-04-13,(09101) Quiroga,238,130,174,542
25806,2020-04-01,(04106) Carrera 47,159,85,83,327
25807,2020-07-19,(03011) SUBA - CALLE 100,136,82,75,293
25808,2020-08-16,(04103) Las Ferias,98,49,80,227
25809,2020-05-17,(06002) Normandía,72,36,54,162
25810,2020-05-23,(02102) Calle 161,156,82,109,347
25811,2020-05-24,(02000) Cabecera Autopista Norte,311,198,183,692
25812,2020-03-22,(07112) COMUNEROS,145,100,86,331
25813,2020-08-28,(10003) Ciudad Jardín,210,71,142,423
25814,2020-06-21,(07010) Bosa,201,89,174,464
25815,2020-05-31,(07010) Bosa,177,86,118,381
25816,2020-03-10,(09003) Socorro,141,375,328,844
25817,2020-04-22,(04106) Carrera 47,170,105,83,358
25818,2020-04-11,(07010) Bosa,170,101,139,410
25819,2020-07-22,(06108) Concejo de Bogotá,118,67,76,261
25820,2020-07-05,(40001) Juan Pablo II,164,83,145,392
25821,2020-07-03,(05101) Mandalay - Cr.73,160,89,69,318
25822,2020-03-29,(40002) Manitas,80,26,53,159
25823,2020-10-11,(12003) Ricaurte,54,68,92,214
25824,2020-06-28,(06002) Normandía,85,52,64,201
25825,2020-03-29,(10005) Bicentenario,27,15,6,48
25826,2020-05-21,(10005) Bicentenario,100,39,74,213
25827,2020-05-03,(07105) MOVISTAR ARENA,40,31,47,118
25828,2019-12-31,(07009) SENA,46,38,60,144
25829,2020-05-16,(07101) CASTELLANA,71,47,74,192
25830,2020-05-31,(07201) Guatoque -Veraguas,31,24,34,89
25831,2020-09-24,(50002) Corral Calle 40 Sur,28,14,36,78
25832,2020-07-24,(03014) SAN MARTIN,0,7,35,42
25833,2020-06-15,(10004) Policarpa,92,37,84,213
25834,2020-10-04,(12000) Puente Aranda,3,10,30,43
25835,2019-12-31,(06109) Centro Memoria,21,9,18,48
25836,2020-01-25,(50006) Corral Carrera 77,17,10,25,52
25837,2020-02-07,(50006) Corral Carrera 77,35,26,42,103
25838,2020-07-30,(50004) Corral Avenida Ciudad de Cali,1,0,1,2
25839,2020-02-07,(04000) Cabecera Calle 80 - alimentacion,24829,14007,15846,54682
25840,2020-03-07,(04000) Cabecera Calle 80 - alimentacion,13344,5924,10867,30135
25841,2020-02-06,(07005) ALQUERIA,2567,1456,1395,5418
25842,2020-09-30,(02502) Terminal,536,405,523,1464
25843,2020-08-28,(09118) Marly,1421,888,907,3216
25844,2020-06-18,(07504) TERREROS,5883,3419,2884,12186
25845,2020-09-18,(07504) TERREROS,7055,3644,3847,14546
25846,2020-05-06,(09119) Calle 57,334,229,211,774
25847,2020-02-19,(09122) Calle 72,8602,5624,4457,18683
25848,2020-03-02,(09122) Calle 72,8122,5405,4454,17981
25849,2020-01-15,(07503) SAN MATEO,36063,20021,16725,72809
25850,2020-06-02,(05000) Portal Américas - alimentacion,9607,5021,4568,19196
25851,2020-06-16,(05000) Portal Américas - alimentacion,10751,5855,5142,21748
25852,2020-02-19,(09001) Molinos,7102,4589,6018,17709
25853,2020-01-02,(07010) Bosa,995,608,823,2426
25854,2020-02-27,(05005) Transversal 86,2863,1648,1295,5806
25855,2020-08-24,(05100) Banderas P. Central,692,373,451,1516
25856,2020-07-26,(10001) Country Sur,275,111,209,595
25857,2020-09-29,(10001) Country Sur,1476,667,1025,3168
25858,2020-03-05,(09000) Cabecera Usme,5978,3391,3994,13363
25859,2020-03-13,(09000) Cabecera Usme,197,1153,1175,2525
25860,2020-03-01,(02102) Calle 161,280,139,339,758
25861,2020-01-16,(09000) Cabecera Usme,5122,2893,3664,11679
25862,2020-02-18,(09000) Cabecera Usme - alimentacion,27104,15257,15661,58022
25863,2020-01-04,(02000) Cabecera Autopista Norte,2369,1202,1931,5502
25864,2020-01-25,(09120) Calle 63,2494,1804,2378,6676
25865,2020-02-15,(04000) Cabecera Calle 80 - intermunicipal,1009,667,1285,2961
25866,2020-09-11,(04100) Carrera 77,1278,695,908,2881
25867,2020-09-15,(07505) LEON XIII,2808,1519,1371,5698
25868,2020-02-14,(02204) Pepe Sierra,5071,3301,2470,10842
25869,2020-01-31,(04104) Avenida 68,3461,1857,1892,7210
25870,2020-02-23,(09004) Santa Lucía,2106,883,1601,4590
25871,2020-05-14,(09101) Quiroga,357,207,224,788
25872,2020-01-20,(06106) Recinto Ferial,1447,824,786,3057
25873,2020-01-29,(06106) Recinto Ferial,1583,873,753,3209
25874,2020-02-17,(06106) Recinto Ferial,1552,897,816,3265
25875,2020-08-19,(07102) NQS - CALLE 75,439,264,216,919
25876,2020-05-31,(03013) RIO NEGRO,61,40,70,171
25877,2020-08-28,(06000) Portal Eldorado - alimentacion,3934,1944,2241,8119
25878,2020-09-09,(50003) Corral Molinos,1571,797,1243,3611
25879,2020-09-15,(50003) Corral Molinos,1551,827,1239,3617
25880,2020-01-05,(04100) Carrera 77,1108,481,1050,2639
25881,2020-03-27,(09104) Restrepo,631,469,536,1636
25882,2020-07-17,(14001) La Sabana,108,82,64,254
25883,2020-09-02,(07111) NQS - RICAURTE,1254,741,545,2540
25884,2020-08-17,(07106) EL CAMPIN,103,76,81,260
25885,2020-06-30,(08000) Portal Tunal - alimentacion,6675,3797,3676,14148
25886,2020-01-13,(03003) 21 ANGELES,1386,639,816,2841
25887,2020-01-14,(50003) Corral Molinos,3171,1883,3140,8194
25888,2020-09-18,(50003) Corral Molinos,1690,851,1397,3938
25889,2020-08-02,(05000) Portal Américas,616,366,547,1529
25890,2020-09-29,(04000) Cabecera Calle 80,1278,836,1093,3207
25891,2020-06-25,(07112) COMUNEROS,854,502,469,1825
25892,2020-10-09,(10001) Country Sur,1556,648,1212,3416
25893,2020-01-20,(06109) Centro Memoria,1023,574,595,2192
25894,2020-03-11,(03000) Portal Suba,9151,5230,4774,19155
25895,2020-05-09,(08000) Portal Tunal - alimentacion,3263,1744,1632,6639
25896,2020-09-21,(40003) Mirador del Paraiso,1534,748,1138,3420
25897,2020-01-17,(09107) Hortúa,2027,1163,1467,4657
25898,2020-02-08,(10005) Bicentenario - alimentacion,463,212,453,1128
25899,2020-03-16,(06111) Universidades,1680,1045,1275,4000
25900,2020-01-11,(09116) Avenida 39,526,420,710,1656
25901,2020-07-17,(10000) Portal 20 de Julio,1608,826,932,3366
25902,2020-09-02,(09003) Socorro,600,320,384,1304
25903,2020-04-16,(07503) SAN MATEO,5323,3320,2374,11017
25904,2020-01-20,(08001) Parque el Tunal,1531,869,904,3304
25905,2020-05-21,(08001) Parque el Tunal,389,223,202,814
25906,2020-08-18,(08001) Parque el Tunal,360,235,340,935
25907,2020-09-14,(09116) Avenida 39,435,240,286,961
25908,2020-02-26,(03000) Portal Suba,9920,5452,5214,20586
25909,2020-01-26,(07505) LEON XIII,2131,920,1417,4468
25910,2020-03-16,(09113) Calle 22,1167,655,723,2545
25911,2020-02-20,(06108) Concejo de Bogotá,909,434,435,1778
25912,2020-05-13,(06108) Concejo de Bogotá,131,69,70,270
25913,2020-01-24,(07001) PERDOMO,4475,2486,2556,9517
25914,2020-07-16,(09000) Cabecera Usme - alimentacion,5654,3244,3370,12268
25915,2020-06-22,(10001) Country Sur,398,151,284,833
25916,2020-01-07,(03003) 21 ANGELES,1102,538,666,2306
25917,2020-01-03,(06001) Modelia,1018,644,734,2396
25918,2020-03-05,(03005) SUBA - AV. BOYACA,2716,1610,1646,5972
25919,2020-09-13,(09000) Cabecera Usme,502,253,550,1305
25920,2020-03-27,(09107) Hortúa,445,299,234,978
25921,2020-09-09,(09107) Hortúa,619,371,411,1401
25922,2020-06-03,(09123) Calle 76,904,622,448,1974
25923,2020-04-12,(05002) Tintal,444,268,220,932
25924,2020-03-19,(02103) Mazurén,829,518,562,1909
25925,2020-07-23,(02300) Calle 100,1040,675,480,2195
25926,2020-01-11,(03012) SUBA - CALLE 95,600,427,593,1620
25927,2020-03-11,(50002) Corral Calle 40 Sur,115,95,150,360
25928,2020-06-18,(50002) Corral Calle 40 Sur,19,10,21,50
25929,2020-02-20,(07006) General Santander,2864,1681,1490,6035
25930,2020-06-08,(05101) Mandalay - Cr.73,104,59,71,234
25931,2020-06-13,(05101) Mandalay - Cr.73,83,36,38,157
25932,2020-02-07,(14005) Las Aguas,3203,2078,2015,7296
25933,2020-06-23,(04000) Cabecera Calle 80,1154,745,837,2736
25934,2020-10-01,(07104) Simon Bolivar,608,394,376,1378
25935,2020-01-10,(07006) General Santander,2054,1168,1246,4468
25936,2020-06-01,(09104) Restrepo,1318,820,974,3112
25937,2020-06-23,(02202) Calle 127,1244,845,591,2680
25938,2020-07-10,(02202) Calle 127,1185,805,618,2608
25939,2020-01-18,(04105) Carrera 53,711,390,510,1611
25940,2020-01-27,(06109) Centro Memoria,1085,630,576,2291
25941,2020-03-16,(03009) Av. Suba- Calle 116,1752,1046,866,3664
25942,2020-08-28,(02205) Calle 106,356,233,250,839
25943,2020-10-05,(02205) Calle 106,431,296,337,1064
25944,2020-01-31,(03006) NIZA - CALLE 127,2327,1484,1498,5309
25945,2020-07-24,(04003) Avenida Ciudad de Cali,890,469,635,1994
25946,2020-08-28,(04108) El Polo,501,303,250,1054
25947,2020-09-07,(07505) LEON XIII,2851,1511,1364,5726
25948,2020-09-19,(07113) SANTA ISABEL,349,199,317,865
25949,2020-05-09,(06000) Portal Eldorado,601,386,306,1293
25950,2020-05-05,(03003) 21 ANGELES,196,97,101,394
25951,2020-07-21,(03007) HUMEDAL CORDOBA,155,105,65,325
25952,2020-07-09,(04104) Avenida 68,651,333,341,1325
25953,2020-06-10,(07000) Portal Sur,1703,1081,988,3772
25954,2020-06-06,(02101) Toberín,803,522,570,1895
25955,2020-03-06,(06105) Quinta Paredes,1042,570,543,2155
25956,2020-09-13,(05100) Banderas P. Central - alimentacion,1092,414,821,2327
25957,2020-07-04,(09100) Calle 40 Sur,1529,822,1021,3372
25958,2020-07-18,(09100) Calle 40 Sur,942,533,731,2206
25959,2020-09-02,(07104) Simon Bolivar,607,397,294,1298
25960,2020-06-03,(07109) CAD,590,381,275,1246
25961,2020-09-11,(07109) CAD,605,353,346,1304
25962,2020-07-24,(09104) Restrepo,1121,692,848,2661
25963,2020-07-03,(03013) RIO NEGRO,323,195,227,745
25964,2020-01-24,(07201) Guatoque -Veraguas,958,461,590,2009
25965,2020-05-21,(05103) Marsella,273,158,162,593
25966,2020-06-26,(05103) Marsella,486,224,283,993
25967,2020-09-29,(02104) Calle 146,1053,630,777,2460
25968,2020-04-25,(09101) Quiroga,228,124,143,495
25969,2020-10-01,(02202) Calle 127,1193,871,853,2917
25970,2020-06-29,(05001) Patio Bonito,636,342,415,1393
25971,2020-07-18,(09000) Cabecera Usme - alimentacion,4761,2613,2877,10251
25972,2020-03-14,(07004) VENECIA,2448,1295,1716,5459
25973,2020-04-14,(04108) El Polo,218,165,131,514
25974,2020-03-13,(07009) SENA,473,523,508,1504
25975,2020-05-26,(07009) SENA,569,363,343,1275
25976,2020-02-23,(05001) Patio Bonito,1664,745,1373,3782
25977,2020-08-10,(02302) Virrey,636,431,344,1411
25978,2020-02-03,(12003) Ricaurte,1235,727,677,2639
25979,2020-08-20,(12003) Ricaurte,401,242,179,822
25980,2020-04-01,(03009) Av. Suba- Calle 116,336,232,160,728
25981,2020-08-01,(09116) Avenida 39,182,125,165,472
25982,2020-03-03,(10005) Bicentenario,815,441,350,1606
25983,2020-07-14,(03002) SUBA - TV- 91,685,438,360,1483
25984,2020-05-22,(07103) AV. CHILE,828,513,358,1699
25985,2020-07-01,(07103) AV. CHILE,931,547,495,1973
25986,2020-08-26,(12007) Zona Industrial,385,224,153,762
25987,2020-01-13,(40002) Manitas,1050,594,745,2389
25988,2020-08-26,(09106) Nariño,398,236,324,958
25989,2020-06-06,(02001) Centro Comercial Santa Fe,299,160,209,668
25990,2020-09-23,(02200) Alcalá,2221,1414,1408,5043
25991,2020-09-26,(06101) El Tiempo,213,174,308,695
25992,2020-03-07,(10005) Bicentenario,214,155,312,681
25993,2020-07-24,(05107) Américas - Cr.53,307,204,198,709
25994,2020-07-28,(03006) NIZA - CALLE 127,459,257,199,915
25995,2020-04-21,(02201) Prado,460,300,271,1031
25996,2020-01-24,(09111) Calle 19,1944,1266,1524,4734
25997,2020-04-10,(09122) Calle 72,211,179,121,511
25998,2020-01-04,(07006) General Santander,895,448,622,1965
25999,2020-10-12,(06001) Modelia,79,56,107,242
26000,2020-06-30,(06104) Gobernación,267,165,121,553
26001,2020-05-06,(02302) Virrey,427,299,231,957
26002,2020-06-16,(09114) Calle 26,307,213,193,713
26003,2020-01-03,(10005) Bicentenario - alimentacion,394,173,396,963
26004,2020-03-12,(08001) Parque el Tunal,74,409,273,756
26005,2020-04-05,(07110) PALOQUEMAO,122,90,59,271
26006,2020-05-31,(05103) Marsella,97,49,78,224
26007,2020-02-23,(06107) Ciudad Universitaria,237,137,324,698
26008,2020-08-14,(06107) Ciudad Universitaria,168,112,133,413
26009,2020-05-13,(04103) Las Ferias,277,128,125,530
26010,2020-08-29,(10007) Las Nieves,507,354,350,1211
26011,2020-10-10,(08000) Portal Tunal,590,321,398,1309
26012,2020-01-18,(05005) Transversal 86,1222,509,822,2553
26013,2020-04-20,(10007) Las Nieves,208,164,141,513
26014,2020-04-05,(06000) Portal Eldorado - alimentacion,781,349,331,1461
26015,2020-02-16,(09113) Calle 22,702,331,599,1632
26016,2020-06-02,(12000) Puente Aranda,80,38,39,157
26017,2020-06-11,(07109) CAD,631,390,266,1287
26018,2020-06-21,(07109) CAD,152,118,100,370
26019,2020-05-11,(03011) SUBA - CALLE 100,343,190,153,686
26020,2020-01-21,(12004) Carrera 22,286,275,379,940
26021,2020-04-01,(12004) Carrera 22,40,36,47,123
26022,2020-01-11,(07107) U. NACIONAL,531,454,621,1606
26023,2020-04-08,(07107) U. NACIONAL,208,155,123,486
26024,2020-08-17,(07107) U. NACIONAL,110,56,73,239
26025,2020-07-01,(06001) Modelia,438,256,212,906
26026,2020-06-21,(08001) Parque el Tunal,128,72,84,284
26027,2020-06-06,(12003) Ricaurte,240,185,150,575
26028,2020-09-30,(07004) VENECIA,1134,642,810,2586
26029,2020-01-12,(12002) CDS - Carrera 32,55,80,93,228
26030,2020-07-04,(07005) ALQUERIA,489,254,319,1062
26031,2020-08-27,(03010) PUENTE LARGO,349,204,214,767
26032,2020-07-22,(14004) Museo del Oro,288,162,210,660
26033,2020-04-26,(03001) LA CAMPIÑA,179,113,85,377
26034,2020-03-13,(09108) Hospital,35,44,43,122
26035,2020-08-02,(03006) NIZA - CALLE 127,128,86,80,294
26036,2020-03-10,(40001) Juan Pablo II,56,464,307,827
26037,2020-06-21,(09104) Restrepo,466,288,356,1110
26038,2020-04-16,(05100) Banderas P. Central,331,198,198,727
26039,2019-12-31,(02200) Alcalá,75,40,83,198
26040,2020-04-30,(04103) Las Ferias,214,126,122,462
26041,2020-06-21,(09000) Cabecera Usme,503,266,402,1171
26042,2020-07-30,(07506) DESPENSA,437,241,216,894
26043,2020-06-28,(07000) Portal Sur,473,245,381,1099
26044,2020-07-17,(07200) Tygua-San José,174,83,140,397
26045,2020-07-14,(04106) Carrera 47,318,148,175,641
26046,2020-02-15,(05101) Mandalay - Cr.73,521,226,388,1135
26047,2020-04-28,(12001) Carrera 43,276,165,151,592
26048,2020-05-07,(09121) Las Flores,492,337,303,1132
26049,2020-09-06,(06001) Modelia,92,58,140,290
26050,2020-04-11,(04104) Avenida 68,175,109,89,373
26051,2020-03-20,(50003) Corral Molinos,536,299,366,1201
26052,2020-03-30,(06111) Universidades,0,59,212,271
26053,2020-07-20,(06111) Universidades,76,46,97,219
26054,2020-04-11,(02000) Cabecera Autopista Norte - intermunicipal,55,41,57,153
26055,2020-05-31,(50003) Corral Molinos,386,186,349,921
26056,2020-05-15,(09105) Río Fucha,115,60,79,254
26057,2020-08-06,(09105) Río Fucha,0,55,119,174
26058,2020-08-16,(06002) Normandía,82,54,65,201
26059,2020-06-28,(09106) Nariño,132,73,115,320
26060,2020-04-01,(03004) GRATAMIRA,16,11,13,40
26061,2020-08-13,(03004) GRATAMIRA,0,9,29,38
26062,2020-02-23,(03004) GRATAMIRA,55,37,38,130
26063,2020-06-17,(10003) Ciudad Jardín,214,114,129,457
26064,2020-06-28,(04106) Carrera 47,93,47,77,217
26065,2020-04-08,(10005) Bicentenario,57,29,45,131
26066,2020-08-02,(06108) Concejo de Bogotá,38,24,33,95
26067,2020-09-02,(06100) Av. Rojas,267,159,192,618
26068,2020-05-06,(07008) NQS - Calle 30 Sur,163,101,80,344
26069,2020-03-26,(10003) Ciudad Jardín,82,60,40,182
26070,2020-05-22,(10003) Ciudad Jardín,158,91,130,379
26071,2020-05-18,(10003) Ciudad Jardín,167,94,114,375
26072,2020-08-30,(03012) SUBA - CALLE 95,68,65,89,222
26073,2020-04-02,(05102) Av. Américas - Av. Boyacá,112,65,69,246
26074,2020-05-17,(07003) SEVILLANA,79,45,53,177
26075,2020-04-06,(05101) Mandalay - Cr.73,53,28,32,113
26076,2020-04-26,(10003) Ciudad Jardín,39,20,27,86
26077,2019-12-31,(10003) Ciudad Jardín,5,7,17,29
26078,2020-05-07,(14005) Las Aguas,0,41,142,183
26079,2020-07-25,(09113) Calle 22,295,158,238,691
26080,2020-07-12,(09108) Hospital,39,26,28,93
26081,2020-05-17,(10007) Las Nieves,68,57,59,184
26082,2020-10-11,(06104) Gobernación,47,53,74,174
26083,2020-01-01,(05101) Mandalay - Cr.73,38,23,35,96
26084,2020-06-22,(03007) HUMEDAL CORDOBA,50,46,24,120
26085,2020-08-30,(50002) Corral Calle 40 Sur,1,3,3,7
26086,2020-03-12,(04000) Cabecera Calle 80 - alimentacion,770,5497,4138,10405
26087,2020-06-01,(07005) ALQUERIA,532,297,261,1090
26088,2020-02-19,(09002) Consuelo,1318,730,864,2912
26089,2020-07-14,(09002) Consuelo,307,174,156,637
26090,2020-03-17,(02502) Terminal,2210,1432,1311,4953
26091,2020-03-19,(03002) SUBA - TV- 91,1966,1073,1138,4177
26092,2020-02-11,(02101) Toberín,15686,10083,7872,33641
26093,2020-07-31,(07503) SAN MATEO,10497,5888,5027,21412
26094,2020-01-17,(06104) Gobernación,1196,699,638,2533
26095,2020-02-13,(03010) PUENTE LARGO,2177,1455,1268,4900
26096,2020-02-28,(03010) PUENTE LARGO,2024,1362,1291,4677
26097,2020-03-03,(08001) Parque el Tunal,1666,966,1015,3647
26098,2020-01-10,(10000) Portal 20 de Julio - alimentacion,9455,4134,6239,19828
26099,2020-08-27,(04002) Carrera 90,687,374,409,1470
26100,2020-03-27,(05000) Portal Américas - alimentacion,5747,2612,2589,10948
26101,2020-01-23,(09001) Molinos,7183,4169,5325,16677
26102,2020-01-29,(14004) Museo del Oro,3892,2300,1940,8132
26103,2020-09-10,(07112) COMUNEROS,751,329,580,1660
26104,2020-02-05,(10004) Policarpa,940,470,595,2005
26105,2020-02-17,(07103) AV. CHILE,3671,2268,1880,7819
26106,2020-03-11,(10003) Ciudad Jardín,954,575,659,2188
26107,2020-02-18,(02502) Terminal,5670,3618,3057,12345
26108,2020-03-10,(10000) Portal 20 de Julio - alimentacion,414,1988,1984,4386
26109,2020-10-10,(07005) ALQUERIA,526,258,467,1251
26110,2020-09-02,(07001) PERDOMO,982,599,677,2258
26111,2020-01-24,(07113) SANTA ISABEL,2058,1156,1479,4693
26112,2020-01-06,(06000) Portal Eldorado - alimentacion,3363,1394,2405,7162
26113,2020-01-19,(06000) Portal Eldorado - alimentacion,4257,1760,3214,9231
26114,2020-02-29,(09104) Restrepo,3290,1999,3217,8506
26115,2020-07-09,(09104) Restrepo,1667,985,1195,3847
26116,2020-08-27,(09104) Restrepo,1664,922,1074,3660
26117,2020-05-06,(04100) Carrera 77,795,451,487,1733
26118,2020-05-20,(07505) LEON XIII,2051,1197,908,4156
26119,2020-05-01,(05002) Tintal,615,341,342,1298
26120,2020-02-19,(09117) Calle 45,6973,4440,3139,14552
26121,2020-02-26,(02000) Cabecera Autopista Norte - alimentacion,24212,13580,13366,51158
26122,2020-01-03,(12003) Ricaurte,428,306,335,1069
26123,2020-02-06,(07102) NQS - CALLE 75,1427,995,1023,3445
26124,2020-02-27,(07102) NQS - CALLE 75,1554,1029,919,3502
26125,2020-10-02,(07102) NQS - CALLE 75,506,338,317,1161
26126,2020-01-10,(04100) Carrera 77,4775,2522,3217,10514
26127,2020-04-10,(09104) Restrepo,271,176,178,625
26128,2020-04-03,(09103) Olaya,458,272,244,974
26129,2020-08-14,(14001) La Sabana,158,115,108,381
26130,2020-01-16,(07106) EL CAMPIN,1494,1181,1170,3845
26131,2020-01-05,(02200) Alcalá,1436,773,1371,3580
26132,2020-04-20,(02200) Alcalá,935,665,507,2107
26133,2020-08-19,(04000) Cabecera Calle 80 - alimentacion,3567,2056,2605,8228
26134,2020-03-08,(05000) Portal Américas,2484,1080,2431,5995
26135,2020-08-07,(09001) Molinos,1024,507,681,2212
26136,2020-01-20,(10002) Av. Primero de Mayo,7401,3855,4336,15592
26137,2020-03-25,(50003) Corral Molinos,750,347,482,1579
26138,2020-08-03,(05000) Portal Américas,2122,1454,1686,5262
26139,2020-07-31,(04000) Cabecera Calle 80,837,514,673,2024
26140,2020-03-03,(09114) Calle 26,3416,2248,1781,7445
26141,2020-02-25,(03000) Portal Suba,10000,5973,5142,21115
26142,2020-05-17,(02000) Cabecera Autopista Norte - alimentacion,1363,726,686,2775
26143,2020-05-01,(07000) Portal Sur - alimentacion,2354,1239,999,4592
26144,2020-01-02,(02105) Calle 142,2249,1385,1593,5227
26145,2020-02-01,(02201) Prado,2860,1520,2113,6493
26146,2020-10-07,(06105) Quinta Paredes,180,108,148,436
26147,2020-02-19,(02000) Cabecera Autopista Norte - intermunicipal,5223,3579,3162,11964
26148,2020-04-28,(03000) Portal Suba,674,419,391,1484
26149,2020-04-28,(02000) Cabecera Autopista Norte - intermunicipal,225,154,153,532
26150,2020-09-22,(02000) Cabecera Autopista Norte - intermunicipal,681,441,522,1644
26151,2020-03-10,(09101) Quiroga,88,454,399,941
26152,2020-04-24,(08000) Portal Tunal - alimentacion,3610,1928,1918,7456
26153,2020-05-15,(02000) Cabecera Autopista Norte - alimentacion,3825,2179,1960,7964
26154,2020-08-21,(07112) COMUNEROS,769,454,450,1673
26155,2020-09-14,(02303) Calle 85,801,510,443,1754
26156,2020-01-16,(04002) Carrera 90,3149,1748,1855,6752
26157,2020-02-19,(09116) Avenida 39,3496,2204,1661,7361
26158,2020-03-13,(09116) Avenida 39,951,111,299,1361
26159,2020-07-21,(09116) Avenida 39,337,203,195,735
26160,2020-09-11,(09000) Cabecera Usme - alimentacion,8796,4510,5166,18472
26161,2020-09-28,(08001) Parque el Tunal,520,279,381,1180
26162,2020-02-06,(05102) Av. Américas - Av. Boyacá,1870,1155,929,3954
26163,2020-08-03,(10001) Country Sur,1196,523,671,2390
26164,2020-02-23,(08001) Parque el Tunal,360,165,316,841
26165,2020-09-21,(14004) Museo del Oro,18,191,369,578
26166,2020-03-19,(07001) PERDOMO,2229,1283,1345,4857
26167,2020-03-19,(05105) Pradera,1462,904,647,3013
26168,2020-06-07,(05103) Marsella,75,43,72,190
26169,2020-02-05,(02103) Mazurén,3671,2241,2011,7923
26170,2020-04-19,(02300) Calle 100,325,192,157,674
26171,2020-01-13,(09001) Molinos,6289,3718,5328,15335
26172,2020-06-18,(03009) Av. Suba- Calle 116,497,332,236,1065
26173,2020-02-29,(02205) Calle 106,952,671,930,2553
26174,2020-06-02,(03000) Portal Suba - alimentacion,5557,3205,2965,11727
26175,2020-04-05,(10002) Av. Primero de Mayo,382,212,227,821
26176,2020-04-12,(10002) Av. Primero de Mayo,371,226,247,844
26177,2020-03-06,(12007) Zona Industrial,1132,763,701,2596
26178,2020-01-22,(10009) Museo Nacional,3782,2002,1818,7602
26179,2020-03-14,(07201) Guatoque -Veraguas,451,263,445,1159
26180,2020-05-23,(07201) Guatoque -Veraguas,114,77,106,297
26181,2020-06-05,(07106) EL CAMPIN,335,221,182,738
26182,2020-02-10,(06000) Portal Eldorado,6871,4017,3005,13893
26183,2020-08-24,(04104) Avenida 68,577,271,321,1169
26184,2020-03-24,(09116) Avenida 39,336,230,267,833
26185,2020-09-19,(05101) Mandalay - Cr.73,105,47,95,247
26186,2020-08-07,(09100) Calle 40 Sur,742,370,488,1600
26187,2020-01-02,(07104) Simon Bolivar,837,525,611,1973
26188,2020-06-24,(07104) Simon Bolivar,625,382,292,1299
26189,2020-02-15,(09106) Nariño,1229,646,1118,2993
26190,2020-04-02,(07109) CAD,370,286,180,836
26191,2020-09-05,(03001) LA CAMPIÑA,944,446,712,2102
26192,2020-09-06,(09000) Cabecera Usme - alimentacion,2891,1249,2225,6365
26193,2020-05-01,(02202) Calle 127,412,267,193,872
26194,2020-05-08,(02202) Calle 127,846,595,414,1855
26195,2020-07-22,(06106) Recinto Ferial,223,114,98,435
26196,2020-01-25,(06103) CAN,667,485,736,1888
26197,2020-06-20,(07009) SENA,548,317,344,1209
26198,2020-09-19,(03010) PUENTE LARGO,261,159,224,644
26199,2020-08-04,(10010) San Bernardo,574,301,392,1267
26200,2020-01-10,(07200) Tygua-San José,584,335,495,1414
26201,2020-05-31,(06103) CAN,141,85,61,287
26202,2020-04-30,(05102) Av. Américas - Av. Boyacá,138,75,87,300
26203,2020-08-06,(07007) NQS - Calle 38A Sur,290,192,221,703
26204,2020-09-09,(10010) San Bernardo,563,316,480,1359
26205,2020-07-14,(02104) Calle 146,679,470,395,1544
26206,2020-04-06,(09123) Calle 76,448,356,301,1105
26207,2020-09-08,(07103) AV. CHILE,967,618,545,2130
26208,2020-01-03,(07201) Guatoque -Veraguas,424,236,414,1074
26209,2020-10-05,(06109) Centro Memoria,297,152,214,663
26210,2020-02-09,(04103) Las Ferias,315,158,302,775
26211,2020-02-13,(07105) MOVISTAR ARENA,1272,820,781,2873
26212,2020-04-30,(06109) Centro Memoria,201,126,128,455
26213,2020-02-13,(08002) Biblioteca,1048,631,680,2359
26214,2020-07-24,(02001) Centro Comercial Santa Fe,432,246,254,932
26215,2020-05-06,(10000) Portal 20 de Julio,1526,783,733,3042
26216,2020-08-26,(07003) SEVILLANA,431,240,231,902
26217,2020-03-11,(07104) Simon Bolivar,2356,1430,1182,4968
26218,2020-07-20,(03000) Portal Suba - alimentacion,1740,969,1034,3743
26219,2020-06-26,(09120) Calle 63,1186,818,758,2762
26220,2020-02-09,(04107) Escuela Militar,127,85,196,408
26221,2020-09-27,(04107) Escuela Militar,37,27,66,130
26222,2020-07-28,(05107) Américas - Cr.53,349,195,201,745
26223,2020-09-16,(03006) NIZA - CALLE 127,578,306,292,1176
26224,2020-05-18,(07110) PALOQUEMAO,614,360,215,1189
26225,2020-06-03,(07002) MADELENA,701,403,399,1503
26226,2020-03-18,(12004) Carrera 22,412,317,301,1030
26227,2020-09-16,(07005) ALQUERIA,586,359,429,1374
26228,2020-09-23,(09107) Hortúa,639,399,486,1524
26229,2020-06-11,(09111) Calle 19,749,462,436,1647
26230,2020-07-10,(06102) Salitre El Greco,262,155,136,553
26231,2020-09-04,(04105) Carrera 53,251,186,237,674
26232,2020-07-22,(02303) Calle 85,572,380,290,1242
26233,2020-02-10,(07006) General Santander - alimentacion,1540,925,965,3430
26234,2020-10-07,(50003) Corral Molinos,1580,817,1482,3879
26235,2020-05-19,(07201) Guatoque -Veraguas,165,99,95,359
26236,2020-08-26,(07201) Guatoque -Veraguas,197,102,124,423
26237,2020-10-04,(03000) Portal Suba,470,220,579,1269
26238,2020-07-23,(03003) 21 ANGELES,253,128,134,515
26239,2020-07-07,(10007) Las Nieves,737,410,391,1538
26240,2020-09-17,(10007) Las Nieves,752,456,453,1661
26241,2020-07-04,(09121) Las Flores,562,387,442,1391
26242,2020-09-04,(09121) Las Flores,729,467,575,1771
26243,2020-05-16,(09000) Cabecera Usme,992,569,757,2318
26244,2020-08-21,(10007) Las Nieves,555,357,331,1243
26245,2020-07-21,(06000) Portal Eldorado - alimentacion,3531,1894,1631,7056
26246,2020-10-11,(08000) Portal Tunal,213,153,204,570
26247,2020-09-12,(04103) Las Ferias,282,143,211,636
26248,2020-05-09,(05005) Transversal 86,159,84,94,337
26249,2020-04-13,(02304) Heroes,409,300,223,932
26250,2020-07-03,(12000) Puente Aranda,102,49,61,212
26251,2020-08-02,(07109) CAD,153,90,90,333
26252,2020-04-20,(03005) SUBA - AV. BOYACA,226,162,147,535
26253,2020-04-09,(07505) LEON XIII,528,290,221,1039
26254,2020-10-01,(06001) Modelia,421,263,301,985
26255,2020-08-16,(12003) Ricaurte,50,46,64,160
26256,2020-01-01,(07105) MOVISTAR ARENA,74,55,158,287
26257,2020-07-27,(09003) Socorro,559,295,312,1166
26258,2020-07-20,(03006) NIZA - CALLE 127,177,97,80,354
26259,2020-10-04,(08001) Parque el Tunal,156,65,179,400
26260,2020-02-05,(07200) Tygua-San José,837,498,621,1956
26261,2020-02-25,(09105) Río Fucha,867,462,525,1854
26262,2020-09-03,(02000) Cabecera Autopista Norte - intermunicipal,565,347,484,1396
26263,2020-08-02,(04108) El Polo,64,40,86,190
26264,2020-10-04,(02000) Cabecera Autopista Norte - intermunicipal,153,99,216,468
26265,2020-04-19,(02001) Centro Comercial Santa Fe,62,49,40,151
26266,2020-02-29,(04106) Carrera 47,867,436,698,2001
26267,2020-05-30,(09000) Cabecera Usme,1170,668,891,2729
26268,2020-07-21,(40001) Juan Pablo II,387,238,254,879
26269,2020-07-01,(07108) Av. El Dorado,158,87,111,356
26270,2020-07-12,(07108) Av. El Dorado,47,30,39,116
26271,2020-07-08,(06100) Av. Rojas,248,147,180,575
26272,2020-08-25,(04001) Quirigua,351,230,238,819
26273,2020-07-22,(03001) LA CAMPIÑA,1011,583,531,2125
26274,2020-05-21,(06001) Modelia,346,220,147,713
26275,2020-05-21,(09108) Hospital,55,32,55,142
26276,2020-10-02,(07107) U. NACIONAL,388,273,341,1002
26277,2020-08-02,(09119) Calle 57,168,98,171,437
26278,2020-07-29,(10003) Ciudad Jardín,208,91,138,437
26279,2020-04-05,(05105) Pradera,103,74,74,251
26280,2020-01-09,(07006) General Santander - alimentacion,1090,641,786,2517
26281,2020-09-16,(07105) MOVISTAR ARENA,270,155,160,585
26282,2020-05-12,(09111) Calle 19,521,347,417,1285
26283,2020-03-25,(04104) Avenida 68,357,232,201,790
26284,2020-06-29,(09117) Calle 45,274,166,194,634
26285,2020-08-11,(09111) Calle 19,745,418,465,1628
26286,2020-02-02,(09121) Las Flores,571,390,816,1777
26287,2020-07-24,(06102) Salitre El Greco,209,133,84,426
26288,2020-03-27,(12001) Carrera 43,230,161,131,522
26289,2020-08-23,(04106) Carrera 47,105,56,84,245
26290,2020-05-04,(10004) Policarpa,152,86,130,368
26291,2020-07-27,(05103) Marsella,324,187,162,673
26292,2020-08-03,(10007) Las Nieves,646,377,351,1374
26293,2020-08-02,(09117) Calle 45,229,130,159,518
26294,2020-06-14,(04003) Avenida Ciudad de Cali,265,151,223,639
26295,2020-06-05,(07506) DESPENSA,491,246,250,987
26296,2020-09-17,(40002) Manitas,440,282,357,1079
26297,2020-01-07,(12004) Carrera 22,436,267,335,1038
26298,2020-04-12,(06002) Normandía,58,32,26,116
26299,2020-01-22,(03004) GRATAMIRA,294,158,166,618
26300,2020-06-26,(06103) CAN,385,231,166,782
26301,2020-04-29,(10003) Ciudad Jardín,125,69,89,283
26302,2020-09-07,(07007) NQS - Calle 38A Sur,378,248,296,922
26303,2020-05-07,(09105) Río Fucha,91,43,58,192
26304,2020-04-07,(07007) NQS - Calle 38A Sur,165,101,76,342
26305,2020-07-18,(02304) Heroes,416,309,314,1039
26306,2020-04-08,(10008) San Diego,137,87,100,324
26307,2020-04-03,(12007) Zona Industrial,145,130,78,353
26308,2020-08-20,(06100) Av. Rojas,213,129,123,465
26309,2020-09-12,(06106) Recinto Ferial,212,121,142,475
26310,2020-04-05,(06111) Universidades,0,28,68,96
26311,2020-08-23,(12001) Carrera 43,51,31,66,148
26312,2020-04-26,(06002) Normandía,60,31,40,131
26313,2020-04-30,(14005) Las Aguas,0,34,116,150
26314,2020-03-28,(04001) Quirigua,117,77,47,241
26315,2020-07-14,(07201) Guatoque -Veraguas,111,65,80,256
26316,2020-08-02,(03005) SUBA - AV. BOYACA,82,52,70,204
26317,2020-07-28,(03007) HUMEDAL CORDOBA,135,78,70,283
26318,2020-04-22,(04105) Carrera 53,164,108,81,353
26319,2020-07-19,(05101) Mandalay - Cr.73,21,9,14,44
26320,2020-04-04,(06106) Recinto Ferial,86,63,43,192
26321,2020-04-21,(09105) Río Fucha,86,45,56,187
26322,2020-05-03,(09105) Río Fucha,32,13,31,76
26323,2020-09-23,(03014) SAN MARTIN,0,15,50,65
26324,2020-05-26,(10005) Bicentenario,108,42,70,220
26325,2020-01-16,(50006) Corral Carrera 77,32,16,40,88
26326,2019-12-31,(07110) PALOQUEMAO,31,11,25,67
26327,2020-02-16,(04000) Cabecera Calle 80 - alimentacion,4769,2146,5097,12012
26328,2020-05-16,(04000) Cabecera Calle 80 - alimentacion,2101,1138,1314,4553
26329,2020-07-23,(09002) Consuelo,350,191,192,733
26330,2020-03-11,(09118) Marly,7605,4957,3883,16445
26331,2020-02-26,(07504) TERREROS,17734,10544,9083,37361
26332,2020-09-24,(07504) TERREROS,6829,3511,3621,13961
26333,2020-08-19,(05000) Portal Américas - alimentacion,10033,5295,5204,20532
26334,2020-02-25,(07503) SAN MATEO,41664,23700,17777,83141
26335,2020-01-10,(04101) Minuto de Dios,1683,974,1315,3972
26336,2020-02-10,(07111) NQS - RICAURTE,3203,2059,1915,7177
26337,2020-02-29,(07111) NQS - RICAURTE,2089,1454,1372,4915
26338,2020-07-03,(07503) SAN MATEO,11692,7019,6523,25234
26339,2020-09-14,(06107) Ciudad Universitaria,219,111,145,475
26340,2020-01-13,(02000) Cabecera Autopista Norte - alimentacion,18700,10446,11730,40876
26341,2020-06-17,(07112) COMUNEROS,838,493,499,1830
26342,2020-01-30,(05005) Transversal 86,2640,1518,1328,5486
26343,2020-02-23,(03009) Av. Suba- Calle 116,357,243,349,949
26344,2020-02-19,(05100) Banderas P. Central,8479,4998,3835,17312
26345,2020-10-07,(09000) Cabecera Usme,1920,1105,1653,4678
26346,2020-01-17,(05100) Banderas P. Central - alimentacion,12710,6647,7404,26761
26347,2020-03-14,(05100) Banderas P. Central - alimentacion,7745,3481,4995,16221
26348,2020-02-18,(07009) SENA,3897,2283,2049,8229
26349,2020-02-06,(10003) Ciudad Jardín,1083,596,729,2408
26350,2020-02-20,(02204) Pepe Sierra,4945,3191,2253,10389
26351,2020-03-05,(09120) Calle 63,7316,4659,3809,15784
26352,2020-07-05,(09109) Tercer Milenio,91,45,111,247
26353,2020-07-27,(03000) Portal Suba - alimentacion,5850,3494,3180,12524
26354,2020-01-11,(02204) Pepe Sierra,1671,1145,1246,4062
26355,2020-02-06,(05103) Marsella,3080,1860,1483,6423
26356,2020-02-16,(10006) San Victorino,298,318,494,1110
26357,2020-03-06,(09110) Avenida Jimenez,5012,3423,3008,11443
26358,2020-02-10,(09123) Calle 76,5853,3828,3116,12797
26359,2020-01-23,(03005) SUBA - AV. BOYACA,2696,1527,1506,5729
26360,2020-01-07,(09101) Quiroga,1213,675,1036,2924
26361,2020-06-25,(07102) NQS - CALLE 75,441,273,233,947
26362,2020-07-23,(07102) NQS - CALLE 75,404,242,176,822
26363,2020-01-20,(02103) Mazurén,3099,2000,1766,6865
26364,2020-07-01,(14001) La Sabana,181,104,119,404
26365,2020-03-11,(50003) Corral Molinos,3683,1951,2971,8605
26366,2020-09-15,(09110) Avenida Jimenez,1027,760,866,2653
26367,2020-01-13,(06106) Recinto Ferial,1161,659,734,2554
26368,2020-01-27,(10001) Country Sur,4925,2208,2554,9687
26369,2020-05-05,(10001) Country Sur,697,346,472,1515
26370,2020-06-24,(04100) Carrera 77,1350,755,868,2973
26371,2020-06-14,(06000) Portal Eldorado,198,142,183,523
26372,2020-01-21,(05002) Tintal,6500,2562,4268,13330
26373,2020-03-07,(02000) Cabecera Autopista Norte - intermunicipal,2041,1142,1868,5051
26374,2020-03-24,(04000) Cabecera Calle 80 - alimentacion,3481,1845,2274,7600
26375,2020-02-02,(06101) El Tiempo,319,229,439,987
26376,2020-07-20,(06101) El Tiempo,103,70,64,237
26377,2020-09-10,(03000) Portal Suba,1376,833,956,3165
26378,2020-05-29,(02000) Cabecera Autopista Norte - intermunicipal,489,314,286,1089
26379,2020-10-02,(02000) Cabecera Autopista Norte - intermunicipal,685,453,568,1706
26380,2020-04-29,(03000) Portal Suba - alimentacion,3638,2180,1913,7731
26381,2020-02-14,(06100) Av. Rojas,2704,1473,1472,5649
26382,2020-02-11,(04001) Quirigua,2240,1347,1234,4821
26383,2020-02-14,(07000) Portal Sur,8035,4714,4400,17149
26384,2020-02-09,(02502) Terminal,342,324,875,1541
26385,2020-03-30,(07503) SAN MATEO,5619,2983,2794,11396
26386,2020-08-05,(02101) Toberín,1158,743,776,2677
26387,2020-04-24,(09000) Cabecera Usme - alimentacion,4782,2549,2721,10052
26388,2020-04-27,(10002) Av. Primero de Mayo,882,157,172,1211
26389,2020-10-06,(09120) Calle 63,1299,916,1079,3294
26390,2020-10-11,(09118) Marly,503,361,525,1389
26391,2020-06-16,(10000) Portal 20 de Julio,2318,1176,1107,4601
26392,2020-09-28,(02000) Cabecera Autopista Norte - alimentacion,5111,2711,3677,11499
26393,2020-07-16,(10006) San Victorino,398,209,221,828
26394,2020-04-26,(02300) Calle 100,299,191,173,663
26395,2020-08-20,(02300) Calle 100,1050,706,643,2399
26396,2020-01-10,(02104) Calle 146,6027,3431,3638,13096
26397,2020-10-09,(07104) Simon Bolivar,641,409,411,1461
26398,2020-06-18,(10008) San Diego,319,168,192,679
26399,2020-02-03,(09106) Nariño,2066,1255,1376,4697
26400,2020-03-11,(03009) Av. Suba- Calle 116,2428,1547,1424,5399
26401,2020-07-30,(03009) Av. Suba- Calle 116,483,311,229,1023
26402,2020-04-11,(02205) Calle 106,122,87,50,259
26403,2020-07-08,(06000) Portal Eldorado - alimentacion,4155,2172,2152,8479
26404,2020-08-04,(06000) Portal Eldorado - alimentacion,3279,1698,1648,6625
26405,2020-10-03,(07106) EL CAMPIN,354,236,357,947
26406,2020-09-11,(07010) Bosa,0,371,933,1304
26407,2020-07-02,(04104) Avenida 68,690,317,371,1378
26408,2020-01-03,(04000) Cabecera Calle 80,3450,1929,2826,8205
26409,2020-06-23,(02000) Cabecera Autopista Norte - alimentacion,5146,2961,2851,10958
26410,2020-02-29,(14005) Las Aguas,1129,803,1366,3298
26411,2020-08-12,(09115) Calle 34,610,356,388,1354
26412,2020-06-16,(09100) Calle 40 Sur,1788,1067,1047,3902
26413,2020-02-19,(07109) CAD,2908,1754,1456,6118
26414,2020-08-09,(10010) San Bernardo,220,97,181,498
26415,2020-03-18,(09121) Las Flores,1892,1257,1070,4219
26416,2020-05-17,(05000) Portal Américas - alimentacion,2629,1267,1231,5127
26417,2020-01-16,(05103) Marsella,2424,1288,1255,4967
26418,2020-05-13,(05103) Marsella,251,136,141,528
26419,2020-06-06,(05103) Marsella,234,118,166,518
26420,2020-06-20,(09109) Tercer Milenio,296,176,271,743
26421,2020-07-13,(02104) Calle 146,658,435,430,1523
26422,2020-06-22,(09101) Quiroga,232,111,181,524
26423,2020-09-01,(05002) Tintal,2607,1500,1532,5639
26424,2020-05-05,(03001) LA CAMPIÑA,637,351,372,1360
26425,2020-03-26,(04108) El Polo,171,144,105,420
26426,2020-05-14,(07009) SENA,479,282,305,1066
26427,2020-05-31,(06100) Av. Rojas,39,30,48,117
26428,2020-05-06,(05100) Banderas P. Central - alimentacion,1942,939,875,3756
26429,2020-04-21,(12003) Ricaurte,163,134,109,406
26430,2020-02-16,(12007) Zona Industrial,153,150,196,499
26431,2020-08-29,(09104) Restrepo,1230,698,1013,2941
26432,2020-04-18,(02302) Virrey,242,184,112,538
26433,2020-09-03,(06103) CAN,398,228,203,829
26434,2020-08-10,(02105) Calle 142,676,449,433,1558
26435,2020-02-02,(05002) Tintal,2388,984,2096,5468
26436,2020-02-09,(09113) Calle 22,687,338,567,1592
26437,2020-01-13,(10005) Bicentenario,609,345,317,1271
26438,2020-07-18,(09104) Restrepo,909,546,747,2202
26439,2020-04-16,(05107) Américas - Cr.53,323,214,165,702
26440,2020-08-20,(05107) Américas - Cr.53,360,231,233,824
26441,2020-09-17,(10010) San Bernardo,626,339,475,1440
26442,2020-02-29,(40002) Manitas,955,500,715,2170
26443,2020-03-03,(12002) CDS - Carrera 32,637,390,319,1346
26444,2020-02-29,(06101) El Tiempo,987,709,1061,2757
26445,2020-09-26,(02304) Heroes,608,458,566,1632
26446,2020-09-12,(03001) LA CAMPIÑA,938,407,707,2052
26447,2020-05-29,(02001) Centro Comercial Santa Fe,416,260,257,933
26448,2020-09-29,(04100) Carrera 77,1481,840,1181,3502
26449,2020-08-13,(09123) Calle 76,962,652,547,2161
26450,2020-09-09,(07004) VENECIA,1121,659,694,2474
26451,2020-09-24,(03011) SUBA - CALLE 100,653,293,312,1258
26452,2020-06-04,(10009) Museo Nacional,471,263,267,1001
26453,2020-06-09,(10009) Museo Nacional,478,304,264,1046
26454,2020-08-25,(10009) Museo Nacional,470,254,295,1019
26455,2020-05-25,(02202) Calle 127,400,326,157,883
26456,2020-06-11,(05107) Américas - Cr.53,442,259,233,934
26457,2020-07-23,(06111) Universidades,252,136,237,625
26458,2020-07-31,(09115) Calle 34,574,348,326,1248
26459,2020-03-19,(03006) NIZA - CALLE 127,1015,674,603,2292
26460,2020-08-04,(02204) Pepe Sierra,706,518,353,1577
26461,2020-02-15,(07201) Guatoque -Veraguas,469,286,564,1319
26462,2020-09-06,(09122) Calle 72,370,249,491,1110
26463,2020-06-17,(06104) Gobernación,272,167,107,546
26464,2020-06-30,(07111) NQS - RICAURTE,1197,720,466,2383
26465,2020-05-15,(07006) General Santander - alimentacion,291,159,186,636
26466,2020-01-26,(06101) El Tiempo,306,227,438,971
26467,2020-03-14,(50002) Corral Calle 40 Sur,57,46,78,181
26468,2020-10-11,(07104) Simon Bolivar,138,94,193,425
26469,2020-09-27,(07008) NQS - Calle 30 Sur,123,59,115,297
26470,2020-07-23,(10007) Las Nieves,381,242,229,852
26471,2020-05-20,(04003) Avenida Ciudad de Cali,808,512,518,1838
26472,2020-02-09,(07105) MOVISTAR ARENA,200,138,288,626
26473,2020-07-25,(10006) San Victorino,243,160,187,590
26474,2020-06-01,(07110) PALOQUEMAO,607,390,235,1232
26475,2020-05-12,(10007) Las Nieves,398,236,247,881
26476,2020-07-29,(08002) Biblioteca,311,171,166,648
26477,2020-01-22,(12000) Puente Aranda,265,155,180,600
26478,2020-05-11,(12000) Puente Aranda,68,39,25,132
26479,2020-05-20,(07109) CAD,532,339,230,1101
26480,2020-07-05,(07109) CAD,165,112,127,404
26481,2020-06-10,(14005) Las Aguas,0,79,215,294
26482,2020-07-03,(05102) Av. Américas - Av. Boyacá,242,135,146,523
26483,2020-09-16,(02102) Calle 161,269,166,204,639
26484,2020-10-10,(14001) La Sabana,137,88,113,338
26485,2020-09-11,(03011) SUBA - CALLE 100,577,260,318,1155
26486,2020-04-17,(07002) MADELENA,352,192,225,769
26487,2020-02-15,(10007) Las Nieves,1073,871,1027,2971
26488,2020-01-14,(09111) Calle 19,1691,1120,1401,4212
26489,2020-03-22,(07505) LEON XIII,530,245,224,999
26490,2020-06-01,(02300) Calle 100,1217,761,576,2554
26491,2020-07-27,(07009) SENA,501,336,349,1186
26492,2020-07-25,(04000) Cabecera Calle 80,633,407,519,1559
26493,2020-05-20,(04106) Carrera 47,266,135,155,556
26494,2020-06-17,(04001) Quirigua,428,281,265,974
26495,2020-10-11,(09113) Calle 22,237,108,275,620
26496,2020-05-25,(09120) Calle 63,312,227,210,749
26497,2020-09-16,(03010) PUENTE LARGO,392,246,257,895
26498,2020-04-27,(07003) SEVILLANA,116,30,30,176
26499,2020-03-12,(06102) Salitre El Greco,530,118,150,798
26500,2020-06-21,(02303) Calle 85,196,123,127,446
26501,2020-04-18,(09115) Calle 34,199,185,124,508
26502,2020-01-17,(09106) Nariño,1761,1003,1342,4106
26503,2020-03-30,(02103) Mazurén,83,58,74,215
26504,2020-05-24,(12002) CDS - Carrera 32,30,19,14,63
26505,2020-03-20,(09122) Calle 72,629,421,321,1371
26506,2020-08-26,(04000) Cabecera Calle 80 - intermunicipal,321,163,287,771
26507,2020-06-10,(04001) Quirigua,381,212,214,807
26508,2020-05-17,(03001) LA CAMPIÑA,193,123,114,430
26509,2020-02-18,(03014) SAN MARTIN,258,171,167,596
26510,2020-09-21,(07002) MADELENA,599,394,655,1648
26511,2020-09-08,(09003) Socorro,580,307,373,1260
26512,2020-01-24,(10003) Ciudad Jardín,998,487,651,2136
26513,2020-04-03,(03006) NIZA - CALLE 127,257,191,127,575
26514,2020-07-02,(06105) Quinta Paredes,135,83,79,297
26515,2020-07-30,(04106) Carrera 47,311,177,192,680
26516,2020-08-02,(04003) Avenida Ciudad de Cali,181,123,203,507
26517,2020-06-06,(06102) Salitre El Greco,137,88,81,306
26518,2020-04-14,(06001) Modelia,254,179,142,575
26519,2020-06-28,(09110) Avenida Jimenez,394,329,356,1079
26520,2020-05-10,(12007) Zona Industrial,29,30,36,95
26521,2020-06-24,(07006) General Santander,546,331,314,1191
26522,2020-08-22,(07006) General Santander,401,216,284,901
26523,2020-03-24,(04102) Avenida Boyaca,242,193,190,625
26524,2020-04-26,(07106) EL CAMPIN,79,63,43,185
26525,2020-07-12,(09106) Nariño,139,77,133,349
26526,2020-08-17,(06101) El Tiempo,109,78,80,267
26527,2020-03-23,(02000) Cabecera Autopista Norte,263,183,152,598
26528,2020-06-07,(12004) Carrera 22,31,27,39,97
26529,2020-01-01,(04106) Carrera 47,133,62,144,339
26530,2020-09-07,(09116) Avenida 39,409,242,316,967
26531,2020-05-08,(03002) SUBA - TV- 91,495,283,261,1039
26532,2020-08-16,(12007) Zona Industrial,41,35,49,125
26533,2020-04-07,(08001) Parque el Tunal,242,122,133,497
26534,2020-09-21,(06106) Recinto Ferial,200,147,138,485
26535,2020-05-20,(04105) Carrera 53,216,124,125,465
26536,2020-08-11,(14005) Las Aguas,189,109,191,489
26537,2020-08-12,(05103) Marsella,405,214,211,830
26538,2020-04-02,(10005) Bicentenario,48,35,45,128
26539,2020-05-02,(02204) Pepe Sierra,334,271,173,778
26540,2020-07-12,(07201) Guatoque -Veraguas,36,40,66,142
26541,2020-03-21,(09108) Hospital,19,18,22,59
26542,2020-09-06,(03014) SAN MARTIN,0,8,17,25
26543,2020-04-05,(10003) Ciudad Jardín,23,15,19,57
26544,2020-06-22,(06102) Salitre El Greco,90,60,56,206
26545,2020-01-02,(50002) Corral Calle 40 Sur,50,32,59,141
26546,2019-12-31,(02303) Calle 85,28,13,39,80
26547,2020-04-15,(05101) Mandalay - Cr.73,61,30,25,116
26548,2020-08-04,(50006) Corral Carrera 77,4,1,5,10
26549,2020-04-22,(50006) Corral Carrera 77,5,3,4,12
26550,2020-02-24,(50004) Corral Avenida Ciudad de Cali,1,1,1,3
26551,2020-06-05,(04000) Cabecera Calle 80 - alimentacion,3728,2102,2391,8221
26552,2020-02-24,(09002) Consuelo,1462,832,834,3128
26553,2020-01-13,(02502) Terminal,3970,2586,2496,9052
26554,2020-07-17,(02502) Terminal,369,266,287,922
26555,2020-01-30,(02303) Calle 85,3572,2479,1825,7876
26556,2020-01-21,(03002) SUBA - TV- 91,1255,1247,1555,4057
26557,2020-01-26,(03002) SUBA - TV- 91,862,403,836,2101
26558,2020-02-24,(03002) SUBA - TV- 91,4620,2754,2405,9779
26559,2020-01-02,(09122) Calle 72,2834,1875,2128,6837
26560,2020-02-26,(02200) Alcalá,15144,9020,6873,31037
26561,2020-09-22,(05000) Portal Américas,3692,2178,2569,8439
26562,2020-09-18,(09003) Socorro,629,323,406,1358
26563,2020-01-28,(04002) Carrera 90,3522,2115,1925,7562
26564,2020-02-05,(04002) Carrera 90,3831,2311,2168,8310
26565,2020-04-09,(05000) Portal Américas - alimentacion,2632,1229,972,4833
26566,2020-01-16,(07112) COMUNEROS,3248,1831,2153,7232
26567,2020-08-17,(07112) COMUNEROS,200,134,164,498
26568,2020-02-24,(03009) Av. Suba- Calle 116,2618,1667,1416,5701
26569,2020-08-23,(10001) Country Sur,315,128,237,680
26570,2020-06-06,(09000) Cabecera Usme,1220,667,874,2761
26571,2020-08-06,(09113) Calle 22,411,248,300,959
26572,2020-02-11,(07009) SENA,3938,2344,1989,8271
26573,2020-01-13,(07113) SANTA ISABEL,1717,1011,1265,3993
26574,2020-02-19,(07113) SANTA ISABEL,2239,1372,1407,5018
26575,2020-02-04,(07505) LEON XIII,8561,4841,3785,17187
26576,2020-08-22,(07505) LEON XIII,2092,1045,1016,4153
26577,2020-10-11,(07505) LEON XIII,959,374,716,2049
26578,2020-07-14,(03000) Portal Suba - alimentacion,5538,3191,2957,11686
26579,2020-01-27,(06002) Normandía,2458,1508,1249,5215
26580,2020-08-28,(03000) Portal Suba - alimentacion,6377,3567,3844,13788
26581,2020-04-17,(07102) NQS - CALLE 75,170,122,98,390
26582,2020-06-19,(07102) NQS - CALLE 75,467,320,236,1023
26583,2020-06-23,(03013) RIO NEGRO,279,185,200,664
26584,2020-08-29,(06000) Portal Eldorado - alimentacion,3090,1440,1955,6485
26585,2020-02-11,(07110) PALOQUEMAO,2825,1640,1199,5664
26586,2020-08-01,(50003) Corral Molinos,1102,491,859,2452
26587,2020-03-21,(09104) Restrepo,436,299,319,1054
26588,2020-05-29,(07000) Portal Sur - alimentacion,7075,3912,3199,14186
26589,2020-06-04,(07000) Portal Sur - alimentacion,7207,3991,3234,14432
26590,2020-03-11,(09103) Olaya,3860,2338,2423,8621
26591,2020-03-01,(09103) Olaya,981,449,892,2322
26592,2020-08-10,(50003) Corral Molinos,1456,740,1043,3239
26593,2020-01-26,(03000) Portal Suba - alimentacion,5992,2830,5289,14111
26594,2020-01-15,(06106) Recinto Ferial,1214,668,718,2600
26595,2020-01-12,(09114) Calle 26,204,170,391,765
26596,2020-09-07,(10001) Country Sur,1280,553,816,2649
26597,2020-07-30,(06000) Portal Eldorado,895,576,484,1955
26598,2020-03-10,(06002) Normandía,395,588,448,1431
26599,2020-05-30,(12001) Carrera 43,252,147,172,571
26600,2020-03-19,(07505) LEON XIII,5179,2659,2337,10175
26601,2020-02-04,(09107) Hortúa,2483,1507,1500,5490
26602,2020-02-17,(10005) Bicentenario - alimentacion,677,329,494,1500
26603,2020-02-06,(06111) Universidades,6105,3995,2811,12911
26604,2020-06-23,(06101) El Tiempo,384,245,196,825
26605,2020-06-30,(06101) El Tiempo,374,246,224,844
26606,2020-01-17,(10000) Portal 20 de Julio,7967,3408,3968,15343
26607,2020-01-30,(10000) Portal 20 de Julio,8806,4067,3799,16672
26608,2020-02-22,(10010) San Bernardo,974,594,1053,2621
26609,2020-01-07,(09116) Avenida 39,1497,1052,1043,3592
26610,2020-08-05,(10000) Portal 20 de Julio,2097,1046,1012,4155
26611,2020-08-15,(10000) Portal 20 de Julio,1850,849,1119,3818
26612,2020-05-28,(07112) COMUNEROS,696,406,362,1464
26613,2020-05-29,(07112) COMUNEROS,721,423,352,1496
26614,2020-07-31,(02303) Calle 85,637,441,317,1395
26615,2020-07-17,(09116) Avenida 39,307,202,182,691
26616,2020-04-01,(08002) Biblioteca,152,91,93,336
26617,2020-03-16,(02001) Centro Comercial Santa Fe,2872,1755,1571,6198
26618,2020-03-04,(05102) Av. Américas - Av. Boyacá,1961,1170,990,4121
26619,2020-02-22,(06108) Concejo de Bogotá,323,194,365,882
26620,2020-01-15,(03000) Portal Suba,7549,4430,4649,16628
26621,2020-08-09,(07001) PERDOMO,225,127,167,519
26622,2020-03-12,(02000) Cabecera Autopista Norte,1106,2178,1581,4865
26623,2020-08-08,(09107) Hortúa,384,237,266,887
26624,2020-01-15,(05105) Pradera,2105,1276,1118,4499
26625,2020-05-07,(02300) Calle 100,882,562,418,1862
26626,2020-09-19,(02300) Calle 100,744,598,760,2102
26627,2020-09-29,(03012) SUBA - CALLE 95,392,218,247,857
26628,2020-01-11,(10000) Portal 20 de Julio,4484,1924,2831,9239
26629,2020-08-15,(05005) Transversal 86,290,119,200,609
26630,2020-08-16,(10008) San Diego,82,50,69,201
26631,2020-08-14,(07007) NQS - Calle 38A Sur,381,229,226,836
26632,2020-07-10,(06000) Portal Eldorado - alimentacion,4171,2118,2295,8584
26633,2020-09-24,(04108) El Polo,553,343,330,1226
26634,2020-01-08,(07103) AV. CHILE,2469,1575,1453,5497
26635,2020-01-18,(07113) SANTA ISABEL,1114,607,967,2688
26636,2020-05-15,(06111) Universidades,0,113,326,439
26637,2020-02-20,(04102) Avenida Boyaca,3012,1839,1524,6375
26638,2020-07-11,(03007) HUMEDAL CORDOBA,118,78,73,269
26639,2020-07-30,(03007) HUMEDAL CORDOBA,136,84,74,294
26640,2020-08-27,(08002) Biblioteca,293,184,196,673
26641,2020-04-17,(07000) Portal Sur,939,565,553,2057
26642,2020-03-22,(02101) Toberín,165,142,157,464
26643,2020-10-04,(04100) Carrera 77,491,199,563,1253
26644,2020-07-04,(05100) Banderas P. Central - alimentacion,2331,1082,1540,4953
26645,2020-02-15,(09115) Calle 34,1501,1088,1651,4240
26646,2020-05-05,(10005) Bicentenario - alimentacion,159,84,126,369
26647,2020-03-05,(07109) CAD,2745,1751,1490,5986
26648,2020-03-24,(07004) VENECIA,805,501,542,1848
26649,2020-01-16,(06001) Modelia,2037,1241,1130,4408
26650,2020-05-07,(09000) Cabecera Usme,1048,662,729,2439
26651,2020-02-03,(08000) Portal Tunal,2131,1225,1066,4422
26652,2020-01-27,(03007) HUMEDAL CORDOBA,960,626,489,2075
26653,2020-06-23,(05103) Marsella,451,247,242,940
26654,2020-03-19,(02104) Calle 146,2550,1567,1488,5605
26655,2020-09-10,(09118) Marly,1335,826,880,3041
26656,2020-03-10,(09117) Calle 45,2647,502,704,3853
26657,2020-05-30,(06101) El Tiempo,186,133,145,464
26658,2020-05-05,(02202) Calle 127,738,535,398,1671
26659,2020-01-26,(03011) SUBA - CALLE 100,414,252,489,1155
26660,2020-04-07,(03011) SUBA - CALLE 100,267,162,138,567
26661,2020-08-07,(04100) Carrera 77,425,222,270,917
26662,2020-02-18,(07101) CASTELLANA,977,618,575,2170
26663,2020-02-19,(07101) CASTELLANA,1011,570,586,2167
26664,2020-09-07,(07109) CAD,685,379,354,1418
26665,2020-09-14,(07109) CAD,698,427,349,1474
26666,2020-10-12,(40001) Juan Pablo II,225,99,220,544
26667,2020-08-16,(05100) Banderas P. Central,147,72,133,352
26668,2020-01-05,(07200) Tygua-San José,114,74,189,377
26669,2020-04-22,(02105) Calle 142,426,270,215,911
26670,2020-01-21,(05005) Transversal 86,1856,559,708,3123
26671,2020-09-30,(05107) Américas - Cr.53,484,314,355,1153
26672,2020-03-31,(09123) Calle 76,455,354,286,1095
26673,2020-08-29,(12007) Zona Industrial,281,181,169,631
26674,2020-08-16,(10005) Bicentenario,22,14,44,80
26675,2020-06-24,(09114) Calle 26,315,225,212,752
26676,2020-07-07,(02300) Calle 100,1333,868,748,2949
26677,2020-02-16,(02102) Calle 161,269,144,326,739
26678,2020-04-06,(07112) COMUNEROS,392,268,220,880
26679,2020-01-23,(08002) Biblioteca,964,512,612,2088
26680,2020-08-03,(09120) Calle 63,984,664,627,2275
26681,2020-09-21,(09120) Calle 63,862,640,686,2188
26682,2020-08-24,(03011) SUBA - CALLE 100,517,227,228,972
26683,2020-05-15,(07000) Portal Sur,1421,860,750,3031
26684,2020-03-08,(10004) Policarpa,240,116,275,631
26685,2020-06-14,(12007) Zona Industrial,30,21,34,85
26686,2020-09-19,(12007) Zona Industrial,245,185,194,624
26687,2020-05-22,(06111) Universidades,0,113,335,448
26688,2020-02-22,(07003) SEVILLANA,1219,600,929,2748
26689,2020-04-02,(09004) Santa Lucía,1054,564,610,2228
26690,2020-06-16,(07111) NQS - RICAURTE,1110,693,435,2238
26691,2020-09-11,(09115) Calle 34,636,390,452,1478
26692,2020-03-16,(03004) GRATAMIRA,149,82,86,317
26693,2020-05-22,(07005) ALQUERIA,440,269,237,946
26694,2020-04-22,(02204) Pepe Sierra,455,346,246,1047
26695,2020-02-02,(12004) Carrera 22,108,117,208,433
26696,2020-03-12,(12004) Carrera 22,268,46,82,396
26697,2020-08-11,(07200) Tygua-San José,231,126,141,498
26698,2020-06-19,(07006) General Santander,561,328,329,1218
26699,2020-03-15,(12007) Zona Industrial,119,99,167,385
26700,2020-02-24,(07006) General Santander - alimentacion,1512,897,973,3382
26701,2020-04-06,(02200) Alcalá,879,638,502,2019
26702,2019-12-31,(02302) Virrey,16,10,25,51
26703,2020-07-21,(07107) U. NACIONAL,336,198,173,707
26704,2020-09-22,(09114) Calle 26,396,238,286,920
26705,2020-04-20,(02303) Calle 85,365,265,179,809
26706,2020-07-30,(07104) Simon Bolivar,545,338,299,1182
26707,2020-04-06,(10007) Las Nieves,173,148,143,464
26708,2020-08-21,(08000) Portal Tunal,772,297,298,1367
26709,2020-09-21,(04103) Las Ferias,316,170,179,665
26710,2020-05-17,(07009) SENA,142,79,107,328
26711,2020-04-04,(04000) Cabecera Calle 80,348,234,254,836
26712,2020-08-27,(02200) Alcalá,1806,1222,919,3947
26713,2020-04-01,(09119) Calle 57,235,186,172,593
26714,2020-09-19,(14005) Las Aguas,180,107,276,563
26715,2020-02-05,(12000) Puente Aranda,337,156,200,693
26716,2020-07-02,(03005) SUBA - AV. BOYACA,464,262,290,1016
26717,2020-03-27,(02102) Calle 161,93,55,66,214
26718,2020-08-18,(09113) Calle 22,368,230,329,927
26719,2020-03-03,(12004) Carrera 22,713,435,470,1618
26720,2020-09-21,(09111) Calle 19,454,359,435,1248
26721,2020-10-06,(09111) Calle 19,801,491,601,1893
26722,2020-05-29,(06001) Modelia,375,261,202,838
26723,2020-04-01,(06101) El Tiempo,239,186,123,548
26724,2020-01-30,(09108) Hospital,237,129,217,583
26725,2020-08-08,(02201) Prado,455,360,439,1254
26726,2020-01-26,(09115) Calle 34,473,355,737,1565
26727,2020-04-24,(07008) NQS - Calle 30 Sur,141,82,84,307
26728,2020-05-15,(07003) SEVILLANA,346,197,151,694
26729,2020-05-24,(14001) La Sabana,47,32,38,117
26730,2020-07-23,(12002) CDS - Carrera 32,164,94,54,312
26731,2020-07-31,(07006) General Santander,455,283,255,993
26732,2020-02-22,(09105) Río Fucha,458,259,385,1102
26733,2020-03-26,(40001) Juan Pablo II,222,113,111,446
26734,2020-04-01,(09100) Calle 40 Sur,784,460,504,1748
26735,2020-09-14,(06103) CAN,397,226,216,839
26736,2020-09-20,(07000) Portal Sur,572,286,639,1497
26737,2020-06-16,(06002) Normandía,307,180,191,678
26738,2020-08-02,(40002) Manitas,119,50,106,275
26739,2020-03-19,(09108) Hospital,149,85,118,352
26740,2020-09-01,(09108) Hospital,37,41,67,145
26741,2020-09-14,(09108) Hospital,65,32,63,160
26742,2020-03-14,(03014) SAN MARTIN,88,71,102,261
26743,2020-06-16,(06101) El Tiempo,373,238,194,805
26744,2020-08-29,(06103) CAN,205,146,132,483
26745,2020-05-31,(07000) Portal Sur,380,208,257,845
26746,2020-05-05,(09117) Calle 45,515,368,239,1122
26747,2020-05-09,(09117) Calle 45,415,235,242,892
26748,2020-09-20,(07109) CAD,159,113,181,453
26749,2020-08-17,(04106) Carrera 47,132,77,79,288
26750,2020-03-25,(12001) Carrera 43,266,200,126,592
26751,2020-08-28,(09121) Las Flores,698,406,431,1535
26752,2020-04-06,(08001) Parque el Tunal,214,123,129,466
26753,2020-07-19,(07111) NQS - RICAURTE,170,122,108,400
26754,2020-10-04,(07006) General Santander - alimentacion,83,54,125,262
26755,2020-07-14,(06102) Salitre El Greco,207,107,83,397
26756,2020-03-30,(09117) Calle 45,478,335,246,1059
26757,2020-08-13,(10007) Las Nieves,690,404,338,1432
26758,2020-04-06,(07107) U. NACIONAL,185,167,131,483
26759,2020-06-28,(10006) San Victorino,181,115,138,434
26760,2020-02-11,(03004) GRATAMIRA,339,187,167,693
26761,2020-06-08,(03004) GRATAMIRA,33,16,24,73
26762,2020-01-11,(09106) Nariño,913,476,794,2183
26763,2020-10-07,(06106) Recinto Ferial,298,175,201,674
26764,2020-09-18,(07105) MOVISTAR ARENA,267,155,190,612
26765,2020-10-05,(07201) Guatoque -Veraguas,231,150,184,565
26766,2020-07-09,(07007) NQS - Calle 38A Sur,419,243,254,916
26767,2020-08-02,(06111) Universidades,92,59,118,269
26768,2020-06-19,(09114) Calle 26,327,221,189,737
26769,2020-06-20,(07108) Av. El Dorado,105,61,93,259
26770,2020-03-26,(04107) Escuela Militar,53,40,36,129
26771,2020-07-03,(07200) Tygua-San José,271,126,170,567
26772,2020-07-09,(06106) Recinto Ferial,265,144,139,548
26773,2020-01-01,(07108) Av. El Dorado,45,44,110,199
26774,2020-04-26,(09114) Calle 26,50,38,34,122
26775,2020-05-01,(02103) Mazurén,33,27,31,91
26776,2020-05-24,(40001) Juan Pablo II,129,70,99,298
26777,2020-04-03,(05103) Marsella,192,94,94,380
26778,2020-04-05,(09106) Nariño,47,37,42,126
26779,2020-07-22,(09105) Río Fucha,89,42,64,195
26780,2020-04-04,(07004) VENECIA,379,215,164,758
26781,2020-08-07,(07105) MOVISTAR ARENA,72,43,59,174
26782,2020-05-15,(10005) Bicentenario,106,47,51,204
26783,2020-04-09,(07201) Guatoque -Veraguas,10,7,20,37
26784,2020-08-22,(09105) Río Fucha,0,41,86,127
26785,2020-07-26,(09115) Calle 34,131,96,132,359
26786,2020-08-28,(09105) Río Fucha,0,79,161,240
26787,2020-07-05,(09105) Río Fucha,43,12,46,101
26788,2020-07-11,(03014) SAN MARTIN,22,8,27,57
26789,2020-09-21,(03014) SAN MARTIN,0,14,37,51
26790,2020-02-29,(50006) Corral Carrera 77,14,8,23,45
26791,2020-08-01,(50006) Corral Carrera 77,1,2,7,10
26792,2020-07-19,(12003) Ricaurte,38,45,40,123
26793,2020-09-07,(04000) Cabecera Calle 80 - alimentacion,4176,2486,3090,9752
26794,2020-03-10,(07005) ALQUERIA,345,614,462,1421
26795,2020-01-21,(07504) TERREROS,13747,6849,6531,27127
26796,2020-03-03,(07504) TERREROS,17291,10482,9451,37224
26797,2020-07-22,(07504) TERREROS,5672,3000,2584,11256
26798,2020-08-05,(07504) TERREROS,5627,3034,2764,11425
26799,2020-10-03,(07504) TERREROS,5849,2450,3861,12160
26800,2020-02-01,(05000) Portal Américas - alimentacion,24920,12430,16346,53696
26801,2020-01-30,(03000) Portal Suba - alimentacion,27257,15694,15748,58699
26802,2020-06-01,(09122) Calle 72,1100,767,634,2501
26803,2020-02-13,(07503) SAN MATEO,41926,22190,17809,81925
26804,2020-06-03,(05000) Portal Américas,2090,1556,1559,5205
26805,2020-06-17,(04002) Carrera 90,787,428,431,1646
26806,2020-03-07,(05001) Patio Bonito,4950,2419,3003,10372
26807,2020-02-05,(02000) Cabecera Autopista Norte - alimentacion,24250,14128,13754,52132
26808,2020-02-18,(02000) Cabecera Autopista Norte - intermunicipal,5135,3566,3018,11719
26809,2020-02-03,(02201) Prado,5802,3705,3066,12573
26810,2020-01-20,(09104) Restrepo,4761,2824,3803,11388
26811,2020-03-29,(10001) Country Sur,200,85,97,382
26812,2020-02-25,(02102) Calle 161,1988,1193,1109,4290
26813,2020-04-10,(06000) Portal Eldorado - alimentacion,756,368,291,1415
26814,2020-02-25,(09115) Calle 34,4659,2920,2459,10038
26815,2020-01-21,(07009) SENA,2389,1247,1218,4854
26816,2020-03-06,(04000) Cabecera Calle 80,6836,4125,5456,16417
26817,2020-01-27,(07002) MADELENA,4736,2779,2474,9989
26818,2020-03-06,(10002) Av. Primero de Mayo,8300,4024,4891,17215
26819,2020-10-07,(05100) Banderas P. Central,1147,616,941,2704
26820,2020-02-19,(09000) Cabecera Usme - alimentacion,22737,14420,16664,53821
26821,2020-08-23,(07001) PERDOMO,245,112,183,540
26822,2020-03-18,(02000) Cabecera Autopista Norte,4407,2682,2445,9534
26823,2020-02-23,(09120) Calle 63,1182,736,1210,3128
26824,2020-05-06,(09000) Cabecera Usme,1005,668,687,2360
26825,2020-02-21,(05103) Marsella,3129,1541,1532,6202
26826,2020-01-15,(04104) Avenida 68,2935,1538,1579,6052
26827,2020-02-04,(05002) Tintal,11592,6707,6203,24502
26828,2020-09-04,(03000) Portal Suba - alimentacion,7028,3909,4583,15520
26829,2020-01-15,(12003) Ricaurte,1099,704,611,2414
26830,2020-05-29,(09101) Quiroga,434,245,328,1007
26831,2020-02-18,(06106) Recinto Ferial,1644,932,794,3370
26832,2020-04-02,(07102) NQS - CALLE 75,141,107,88,336
26833,2020-05-30,(03013) RIO NEGRO,166,101,164,431
26834,2020-02-19,(02302) Virrey,3975,2649,1923,8547
26835,2020-08-25,(07000) Portal Sur - alimentacion,7508,4306,3829,15643
26836,2020-02-29,(04100) Carrera 77,3949,1901,3097,8947
26837,2020-05-09,(02103) Mazurén,83,49,79,211
26838,2020-06-18,(07000) Portal Sur - alimentacion,8125,4766,3739,16630
26839,2020-08-06,(05100) Banderas P. Central - alimentacion,2735,1385,1578,5698
26840,2020-04-28,(14001) La Sabana,90,76,56,222
26841,2020-09-04,(14001) La Sabana,156,101,131,388
26842,2020-07-11,(07002) MADELENA,656,333,434,1423
26843,2020-03-19,(02000) Cabecera Autopista Norte - alimentacion,11156,5723,5877,22756
26844,2020-07-28,(02000) Cabecera Autopista Norte - alimentacion,4369,2376,2409,9154
26845,2020-05-08,(02000) Cabecera Autopista Norte,826,562,501,1889
26846,2020-09-29,(02000) Cabecera Autopista Norte,1696,1050,1271,4017
26847,2020-02-06,(02104) Calle 146,9427,6043,5247,20717
26848,2020-08-23,(02104) Calle 146,248,154,186,588
26849,2020-01-20,(04102) Avenida Boyaca,2682,1638,1509,5829
26850,2020-01-13,(02001) Centro Comercial Santa Fe,3822,2348,2368,8538
26851,2020-01-23,(02001) Centro Comercial Santa Fe,4488,2754,2646,9888
26852,2020-03-20,(04105) Carrera 53,132,91,69,292
26853,2020-04-21,(50003) Corral Molinos,791,418,558,1767
26854,2020-04-20,(05000) Portal Américas,1300,964,1070,3334
26855,2020-10-02,(02201) Prado,1087,720,833,2640
26856,2020-04-21,(10001) Country Sur,544,268,382,1194
26857,2020-03-30,(04002) Carrera 90,330,195,139,664
26858,2020-09-06,(05002) Tintal,732,351,747,1830
26859,2020-03-16,(10005) Bicentenario - alimentacion,574,260,398,1232
26860,2020-05-21,(09000) Cabecera Usme - alimentacion,6887,3843,3707,14437
26861,2020-07-14,(03000) Portal Suba,1116,681,681,2478
26862,2020-05-28,(02000) Cabecera Autopista Norte - intermunicipal,447,289,304,1040
26863,2020-07-16,(02000) Cabecera Autopista Norte - intermunicipal,493,311,347,1151
26864,2020-02-14,(09115) Calle 34,4381,2864,2583,9828
26865,2020-05-09,(02303) Calle 85,284,203,164,651
26866,2020-06-17,(02303) Calle 85,744,525,359,1628
26867,2020-09-10,(02303) Calle 85,698,440,472,1610
26868,2020-10-10,(02303) Calle 85,488,358,455,1301
26869,2020-06-19,(09116) Avenida 39,353,213,247,813
26870,2020-01-01,(10002) Av. Primero de Mayo,654,329,950,1933
26871,2020-07-06,(10002) Av. Primero de Mayo,2300,1199,1390,4889
26872,2020-03-07,(06102) Salitre El Greco,663,442,590,1695
26873,2020-07-24,(09116) Avenida 39,288,188,197,673
26874,2020-04-03,(09107) Hortúa,407,293,243,943
26875,2020-08-21,(09107) Hortúa,555,334,371,1260
26876,2020-09-23,(09123) Calle 76,1160,781,799,2740
26877,2020-03-11,(04002) Carrera 90,3553,2166,1953,7672
26878,2020-05-09,(03012) SUBA - CALLE 95,158,120,101,379
26879,2020-09-24,(04106) Carrera 47,373,179,229,781
26880,2020-02-15,(08000) Portal Tunal,1433,851,925,3209
26881,2020-01-18,(10008) San Diego,569,412,618,1599
26882,2020-07-06,(10008) San Diego,325,195,205,725
26883,2020-02-13,(08000) Portal Tunal,2331,1264,1110,4705
26884,2020-04-21,(03012) SUBA - CALLE 95,197,128,112,437
26885,2020-07-03,(05107) Américas - Cr.53,454,247,293,994
26886,2020-03-18,(03009) Av. Suba- Calle 116,1312,824,675,2811
26887,2020-04-28,(03009) Av. Suba- Calle 116,341,239,172,752
26888,2020-04-16,(10002) Av. Primero de Mayo,1207,654,690,2551
26889,2020-05-11,(09118) Marly,1229,796,603,2628
26890,2020-04-21,(04003) Avenida Ciudad de Cali,518,336,362,1216
26891,2020-07-28,(04108) El Polo,468,300,207,975
26892,2020-01-03,(12007) Zona Industrial,550,415,379,1344
26893,2020-03-11,(07101) CASTELLANA,876,569,592,2037
26894,2020-07-04,(07106) EL CAMPIN,316,223,216,755
26895,2020-07-01,(03007) HUMEDAL CORDOBA,172,101,70,343
26896,2020-01-19,(03002) SUBA - TV- 91,820,387,826,2033
26897,2020-09-24,(07000) Portal Sur,2333,1341,1553,5227
26898,2020-02-18,(04103) Las Ferias,1590,907,880,3377
26899,2020-03-16,(02105) Calle 142,4047,2473,2094,8614
26900,2020-02-28,(04101) Minuto de Dios,3488,2028,1938,7454
26901,2020-01-17,(07102) NQS - CALLE 75,1317,860,940,3117
26902,2020-09-01,(07102) NQS - CALLE 75,452,265,222,939
26903,2020-04-20,(09100) Calle 40 Sur,912,575,549,2036
26904,2020-07-19,(09100) Calle 40 Sur,401,227,311,939
26905,2020-10-09,(04107) Escuela Militar,177,115,118,410
26906,2020-01-27,(06000) Portal Eldorado,6336,3669,2749,12754
26907,2020-04-12,(04105) Carrera 53,52,36,37,125
26908,2020-08-02,(09101) Quiroga,148,66,161,375
26909,2020-06-24,(02204) Pepe Sierra,857,590,436,1883
26910,2020-06-09,(02304) Heroes,742,548,425,1715
26911,2020-09-11,(07003) SEVILLANA,479,255,292,1026
26912,2020-08-16,(09000) Cabecera Usme - alimentacion,2430,1119,1604,5153
26913,2020-06-03,(06106) Recinto Ferial,239,152,106,497
26914,2020-05-15,(07009) SENA,526,296,296,1118
26915,2020-07-22,(02302) Virrey,482,352,271,1105
26916,2020-04-17,(07106) EL CAMPIN,181,127,111,419
26917,2020-04-24,(03009) Av. Suba- Calle 116,341,217,161,719
26918,2020-10-08,(06001) Modelia,396,254,301,951
26919,2020-03-23,(04100) Carrera 77,232,127,146,505
26920,2020-04-17,(02105) Calle 142,447,279,232,958
26921,2020-06-22,(05002) Tintal,780,403,468,1651
26922,2020-03-30,(09116) Avenida 39,174,151,124,449
26923,2020-07-23,(03002) SUBA - TV- 91,681,381,362,1424
26924,2020-09-20,(09001) Molinos,910,382,923,2215
26925,2020-09-05,(05107) Américas - Cr.53,325,228,267,820
26926,2020-09-12,(05107) Américas - Cr.53,301,199,264,764
26927,2020-06-27,(07103) AV. CHILE,661,420,384,1465
26928,2020-08-30,(07103) AV. CHILE,185,146,242,573
26929,2020-08-01,(07004) VENECIA,676,381,458,1515
26930,2020-03-13,(12002) CDS - Carrera 32,184,33,54,271
26931,2020-02-21,(09106) Nariño,1959,1124,1303,4386
26932,2020-01-12,(12007) Zona Industrial,146,131,189,466
26933,2020-01-01,(04100) Carrera 77,440,241,677,1358
26934,2020-09-03,(07006) General Santander,616,350,357,1323
26935,2020-08-03,(07004) VENECIA,850,543,502,1895
26936,2020-05-26,(02200) Alcalá,1536,1140,830,3506
26937,2020-05-12,(08002) Biblioteca,239,129,129,497
26938,2020-08-28,(03011) SUBA - CALLE 100,569,242,254,1065
26939,2020-09-09,(10009) Museo Nacional,569,319,441,1329
26940,2020-06-02,(09003) Socorro,534,281,308,1123
26941,2020-06-12,(05105) Pradera,572,356,243,1171
26942,2020-03-13,(08002) Biblioteca,79,178,159,416
26943,2020-10-04,(10000) Portal 20 de Julio - alimentacion,1736,698,1526,3960
26944,2020-07-06,(06111) Universidades,327,217,367,911
26945,2020-06-12,(12007) Zona Industrial,319,221,137,677
26946,2020-09-16,(07111) NQS - RICAURTE,1238,731,554,2523
26947,2020-01-20,(03004) GRATAMIRA,284,139,134,557
26948,2020-05-20,(02204) Pepe Sierra,645,451,337,1433
26949,2020-07-06,(02200) Alcalá,1992,1334,1059,4385
26950,2020-06-01,(07000) Portal Sur,1659,1022,884,3565
26951,2020-10-09,(07110) PALOQUEMAO,699,418,420,1537
26952,2020-03-23,(04108) El Polo,62,36,32,130
26953,2020-03-27,(06105) Quinta Paredes,64,52,44,160
26954,2020-05-18,(02201) Prado,726,482,399,1607
26955,2020-01-04,(05005) Transversal 86,679,290,441,1410
26956,2020-02-04,(09111) Calle 19,2400,1401,1635,5436
26957,2020-10-03,(09122) Calle 72,935,685,1114,2734
26958,2020-01-26,(02205) Calle 106,210,225,417,852
26959,2020-03-30,(06102) Salitre El Greco,178,124,106,408
26960,2020-08-27,(07201) Guatoque -Veraguas,187,103,146,436
26961,2020-03-28,(02200) Alcalá,634,453,354,1441
26962,2020-02-09,(05105) Pradera,528,346,463,1337
26963,2020-05-12,(03003) 21 ANGELES,225,117,96,438
26964,2020-04-25,(02104) Calle 146,305,199,177,681
26965,2020-08-09,(06107) Ciudad Universitaria,44,34,48,126
26966,2020-09-17,(08000) Portal Tunal,770,342,405,1517
26967,2020-04-29,(05102) Av. Américas - Av. Boyacá,136,82,87,305
26968,2020-08-27,(03005) SUBA - AV. BOYACA,450,262,268,980
26969,2020-10-05,(03005) SUBA - AV. BOYACA,535,318,381,1234
26970,2020-09-28,(14005) Las Aguas,146,171,385,702
26971,2020-07-06,(12000) Puente Aranda,98,42,54,194
26972,2020-09-13,(50003) Corral Molinos,537,248,498,1283
26973,2020-03-28,(07103) AV. CHILE,213,179,153,545
26974,2020-01-10,(09003) Socorro,1291,672,824,2787
26975,2020-09-01,(09121) Las Flores,696,450,443,1589
26976,2019-12-31,(09100) Calle 40 Sur,112,54,121,287
26977,2020-09-17,(06000) Portal Eldorado,939,640,624,2203
26978,2019-12-31,(02201) Prado,65,33,48,146
26979,2020-06-04,(08001) Parque el Tunal,450,255,226,931
26980,2020-04-02,(06002) Normandía,161,105,100,366
26981,2020-01-24,(07200) Tygua-San José,750,441,619,1810
26982,2020-04-26,(14001) La Sabana,32,25,19,76
26983,2020-06-05,(12003) Ricaurte,352,236,160,748
26984,2020-06-16,(12002) CDS - Carrera 32,195,138,72,405
26985,2020-08-20,(12002) CDS - Carrera 32,202,99,75,376
26986,2020-03-28,(09113) Calle 22,137,99,136,372
26987,2020-08-13,(06002) Normandía,259,169,190,618
26988,2020-05-04,(40001) Juan Pablo II,340,210,195,745
26989,2020-04-06,(10005) Bicentenario - alimentacion,160,66,98,324
26990,2020-05-27,(06100) Av. Rojas,190,88,102,380
26991,2020-07-26,(14004) Museo del Oro,20,14,32,66
26992,2020-01-01,(05105) Pradera,130,109,232,471
26993,2020-09-20,(07006) General Santander - alimentacion,65,49,127,241
26994,2020-05-01,(03005) SUBA - AV. BOYACA,120,84,74,278
26995,2020-06-05,(07101) CASTELLANA,177,127,112,416
26996,2020-06-30,(14004) Museo del Oro,304,181,248,733
26997,2020-05-21,(05102) Av. Américas - Av. Boyacá,177,83,116,376
26998,2020-08-22,(06001) Modelia,224,156,159,539
26999,2020-06-27,(12004) Carrera 22,206,132,145,483
27000,2020-08-04,(07200) Tygua-San José,212,111,144,467
27001,2020-07-12,(07008) NQS - Calle 30 Sur,95,53,86,234
27002,2019-12-31,(09001) Molinos,107,63,147,317
27003,2020-08-01,(07106) EL CAMPIN,260,180,136,576
27004,2020-05-01,(07000) Portal Sur,452,265,314,1031
27005,2020-09-27,(07005) ALQUERIA,186,110,191,487
27006,2020-06-22,(07104) Simon Bolivar,156,109,110,375
27007,2020-09-20,(04001) Quirigua,146,68,179,393
27008,2020-03-27,(03013) RIO NEGRO,131,93,82,306
27009,2020-05-02,(02000) Cabecera Autopista Norte - intermunicipal,102,73,77,252
27010,2020-08-02,(06103) CAN,106,77,71,254
27011,2020-04-10,(04106) Carrera 47,68,32,21,121
27012,2020-03-21,(06108) Concejo de Bogotá,62,46,41,149
27013,2020-08-04,(06108) Concejo de Bogotá,137,71,79,287
27014,2020-01-06,(05102) Av. Américas - Av. Boyacá,178,101,173,452
27015,2020-05-23,(08002) Biblioteca,191,99,101,391
27016,2020-07-05,(07008) NQS - Calle 30 Sur,95,36,82,213
27017,2020-08-23,(07006) General Santander - alimentacion,70,45,94,209
27018,2020-05-30,(04101) Minuto de Dios,185,115,163,463
27019,2020-07-31,(14005) Las Aguas,148,94,158,400
27020,2020-03-21,(03005) SUBA - AV. BOYACA,117,91,80,288
27021,2020-04-29,(12007) Zona Industrial,231,173,111,515
27022,2020-06-22,(12002) CDS - Carrera 32,40,46,26,112
27023,2020-04-12,(07002) MADELENA,99,41,70,210
27024,2020-08-17,(05101) Mandalay - Cr.73,31,12,24,67
27025,2020-04-03,(07106) EL CAMPIN,128,108,104,340
27026,2020-02-08,(50006) Corral Carrera 77,20,18,23,61
27027,2020-03-30,(50006) Corral Carrera 77,6,3,4,13
27028,2020-07-20,(50006) Corral Carrera 77,3,1,3,7
27029,2020-07-05,(04107) Escuela Militar,39,31,44,114
27030,2020-04-18,(03014) SAN MARTIN,8,3,5,16
27031,2020-04-16,(03004) GRATAMIRA,19,14,15,48
27032,2020-02-15,(05000) Portal Américas - alimentacion,25475,12998,16327,54800
27033,2020-05-27,(05000) Portal Américas - alimentacion,9517,4986,4439,18942
27034,2020-01-27,(04106) Carrera 47,1392,793,796,2981
27035,2020-03-03,(02101) Toberín,14912,9338,7722,31972
27036,2020-02-25,(09122) Calle 72,8728,5563,4342,18633
27037,2020-03-14,(07503) SAN MATEO,24143,11829,12702,48674
27038,2020-01-10,(02200) Alcalá,9397,5477,5082,19956
27039,2020-02-22,(06104) Gobernación,393,276,480,1149
27040,2020-01-10,(08001) Parque el Tunal,1270,701,757,2728
27041,2020-07-17,(07503) SAN MATEO,10572,6054,4998,21624
27042,2020-02-08,(09001) Molinos,5653,2698,4466,12817
27043,2020-01-29,(07010) Bosa,2224,1297,1420,4941
27044,2020-01-17,(10004) Policarpa,741,359,592,1692
27045,2020-09-29,(05100) Banderas P. Central,1141,682,856,2679
27046,2020-02-13,(02102) Calle 161,1965,1179,1144,4288
27047,2020-05-08,(06000) Portal Eldorado - alimentacion,2796,1415,1225,5436
27048,2020-01-02,(07001) PERDOMO,2108,1203,1388,4699
27049,2020-05-06,(07001) PERDOMO,563,312,337,1212
27050,2020-01-09,(04100) Carrera 77,4559,2532,2970,10061
27051,2020-08-01,(07505) LEON XIII,1925,958,905,3788
27052,2020-05-08,(03000) Portal Suba - alimentacion,4258,2370,2101,8729
27053,2020-06-11,(02204) Pepe Sierra,771,521,401,1693
27054,2020-02-06,(09117) Calle 45,6521,4386,3135,14042
27055,2020-05-27,(03013) RIO NEGRO,269,173,154,596
27056,2020-08-17,(09000) Cabecera Usme - alimentacion,2786,1319,1681,5786
27057,2020-01-05,(05000) Portal Américas - alimentacion,7611,3040,5438,16089
27058,2020-06-30,(09103) Olaya,1096,593,631,2320
27059,2020-03-08,(02302) Virrey,363,318,515,1196
27060,2020-06-18,(50003) Corral Molinos,1511,812,1137,3460
27061,2020-01-22,(02303) Calle 85,3499,2321,1808,7628
27062,2020-07-01,(07000) Portal Sur - alimentacion,8280,4770,4147,17197
27063,2020-03-16,(14001) La Sabana,345,241,271,857
27064,2020-04-21,(14001) La Sabana,75,66,66,207
27065,2020-06-20,(14001) La Sabana,162,103,94,359
27066,2020-08-18,(07111) NQS - RICAURTE,1071,650,482,2203
27067,2020-09-11,(02000) Cabecera Autopista Norte - alimentacion,4541,2318,2926,9785
27068,2020-01-30,(07106) EL CAMPIN,2086,1314,1153,4553
27069,2020-02-11,(07112) COMUNEROS,4008,2431,2368,8807
27070,2020-03-06,(07112) COMUNEROS,3659,2131,2498,8288
27071,2020-03-14,(03003) 21 ANGELES,852,299,596,1747
27072,2020-05-20,(05000) Portal Américas,1987,1391,1445,4823
27073,2020-01-14,(04003) Avenida Ciudad de Cali,4661,2599,2993,10253
27074,2020-05-12,(09002) Consuelo,404,198,230,832
27075,2020-05-29,(04002) Carrera 90,644,352,350,1346
27076,2020-07-13,(04002) Carrera 90,682,355,403,1440
27077,2020-02-10,(10006) San Victorino,2547,1344,1263,5154
27078,2020-03-06,(06000) Portal Eldorado,6264,3696,2947,12907
27079,2020-02-13,(02000) Cabecera Autopista Norte - intermunicipal,5249,3482,3068,11799
27080,2020-07-07,(02101) Toberín,1622,1003,1032,3657
27081,2020-06-15,(12001) Carrera 43,78,50,70,198
27082,2020-07-11,(12001) Carrera 43,331,173,198,702
27083,2020-08-06,(12001) Carrera 43,372,194,175,741
27084,2020-03-04,(06111) Universidades,5793,3644,2641,12078
27085,2020-02-08,(07106) EL CAMPIN,1286,840,959,3085
27086,2020-07-17,(10000) Portal 20 de Julio - alimentacion,3016,1383,1765,6164
27087,2020-02-11,(10010) San Bernardo,1918,1065,1404,4387
27088,2020-08-11,(10000) Portal 20 de Julio,2152,1075,1056,4283
27089,2020-01-26,(07000) Portal Sur,1439,692,1354,3485
27090,2020-09-05,(02201) Prado,749,460,632,1841
27091,2020-02-22,(02001) Centro Comercial Santa Fe,1950,980,1728,4658
27092,2020-01-22,(10007) Las Nieves,1900,1124,1115,4139
27093,2020-03-07,(09107) Hortúa,1292,734,1142,3168
27094,2020-04-28,(07503) SAN MATEO,6133,3844,2709,12686
27095,2020-01-11,(07007) NQS - Calle 38A Sur,1054,559,722,2335
27096,2020-07-20,(02101) Toberín,281,213,233,727
27097,2020-09-07,(06108) Concejo de Bogotá,139,77,80,296
27098,2020-06-29,(08000) Portal Tunal - alimentacion,2407,1169,1355,4931
27099,2020-06-09,(10002) Av. Primero de Mayo,2021,1065,1158,4244
27100,2020-05-20,(08001) Parque el Tunal,390,207,225,822
27101,2020-06-20,(08001) Parque el Tunal,379,223,274,876
27102,2020-08-24,(06102) Salitre El Greco,183,104,129,416
27103,2020-02-03,(05105) Pradera,2579,1511,1283,5373
27104,2020-02-18,(03012) SUBA - CALLE 95,1540,920,1086,3546
27105,2020-03-04,(05105) Pradera,2543,1597,1289,5429
27106,2020-08-18,(07104) Simon Bolivar,577,355,269,1201
27107,2020-05-15,(05005) Transversal 86,253,132,158,543
27108,2020-01-06,(10008) San Diego,142,116,234,492
27109,2020-02-08,(04104) Avenida 68,1724,974,1450,4148
27110,2020-07-24,(02205) Calle 106,279,187,173,639
27111,2020-08-11,(02205) Calle 106,316,224,180,720
27112,2020-10-07,(09101) Quiroga,568,325,481,1374
27113,2020-06-23,(04108) El Polo,501,298,240,1039
27114,2020-01-17,(12007) Zona Industrial,1119,750,637,2506
27115,2020-02-08,(12007) Zona Industrial,682,474,518,1674
27116,2020-06-16,(07201) Guatoque -Veraguas,174,113,121,408
27117,2020-01-24,(07101) CASTELLANA,879,543,596,2018
27118,2020-02-27,(06102) Salitre El Greco,1569,887,713,3169
27119,2020-06-30,(04104) Avenida 68,669,310,341,1320
27120,2020-04-30,(09000) Cabecera Usme,955,589,740,2284
27121,2020-04-26,(02101) Toberín,124,111,115,350
27122,2020-08-15,(02101) Toberín,918,505,827,2250
27123,2020-05-18,(07104) Simon Bolivar,488,318,236,1042
27124,2020-07-24,(04107) Escuela Militar,111,67,64,242
27125,2020-01-08,(07004) VENECIA,3323,1928,1963,7214
27126,2020-05-05,(04002) Carrera 90,461,262,286,1009
27127,2020-08-20,(03001) LA CAMPIÑA,1037,616,576,2229
27128,2020-06-02,(05103) Marsella,278,142,189,609
27129,2020-03-18,(02104) Calle 146,3006,1876,1679,6561
27130,2020-02-02,(09117) Calle 45,811,499,1119,2429
27131,2020-09-18,(03001) LA CAMPIÑA,1439,758,922,3119
27132,2020-01-12,(02202) Calle 127,932,576,905,2413
27133,2020-06-04,(04001) Quirigua,389,227,237,853
27134,2020-05-21,(07007) NQS - Calle 38A Sur,269,163,196,628
27135,2020-03-30,(10001) Country Sur,510,239,383,1132
27136,2020-09-05,(07101) CASTELLANA,129,85,140,354
27137,2020-09-04,(02200) Alcalá,2060,1324,1202,4586
27138,2020-06-03,(03001) LA CAMPIÑA,984,580,489,2053
27139,2020-01-05,(09002) Consuelo,310,125,233,668
27140,2020-04-08,(04108) El Polo,193,137,126,456
27141,2020-02-02,(06106) Recinto Ferial,316,160,341,817
27142,2020-05-22,(07106) EL CAMPIN,275,182,170,627
27143,2020-05-22,(06103) CAN,327,221,170,718
27144,2020-06-26,(10009) Museo Nacional,526,318,348,1192
27145,2020-05-04,(07103) AV. CHILE,623,394,287,1304
27146,2020-07-02,(07103) AV. CHILE,953,560,514,2027
27147,2020-07-04,(10005) Bicentenario,95,58,84,237
27148,2020-07-08,(40002) Manitas,448,282,278,1008
27149,2020-04-28,(06109) Centro Memoria,195,127,88,410
27150,2020-09-03,(06109) Centro Memoria,268,178,162,608
27151,2020-05-23,(09117) Calle 45,462,281,280,1023
27152,2020-04-11,(07112) COMUNEROS,216,150,117,483
27153,2020-01-10,(07102) NQS - CALLE 75,1101,726,751,2578
27154,2020-07-13,(10008) San Diego,194,116,114,424
27155,2020-01-04,(02103) Mazurén,499,215,501,1215
27156,2020-04-01,(09120) Calle 63,499,350,353,1202
27157,2020-07-15,(03011) SUBA - CALLE 100,514,234,191,939
27158,2020-06-14,(09113) Calle 22,209,111,174,494
27159,2020-03-24,(03003) 21 ANGELES,281,149,190,620
27160,2020-07-23,(12007) Zona Industrial,227,148,114,489
27161,2020-08-12,(04101) Minuto de Dios,265,173,202,640
27162,2020-08-28,(03006) NIZA - CALLE 127,506,300,257,1063
27163,2020-01-18,(05102) Av. Américas - Av. Boyacá,727,357,530,1614
27164,2020-06-27,(07000) Portal Sur,1561,885,1031,3477
27165,2020-06-23,(07110) PALOQUEMAO,706,414,308,1428
27166,2020-03-19,(06104) Gobernación,558,340,284,1182
27167,2020-07-13,(05103) Marsella,379,185,189,753
27168,2020-05-21,(06104) Gobernación,221,139,91,451
27169,2020-09-24,(09114) Calle 26,389,235,315,939
27170,2020-07-07,(09113) Calle 22,432,261,356,1049
27171,2020-02-02,(06001) Modelia,295,194,394,883
27172,2020-06-26,(10007) Las Nieves,705,412,409,1526
27173,2020-03-10,(09111) Calle 19,1168,171,393,1732
27174,2020-09-05,(06107) Ciudad Universitaria,160,100,152,412
27175,2020-09-03,(12001) Carrera 43,498,255,268,1021
27176,2020-07-21,(07109) CAD,571,334,276,1181
27177,2020-09-05,(02102) Calle 161,202,103,190,495
27178,2020-04-30,(12004) Carrera 22,109,74,84,267
27179,2020-05-27,(09111) Calle 19,624,407,425,1456
27180,2020-05-13,(10009) Museo Nacional,404,247,230,881
27181,2020-09-30,(03013) RIO NEGRO,293,201,260,754
27182,2020-08-14,(07101) CASTELLANA,188,84,121,393
27183,2020-07-05,(06111) Universidades,98,56,164,318
27184,2020-04-07,(09002) Consuelo,221,108,127,456
27185,2020-09-12,(06002) Normandía,238,130,192,560
27186,2020-04-24,(07200) Tygua-San José,109,77,62,248
27187,2020-09-01,(12001) Carrera 43,439,246,257,942
27188,2020-04-10,(02200) Alcalá,345,267,143,755
27189,2020-06-24,(04102) Avenida Boyaca,380,219,227,826
27190,2020-06-23,(06100) Av. Rojas,242,134,148,524
27191,2020-03-04,(03014) SAN MARTIN,240,138,186,564
27192,2020-04-30,(03006) NIZA - CALLE 127,271,161,138,570
27193,2020-04-24,(02502) Terminal,174,121,168,463
27194,2020-06-06,(04104) Avenida 68,409,229,272,910
27195,2020-06-26,(09003) Socorro,606,335,357,1298
27196,2020-06-29,(10008) San Diego,95,56,67,218
27197,2020-02-02,(09105) Río Fucha,116,83,225,424
27198,2020-04-06,(07004) VENECIA,478,305,244,1027
27199,2020-08-23,(02000) Cabecera Autopista Norte - intermunicipal,110,77,113,300
27200,2020-03-22,(07107) U. NACIONAL,67,65,50,182
27201,2020-05-17,(02304) Heroes,142,129,96,367
27202,2020-09-27,(04104) Avenida 68,220,132,268,620
27203,2020-04-11,(03010) PUENTE LARGO,144,111,66,321
27204,2020-05-07,(06101) El Tiempo,241,153,121,515
27205,2020-09-19,(10004) Policarpa,234,104,193,531
27206,2020-06-18,(03002) SUBA - TV- 91,742,485,456,1683
27207,2020-07-28,(09106) Nariño,314,193,283,790
27208,2020-10-03,(09106) Nariño,403,222,443,1068
27209,2020-04-03,(09105) Río Fucha,57,49,44,150
27210,2020-07-19,(05105) Pradera,153,126,77,356
27211,2020-09-09,(03005) SUBA - AV. BOYACA,511,307,315,1133
27212,2020-05-03,(06103) CAN,135,94,60,289
27213,2020-07-26,(07001) PERDOMO,216,98,149,463
27214,2020-10-09,(03005) SUBA - AV. BOYACA,562,348,497,1407
27215,2020-03-27,(03003) 21 ANGELES,148,77,68,293
27216,2020-06-05,(12004) Carrera 22,204,101,107,412
27217,2020-08-24,(06106) Recinto Ferial,204,125,89,418
27218,2020-08-12,(06103) CAN,351,215,189,755
27219,2020-04-02,(07002) MADELENA,364,185,196,745
27220,2020-09-20,(09106) Nariño,163,92,181,436
27221,2020-05-07,(09114) Calle 26,186,142,131,459
27222,2020-05-27,(10003) Ciudad Jardín,169,88,117,374
27223,2020-07-24,(10003) Ciudad Jardín,175,81,106,362
27224,2020-06-28,(07201) Guatoque -Veraguas,32,35,47,114
27225,2019-12-31,(10007) Las Nieves,10,7,25,42
27226,2020-07-20,(12002) CDS - Carrera 32,35,42,18,95
27227,2020-05-31,(09105) Río Fucha,40,18,36,94
27228,2019-12-31,(14004) Museo del Oro,4,5,19,28
27229,2020-03-26,(03014) SAN MARTIN,13,8,16,37
27230,2020-04-10,(02102) Calle 161,28,22,25,75
27231,2019-12-31,(12002) CDS - Carrera 32,5,1,4,10
27232,2019-12-31,(09108) Hospital,3,4,8,15
27233,2020-02-13,(09002) Consuelo,1471,799,859,3129
27234,2020-06-12,(09002) Consuelo,495,272,271,1038
27235,2020-07-09,(02502) Terminal,419,312,364,1095
27236,2020-07-31,(02502) Terminal,324,250,287,861
27237,2020-06-25,(07504) TERREROS,6232,3536,2972,12740
27238,2020-09-21,(07504) TERREROS,5741,2504,2728,10973
27239,2020-02-12,(03000) Portal Suba - alimentacion,30303,18003,16892,65198
27240,2020-03-17,(03000) Portal Suba - alimentacion,17380,9642,9388,36410
27241,2020-02-24,(09122) Calle 72,8377,5387,4647,18411
27242,2020-03-04,(14005) Las Aguas,3444,2175,1929,7548
27243,2020-02-04,(08001) Parque el Tunal,1732,976,961,3669
27244,2020-05-23,(10000) Portal 20 de Julio - alimentacion,3017,1396,1724,6137
27245,2020-10-07,(05001) Patio Bonito,2271,1222,1430,4923
27246,2020-08-22,(02000) Cabecera Autopista Norte - alimentacion,3607,1779,2206,7592
27247,2020-09-23,(09000) Cabecera Usme,1952,1187,1525,4664
27248,2020-01-21,(02205) Calle 106,1680,1224,935,3839
27249,2020-06-10,(09000) Cabecera Usme - alimentacion,8130,4597,4267,16994
27250,2020-06-10,(07001) PERDOMO,901,477,490,1868
27251,2020-01-10,(02000) Cabecera Autopista Norte,7008,4172,4665,15845
27252,2020-09-02,(40003) Mirador del Paraiso,1752,1076,1153,3981
27253,2020-08-18,(07505) LEON XIII,2611,1386,1172,5169
27254,2020-10-08,(07505) LEON XIII,3134,1613,1750,6497
27255,2020-01-28,(05103) Marsella,2906,1667,1417,5990
27256,2020-03-20,(03000) Portal Suba - alimentacion,3251,1751,1455,6457
27257,2020-03-05,(02000) Cabecera Autopista Norte - alimentacion,23406,13389,13662,50457
27258,2020-02-25,(07111) NQS - RICAURTE,3218,2060,1751,7029
27259,2020-07-09,(09000) Cabecera Usme - alimentacion,8991,4930,5075,18996
27260,2020-02-15,(09103) Olaya,2627,1298,1974,5899
27261,2020-03-02,(50003) Corral Molinos,2656,2347,4136,9139
27262,2020-05-27,(14001) La Sabana,134,103,92,329
27263,2020-01-24,(07002) MADELENA,4637,2486,2506,9629
27264,2020-07-06,(04102) Avenida Boyaca,366,215,252,833
27265,2020-03-03,(03003) 21 ANGELES,1749,924,942,3615
27266,2020-01-03,(04105) Carrera 53,643,369,428,1440
27267,2020-01-21,(10002) Av. Primero de Mayo,5148,2262,3250,10660
27268,2020-06-12,(50003) Corral Molinos,1461,803,957,3221
27269,2020-07-31,(05000) Portal Américas,2183,1445,1684,5312
27270,2020-08-12,(09110) Avenida Jimenez,1432,982,765,3179
27271,2020-07-19,(07000) Portal Sur - alimentacion,2267,1077,1099,4443
27272,2020-01-11,(06109) Centro Memoria,439,300,405,1144
27273,2020-02-27,(06000) Portal Eldorado,6746,4013,2889,13648
27274,2020-02-17,(40003) Mirador del Paraiso,4840,2738,2618,10196
27275,2020-03-17,(04001) Quirigua,1155,709,694,2558
27276,2020-03-12,(02105) Calle 142,505,1379,880,2764
27277,2020-02-19,(14004) Museo del Oro,4371,2680,2011,9062
27278,2020-02-18,(06105) Quinta Paredes,1143,663,496,2302
27279,2020-02-03,(40001) Juan Pablo II,1672,987,1017,3676
27280,2020-02-29,(07106) EL CAMPIN,1267,849,961,3077
27281,2020-10-09,(09101) Quiroga,589,353,500,1442
27282,2020-02-04,(06100) Av. Rojas,2839,1585,1248,5672
27283,2020-03-17,(06111) Universidades,1407,815,1027,3249
27284,2020-07-24,(07112) COMUNEROS,635,369,370,1374
27285,2020-07-27,(02303) Calle 85,672,444,324,1440
27286,2020-04-17,(09116) Avenida 39,197,126,124,447
27287,2020-06-03,(09116) Avenida 39,286,196,179,661
27288,2020-01-17,(06103) CAN,2105,1271,1132,4508
27289,2020-06-25,(07010) Bosa,772,370,481,1623
27290,2019-12-31,(05000) Portal Américas - alimentacion,272,221,377,870
27291,2020-07-15,(02201) Prado,778,514,419,1711
27292,2020-08-26,(02000) Cabecera Autopista Norte - alimentacion,4069,2250,2519,8838
27293,2020-01-29,(03005) SUBA - AV. BOYACA,2800,1598,1537,5935
27294,2020-03-18,(06102) Salitre El Greco,783,440,326,1549
27295,2020-06-10,(09107) Hortúa,605,344,347,1296
27296,2020-01-17,(02102) Calle 161,1649,925,1109,3683
27297,2020-01-27,(02300) Calle 100,7122,4421,3739,15282
27298,2020-08-22,(02300) Calle 100,657,485,516,1658
27299,2020-08-28,(02300) Calle 100,1174,798,739,2711
27300,2020-01-28,(50002) Corral Calle 40 Sur,119,85,147,351
27301,2020-03-02,(07104) Simon Bolivar,2324,1449,1186,4959
27302,2020-10-08,(07104) Simon Bolivar,658,395,420,1473
27303,2020-06-19,(05001) Patio Bonito,1935,1072,1153,4160
27304,2020-03-10,(07009) SENA,643,761,622,2026
27305,2020-02-05,(08000) Portal Tunal,2252,1272,1039,4563
27306,2020-02-26,(07106) EL CAMPIN,2191,1370,1162,4723
27307,2020-04-16,(02205) Calle 106,175,121,98,394
27308,2020-01-26,(09101) Quiroga,391,207,524,1122
27309,2020-06-18,(09118) Marly,1467,966,767,3200
27310,2020-06-09,(02300) Calle 100,1188,793,616,2597
27311,2020-09-24,(07106) EL CAMPIN,472,326,302,1100
27312,2020-10-06,(06111) Universidades,506,283,531,1320
27313,2020-06-13,(04104) Avenida 68,431,239,291,961
27314,2020-09-24,(10000) Portal 20 de Julio,2475,1186,1470,5131
27315,2020-02-18,(03005) SUBA - AV. BOYACA,2874,1666,1616,6156
27316,2020-04-05,(02101) Toberín,134,94,121,349
27317,2020-09-21,(04107) Escuela Militar,147,96,98,341
27318,2020-01-26,(04003) Avenida Ciudad de Cali,996,452,1064,2512
27319,2020-10-03,(07004) VENECIA,977,525,774,2276
27320,2020-02-01,(05103) Marsella,1387,674,1016,3077
27321,2020-07-07,(05103) Marsella,499,271,282,1052
27322,2020-02-23,(09117) Calle 45,793,527,980,2300
27323,2020-03-08,(09110) Avenida Jimenez,1009,775,1010,2794
27324,2020-09-11,(03001) LA CAMPIÑA,1240,689,722,2651
27325,2020-08-01,(04104) Avenida 68,330,178,215,723
27326,2020-08-26,(02202) Calle 127,1009,732,584,2325
27327,2020-04-04,(09001) Molinos,878,484,575,1937
27328,2020-07-19,(06000) Portal Eldorado,157,124,144,425
27329,2020-05-08,(03001) LA CAMPIÑA,667,395,343,1405
27330,2020-06-02,(07009) SENA,619,336,365,1320
27331,2020-08-14,(09120) Calle 63,1071,702,666,2439
27332,2020-09-19,(06100) Av. Rojas,162,117,162,441
27333,2020-01-05,(02302) Virrey,288,248,426,962
27334,2020-02-13,(12003) Ricaurte,1297,815,624,2736
27335,2020-05-31,(12003) Ricaurte,43,41,32,116
27336,2020-06-19,(06103) CAN,381,217,184,782
27337,2020-08-12,(09109) Tercer Milenio,354,224,218,796
27338,2020-06-28,(09116) Avenida 39,78,55,76,209
27339,2020-03-18,(06104) Gobernación,599,413,281,1293
27340,2020-08-15,(03002) SUBA - TV- 91,550,298,423,1271
27341,2020-10-01,(07007) NQS - Calle 38A Sur,501,300,350,1151
27342,2020-08-20,(04003) Avenida Ciudad de Cali,885,527,688,2100
27343,2020-07-26,(02104) Calle 146,238,155,150,543
27344,2020-03-21,(09123) Calle 76,306,239,185,730
27345,2020-05-28,(02103) Mazurén,136,109,110,355
27346,2020-04-01,(40002) Manitas,169,83,117,369
27347,2020-02-10,(08002) Biblioteca,1073,634,729,2436
27348,2020-08-05,(02001) Centro Comercial Santa Fe,400,237,287,924
27349,2020-05-22,(04100) Carrera 77,1064,555,630,2249
27350,2020-06-10,(02104) Calle 146,679,447,465,1591
27351,2020-04-16,(04000) Cabecera Calle 80,551,364,349,1264
27352,2020-07-30,(10008) San Diego,286,144,191,621
27353,2020-03-11,(08002) Biblioteca,1015,589,594,2198
27354,2020-08-30,(06000) Portal Eldorado - alimentacion,1401,666,1009,3076
27355,2020-06-25,(09120) Calle 63,1177,791,754,2722
27356,2020-10-10,(02200) Alcalá,1582,987,1248,3817
27357,2020-08-10,(10009) Museo Nacional,496,295,283,1074
27358,2020-09-20,(03001) LA CAMPIÑA,363,182,386,931
27359,2020-03-08,(07111) NQS - RICAURTE,457,411,582,1450
27360,2020-07-03,(07111) NQS - RICAURTE,1150,691,504,2345
27361,2020-09-07,(09115) Calle 34,710,449,475,1634
27362,2020-03-26,(09115) Calle 34,358,298,235,891
27363,2020-04-07,(02204) Pepe Sierra,386,303,230,919
27364,2020-06-21,(08000) Portal Tunal - alimentacion,2051,959,1240,4250
27365,2020-05-21,(07000) Portal Sur,1461,884,825,3170
27366,2020-01-25,(14004) Museo del Oro,566,563,1046,2175
27367,2020-02-23,(04107) Escuela Militar,112,98,158,368
27368,2020-07-19,(09110) Avenida Jimenez,135,133,204,472
27369,2020-06-18,(02200) Alcalá,1862,1298,945,4105
27370,2020-07-18,(07008) NQS - Calle 30 Sur,201,116,132,449
27371,2020-06-29,(03012) SUBA - CALLE 95,85,63,73,221
27372,2020-08-13,(06104) Gobernación,257,150,93,500
27373,2020-08-20,(06109) Centro Memoria,248,151,120,519
27374,2020-09-29,(06104) Gobernación,310,204,176,690
27375,2020-06-30,(07105) MOVISTAR ARENA,267,155,139,561
27376,2020-06-10,(05105) Pradera,505,343,195,1043
27377,2020-06-02,(09115) Calle 34,628,411,320,1359
27378,2020-01-03,(07102) NQS - CALLE 75,677,449,538,1664
27379,2020-07-12,(06109) Centro Memoria,74,59,77,210
27380,2020-02-23,(10003) Ciudad Jardín,193,87,268,548
27381,2020-06-02,(10006) San Victorino,499,254,257,1010
27382,2020-07-13,(03011) SUBA - CALLE 100,535,235,203,973
27383,2020-08-16,(06111) Universidades,97,48,108,253
27384,2020-05-21,(07112) COMUNEROS,626,386,320,1332
27385,2020-05-04,(10007) Las Nieves,315,176,184,675
27386,2020-08-21,(03005) SUBA - AV. BOYACA,423,249,242,914
27387,2020-08-24,(03005) SUBA - AV. BOYACA,419,249,240,908
27388,2020-09-13,(04000) Cabecera Calle 80,313,171,416,900
27389,2020-06-03,(12000) Puente Aranda,70,50,41,161
27390,2020-08-27,(12001) Carrera 43,422,216,207,845
27391,2020-09-16,(12001) Carrera 43,498,266,276,1040
27392,2020-05-26,(03005) SUBA - AV. BOYACA,382,238,244,864
27393,2020-07-13,(02103) Mazurén,178,105,163,446
27394,2020-05-30,(05100) Banderas P. Central,404,204,312,920
27395,2020-08-03,(07110) PALOQUEMAO,547,323,216,1086
27396,2020-07-19,(02000) Cabecera Autopista Norte,348,208,209,765
27397,2020-04-29,(03006) NIZA - CALLE 127,228,171,122,521
27398,2020-01-27,(09108) Hospital,185,137,196,518
27399,2020-09-18,(10004) Policarpa,289,134,224,647
27400,2020-01-01,(07506) DESPENSA,131,70,159,360
27401,2020-04-23,(07008) NQS - Calle 30 Sur,155,79,82,316
27402,2020-03-01,(10010) San Bernardo,352,238,544,1134
27403,2020-06-30,(12002) CDS - Carrera 32,185,93,98,376
27404,2020-07-30,(04000) Cabecera Calle 80 - intermunicipal,327,159,248,734
27405,2020-09-29,(06103) CAN,438,262,224,924
27406,2020-07-24,(07506) DESPENSA,374,200,224,798
27407,2020-05-16,(04102) Avenida Boyaca,171,95,133,399
27408,2020-03-26,(04003) Avenida Ciudad de Cali,500,313,328,1141
27409,2020-02-16,(03005) SUBA - AV. BOYACA,455,283,571,1309
27410,2020-08-01,(09108) Hospital,62,30,40,132
27411,2020-08-08,(09108) Hospital,65,32,58,155
27412,2020-09-21,(09108) Hospital,46,32,54,132
27413,2020-04-18,(03001) LA CAMPIÑA,348,197,182,727
27414,2020-07-01,(07107) U. NACIONAL,365,213,204,782
27415,2020-02-07,(03004) GRATAMIRA,325,170,164,659
27416,2020-01-06,(09111) Calle 19,294,230,442,966
27417,2020-04-23,(07006) General Santander,285,175,145,605
27418,2020-10-09,(07107) U. NACIONAL,432,262,367,1061
27419,2020-04-03,(07104) Simon Bolivar,185,140,113,438
27420,2020-08-13,(07006) General Santander - alimentacion,348,181,255,784
27421,2020-09-29,(12002) CDS - Carrera 32,204,128,91,423
27422,2020-10-10,(07109) CAD,444,297,391,1132
27423,2020-06-19,(07008) NQS - Calle 30 Sur,316,172,194,682
27424,2020-05-27,(07006) General Santander - alimentacion,320,189,192,701
27425,2020-03-26,(09117) Calle 45,490,332,238,1060
27426,2020-08-31,(03007) HUMEDAL CORDOBA,151,101,85,337
27427,2020-08-16,(02304) Heroes,160,128,136,424
27428,2020-03-21,(03010) PUENTE LARGO,121,90,63,274
27429,2020-04-07,(03010) PUENTE LARGO,194,157,107,458
27430,2020-07-14,(10004) Policarpa,195,88,107,390
27431,2020-01-03,(07101) CASTELLANA,386,279,351,1016
27432,2020-08-15,(12004) Carrera 22,181,102,134,417
27433,2020-08-22,(10008) San Diego,160,98,154,412
27434,2020-08-06,(10003) Ciudad Jardín,205,100,144,449
27435,2020-03-30,(09114) Calle 26,155,150,116,421
27436,2020-03-24,(12003) Ricaurte,203,161,128,492
27437,2020-05-24,(08002) Biblioteca,89,48,41,178
27438,2020-04-18,(10008) San Diego,117,72,70,259
27439,2020-05-09,(12004) Carrera 22,109,54,73,236
27440,2020-03-28,(12003) Ricaurte,57,53,32,142
27441,2020-10-01,(09105) Río Fucha,0,86,186,272
27442,2020-07-29,(04102) Avenida Boyaca,341,205,191,737
27443,2020-04-24,(05103) Marsella,182,96,90,368
27444,2020-02-09,(09105) Río Fucha,140,93,237,470
27445,2020-05-14,(05101) Mandalay - Cr.73,88,47,31,166
27446,2020-08-09,(07008) NQS - Calle 30 Sur,101,53,82,236
27447,2020-04-08,(07003) SEVILLANA,203,103,115,421
27448,2020-05-05,(50002) Corral Calle 40 Sur,12,9,11,32
27449,2020-08-04,(50002) Corral Calle 40 Sur,19,12,26,57
27450,2020-04-18,(06111) Universidades,0,61,124,185
27451,2020-04-12,(07010) Bosa,99,63,85,247
27452,2020-07-26,(03005) SUBA - AV. BOYACA,95,58,80,233
27453,2020-01-01,(07201) Guatoque -Veraguas,26,23,108,157
27454,2020-08-23,(12000) Puente Aranda,9,8,23,40
27455,2020-04-05,(06102) Salitre El Greco,54,51,40,145
27456,2020-05-04,(50006) Corral Carrera 77,4,3,5,12
27457,2020-05-18,(03004) GRATAMIRA,24,13,14,51
27458,2020-04-26,(04107) Escuela Militar,20,11,16,47
27459,2020-01-13,(50004) Corral Avenida Ciudad de Cali,1,1,0,2
27460,2020-02-26,(04000) Cabecera Calle 80 - alimentacion,24908,14206,14811,53925
27461,2020-08-24,(04000) Cabecera Calle 80 - alimentacion,3524,1961,2219,7704
27462,2020-01-28,(07005) ALQUERIA,2536,1439,1363,5338
27463,2020-09-04,(02502) Terminal,467,334,465,1266
27464,2020-07-24,(09118) Marly,1298,828,630,2756
27465,2020-07-09,(03013) RIO NEGRO,273,189,157,619
27466,2020-03-11,(07504) TERREROS,15760,9977,8695,34432
27467,2020-05-03,(07504) TERREROS,903,585,439,1927
27468,2020-09-05,(07504) TERREROS,5257,2554,3241,11052
27469,2020-01-14,(10000) Portal 20 de Julio - alimentacion,9695,4738,6930,21363
27470,2020-01-18,(07111) NQS - RICAURTE,1875,1370,1282,4527
27471,2020-03-06,(03002) SUBA - TV- 91,4435,2453,2459,9347
27472,2020-01-29,(07503) SAN MATEO,39857,22660,17521,80038
27473,2020-02-21,(06000) Portal Eldorado - alimentacion,18386,9176,9409,36971
27474,2020-03-05,(06000) Portal Eldorado - alimentacion,18060,9607,9723,37390
27475,2020-02-05,(07003) SEVILLANA,2151,1163,1172,4486
27476,2020-01-27,(06104) Gobernación,1363,755,642,2760
27477,2020-02-01,(07504) TERREROS,11952,5884,7862,25698
27478,2020-02-17,(04101) Minuto de Dios,3574,2200,1782,7556
27479,2020-01-26,(09003) Socorro,505,202,431,1138
27480,2020-02-12,(07111) NQS - RICAURTE,3225,2039,1777,7041
27481,2020-08-10,(05000) Portal Américas - alimentacion,10410,5633,5393,21436
27482,2020-03-27,(04000) Cabecera Calle 80 - alimentacion,1814,983,1031,3828
27483,2020-01-04,(08000) Portal Tunal - alimentacion,10040,4765,6091,20896
27484,2020-05-11,(08000) Portal Tunal - alimentacion,4586,2427,2381,9394
27485,2020-02-15,(04103) Las Ferias,878,495,679,2052
27486,2020-05-29,(04103) Las Ferias,307,180,133,620
27487,2020-01-14,(07000) Portal Sur - alimentacion,24858,13989,12882,51729
27488,2020-02-21,(07112) COMUNEROS,3691,2198,2203,8092
27489,2020-02-26,(50006) Corral Carrera 77,30,18,54,102
27490,2020-09-22,(05100) Banderas P. Central,1053,627,764,2444
27491,2020-02-06,(10001) Country Sur,5205,2328,2786,10319
27492,2020-07-03,(09100) Calle 40 Sur,1990,1085,1268,4343
27493,2020-05-11,(06000) Portal Eldorado - alimentacion,3083,1528,1443,6054
27494,2020-01-09,(09115) Calle 34,2953,2070,1895,6918
27495,2020-01-25,(09115) Calle 34,1339,981,1471,3791
27496,2019-12-31,(05100) Banderas P. Central - alimentacion,101,65,120,286
27497,2020-01-07,(02502) Terminal,3038,2063,2072,7173
27498,2020-02-28,(10002) Av. Primero de Mayo,8446,4166,4775,17387
27499,2020-02-28,(09000) Cabecera Usme - alimentacion,26706,14040,15888,56634
27500,2020-02-02,(07504) TERREROS,4626,1945,3697,10268
27501,2020-08-21,(02204) Pepe Sierra,689,502,402,1593
27502,2020-01-04,(05002) Tintal,3757,1743,2535,8035
27503,2020-03-17,(05002) Tintal,6782,3870,3641,14293
27504,2020-02-04,(02304) Heroes,4637,3154,2383,10174
27505,2020-03-03,(02302) Virrey,3774,2601,1915,8290
27506,2020-01-14,(09116) Avenida 39,2165,1472,1261,4898
27507,2020-05-21,(02103) Mazurén,133,79,101,313
27508,2020-09-11,(02103) Mazurén,225,133,209,567
27509,2020-01-28,(02303) Calle 85,3583,2448,1857,7888
27510,2020-02-14,(02303) Calle 85,3477,2536,2047,8060
27511,2020-02-10,(05100) Banderas P. Central - alimentacion,16557,9645,8486,34688
27512,2020-05-16,(07002) MADELENA,375,208,246,829
27513,2020-03-27,(07111) NQS - RICAURTE,323,246,191,760
27514,2020-04-16,(03003) 21 ANGELES,161,75,71,307
27515,2020-01-11,(02001) Centro Comercial Santa Fe,1493,739,1389,3621
27516,2020-06-08,(04000) Cabecera Calle 80,996,640,700,2336
27517,2020-05-07,(08000) Portal Tunal - alimentacion,4105,2177,2084,8366
27518,2020-06-27,(09110) Avenida Jimenez,1241,888,803,2932
27519,2020-03-11,(04106) Carrera 47,1411,782,790,2983
27520,2020-03-05,(09114) Calle 26,3336,2111,1825,7272
27521,2020-04-17,(04002) Carrera 90,386,204,188,778
27522,2020-05-06,(04002) Carrera 90,477,268,210,955
27523,2020-08-18,(10006) San Victorino,379,225,315,919
27524,2020-01-08,(10008) San Diego,1101,589,651,2341
27525,2020-03-10,(04001) Quirigua,133,578,442,1153
27526,2020-05-04,(12001) Carrera 43,310,187,152,649
27527,2020-02-06,(06101) El Tiempo,2883,1754,1479,6116
27528,2020-07-07,(03000) Portal Suba,1386,854,958,3198
27529,2020-02-06,(09101) Quiroga,1584,1026,1301,3911
27530,2020-03-19,(10002) Av. Primero de Mayo,4746,2244,2692,9682
27531,2020-01-14,(02502) Terminal,4181,2676,2577,9434
27532,2020-01-22,(09109) Tercer Milenio,1276,758,819,2853
27533,2020-05-02,(07503) SAN MATEO,4014,2554,1874,8442
27534,2020-07-03,(09116) Avenida 39,362,241,249,852
27535,2020-03-05,(07007) NQS - Calle 38A Sur,2217,1249,1276,4742
27536,2020-03-11,(06103) CAN,2404,1447,1158,5009
27537,2020-05-27,(09004) Santa Lucía,2205,1128,1196,4529
27538,2020-09-05,(04000) Cabecera Calle 80,920,492,912,2324
27539,2020-05-28,(10001) Country Sur,993,428,539,1960
27540,2020-06-03,(10001) Country Sur,1031,485,641,2157
27541,2020-03-11,(02202) Calle 127,5451,3700,2811,11962
27542,2020-03-16,(02202) Calle 127,3640,2587,1874,8101
27543,2020-07-05,(02201) Prado,255,200,262,717
27544,2020-07-01,(05000) Portal Américas,2523,1855,2019,6397
27545,2020-01-22,(02304) Heroes,4122,2900,2148,9170
27546,2020-03-07,(04003) Avenida Ciudad de Cali,3165,1513,2576,7254
27547,2020-10-06,(05002) Tintal,2903,1726,2149,6778
27548,2020-07-22,(02300) Calle 100,1005,702,661,2368
27549,2020-09-06,(08000) Portal Tunal,261,157,196,614
27550,2020-06-16,(08000) Portal Tunal,776,323,262,1361
27551,2020-01-25,(09104) Restrepo,3235,1880,2830,7945
27552,2020-07-25,(02202) Calle 127,770,518,394,1682
27553,2020-03-15,(02104) Calle 146,901,438,882,2221
27554,2020-08-01,(09002) Consuelo,385,172,221,778
27555,2020-01-10,(03009) Av. Suba- Calle 116,1969,1187,1141,4297
27556,2020-07-12,(05000) Portal Américas - alimentacion,3961,1808,2095,7864
27557,2020-01-13,(03006) NIZA - CALLE 127,1874,1191,1277,4342
27558,2020-03-03,(03006) NIZA - CALLE 127,2434,1628,1479,5541
27559,2020-01-05,(07113) SANTA ISABEL,339,178,413,930
27560,2020-07-27,(04003) Avenida Ciudad de Cali,925,538,664,2127
27561,2020-02-20,(04108) El Polo,1866,1192,1077,4135
27562,2020-03-16,(07000) Portal Sur,6057,3526,3167,12750
27563,2020-01-16,(02201) Prado,4934,2947,2858,10739
27564,2020-07-24,(06000) Portal Eldorado - alimentacion,3090,1523,1581,6194
27565,2020-09-25,(07106) EL CAMPIN,538,336,322,1196
27566,2020-06-23,(07113) SANTA ISABEL,433,256,250,939
27567,2020-06-18,(03007) HUMEDAL CORDOBA,169,99,70,338
27568,2020-03-22,(02000) Cabecera Autopista Norte - alimentacion,1158,570,463,2191
27569,2020-08-23,(06000) Portal Eldorado - alimentacion,1196,564,784,2544
27570,2020-08-24,(05101) Mandalay - Cr.73,95,61,59,215
27571,2020-05-03,(09100) Calle 40 Sur,344,199,234,777
27572,2020-06-03,(09100) Calle 40 Sur,1546,940,910,3396
27573,2020-04-27,(07104) Simon Bolivar,71,110,71,252
27574,2020-10-07,(04107) Escuela Militar,193,109,126,428
27575,2020-01-29,(03012) SUBA - CALLE 95,1448,897,969,3314
27576,2020-10-11,(09109) Tercer Milenio,99,70,142,311
27577,2020-03-17,(02105) Calle 142,3057,1879,1657,6593
27578,2020-10-06,(03006) NIZA - CALLE 127,562,340,367,1269
27579,2020-04-29,(09116) Avenida 39,228,152,139,519
27580,2020-03-20,(07113) SANTA ISABEL,175,114,109,398
27581,2020-05-12,(07113) SANTA ISABEL,327,214,217,758
27582,2020-09-22,(04108) El Polo,535,315,305,1155
27583,2020-08-11,(02105) Calle 142,716,461,465,1642
27584,2020-04-16,(09120) Calle 63,547,414,351,1312
27585,2020-07-11,(09120) Calle 63,962,649,655,2266
27586,2020-03-28,(06100) Av. Rojas,69,47,39,155
27587,2020-06-11,(12003) Ricaurte,337,252,157,746
27588,2020-06-14,(12003) Ricaurte,38,32,44,114
27589,2020-06-01,(07106) EL CAMPIN,304,205,175,684
27590,2020-03-10,(09104) Restrepo,1037,1144,1112,3293
27591,2020-05-14,(09104) Restrepo,1133,701,817,2651
27592,2020-02-02,(07107) U. NACIONAL,300,238,458,996
27593,2020-09-26,(06103) CAN,218,175,197,590
27594,2020-06-29,(07009) SENA,252,132,178,562
27595,2020-09-06,(09116) Avenida 39,97,74,120,291
27596,2020-07-25,(09110) Avenida Jimenez,399,371,427,1197
27597,2020-04-20,(09000) Cabecera Usme,666,490,593,1749
27598,2020-05-08,(09000) Cabecera Usme,1051,691,761,2503
27599,2020-10-09,(03006) NIZA - CALLE 127,562,319,407,1288
27600,2020-07-17,(09104) Restrepo,1219,717,897,2833
27601,2020-06-26,(02103) Mazurén,221,137,185,543
27602,2020-01-06,(12007) Zona Industrial,106,108,143,357
27603,2020-01-09,(12002) CDS - Carrera 32,401,279,230,910
27604,2020-03-09,(09106) Nariño,225,459,398,1082
27605,2020-06-10,(02001) Centro Comercial Santa Fe,473,305,298,1076
27606,2020-01-26,(02000) Cabecera Autopista Norte - intermunicipal,632,412,794,1838
27607,2020-04-08,(06002) Normandía,154,80,117,351
27608,2020-07-09,(09000) Cabecera Usme,1803,1137,1246,4186
27609,2020-09-26,(09122) Calle 72,952,681,1037,2670
27610,2020-06-08,(10008) San Diego,253,139,137,529
27611,2020-06-17,(03011) SUBA - CALLE 100,554,240,247,1041
27612,2020-06-24,(10009) Museo Nacional,528,305,331,1164
27613,2020-02-29,(06102) Salitre El Greco,710,469,542,1721
27614,2020-09-02,(09117) Calle 45,724,459,519,1702
27615,2020-06-06,(06111) Universidades,0,108,344,452
27616,2020-06-05,(40001) Juan Pablo II,536,327,301,1164
27617,2020-08-03,(09115) Calle 34,577,344,342,1263
27618,2020-10-07,(02204) Pepe Sierra,921,642,639,2202
27619,2020-03-08,(07105) MOVISTAR ARENA,209,132,266,607
27620,2020-01-14,(06107) Ciudad Universitaria,815,492,658,1965
27621,2020-01-08,(12004) Carrera 22,489,307,366,1162
27622,2020-02-13,(07200) Tygua-San José,761,498,533,1792
27623,2020-09-08,(07200) Tygua-San José,238,130,186,554
27624,2020-04-06,(07001) PERDOMO,447,258,269,974
27625,2020-07-05,(07103) AV. CHILE,185,127,210,522
27626,2020-01-09,(09111) Calle 19,1556,1000,1277,3833
27627,2020-08-28,(07003) SEVILLANA,482,270,268,1020
27628,2020-06-16,(50003) Corral Molinos,1530,800,1029,3359
27629,2020-09-29,(07000) Portal Sur,2298,1366,1565,5229
27630,2020-08-22,(10007) Las Nieves,398,272,299,969
27631,2020-03-15,(04003) Avenida Ciudad de Cali,796,369,799,1964
27632,2020-02-16,(10003) Ciudad Jardín,217,90,258,565
27633,2020-09-12,(10007) Las Nieves,329,361,472,1162
27634,2020-06-22,(04104) Avenida 68,218,123,138,479
27635,2020-10-05,(05102) Av. Américas - Av. Boyacá,295,172,224,691
27636,2020-08-23,(03001) LA CAMPIÑA,241,141,217,599
27637,2020-07-23,(02201) Prado,711,482,399,1592
27638,2020-05-13,(09114) Calle 26,230,165,147,542
27639,2020-02-26,(12000) Puente Aranda,290,174,194,658
27640,2020-05-19,(02102) Calle 161,190,112,126,428
27641,2020-03-24,(14001) La Sabana,87,87,100,274
27642,2020-04-01,(07505) LEON XIII,1225,684,576,2485
27643,2020-06-06,(02103) Mazurén,101,74,100,275
27644,2020-06-10,(02502) Terminal,404,258,308,970
27645,2020-09-20,(04106) Carrera 47,119,73,149,341
27646,2020-04-16,(07200) Tygua-San José,81,51,58,190
27647,2020-06-29,(50003) Corral Molinos,589,298,501,1388
27648,2020-01-01,(03010) PUENTE LARGO,131,90,161,382
27649,2020-04-17,(10006) San Victorino,188,146,162,496
27650,2020-07-26,(04108) El Polo,77,54,64,195
27651,2020-05-04,(12002) CDS - Carrera 32,196,135,67,398
27652,2020-05-08,(12002) CDS - Carrera 32,177,145,78,400
27653,2020-06-21,(07005) ALQUERIA,179,88,123,390
27654,2020-05-29,(05100) Banderas P. Central,619,329,420,1368
27655,2020-06-01,(06002) Normandía,296,168,163,627
27656,2020-07-09,(06002) Normandía,325,180,171,676
27657,2020-07-27,(07506) DESPENSA,362,228,232,822
27658,2020-07-08,(07200) Tygua-San José,250,138,163,551
27659,2020-08-16,(04101) Minuto de Dios,75,36,77,188
27660,2020-01-08,(09108) Hospital,157,97,160,414
27661,2020-05-16,(02502) Terminal,154,104,172,430
27662,2020-04-28,(04103) Las Ferias,210,118,105,433
27663,2020-05-26,(04104) Avenida 68,551,286,308,1145
27664,2020-04-13,(09111) Calle 19,290,202,243,735
27665,2020-06-08,(06102) Salitre El Greco,204,119,107,430
27666,2020-06-29,(06001) Modelia,101,61,88,250
27667,2020-04-27,(07005) ALQUERIA,188,44,30,262
27668,2020-01-12,(07006) General Santander - alimentacion,243,159,325,727
27669,2020-04-18,(07006) General Santander - alimentacion,141,90,84,315
27670,2020-07-06,(06102) Salitre El Greco,259,149,132,540
27671,2020-03-21,(06001) Modelia,166,119,79,364
27672,2020-07-22,(10007) Las Nieves,384,240,291,915
27673,2020-07-16,(40002) Manitas,267,185,174,626
27674,2020-07-20,(03004) GRATAMIRA,9,6,8,23
27675,2020-09-06,(07112) COMUNEROS,270,157,265,692
27676,2020-03-27,(03006) NIZA - CALLE 127,231,167,149,547
27677,2020-09-02,(09106) Nariño,426,251,333,1010
27678,2020-01-19,(14001) La Sabana,79,65,114,258
27679,2020-06-21,(06103) CAN,129,100,75,304
27680,2020-04-15,(09113) Calle 22,250,154,242,646
27681,2020-05-21,(14004) Museo del Oro,0,90,177,267
27682,2020-08-01,(04106) Carrera 47,184,88,116,388
27683,2020-02-24,(03014) SAN MARTIN,228,160,194,582
27684,2020-03-10,(10005) Bicentenario - alimentacion,76,109,130,315
27685,2020-06-07,(07506) DESPENSA,142,67,87,296
27686,2020-09-12,(06105) Quinta Paredes,91,63,79,233
27687,2020-09-13,(09116) Avenida 39,99,52,138,289
27688,2020-05-20,(10005) Bicentenario - alimentacion,213,96,133,442
27689,2020-07-12,(04107) Escuela Militar,43,23,51,117
27690,2020-08-15,(07200) Tygua-San José,165,111,159,435
27691,2020-03-30,(04107) Escuela Militar,55,50,33,138
27692,2020-04-16,(04107) Escuela Militar,53,41,47,141
27693,2020-05-31,(03001) LA CAMPIÑA,233,134,172,539
27694,2020-07-30,(05103) Marsella,380,221,198,799
27695,2020-04-04,(07002) MADELENA,215,120,132,467
27696,2020-08-17,(06002) Normandía,78,54,62,194
27697,2020-07-28,(09105) Río Fucha,80,34,75,189
27698,2020-08-20,(06108) Concejo de Bogotá,127,67,52,246
27699,2020-07-18,(06100) Av. Rojas,119,71,91,281
27700,2020-08-10,(06108) Concejo de Bogotá,137,61,83,281
27701,2020-06-21,(03014) SAN MARTIN,7,2,13,22
27702,2020-06-29,(03014) SAN MARTIN,7,7,25,39
27703,2020-04-18,(05101) Mandalay - Cr.73,36,19,15,70
27704,2019-12-31,(06106) Recinto Ferial,17,11,15,43
27705,2020-04-08,(12000) Puente Aranda,39,26,20,85
27706,2020-06-29,(04000) Cabecera Calle 80 - alimentacion,1218,677,996,2891
27707,2020-02-14,(09002) Consuelo,1476,768,903,3147
27708,2020-03-10,(02502) Terminal,480,1266,856,2602
27709,2020-03-05,(09118) Marly,7923,5121,4052,17096
27710,2020-07-24,(07504) TERREROS,5385,2956,2431,10772
27711,2020-02-12,(05000) Portal Américas - alimentacion,38518,23034,21156,82708
27712,2020-02-06,(03000) Portal Suba - alimentacion,27932,16235,15807,59974
27713,2020-02-04,(02303) Calle 85,3782,2504,1999,8285
27714,2020-01-17,(02200) Alcalá,12134,6990,6369,25493
27715,2020-01-24,(02200) Alcalá,13683,7901,6570,28154
27716,2020-01-20,(06000) Portal Eldorado - alimentacion,16051,8599,8887,33537
27717,2020-02-14,(10000) Portal 20 de Julio - alimentacion,11816,5720,7393,24929
27718,2020-06-25,(10000) Portal 20 de Julio - alimentacion,4327,2080,2579,8986
27719,2020-02-18,(09001) Molinos,7708,4798,5894,18400
27720,2020-03-11,(06107) Ciudad Universitaria,1530,968,870,3368
27721,2020-06-20,(07503) SAN MATEO,8642,4975,4887,18504
27722,2020-08-14,(09001) Molinos,2362,1280,1632,5274
27723,2020-01-17,(02000) Cabecera Autopista Norte - intermunicipal,3968,2539,2758,9265
27724,2020-02-10,(14004) Museo del Oro,4347,2607,1940,8894
27725,2020-02-18,(05005) Transversal 86,2893,1671,1309,5873
27726,2020-09-18,(07112) COMUNEROS,965,519,648,2132
27727,2020-02-07,(05100) Banderas P. Central,8252,4527,4176,16955
27728,2020-03-11,(40001) Juan Pablo II,1520,876,880,3276
27729,2020-02-07,(02102) Calle 161,2005,1126,1230,4361
27730,2020-09-12,(09000) Cabecera Usme,1499,752,1328,3579
27731,2020-04-01,(06000) Portal Eldorado - alimentacion,2212,1043,974,4229
27732,2020-01-13,(05100) Banderas P. Central - alimentacion,11625,6441,7106,25172
27733,2020-01-13,(07009) SENA,2692,1600,1811,6103
27734,2020-04-28,(07000) Portal Sur - alimentacion,4704,2583,1896,9183
27735,2020-01-15,(02205) Calle 106,2352,1429,1257,5038
27736,2020-01-13,(10005) Bicentenario - alimentacion,561,255,560,1376
27737,2020-08-03,(07001) PERDOMO,822,491,513,1826
27738,2020-02-08,(02000) Cabecera Autopista Norte,5110,2592,4079,11781
27739,2020-02-27,(07113) SANTA ISABEL,2185,1325,1418,4928
27740,2020-07-22,(40003) Mirador del Paraiso,1180,744,780,2704
27741,2020-07-08,(09104) Restrepo,1621,977,1118,3716
27742,2020-10-06,(09104) Restrepo,1701,994,1679,4374
27743,2020-07-16,(04101) Minuto de Dios,273,161,182,616
27744,2020-07-18,(07505) LEON XIII,1882,975,808,3665
27745,2020-02-14,(06002) Normandía,2697,1503,1392,5592
27746,2020-03-14,(09123) Calle 76,2081,1657,1968,5706
27747,2020-01-22,(03005) SUBA - AV. BOYACA,2613,1548,1476,5637
27748,2020-03-12,(03005) SUBA - AV. BOYACA,516,406,361,1283
27749,2020-08-19,(09101) Quiroga,480,262,325,1067
27750,2020-02-06,(03001) LA CAMPIÑA,6721,4014,4057,14792
27751,2020-01-20,(03007) HUMEDAL CORDOBA,899,584,511,1994
27752,2020-05-18,(09103) Olaya,801,435,413,1649
27753,2020-04-01,(07111) NQS - RICAURTE,381,288,193,862
27754,2020-08-19,(07111) NQS - RICAURTE,1121,698,443,2262
27755,2020-07-17,(07002) MADELENA,576,350,434,1360
27756,2020-09-15,(07002) MADELENA,902,529,611,2042
27757,2020-09-02,(02000) Cabecera Autopista Norte,1486,916,964,3366
27758,2020-01-15,(04105) Carrera 53,1165,643,708,2516
27759,2020-02-05,(07109) CAD,3001,1782,1553,6336
27760,2020-02-26,(07007) NQS - Calle 38A Sur,2228,1287,1154,4669
27761,2020-03-26,(50003) Corral Molinos,713,329,447,1489
27762,2020-07-23,(50003) Corral Molinos,1123,594,787,2504
27763,2020-02-23,(04000) Cabecera Calle 80,1229,691,1411,3331
27764,2020-03-22,(07506) DESPENSA,60,48,60,168
27765,2020-01-02,(09004) Santa Lucía,3602,1900,2585,8087
27766,2020-05-29,(10002) Av. Primero de Mayo,1900,987,1133,4020
27767,2020-02-21,(10005) Bicentenario - alimentacion,726,330,524,1580
27768,2020-07-17,(10005) Bicentenario - alimentacion,176,79,158,413
27769,2020-02-22,(02000) Cabecera Autopista Norte - intermunicipal,2075,1154,1885,5114
27770,2020-08-24,(03000) Portal Suba,1130,696,787,2613
27771,2020-03-31,(02000) Cabecera Autopista Norte - intermunicipal,141,106,103,350
27772,2020-09-02,(09101) Quiroga,484,298,399,1181
27773,2020-02-21,(08001) Parque el Tunal,1706,851,949,3506
27774,2020-04-23,(10000) Portal 20 de Julio - alimentacion,2506,1132,1553,5191
27775,2020-06-12,(08000) Portal Tunal - alimentacion,6409,3492,3408,13309
27776,2020-05-26,(04108) El Polo,450,287,177,914
27777,2020-01-27,(08002) Biblioteca,951,542,627,2120
27778,2020-03-16,(02303) Calle 85,2645,1864,1375,5884
27779,2020-03-10,(02104) Calle 146,637,2464,1438,4539
27780,2020-02-08,(09105) Río Fucha,431,236,419,1086
27781,2020-05-25,(07503) SAN MATEO,2704,1590,1219,5513
27782,2020-05-13,(08001) Parque el Tunal,348,205,220,773
27783,2020-06-12,(09116) Avenida 39,341,219,206,766
27784,2020-07-03,(07010) Bosa,788,403,502,1693
27785,2020-05-06,(02201) Prado,532,358,317,1207
27786,2020-05-09,(02201) Prado,429,269,264,962
27787,2020-09-16,(02201) Prado,940,671,658,2269
27788,2020-09-16,(06102) Salitre El Greco,277,137,172,586
27789,2020-01-28,(05105) Pradera,2502,1453,1131,5086
27790,2020-07-11,(05103) Marsella,372,181,228,781
27791,2020-01-21,(02300) Calle 100,4866,3274,2543,10683
27792,2020-06-30,(02300) Calle 100,1365,853,726,2944
27793,2020-02-01,(03012) SUBA - CALLE 95,713,511,777,2001
27794,2020-09-17,(10000) Portal 20 de Julio,2485,1237,1445,5167
27795,2020-02-01,(08000) Portal Tunal,1354,825,887,3066
27796,2020-05-28,(07104) Simon Bolivar,538,368,259,1165
27797,2020-01-22,(08000) Portal Tunal,2026,1119,1017,4162
27798,2020-03-18,(06109) Centro Memoria,663,377,334,1374
27799,2020-01-13,(03009) Av. Suba- Calle 116,2146,1310,1192,4648
27800,2020-05-21,(03009) Av. Suba- Calle 116,426,268,187,881
27801,2020-06-30,(04101) Minuto de Dios,343,202,270,815
27802,2020-10-06,(04108) El Polo,547,326,332,1205
27803,2020-01-31,(07101) CASTELLANA,863,579,639,2081
27804,2020-02-08,(02304) Heroes,1806,1466,1534,4806
27805,2020-06-26,(50003) Corral Molinos,1651,870,1127,3648
27806,2020-01-07,(03007) HUMEDAL CORDOBA,561,354,357,1272
27807,2020-04-25,(03007) HUMEDAL CORDOBA,67,37,31,135
27808,2020-06-06,(03007) HUMEDAL CORDOBA,120,69,43,232
27809,2020-03-18,(07108) Av. El Dorado,443,322,295,1060
27810,2020-01-25,(09117) Calle 45,1931,1265,1885,5081
27811,2020-02-01,(09117) Calle 45,2459,1540,2233,6232
27812,2020-07-01,(09000) Cabecera Usme,1876,1156,1339,4371
27813,2020-06-05,(07000) Portal Sur,1711,1054,930,3695
27814,2020-02-08,(09115) Calle 34,1464,1105,1627,4196
27815,2020-01-09,(02304) Heroes,3167,2279,1796,7242
27816,2020-05-13,(10005) Bicentenario - alimentacion,197,99,131,427
27817,2020-10-01,(10010) San Bernardo,652,345,579,1576
27818,2020-03-08,(03006) NIZA - CALLE 127,474,334,487,1295
27819,2020-04-23,(07000) Portal Sur,933,581,553,2067
27820,2020-06-11,(02303) Calle 85,647,471,312,1430
27821,2020-01-19,(04003) Avenida Ciudad de Cali,992,458,1113,2563
27822,2020-10-06,(09110) Avenida Jimenez,1542,1114,1132,3788
27823,2020-02-29,(04001) Quirigua,1153,559,957,2669
27824,2020-02-26,(07003) SEVILLANA,2221,1126,1135,4482
27825,2020-05-17,(05002) Tintal,478,228,263,969
27826,2020-05-11,(02204) Pepe Sierra,557,414,295,1266
27827,2020-02-03,(07101) CASTELLANA,988,570,600,2158
27828,2020-03-05,(07101) CASTELLANA,873,579,633,2085
27829,2020-01-26,(02001) Centro Comercial Santa Fe,590,350,837,1777
27830,2020-05-20,(02001) Centro Comercial Santa Fe,341,214,249,804
27831,2020-02-09,(02105) Calle 142,874,483,1092,2449
27832,2020-08-05,(02302) Virrey,615,418,285,1318
27833,2020-02-09,(03010) PUENTE LARGO,296,201,339,836
27834,2020-05-25,(03010) PUENTE LARGO,93,69,62,224
27835,2020-09-19,(06103) CAN,231,160,219,610
27836,2020-08-12,(07009) SENA,580,319,371,1270
27837,2020-04-14,(02105) Calle 142,423,290,233,946
27838,2020-08-05,(09109) Tercer Milenio,327,222,206,755
27839,2020-01-05,(03013) RIO NEGRO,197,104,254,555
27840,2020-04-24,(07007) NQS - Calle 38A Sur,181,135,113,429
27841,2020-05-14,(04000) Cabecera Calle 80 - intermunicipal,186,104,168,458
27842,2020-07-20,(02104) Calle 146,226,150,147,523
27843,2020-03-25,(09123) Calle 76,491,391,301,1183
27844,2020-04-29,(07103) AV. CHILE,632,413,292,1337
27845,2020-09-05,(09122) Calle 72,896,633,916,2445
27846,2020-02-07,(07105) MOVISTAR ARENA,1343,849,757,2949
27847,2020-02-05,(40002) Manitas,1319,770,823,2912
27848,2020-04-06,(40002) Manitas,168,87,122,377
27849,2020-03-24,(06109) Centro Memoria,260,208,192,660
27850,2020-10-09,(05103) Marsella,541,298,402,1241
27851,2020-09-22,(02001) Centro Comercial Santa Fe,616,379,502,1497
27852,2020-01-20,(07006) General Santander,2593,1496,1530,5619
27853,2020-05-13,(10006) San Victorino,362,206,254,822
27854,2020-09-25,(07003) SEVILLANA,548,290,375,1213
27855,2020-02-03,(03005) SUBA - AV. BOYACA,2835,1613,1555,6003
27856,2020-05-22,(09118) Marly,1355,889,653,2897
27857,2020-06-17,(10008) San Diego,321,166,182,669
27858,2020-06-29,(06000) Portal Eldorado - alimentacion,1437,708,843,2988
27859,2020-07-18,(06000) Portal Eldorado - alimentacion,2633,1211,1413,5257
27860,2020-05-20,(09120) Calle 63,856,590,520,1966
27861,2020-07-12,(09120) Calle 63,405,267,363,1035
27862,2020-10-07,(03011) SUBA - CALLE 100,621,334,382,1337
27863,2020-07-28,(09003) Socorro,557,284,328,1169
27864,2020-03-12,(03003) 21 ANGELES,56,365,280,701
27865,2020-09-02,(09115) Calle 34,684,405,449,1538
27866,2020-03-27,(09115) Calle 34,358,275,227,860
27867,2020-10-08,(09115) Calle 34,739,469,599,1807
27868,2020-06-30,(03006) NIZA - CALLE 127,502,294,240,1036
27869,2020-08-26,(07002) MADELENA,755,472,497,1724
27870,2020-08-27,(02204) Pepe Sierra,736,527,379,1642
27871,2020-02-23,(03007) HUMEDAL CORDOBA,151,86,164,401
27872,2020-06-23,(07006) General Santander,536,348,285,1169
27873,2020-03-02,(12004) Carrera 22,697,427,477,1601
27874,2020-08-25,(02101) Toberín,1300,797,887,2984
27875,2020-06-25,(12004) Carrera 22,271,157,136,564
27876,2020-01-21,(09106) Nariño,1312,737,791,2840
27877,2020-03-24,(06104) Gobernación,246,226,153,625
27878,2020-05-11,(06104) Gobernación,202,130,76,408
27879,2020-02-29,(07006) General Santander - alimentacion,929,517,792,2238
27880,2020-09-18,(02302) Virrey,779,521,480,1780
27881,2020-01-20,(07105) MOVISTAR ARENA,1222,746,729,2697
27882,2020-08-30,(03009) Av. Suba- Calle 116,134,102,98,334
27883,2020-08-25,(07107) U. NACIONAL,315,169,163,647
27884,2020-05-28,(02303) Calle 85,609,421,289,1319
27885,2020-09-29,(10004) Policarpa,313,134,207,654
27886,2020-04-18,(07107) U. NACIONAL,151,118,85,354
27887,2020-06-19,(02104) Calle 146,807,509,535,1851
27888,2020-07-16,(07110) PALOQUEMAO,525,332,205,1062
27889,2020-05-30,(08000) Portal Tunal,512,244,216,972
27890,2020-09-04,(05005) Transversal 86,434,240,335,1009
27891,2020-08-31,(09110) Avenida Jimenez,1021,786,762,2569
27892,2020-04-23,(10004) Policarpa,139,74,85,298
27893,2020-08-04,(02304) Heroes,752,542,412,1706
27894,2020-09-16,(08002) Biblioteca,349,198,201,748
27895,2020-08-14,(12000) Puente Aranda,94,52,42,188
27896,2020-02-09,(04000) Cabecera Calle 80 - intermunicipal,308,167,433,908
27897,2020-09-05,(09121) Las Flores,515,331,461,1307
27898,2020-06-03,(02102) Calle 161,218,145,136,499
27899,2020-09-15,(12004) Carrera 22,238,144,134,516
27900,2020-10-06,(06000) Portal Eldorado,939,690,743,2372
27901,2020-07-21,(04106) Carrera 47,295,159,140,594
27902,2020-09-07,(04106) Carrera 47,345,169,234,748
27903,2020-06-22,(09119) Calle 57,207,125,208,540
27904,2020-07-16,(04106) Carrera 47,312,143,134,589
27905,2020-08-18,(10004) Policarpa,205,95,158,458
27906,2020-05-30,(07006) General Santander,308,175,190,673
27907,2020-03-15,(06002) Normandía,226,129,293,648
27908,2020-02-21,(07200) Tygua-San José,734,449,592,1775
27909,2020-03-18,(07200) Tygua-San José,422,257,371,1050
27910,2020-02-09,(09106) Nariño,420,233,487,1140
27911,2020-08-02,(07009) SENA,152,96,127,375
27912,2020-03-23,(07103) AV. CHILE,158,124,123,405
27913,2020-08-26,(06106) Recinto Ferial,218,135,120,473
27914,2020-02-11,(12002) CDS - Carrera 32,662,405,321,1388
27915,2020-09-27,(12002) CDS - Carrera 32,37,36,24,97
27916,2020-01-12,(40001) Juan Pablo II,413,173,349,935
27917,2020-05-12,(04001) Quirigua,260,183,183,626
27918,2020-06-04,(09113) Calle 22,369,227,342,938
27919,2020-02-23,(07003) SEVILLANA,325,188,375,888
27920,2020-04-07,(40001) Juan Pablo II,246,134,153,533
27921,2020-07-20,(06103) CAN,146,108,55,309
27922,2020-04-28,(04101) Minuto de Dios,168,108,98,374
27923,2020-10-12,(04001) Quirigua,142,74,149,365
27924,2020-08-14,(04000) Cabecera Calle 80 - intermunicipal,324,152,285,761
27925,2020-05-29,(09108) Hospital,77,44,38,159
27926,2020-06-14,(02502) Terminal,68,52,97,217
27927,2020-07-28,(04000) Cabecera Calle 80 - intermunicipal,325,175,249,749
27928,2020-06-19,(06105) Quinta Paredes,126,95,86,307
27929,2020-07-08,(06105) Quinta Paredes,151,78,86,315
27930,2020-05-21,(03011) SUBA - CALLE 100,351,188,173,712
27931,2020-05-20,(07006) General Santander - alimentacion,297,180,150,627
27932,2020-04-21,(09117) Calle 45,472,321,237,1030
27933,2020-04-25,(06001) Modelia,182,131,118,431
27934,2020-07-12,(07006) General Santander,197,93,148,438
27935,2020-06-25,(03010) PUENTE LARGO,361,244,209,814
27936,2020-01-01,(02303) Calle 85,208,169,283,660
27937,2020-04-30,(02102) Calle 161,116,83,40,239
27938,2020-05-05,(05100) Banderas P. Central,454,240,311,1005
27939,2020-06-28,(06101) El Tiempo,113,71,94,278
27940,2020-04-28,(04104) Avenida 68,365,214,176,755
27941,2020-08-30,(06107) Ciudad Universitaria,51,45,65,161
27942,2020-06-29,(07108) Av. El Dorado,40,25,37,102
27943,2020-04-11,(02104) Calle 146,224,178,122,524
27944,2020-04-17,(07004) VENECIA,514,313,288,1115
27945,2020-04-21,(07201) Guatoque -Veraguas,101,67,84,252
27946,2020-08-15,(06105) Quinta Paredes,102,66,64,232
27947,2020-09-20,(07104) Simon Bolivar,132,98,156,386
27948,2020-04-15,(04106) Carrera 47,166,100,88,354
27949,2020-06-16,(05102) Av. Américas - Av. Boyacá,225,129,145,499
27950,2020-05-12,(04002) Carrera 90,537,318,297,1152
27951,2020-08-03,(06104) Gobernación,236,143,101,480
27952,2020-08-12,(06104) Gobernación,244,135,108,487
27953,2020-04-29,(04107) Escuela Militar,71,49,57,177
27954,2020-05-25,(05107) Américas - Cr.53,87,73,57,217
27955,2020-09-13,(04103) Las Ferias,113,52,91,256
27956,2020-10-08,(09105) Río Fucha,0,70,143,213
27957,2020-06-07,(07108) Av. El Dorado,36,22,22,80
27958,2020-01-11,(50002) Corral Calle 40 Sur,48,29,87,164
27959,2020-03-26,(09105) Río Fucha,59,39,55,153
27960,2020-06-14,(14005) Las Aguas,27,30,80,137
27961,2020-05-24,(03011) SUBA - CALLE 100,115,59,68,242
27962,2020-04-05,(02204) Pepe Sierra,158,120,105,383
27963,2020-08-30,(07201) Guatoque -Veraguas,41,30,72,143
27964,2020-03-29,(06105) Quinta Paredes,24,23,15,62
27965,2020-09-15,(09105) Río Fucha,0,78,175,253
27966,2020-09-13,(06105) Quinta Paredes,34,25,45,104
27967,2020-07-25,(50006) Corral Carrera 77,4,1,5,10
27968,2020-06-14,(12002) CDS - Carrera 32,31,32,17,80
27969,2020-04-25,(10005) Bicentenario,45,34,31,110
27970,2020-04-11,(02102) Calle 161,46,32,33,111
27971,2020-01-16,(04000) Cabecera Calle 80 - alimentacion,19793,10758,13192,43743
27972,2020-03-11,(07005) ALQUERIA,2404,1331,1400,5135
27973,2020-09-27,(09118) Marly,490,308,521,1319
27974,2020-04-24,(03013) RIO NEGRO,172,105,110,387
27975,2020-04-21,(07504) TERREROS,2476,1644,1330,5450
27976,2020-02-27,(14005) Las Aguas,3418,2149,1930,7497
27977,2020-01-17,(09100) Calle 40 Sur,6506,3411,3947,13864
27978,2020-02-17,(09100) Calle 40 Sur,7606,4532,4232,16370
27979,2020-01-19,(05000) Portal Américas - alimentacion,9296,3664,6731,19691
27980,2020-03-28,(04002) Carrera 90,216,130,88,434
27981,2020-06-08,(07503) SAN MATEO,9767,6051,5300,21118
27982,2020-01-13,(06107) Ciudad Universitaria,732,468,684,1884
27983,2020-02-20,(09001) Molinos,7066,4319,5291,16676
27984,2020-08-25,(09001) Molinos,2442,1302,1580,5324
27985,2020-02-28,(05005) Transversal 86,2859,1456,1336,5651
27986,2020-07-05,(05000) Portal Américas - alimentacion,3462,1567,1917,6946
27987,2020-10-07,(10001) Country Sur,1527,663,1084,3274
27988,2020-10-05,(09000) Cabecera Usme,1927,1123,1638,4688
27989,2020-04-20,(09115) Calle 34,353,275,185,813
27990,2020-01-15,(02105) Calle 142,5786,3439,3348,12573
27991,2020-01-20,(02105) Calle 142,6503,4030,3691,14224
27992,2020-02-17,(04000) Cabecera Calle 80,7630,4755,4795,17180
27993,2020-01-15,(06102) Salitre El Greco,1316,737,674,2727
27994,2020-03-07,(07002) MADELENA,2735,1189,1985,5909
27995,2020-02-02,(02204) Pepe Sierra,612,493,807,1912
27996,2020-01-10,(07005) ALQUERIA,1842,994,1126,3962
27997,2020-02-22,(02000) Cabecera Autopista Norte,5040,2587,3953,11580
27998,2020-09-01,(04100) Carrera 77,1232,725,873,2830
27999,2020-02-16,(02204) Pepe Sierra,622,494,828,1944
28000,2020-02-27,(04104) Avenida 68,3702,2002,1714,7418
28001,2020-02-17,(05002) Tintal,10938,6982,6261,24181
28002,2020-07-02,(02000) Cabecera Autopista Norte - alimentacion,5056,2716,3057,10829
28003,2020-03-10,(03013) RIO NEGRO,495,139,205,839
28004,2020-04-03,(09000) Cabecera Usme - alimentacion,4574,2126,2494,9194
28005,2020-02-24,(03001) LA CAMPIÑA,6581,4090,4149,14820
28006,2020-07-01,(03001) LA CAMPIÑA,1211,661,695,2567
28007,2020-09-14,(02103) Mazurén,226,149,205,580
28008,2020-02-20,(09119) Calle 57,3834,2285,1982,8101
28009,2020-07-07,(09103) Olaya,1140,644,624,2408
28010,2020-02-25,(14001) La Sabana,640,411,378,1429
28011,2020-07-10,(04102) Avenida Boyaca,403,223,261,887
28012,2020-06-11,(04000) Cabecera Calle 80,984,643,724,2351
28013,2020-03-19,(10006) San Victorino,949,712,694,2355
28014,2020-06-09,(03000) Portal Suba,1186,750,764,2700
28015,2020-01-10,(10008) San Diego,1068,630,675,2373
28016,2020-02-12,(12001) Carrera 43,1861,1059,1081,4001
28017,2020-02-05,(10005) Bicentenario - alimentacion,729,330,562,1621
28018,2020-01-06,(02201) Prado,762,438,804,2004
28019,2020-03-03,(02201) Prado,5989,3696,3119,12804
28020,2020-04-25,(05001) Patio Bonito,758,421,407,1586
28021,2020-01-07,(02304) Heroes,2916,2031,1674,6621
28022,2020-07-09,(03000) Portal Suba,1362,851,856,3069
28023,2020-09-12,(02303) Calle 85,420,307,439,1166
28024,2020-01-15,(07000) Portal Sur,6975,4112,4142,15229
28025,2020-07-28,(09116) Avenida 39,337,207,211,755
28026,2020-10-03,(09116) Avenida 39,224,202,315,741
28027,2020-01-08,(07007) NQS - Calle 38A Sur,1436,866,916,3218
28028,2020-03-12,(06103) CAN,858,179,234,1271
28029,2020-03-18,(06108) Concejo de Bogotá,498,262,239,999
28030,2020-07-04,(10001) Country Sur,1009,492,684,2185
28031,2020-01-06,(03003) 21 ANGELES,256,105,190,551
28032,2020-06-08,(02201) Prado,858,595,474,1927
28033,2020-05-29,(10000) Portal 20 de Julio,2073,1012,1017,4102
28034,2020-07-08,(09107) Hortúa,685,399,413,1497
28035,2020-05-26,(09123) Calle 76,861,586,477,1924
28036,2020-06-15,(40003) Mirador del Paraiso,652,381,455,1488
28037,2020-02-11,(05105) Pradera,2693,1665,1230,5588
28038,2020-02-16,(05103) Marsella,484,221,501,1206
28039,2020-06-12,(02300) Calle 100,1270,803,620,2693
28040,2020-06-12,(10000) Portal 20 de Julio,2316,1123,1106,4545
28041,2020-01-11,(09103) Olaya,2051,956,1499,4506
28042,2020-03-15,(07007) NQS - Calle 38A Sur,533,298,377,1208
28043,2020-02-05,(14005) Las Aguas,3523,2171,1928,7622
28044,2020-03-15,(10008) San Diego,148,126,232,506
28045,2020-05-29,(06109) Centro Memoria,265,153,120,538
28046,2020-01-17,(10007) Las Nieves,1774,1206,1138,4118
28047,2020-05-14,(08000) Portal Tunal,591,253,222,1066
28048,2020-06-25,(03009) Av. Suba- Calle 116,508,319,230,1057
28049,2020-06-30,(03009) Av. Suba- Calle 116,519,320,273,1112
28050,2020-05-26,(02205) Calle 106,307,200,197,704
28051,2020-09-01,(02205) Calle 106,410,261,245,916
28052,2020-04-25,(03000) Portal Suba,429,267,315,1011
28053,2020-08-18,(10008) San Diego,247,140,157,544
28054,2020-06-08,(06000) Portal Eldorado - alimentacion,3765,1954,1967,7686
28055,2020-02-01,(07101) CASTELLANA,391,270,382,1043
28056,2020-09-17,(07113) SANTA ISABEL,429,244,362,1035
28057,2020-06-20,(08002) Biblioteca,238,108,126,472
28058,2020-05-04,(02101) Toberín,880,569,608,2057
28059,2020-02-13,(04103) Las Ferias,1577,933,870,3380
28060,2020-04-07,(07110) PALOQUEMAO,323,240,176,739
28061,2020-06-09,(07104) Simon Bolivar,574,363,257,1194
28062,2020-09-14,(07104) Simon Bolivar,661,347,341,1349
28063,2020-05-21,(04107) Escuela Militar,123,76,65,264
28064,2020-05-23,(08000) Portal Tunal,485,245,201,931
28065,2020-08-21,(02303) Calle 85,647,418,347,1412
28066,2020-02-06,(07109) CAD,2743,1809,1537,6089
28067,2020-02-04,(03007) HUMEDAL CORDOBA,1082,701,535,2318
28068,2020-05-15,(05103) Marsella,264,128,161,553
28069,2020-03-23,(05100) Banderas P. Central - alimentacion,701,297,311,1309
28070,2020-01-10,(03003) 21 ANGELES,1215,557,677,2449
28071,2020-08-27,(03001) LA CAMPIÑA,1136,665,666,2467
28072,2020-03-23,(04105) Carrera 53,65,47,36,148
28073,2020-09-16,(09117) Calle 45,727,459,532,1718
28074,2020-10-07,(09117) Calle 45,779,473,675,1927
28075,2020-08-19,(02104) Calle 146,639,412,390,1441
28076,2020-08-15,(05000) Portal Américas,2192,1197,1703,5092
28077,2020-01-11,(09111) Calle 19,851,783,985,2619
28078,2020-02-02,(02000) Cabecera Autopista Norte,1814,914,1990,4718
28079,2020-10-09,(06002) Normandía,410,229,295,934
28080,2020-09-17,(07109) CAD,681,431,380,1492
28081,2020-08-13,(06106) Recinto Ferial,224,141,99,464
28082,2020-02-22,(07008) NQS - Calle 30 Sur,1125,505,777,2407
28083,2020-09-20,(06100) Av. Rojas,38,43,95,176
28084,2020-09-27,(02302) Virrey,168,130,201,499
28085,2020-06-27,(07009) SENA,589,334,384,1307
28086,2020-05-16,(12003) Ricaurte,191,147,121,459
28087,2020-05-22,(09117) Calle 45,649,407,352,1408
28088,2020-06-09,(03009) Av. Suba- Calle 116,459,294,239,992
28089,2020-07-03,(07009) SENA,743,417,433,1593
28090,2020-06-24,(05002) Tintal,2620,1545,1475,5640
28091,2020-01-28,(09109) Tercer Milenio,1320,858,872,3050
28092,2020-01-17,(10005) Bicentenario,662,373,344,1379
28093,2020-01-31,(10005) Bicentenario,738,395,417,1550
28094,2020-02-09,(07103) AV. CHILE,553,379,681,1613
28095,2020-05-05,(07103) AV. CHILE,651,428,294,1373
28096,2020-09-11,(10005) Bicentenario,96,58,77,231
28097,2020-01-22,(40002) Manitas,1160,701,786,2647
28098,2020-06-17,(40002) Manitas,387,245,254,886
28099,2020-08-31,(40002) Manitas,355,238,283,876
28100,2020-02-27,(12002) CDS - Carrera 32,682,391,352,1425
28101,2020-06-04,(09106) Nariño,357,226,242,825
28102,2020-02-14,(08002) Biblioteca,1046,581,662,2289
28103,2020-07-11,(07003) SEVILLANA,352,174,235,761
28104,2020-05-09,(10006) San Victorino,175,120,160,455
28105,2020-06-16,(02104) Calle 146,761,486,506,1753
28106,2020-05-28,(10009) Museo Nacional,487,298,254,1039
28107,2020-05-23,(02202) Calle 127,761,526,393,1680
28108,2020-09-14,(09003) Socorro,569,319,338,1226
28109,2020-09-10,(06100) Av. Rojas,228,125,131,484
28110,2020-04-18,(07000) Portal Sur,639,418,346,1403
28111,2020-07-04,(07002) MADELENA,684,329,420,1433
28112,2020-02-09,(12004) Carrera 22,110,122,207,439
28113,2020-02-23,(02105) Calle 142,859,462,1024,2345
28114,2020-05-25,(05001) Patio Bonito,530,261,252,1043
28115,2020-07-11,(09103) Olaya,899,452,551,1902
28116,2020-10-11,(02000) Cabecera Autopista Norte,526,280,579,1385
28117,2020-10-12,(02000) Cabecera Autopista Norte,515,330,556,1401
28118,2020-02-04,(04102) Avenida Boyaca,3143,1882,1643,6668
28119,2020-04-05,(03000) Portal Suba,188,124,122,434
28120,2020-04-27,(03000) Portal Suba,443,94,99,636
28121,2020-07-28,(07105) MOVISTAR ARENA,261,129,126,516
28122,2020-06-20,(50003) Corral Molinos,1350,676,996,3022
28123,2020-04-01,(12007) Zona Industrial,140,123,81,344
28124,2020-04-28,(09123) Calle 76,609,440,340,1389
28125,2020-08-30,(07104) Simon Bolivar,126,89,126,341
28126,2020-08-14,(04102) Avenida Boyaca,293,192,238,723
28127,2020-06-17,(10007) Las Nieves,669,365,370,1404
28128,2020-07-01,(10007) Las Nieves,696,394,427,1517
28129,2020-08-08,(03001) LA CAMPIÑA,557,261,398,1216
28130,2020-04-22,(10006) San Victorino,182,158,172,512
28131,2020-07-18,(10006) San Victorino,222,143,213,578
28132,2020-06-07,(06107) Ciudad Universitaria,44,32,34,110
28133,2020-09-07,(40002) Manitas,416,245,272,933
28134,2020-07-07,(02202) Calle 127,1204,866,633,2703
28135,2020-06-25,(12000) Puente Aranda,105,56,48,209
28136,2020-06-26,(12000) Puente Aranda,89,52,47,188
28137,2020-07-22,(14005) Las Aguas,160,90,179,429
28138,2020-10-08,(09113) Calle 22,431,236,461,1128
28139,2020-07-03,(12004) Carrera 22,258,139,166,563
28140,2020-07-11,(07102) NQS - CALLE 75,279,219,223,721
28141,2020-07-01,(07009) SENA,694,404,424,1522
28142,2020-02-03,(09108) Hospital,244,138,213,595
28143,2020-04-04,(02201) Prado,288,201,152,641
28144,2020-02-21,(09105) Río Fucha,801,408,474,1683
28145,2020-06-08,(02502) Terminal,395,266,321,982
28146,2020-04-23,(07003) SEVILLANA,229,151,143,523
28147,2020-01-16,(09106) Nariño,1758,1025,1232,4015
28148,2020-09-22,(07004) VENECIA,1143,661,761,2565
28149,2020-01-14,(12002) CDS - Carrera 32,530,349,278,1157
28150,2020-08-27,(06103) CAN,341,190,186,717
28151,2020-10-09,(04000) Cabecera Calle 80 - intermunicipal,422,214,450,1086
28152,2020-06-04,(04000) Cabecera Calle 80 - intermunicipal,259,158,212,629
28153,2020-02-07,(09111) Calle 19,2339,1419,1680,5438
28154,2020-08-16,(04000) Cabecera Calle 80 - intermunicipal,61,29,52,142
28155,2020-04-26,(02502) Terminal,40,33,47,120
28156,2020-04-09,(09002) Consuelo,81,51,60,192
28157,2020-07-18,(09111) Calle 19,362,240,290,892
28158,2020-09-19,(12002) CDS - Carrera 32,119,92,95,306
28159,2020-06-03,(09106) Nariño,364,206,245,815
28160,2020-08-17,(02001) Centro Comercial Santa Fe,134,72,118,324
28161,2020-05-09,(14004) Museo del Oro,0,40,90,130
28162,2020-03-29,(02300) Calle 100,253,249,180,682
28163,2020-07-18,(07109) CAD,373,243,222,838
28164,2020-08-25,(05102) Av. Américas - Av. Boyacá,210,124,133,467
28165,2020-04-03,(10004) Policarpa,130,66,118,314
28166,2020-05-21,(10004) Policarpa,209,91,141,441
28167,2020-05-30,(14001) La Sabana,125,87,92,304
28168,2020-07-20,(02303) Calle 85,147,110,99,356
28169,2020-05-09,(04001) Quirigua,191,98,101,390
28170,2020-07-07,(07007) NQS - Calle 38A Sur,438,259,262,959
28171,2020-03-13,(03004) GRATAMIRA,35,22,30,87
28172,2020-03-31,(02105) Calle 142,363,266,237,866
28173,2020-06-28,(07102) NQS - CALLE 75,74,65,102,241
28174,2020-04-29,(06103) CAN,321,208,127,656
28175,2020-04-25,(05103) Marsella,141,69,95,305
28176,2020-09-11,(07201) Guatoque -Veraguas,200,121,134,455
28177,2020-06-15,(10006) San Victorino,84,79,102,265
28178,2020-09-21,(07007) NQS - Calle 38A Sur,278,205,256,739
28179,2020-10-03,(06105) Quinta Paredes,104,66,91,261
28180,2020-09-19,(09106) Nariño,390,208,384,982
28181,2020-04-22,(09114) Calle 26,162,132,128,422
28182,2020-08-13,(09106) Nariño,399,237,314,950
28183,2020-03-23,(07107) U. NACIONAL,105,73,84,262
28184,2020-03-27,(03010) PUENTE LARGO,209,158,115,482
28185,2020-08-23,(09115) Calle 34,129,99,181,409
28186,2020-03-27,(09106) Nariño,154,111,102,367
28187,2020-07-15,(07113) SANTA ISABEL,333,186,230,749
28188,2020-05-22,(06106) Recinto Ferial,224,144,103,471
28189,2020-04-17,(07108) Av. El Dorado,75,46,50,171
28190,2020-07-12,(10008) San Diego,111,74,80,265
28191,2020-09-21,(05101) Mandalay - Cr.73,106,57,68,231
28192,2020-09-07,(10005) Bicentenario,103,62,86,251
28193,2020-04-13,(07101) CASTELLANA,78,63,53,194
28194,2020-08-22,(05101) Mandalay - Cr.73,85,32,63,180
28195,2020-03-30,(03014) SAN MARTIN,13,12,27,52
28196,2020-08-02,(06101) El Tiempo,81,55,70,206
28197,2020-03-29,(04003) Avenida Ciudad de Cali,157,100,121,378
28198,2020-06-01,(06100) Av. Rojas,194,107,119,420
28199,2020-04-04,(10003) Ciudad Jardín,52,33,43,128
28200,2020-09-14,(50002) Corral Calle 40 Sur,24,12,33,69
28201,2020-01-23,(50006) Corral Carrera 77,41,20,47,108
28202,2020-09-18,(03014) SAN MARTIN,0,21,52,73
28203,2020-03-10,(50006) Corral Carrera 77,1,8,7,16
28204,2020-09-25,(03014) SAN MARTIN,0,17,61,78
28205,2020-03-21,(10005) Bicentenario,23,13,20,56
28206,2020-06-30,(50006) Corral Carrera 77,8,1,7,16
28207,2020-07-24,(50006) Corral Carrera 77,1,3,6,10
28208,2020-06-14,(12000) Puente Aranda,9,9,13,31
28209,2020-09-03,(03004) GRATAMIRA,0,11,30,41
28210,2020-05-31,(04105) Carrera 53,83,47,63,193
28211,2020-07-04,(04000) Cabecera Calle 80 - alimentacion,3365,1717,2403,7485
28212,2020-07-08,(04000) Cabecera Calle 80 - alimentacion,4405,2499,2827,9731
28213,2020-09-16,(04000) Cabecera Calle 80 - alimentacion,4565,2683,3430,10678
28214,2020-01-23,(07005) ALQUERIA,2368,1364,1359,5091
28215,2020-03-09,(07005) ALQUERIA,318,586,411,1315
28216,2020-01-21,(09002) Consuelo,1118,484,635,2237
28217,2020-01-24,(09002) Consuelo,1392,686,809,2887
28218,2020-07-04,(09002) Consuelo,417,174,288,879
28219,2020-09-21,(02502) Terminal,423,288,365,1076
28220,2020-03-23,(09118) Marly,582,379,258,1219
28221,2020-02-27,(07504) TERREROS,17633,10687,9257,37577
28222,2020-06-04,(07504) TERREROS,5095,2999,2387,10481
28223,2020-06-02,(09119) Calle 57,479,323,293,1095
28224,2020-03-05,(08000) Portal Tunal - alimentacion,24029,13058,11865,48952
28225,2020-02-25,(03002) SUBA - TV- 91,4759,2842,2450,10051
28226,2020-03-17,(03002) SUBA - TV- 91,2500,1438,1409,5347
28227,2020-02-18,(09100) Calle 40 Sur,7807,4448,4304,16559
28228,2020-02-05,(09003) Socorro,1735,1003,1053,3791
28229,2020-08-15,(09003) Socorro,544,238,329,1111
28230,2020-08-01,(07503) SAN MATEO,7991,4037,3943,15971
28231,2020-05-26,(07503) SAN MATEO,9362,5867,4967,20196
28232,2020-02-10,(06107) Ciudad Universitaria,1781,1043,837,3661
28233,2020-03-28,(05001) Patio Bonito,580,331,378,1289
28234,2020-06-26,(05001) Patio Bonito,2075,1130,1192,4397
28235,2020-03-05,(07000) Portal Sur - alimentacion,28445,15840,14771,59056
28236,2020-03-06,(07000) Portal Sur - alimentacion,28228,15791,15269,59288
28237,2020-02-24,(05100) Banderas P. Central,8258,4899,3621,16778
28238,2020-01-30,(09000) Cabecera Usme,5676,3442,3832,12950
28239,2020-01-10,(09000) Cabecera Usme,4622,2489,3429,10540
28240,2020-02-13,(02000) Cabecera Autopista Norte,11995,7125,6214,25334
28241,2020-02-12,(10002) Av. Primero de Mayo,8760,4470,4810,18040
28242,2020-01-29,(02000) Cabecera Autopista Norte,11081,6707,5985,23773
28243,2020-05-07,(09109) Tercer Milenio,246,158,164,568
28244,2020-02-06,(05107) Américas - Cr.53,2615,1542,1380,5537
28245,2020-02-03,(09104) Restrepo,5171,3265,3976,12412
28246,2020-09-03,(04101) Minuto de Dios,335,198,272,805
28247,2020-07-14,(04100) Carrera 77,1144,645,714,2503
28248,2020-06-12,(07505) LEON XIII,2723,1494,1169,5386
28249,2020-06-07,(07504) TERREROS,1337,705,848,2890
28250,2020-03-04,(02000) Cabecera Autopista Norte - alimentacion,23544,13799,13622,50965
28251,2020-02-18,(07102) NQS - CALLE 75,1635,1035,908,3578
28252,2020-04-07,(07102) NQS - CALLE 75,158,115,113,386
28253,2020-06-12,(07102) NQS - CALLE 75,435,283,222,940
28254,2020-05-15,(03013) RIO NEGRO,236,148,145,529
28255,2020-03-06,(09103) Olaya,4174,2358,2647,9179
28256,2020-08-25,(05100) Banderas P. Central - alimentacion,2925,1501,1544,5970
28257,2020-06-26,(09103) Olaya,1149,613,621,2383
28258,2020-01-21,(14001) La Sabana,197,194,307,698
28259,2020-05-14,(14001) La Sabana,139,95,77,311
28260,2020-06-21,(07002) MADELENA,222,116,178,516
28261,2020-08-26,(02000) Cabecera Autopista Norte,1258,729,823,2810
28262,2020-09-08,(02000) Cabecera Autopista Norte,1533,953,1059,3545
28263,2020-10-04,(02000) Cabecera Autopista Norte,548,306,626,1480
28264,2020-02-05,(02104) Calle 146,9763,6244,5086,21093
28265,2020-06-23,(04102) Avenida Boyaca,386,237,235,858
28266,2020-05-26,(03003) 21 ANGELES,290,152,163,605
28267,2020-09-30,(09004) Santa Lucía,2803,1446,1852,6101
28268,2020-01-10,(10002) Av. Primero de Mayo,6390,3005,3917,13312
28269,2020-03-02,(07007) NQS - Calle 38A Sur,2226,1273,1227,4726
28270,2020-07-22,(05000) Portal Américas,2603,1607,1752,5962
28271,2020-02-07,(04104) Avenida 68,3764,1988,1978,7730
28272,2020-07-26,(04100) Carrera 77,308,170,266,744
28273,2020-01-08,(09111) Calle 19,1545,1005,1190,3740
28274,2020-08-22,(06000) Portal Eldorado,604,423,483,1510
28275,2020-05-26,(40003) Mirador del Paraiso,1514,957,978,3449
28276,2020-02-26,(10000) Portal 20 de Julio,9202,4161,3953,17316
28277,2020-06-23,(12001) Carrera 43,457,285,273,1015
28278,2020-08-21,(12001) Carrera 43,411,210,229,850
28279,2020-09-14,(12001) Carrera 43,434,238,272,944
28280,2020-03-13,(07505) LEON XIII,303,1590,1204,3097
28281,2020-04-30,(02000) Cabecera Autopista Norte - intermunicipal,231,138,158,527
28282,2020-06-23,(02000) Cabecera Autopista Norte - intermunicipal,624,436,441,1501
28283,2020-02-08,(09101) Quiroga,1064,560,956,2580
28284,2020-03-27,(08001) Parque el Tunal,213,113,106,432
28285,2020-07-26,(03000) Portal Suba - alimentacion,1529,828,920,3277
28286,2020-07-18,(08002) Biblioteca,168,90,90,348
28287,2020-09-26,(02303) Calle 85,486,357,493,1336
28288,2020-10-03,(02303) Calle 85,497,366,479,1342
28289,2020-03-01,(09107) Hortúa,504,304,596,1404
28290,2020-07-29,(08001) Parque el Tunal,427,250,253,930
28291,2020-01-21,(06108) Concejo de Bogotá,652,327,333,1312
28292,2020-10-07,(06108) Concejo de Bogotá,159,82,110,351
28293,2020-05-02,(07010) Bosa,269,150,178,597
28294,2020-04-02,(04000) Cabecera Calle 80,474,316,340,1130
28295,2020-04-17,(09000) Cabecera Usme - alimentacion,3282,2342,3171,8795
28296,2020-08-01,(10001) Country Sur,919,392,572,1883
28297,2020-07-02,(02201) Prado,960,600,595,2155
28298,2020-05-07,(02000) Cabecera Autopista Norte,799,527,500,1826
28299,2020-10-01,(09118) Marly,1559,1033,1089,3681
28300,2020-03-25,(05002) Tintal,1171,702,698,2571
28301,2020-08-06,(05002) Tintal,2048,1156,1364,4568
28302,2020-09-20,(10000) Portal 20 de Julio,851,365,724,1940
28303,2020-01-03,(06000) Portal Eldorado,3465,2182,1885,7532
28304,2020-04-17,(05105) Pradera,426,266,153,845
28305,2020-04-20,(05105) Pradera,419,278,159,856
28306,2020-09-02,(05105) Pradera,692,391,331,1414
28307,2020-03-05,(03012) SUBA - CALLE 95,1410,933,992,3335
28308,2020-09-12,(02205) Calle 106,202,167,215,584
28309,2020-07-08,(03000) Portal Suba - alimentacion,6607,3934,3806,14347
28310,2020-07-07,(07106) EL CAMPIN,439,273,260,972
28311,2020-09-29,(03003) 21 ANGELES,407,202,232,841
28312,2020-08-14,(14004) Museo del Oro,298,185,209,692
28313,2020-05-19,(10006) San Victorino,407,219,242,868
28314,2020-08-06,(03001) LA CAMPIÑA,866,515,563,1944
28315,2020-01-15,(07108) Av. El Dorado,775,494,567,1836
28316,2020-01-07,(09117) Calle 45,1901,1494,1906,5301
28317,2020-03-22,(03011) SUBA - CALLE 100,140,81,64,285
28318,2020-06-10,(10010) San Bernardo,610,332,404,1346
28319,2020-02-12,(04102) Avenida Boyaca,3262,1956,1723,6941
28320,2020-04-29,(09100) Calle 40 Sur,996,617,668,2281
28321,2020-08-05,(09000) Cabecera Usme,1495,942,1117,3554
28322,2020-03-25,(07111) NQS - RICAURTE,380,313,196,889
28323,2020-04-08,(09118) Marly,1028,716,475,2219
28324,2020-02-23,(09100) Calle 40 Sur,1607,723,1383,3713
28325,2020-08-26,(04105) Carrera 53,304,156,152,612
28326,2020-03-10,(06101) El Tiempo,1121,317,400,1838
28327,2020-02-07,(06000) Portal Eldorado,6550,3929,3056,13535
28328,2020-07-29,(02200) Alcalá,1684,1172,905,3761
28329,2020-09-18,(02105) Calle 142,978,529,683,2190
28330,2020-09-29,(06106) Recinto Ferial,329,217,188,734
28331,2020-07-02,(12003) Ricaurte,421,215,206,842
28332,2020-08-28,(12003) Ricaurte,405,286,185,876
28333,2020-05-20,(07106) EL CAMPIN,269,180,167,616
28334,2020-04-22,(02302) Virrey,352,270,208,830
28335,2020-02-08,(10010) San Bernardo,957,611,1143,2711
28336,2020-02-02,(06103) CAN,261,208,342,811
28337,2020-04-03,(02105) Calle 142,406,261,246,913
28338,2020-04-11,(02105) Calle 142,272,211,121,604
28339,2020-09-02,(02105) Calle 142,851,533,561,1945
28340,2020-07-21,(09109) Tercer Milenio,232,138,174,544
28341,2020-02-22,(03006) NIZA - CALLE 127,1248,772,983,3003
28342,2020-04-12,(02000) Cabecera Autopista Norte - alimentacion,1087,585,435,2107
28343,2020-04-13,(09123) Calle 76,520,399,288,1207
28344,2020-07-08,(07103) AV. CHILE,1029,619,521,2169
28345,2020-03-01,(09122) Calle 72,1125,808,1529,3462
28346,2020-03-25,(06109) Centro Memoria,168,134,103,405
28347,2020-06-10,(09106) Nariño,368,227,252,847
28348,2020-09-02,(02304) Heroes,903,622,541,2066
28349,2020-07-28,(02001) Centro Comercial Santa Fe,443,260,281,984
28350,2020-07-19,(02102) Calle 161,57,33,51,141
28351,2020-05-15,(05100) Banderas P. Central - alimentacion,2170,1025,974,4169
28352,2020-02-24,(40001) Juan Pablo II,1705,1044,953,3702
28353,2020-06-12,(08002) Biblioteca,316,159,175,650
28354,2020-03-29,(09101) Quiroga,57,39,68,164
28355,2020-08-16,(10000) Portal 20 de Julio - alimentacion,1289,521,1022,2832
28356,2020-01-05,(06102) Salitre El Greco,234,159,206,599
28357,2020-07-12,(05107) Américas - Cr.53,96,60,113,269
28358,2020-03-04,(09003) Socorro,1677,971,1094,3742
28359,2020-05-28,(06111) Universidades,0,120,309,429
28360,2020-08-27,(06111) Universidades,365,200,308,873
28361,2020-06-19,(40001) Juan Pablo II,582,366,340,1288
28362,2020-07-01,(40001) Juan Pablo II,596,343,366,1305
28363,2020-04-02,(07111) NQS - RICAURTE,352,254,209,815
28364,2020-06-03,(07111) NQS - RICAURTE,1034,652,388,2074
28365,2020-04-30,(09115) Calle 34,404,308,220,932
28366,2020-09-14,(02200) Alcalá,1975,1270,1198,4443
28367,2020-01-02,(07110) PALOQUEMAO,934,602,640,2176
28368,2020-09-02,(07110) PALOQUEMAO,733,425,313,1471
28369,2020-09-05,(07006) General Santander,496,259,353,1108
28370,2020-09-21,(09107) Hortúa,454,284,363,1101
28371,2020-02-16,(04002) Carrera 90,786,333,766,1885
28372,2020-08-11,(06109) Centro Memoria,264,137,127,528
28373,2020-08-13,(07001) PERDOMO,850,486,566,1902
28374,2020-03-25,(04100) Carrera 77,597,345,350,1292
28375,2020-10-04,(09002) Consuelo,179,75,194,448
28376,2020-05-17,(09114) Calle 26,56,40,56,152
28377,2020-08-24,(07201) Guatoque -Veraguas,164,81,115,360
28378,2020-06-06,(09121) Las Flores,502,342,303,1147
28379,2020-02-14,(07506) DESPENSA,1446,944,921,3311
28380,2020-02-26,(07506) DESPENSA,1556,973,879,3408
28381,2020-06-14,(04001) Quirigua,132,65,88,285
28382,2020-08-31,(06107) Ciudad Universitaria,190,102,131,423
28383,2020-05-04,(04100) Carrera 77,797,437,535,1769
28384,2020-04-20,(09119) Calle 57,256,212,175,643
28385,2020-07-21,(09110) Avenida Jimenez,544,474,546,1564
28386,2020-05-21,(09110) Avenida Jimenez,862,641,563,2066
28387,2020-04-11,(12003) Ricaurte,59,53,45,157
28388,2020-04-16,(07109) CAD,423,288,170,881
28389,2020-10-02,(14005) Las Aguas,285,201,343,829
28390,2020-08-31,(06105) Quinta Paredes,161,85,100,346
28391,2020-03-20,(02102) Calle 161,103,83,44,230
28392,2020-05-16,(02102) Calle 161,144,84,100,328
28393,2020-05-27,(03011) SUBA - CALLE 100,419,209,200,828
28394,2020-04-06,(07005) ALQUERIA,250,153,156,559
28395,2020-05-25,(09119) Calle 57,161,109,135,405
28396,2020-09-27,(04106) Carrera 47,130,63,122,315
28397,2020-09-15,(10004) Policarpa,235,103,179,517
28398,2020-01-09,(07200) Tygua-San José,549,313,452,1314
28399,2020-08-03,(07200) Tygua-San José,203,126,145,474
28400,2020-04-06,(09122) Calle 72,577,416,382,1375
28401,2020-06-03,(12003) Ricaurte,316,211,151,678
28402,2020-07-07,(12002) CDS - Carrera 32,189,108,97,394
28403,2020-09-27,(03003) 21 ANGELES,113,56,127,296
28404,2020-08-31,(04000) Cabecera Calle 80 - intermunicipal,377,198,325,900
28405,2020-07-27,(09108) Hospital,63,29,65,157
28406,2020-09-22,(09108) Hospital,64,51,71,186
28407,2020-04-11,(07004) VENECIA,295,164,146,605
28408,2020-09-08,(06103) CAN,401,236,212,849
28409,2020-08-22,(07009) SENA,466,256,310,1032
28410,2020-01-17,(09105) Río Fucha,672,350,488,1510
28411,2020-05-01,(07111) NQS - RICAURTE,224,164,132,520
28412,2020-03-20,(04103) Las Ferias,166,111,76,353
28413,2020-04-19,(04103) Las Ferias,76,47,36,159
28414,2020-10-08,(07003) SEVILLANA,544,282,391,1217
28415,2020-06-23,(06105) Quinta Paredes,137,85,85,307
28416,2020-04-25,(03011) SUBA - CALLE 100,192,131,99,422
28417,2020-01-19,(09121) Las Flores,524,347,716,1587
28418,2020-04-25,(07005) ALQUERIA,234,133,127,494
28419,2020-10-10,(07007) NQS - Calle 38A Sur,409,227,335,971
28420,2020-05-28,(09106) Nariño,348,213,202,763
28421,2020-08-16,(04106) Carrera 47,114,52,53,219
28422,2020-07-28,(05102) Av. Américas - Av. Boyacá,183,114,140,437
28423,2020-05-22,(07006) General Santander - alimentacion,311,177,176,664
28424,2020-04-03,(09117) Calle 45,457,299,264,1020
28425,2020-04-20,(07003) SEVILLANA,245,135,125,505
28426,2020-04-08,(06001) Modelia,223,165,128,516
28427,2020-08-07,(09110) Avenida Jimenez,681,520,400,1601
28428,2020-06-04,(12007) Zona Industrial,330,219,142,691
28429,2020-05-09,(04101) Minuto de Dios,143,82,119,344
28430,2020-09-16,(10004) Policarpa,286,132,175,593
28431,2020-03-01,(07506) DESPENSA,352,180,357,889
28432,2020-06-13,(03004) GRATAMIRA,32,13,23,68
28433,2020-06-17,(03004) GRATAMIRA,31,17,19,67
28434,2020-10-10,(07105) MOVISTAR ARENA,183,137,212,532
28435,2020-01-26,(10005) Bicentenario - alimentacion,131,90,211,432
28436,2020-03-30,(06106) Recinto Ferial,127,90,84,301
28437,2020-04-19,(04002) Carrera 90,99,64,62,225
28438,2020-07-28,(03005) SUBA - AV. BOYACA,414,237,226,877
28439,2019-12-31,(03002) SUBA - TV- 91,36,24,49,109
28440,2020-01-05,(04108) El Polo,210,116,342,668
28441,2020-07-20,(07113) SANTA ISABEL,98,56,82,236
28442,2020-09-05,(07009) SENA,608,328,482,1418
28443,2020-04-03,(14005) Las Aguas,0,36,97,133
28444,2020-03-11,(03014) SAN MARTIN,235,158,145,538
28445,2020-04-30,(09116) Avenida 39,203,151,150,504
28446,2020-08-24,(09116) Avenida 39,264,159,154,577
28447,2020-01-12,(06105) Quinta Paredes,106,75,157,338
28448,2020-04-03,(12004) Carrera 22,53,45,45,143
28449,2020-06-07,(03004) GRATAMIRA,13,7,7,27
28450,2020-04-22,(07113) SANTA ISABEL,209,143,131,483
28451,2020-06-22,(14005) Las Aguas,36,30,85,151
28452,2020-04-13,(06104) Gobernación,153,114,72,339
28453,2020-06-14,(04101) Minuto de Dios,81,42,78,201
28454,2020-06-06,(10003) Ciudad Jardín,131,62,108,301
28455,2020-04-04,(14005) Las Aguas,0,24,56,80
28456,2020-05-23,(07101) CASTELLANA,77,56,74,207
28457,2020-04-20,(10003) Ciudad Jardín,111,68,68,247
28458,2020-06-22,(07006) General Santander,170,89,122,381
28459,2020-08-23,(08002) Biblioteca,83,44,52,179
28460,2020-08-24,(50002) Corral Calle 40 Sur,20,10,14,44
28461,2020-08-23,(09106) Nariño,127,71,116,314
28462,2020-09-19,(09105) Río Fucha,0,63,154,217
28463,2020-10-06,(50006) Corral Carrera 77,4,1,15,20
28464,2020-03-29,(03007) HUMEDAL CORDOBA,40,29,16,85
28465,2020-04-26,(03014) SAN MARTIN,10,5,11,26
28466,2020-04-10,(05101) Mandalay - Cr.73,13,9,4,26
28467,2020-06-28,(04103) Las Ferias,113,68,65,246
28468,2020-06-13,(50006) Corral Carrera 77,6,2,6,14
28469,2020-04-25,(03004) GRATAMIRA,17,9,8,34
28470,2020-03-31,(03004) GRATAMIRA,17,8,9,34
28471,2020-06-05,(50006) Corral Carrera 77,6,2,8,16
28472,2020-04-06,(04000) Cabecera Calle 80 - alimentacion,1934,1017,1201,4152
28473,2020-06-26,(07005) ALQUERIA,611,338,338,1287
28474,2020-02-24,(05000) Portal Américas - alimentacion,30014,22296,25282,77592
28475,2020-07-30,(05000) Portal Américas - alimentacion,9569,5145,4719,19433
28476,2020-06-08,(09119) Calle 57,517,345,336,1198
28477,2020-06-09,(09119) Calle 57,547,354,349,1250
28478,2020-01-15,(03000) Portal Suba - alimentacion,24029,13192,14222,51443
28479,2020-08-20,(02303) Calle 85,636,418,375,1429
28480,2020-04-07,(05000) Portal Américas - alimentacion,5909,2791,2407,11107
28481,2020-02-12,(07505) LEON XIII,8677,4944,3857,17478
28482,2020-01-02,(06104) Gobernación,539,339,340,1218
28483,2020-01-09,(03010) PUENTE LARGO,1511,929,882,3322
28484,2020-02-20,(03010) PUENTE LARGO,2020,1355,1094,4469
28485,2020-02-19,(09003) Socorro,1463,967,1103,3533
28486,2020-01-20,(09000) Cabecera Usme - alimentacion,23686,12994,15007,51687
28487,2020-02-04,(09000) Cabecera Usme - alimentacion,26047,14678,16211,56936
28488,2020-02-01,(04002) Carrera 90,2060,916,1550,4526
28489,2020-06-03,(07503) SAN MATEO,9834,6002,4657,20493
28490,2020-01-10,(09001) Molinos,5963,3216,4975,14154
28491,2020-02-14,(09001) Molinos,7817,4607,5952,18376
28492,2020-03-06,(05001) Patio Bonito,7268,3753,3738,14759
28493,2020-04-25,(02000) Cabecera Autopista Norte - alimentacion,2158,1210,1032,4400
28494,2020-01-25,(07010) Bosa,1526,758,1164,3448
28495,2020-01-18,(05000) Portal Américas,8408,3898,5676,17982
28496,2020-01-20,(02201) Prado,5326,3388,3004,11718
28497,2020-02-14,(04100) Carrera 77,7156,4068,4025,15249
28498,2020-01-21,(08000) Portal Tunal - alimentacion,18581,8690,8024,35295
28499,2020-02-14,(09004) Santa Lucía,7813,4246,4242,16301
28500,2020-08-14,(05100) Banderas P. Central,786,429,499,1714
28501,2020-03-11,(09000) Cabecera Usme,5593,3368,3919,12880
28502,2020-03-15,(05100) Banderas P. Central - alimentacion,2562,976,1746,5284
28503,2020-03-03,(02000) Cabecera Autopista Norte,11739,7051,6283,25073
28504,2020-01-14,(06102) Salitre El Greco,1242,696,669,2607
28505,2020-03-04,(10002) Av. Primero de Mayo,8405,4159,4684,17248
28506,2020-01-24,(02204) Pepe Sierra,4651,3020,2327,9998
28507,2020-09-01,(10005) Bicentenario - alimentacion,203,104,229,536
28508,2020-09-26,(03000) Portal Suba - alimentacion,5628,2698,4390,12716
28509,2020-10-07,(09000) Cabecera Usme - alimentacion,9950,4859,6723,21532
28510,2020-09-09,(40003) Mirador del Paraiso,1722,1046,1260,4028
28511,2020-03-02,(04100) Carrera 77,6742,4065,4042,14849
28512,2020-03-05,(12003) Ricaurte,1287,791,658,2736
28513,2020-01-31,(07111) NQS - RICAURTE,3070,1956,1873,6899
28514,2020-04-25,(07102) NQS - CALLE 75,134,93,70,297
28515,2020-06-11,(07102) NQS - CALLE 75,421,260,202,883
28516,2020-08-04,(07102) NQS - CALLE 75,307,193,172,672
28517,2020-02-03,(09103) Olaya,4244,2498,2458,9200
28518,2020-02-05,(03001) LA CAMPIÑA,6755,4245,4218,15218
28519,2020-07-10,(03001) LA CAMPIÑA,1241,685,695,2621
28520,2020-09-12,(50003) Corral Molinos,1333,685,1174,3192
28521,2020-08-19,(05100) Banderas P. Central - alimentacion,2877,1510,1549,5936
28522,2020-01-14,(09103) Olaya,3341,1912,2198,7451
28523,2020-02-24,(14001) La Sabana,596,391,388,1375
28524,2020-06-04,(14001) La Sabana,150,96,89,335
28525,2020-07-04,(07000) Portal Sur - alimentacion,6903,3642,3788,14333
28526,2020-02-09,(02000) Cabecera Autopista Norte - alimentacion,6598,2724,5085,14407
28527,2020-10-01,(02000) Cabecera Autopista Norte,1733,1042,1415,4190
28528,2020-01-27,(04102) Avenida Boyaca,2829,1724,1432,5985
28529,2020-07-17,(03003) 21 ANGELES,305,158,132,595
28530,2020-03-28,(04105) Carrera 53,113,71,53,237
28531,2020-05-26,(05000) Portal Américas,2199,1472,1740,5411
28532,2020-08-24,(05000) Portal Américas,2643,1621,1714,5978
28533,2020-01-30,(04000) Cabecera Calle 80,7341,4356,4576,16273
28534,2020-01-29,(05002) Tintal,10870,6362,6050,23282
28535,2020-06-23,(10001) Country Sur,1259,615,687,2561
28536,2020-02-21,(10008) San Diego,1391,851,780,3022
28537,2020-08-23,(10005) Bicentenario - alimentacion,45,32,63,140
28538,2020-03-02,(02001) Centro Comercial Santa Fe,4740,2974,2589,10303
28539,2020-08-07,(06105) Quinta Paredes,48,32,39,119
28540,2020-05-07,(02000) Cabecera Autopista Norte - intermunicipal,292,208,208,708
28541,2020-02-15,(10000) Portal 20 de Julio,5744,2416,3641,11801
28542,2020-06-20,(02303) Calle 85,497,361,288,1146
28543,2020-01-28,(07000) Portal Sur,7769,4669,4147,16585
28544,2020-02-18,(07004) VENECIA,4883,2818,2483,10184
28545,2020-08-28,(10002) Av. Primero de Mayo,2135,1047,1443,4625
28546,2020-09-24,(10002) Av. Primero de Mayo,2445,1170,1649,5264
28547,2020-09-07,(07108) Av. El Dorado,171,103,112,386
28548,2020-02-24,(04003) Avenida Ciudad de Cali,5763,3500,3514,12777
28549,2020-01-11,(09003) Socorro,977,432,663,2072
28550,2020-10-09,(09116) Avenida 39,416,287,425,1128
28551,2020-01-12,(07000) Portal Sur - alimentacion,6961,2955,4650,14566
28552,2020-01-17,(07007) NQS - Calle 38A Sur,1883,999,1175,4057
28553,2020-02-12,(07001) PERDOMO,4887,2965,2639,10491
28554,2020-06-15,(10001) Country Sur,357,143,287,787
28555,2020-06-09,(05000) Portal Américas,2211,1534,1736,5481
28556,2020-04-14,(02000) Cabecera Autopista Norte,520,387,332,1239
28557,2020-02-05,(06002) Normandía,2731,1568,1418,5717
28558,2020-06-18,(03001) LA CAMPIÑA,1073,657,593,2323
28559,2020-02-08,(06106) Recinto Ferial,794,463,610,1867
28560,2020-02-19,(03005) SUBA - AV. BOYACA,2850,1680,1544,6074
28561,2020-03-23,(09000) Cabecera Usme - alimentacion,2012,926,1084,4022
28562,2020-06-24,(09107) Hortúa,642,363,358,1363
28563,2020-02-07,(05105) Pradera,2655,1576,1257,5488
28564,2020-03-17,(02200) Alcalá,6611,4264,3139,14014
28565,2020-09-10,(03012) SUBA - CALLE 95,334,199,220,753
28566,2020-09-06,(10000) Portal 20 de Julio,832,382,707,1921
28567,2020-01-29,(50002) Corral Calle 40 Sur,162,87,141,390
28568,2020-02-10,(02104) Calle 146,9620,6360,4957,20937
28569,2020-01-29,(10010) San Bernardo,1714,1014,1262,3990
28570,2020-02-01,(05101) Mandalay - Cr.73,528,217,366,1111
28571,2020-07-22,(04000) Cabecera Calle 80,1012,617,707,2336
28572,2020-10-03,(05105) Pradera,514,335,368,1217
28573,2020-01-12,(10008) San Diego,170,127,256,553
28574,2020-03-08,(02104) Calle 146,1336,508,1377,3221
28575,2020-06-09,(04108) El Polo,468,296,201,965
28576,2020-02-03,(10009) Museo Nacional,4422,2261,1952,8635
28577,2020-07-21,(03003) 21 ANGELES,293,155,157,605
28578,2020-09-08,(06111) Universidades,414,229,384,1027
28579,2020-08-13,(10006) San Victorino,698,309,288,1295
28580,2020-09-17,(08002) Biblioteca,337,188,226,751
28581,2020-04-05,(02000) Cabecera Autopista Norte - alimentacion,1141,556,455,2152
28582,2020-03-21,(07000) Portal Sur - alimentacion,2553,1338,938,4829
28583,2020-03-20,(03011) SUBA - CALLE 100,360,218,127,705
28584,2020-02-03,(04103) Las Ferias,1570,915,897,3382
28585,2020-04-08,(09100) Calle 40 Sur,818,477,540,1835
28586,2020-07-14,(07104) Simon Bolivar,563,360,240,1163
28587,2020-04-14,(10005) Bicentenario - alimentacion,161,74,124,359
28588,2020-07-25,(10005) Bicentenario - alimentacion,120,53,103,276
28589,2020-03-06,(04107) Escuela Militar,621,407,456,1484
28590,2020-07-08,(04107) Escuela Militar,140,82,90,312
28591,2020-01-01,(09004) Santa Lucía,677,289,849,1815
28592,2020-04-14,(02000) Cabecera Autopista Norte - alimentacion,2887,1528,1349,5764
28593,2020-06-30,(09109) Tercer Milenio,370,207,284,861
28594,2020-10-02,(09109) Tercer Milenio,386,260,357,1003
28595,2020-02-13,(07104) Simon Bolivar,2161,1519,1313,4993
28596,2020-03-01,(07109) CAD,568,355,546,1469
28597,2020-08-11,(03001) LA CAMPIÑA,920,533,568,2021
28598,2020-08-03,(09117) Calle 45,630,396,365,1391
28599,2020-07-22,(02104) Calle 146,670,406,411,1487
28600,2020-09-14,(02104) Calle 146,894,574,597,2065
28601,2020-09-24,(02104) Calle 146,1012,625,740,2377
28602,2020-06-25,(02204) Pepe Sierra,856,563,428,1847
28603,2020-08-19,(07101) CASTELLANA,212,116,128,456
28604,2020-04-20,(03001) LA CAMPIÑA,525,318,267,1110
28605,2020-08-14,(04108) El Polo,383,242,208,833
28606,2020-07-07,(12003) Ricaurte,409,260,214,883
28607,2020-08-19,(12003) Ricaurte,413,252,179,844
28608,2020-02-09,(12007) Zona Industrial,164,167,234,565
28609,2020-09-22,(05107) Américas - Cr.53,418,281,348,1047
28610,2020-06-30,(02103) Mazurén,222,136,190,548
28611,2020-05-26,(05100) Banderas P. Central - alimentacion,2504,1276,1410,5190
28612,2020-03-14,(07105) MOVISTAR ARENA,550,401,463,1414
28613,2020-07-21,(10005) Bicentenario,91,55,72,218
28614,2020-04-05,(40002) Manitas,65,37,47,149
28615,2020-07-05,(40002) Manitas,141,61,122,324
28616,2020-06-01,(09117) Calle 45,678,379,419,1476
28617,2020-06-02,(02304) Heroes,680,516,413,1609
28618,2020-01-18,(03005) SUBA - AV. BOYACA,1318,734,1022,3074
28619,2020-03-25,(05100) Banderas P. Central - alimentacion,1654,734,787,3175
28620,2020-05-18,(05100) Banderas P. Central,490,297,361,1148
28621,2020-04-10,(09120) Calle 63,203,127,121,451
28622,2020-05-16,(09120) Calle 63,639,457,395,1491
28623,2020-01-07,(14001) La Sabana,245,211,265,721
28624,2020-03-21,(12007) Zona Industrial,156,118,65,339
28625,2020-05-07,(09004) Santa Lucía,1560,817,835,3212
28626,2020-04-13,(05100) Banderas P. Central - alimentacion,1558,763,690,3011
28627,2020-06-22,(02204) Pepe Sierra,285,207,173,665
28628,2020-03-16,(09111) Calle 19,1799,1094,1159,4052
28629,2020-04-27,(09107) Hortúa,146,132,66,344
28630,2020-08-02,(09106) Nariño,109,64,93,266
28631,2020-01-03,(08002) Biblioteca,575,288,442,1305
28632,2020-04-04,(06102) Salitre El Greco,137,86,72,295
28633,2020-03-29,(09103) Olaya,170,105,79,354
28634,2020-07-21,(06104) Gobernación,234,136,74,444
28635,2020-05-26,(02302) Virrey,557,395,288,1240
28636,2020-06-04,(02302) Virrey,600,389,307,1296
28637,2020-08-15,(07201) Guatoque -Veraguas,172,95,137,404
28638,2020-03-21,(03000) Portal Suba,389,249,233,871
28639,2020-03-29,(03000) Portal Suba,205,127,123,455
28640,2020-05-25,(07105) MOVISTAR ARENA,71,36,53,160
28641,2020-06-28,(07104) Simon Bolivar,123,87,112,322
28642,2020-08-16,(05105) Pradera,131,93,121,345
28643,2020-09-07,(04102) Avenida Boyaca,351,199,291,841
28644,2020-07-01,(09121) Las Flores,750,501,440,1691
28645,2020-04-27,(10006) San Victorino,17,100,68,185
28646,2020-07-19,(02204) Pepe Sierra,194,143,113,450
28647,2020-10-03,(09119) Calle 57,509,347,554,1410
28648,2020-01-31,(04103) Las Ferias,1482,837,903,3222
28649,2020-06-25,(03011) SUBA - CALLE 100,573,262,253,1088
28650,2020-08-16,(05102) Av. Américas - Av. Boyacá,64,32,63,159
28651,2020-05-28,(09110) Avenida Jimenez,649,712,727,2088
28652,2020-05-29,(40002) Manitas,394,228,254,876
28653,2020-03-25,(12000) Puente Aranda,33,24,22,79
28654,2020-05-02,(12000) Puente Aranda,26,28,18,72
28655,2020-03-19,(04102) Avenida Boyaca,1107,635,663,2405
28656,2020-05-24,(07506) DESPENSA,115,59,72,246
28657,2020-01-19,(12004) Carrera 22,114,110,208,432
28658,2020-03-18,(04107) Escuela Militar,352,233,225,810
28659,2020-03-18,(04106) Carrera 47,804,461,446,1711
28660,2020-05-11,(10009) Museo Nacional,394,230,197,821
28661,2020-08-24,(09110) Avenida Jimenez,675,640,712,2027
28662,2020-08-04,(07009) SENA,504,303,383,1190
28663,2020-03-24,(07111) NQS - RICAURTE,539,453,389,1381
28664,2020-05-11,(12002) CDS - Carrera 32,177,141,58,376
28665,2020-07-22,(12002) CDS - Carrera 32,188,104,91,383
28666,2020-10-07,(12002) CDS - Carrera 32,213,151,115,479
28667,2020-08-11,(03006) NIZA - CALLE 127,349,223,211,783
28668,2020-06-13,(04102) Avenida Boyaca,241,136,182,559
28669,2020-06-29,(04102) Avenida Boyaca,138,81,107,326
28670,2020-09-24,(09106) Nariño,461,287,403,1151
28671,2020-04-16,(04101) Minuto de Dios,136,84,132,352
28672,2020-05-21,(06100) Av. Rojas,178,96,78,352
28673,2020-06-20,(04000) Cabecera Calle 80 - intermunicipal,206,108,200,514
28674,2020-08-19,(10003) Ciudad Jardín,174,85,133,392
28675,2020-04-02,(04103) Las Ferias,169,126,96,391
28676,2020-01-01,(04107) Escuela Militar,30,32,77,139
28677,2020-08-26,(07105) MOVISTAR ARENA,261,129,127,517
28678,2020-01-01,(09108) Hospital,29,22,52,103
28679,2020-10-06,(06100) Av. Rojas,329,196,254,779
28680,2020-01-29,(09105) Río Fucha,740,413,544,1697
28681,2020-08-21,(07006) General Santander - alimentacion,372,213,251,836
28682,2020-04-01,(10007) Las Nieves,171,135,181,487
28683,2020-01-06,(07111) NQS - RICAURTE,324,276,386,986
28684,2020-04-21,(07001) PERDOMO,420,261,230,911
28685,2020-08-09,(07505) LEON XIII,691,356,394,1441
28686,2020-08-18,(05103) Marsella,364,201,223,788
28687,2020-01-26,(07102) NQS - CALLE 75,203,154,300,657
28688,2020-06-15,(04002) Carrera 90,207,95,143,445
28689,2020-02-23,(07006) General Santander,639,299,578,1516
28690,2020-08-15,(02204) Pepe Sierra,552,396,349,1297
28691,2020-07-12,(03011) SUBA - CALLE 100,166,104,123,393
28692,2020-03-25,(04001) Quirigua,187,111,122,420
28693,2020-01-16,(12000) Puente Aranda,214,129,167,510
28694,2020-03-08,(10008) San Diego,186,145,271,602
28695,2020-07-14,(09116) Avenida 39,316,197,187,700
28696,2020-06-23,(10003) Ciudad Jardín,215,112,131,458
28697,2020-03-15,(06107) Ciudad Universitaria,149,106,267,522
28698,2020-08-23,(06111) Universidades,117,52,147,316
28699,2020-01-20,(03014) SAN MARTIN,246,149,195,590
28700,2020-08-17,(09110) Avenida Jimenez,177,177,264,618
28701,2020-05-15,(06100) Av. Rojas,171,89,100,360
28702,2020-06-19,(03005) SUBA - AV. BOYACA,452,288,272,1012
28703,2020-09-13,(03012) SUBA - CALLE 95,75,44,110,229
28704,2020-04-05,(09121) Las Flores,148,102,93,343
28705,2020-09-14,(06100) Av. Rojas,276,174,159,609
28706,2020-04-22,(06107) Ciudad Universitaria,112,67,76,255
28707,2020-10-12,(10008) San Diego,85,60,95,240
28708,2020-04-05,(07107) U. NACIONAL,74,58,46,178
28709,2020-01-01,(14001) La Sabana,29,38,75,142
28710,2020-04-29,(14005) Las Aguas,0,42,115,157
28711,2020-03-28,(06105) Quinta Paredes,45,43,27,115
28712,2020-07-20,(10004) Policarpa,73,24,68,165
28713,2020-07-19,(10005) Bicentenario - alimentacion,48,22,70,140
28714,2020-03-21,(07111) NQS - RICAURTE,200,112,108,420
28715,2020-02-29,(03014) SAN MARTIN,107,67,109,283
28716,2020-04-19,(14005) Las Aguas,0,11,39,50
28717,2020-04-26,(09108) Hospital,29,15,27,71
28718,2020-06-29,(12003) Ricaurte,58,50,53,161
28719,2020-10-04,(50006) Corral Carrera 77,2,2,5,9
28720,2020-03-29,(50006) Corral Carrera 77,5,1,2,8
28721,2020-08-06,(04000) Cabecera Calle 80 - alimentacion,3248,1839,2123,7210
28722,2020-09-28,(07005) ALQUERIA,620,355,457,1432
28723,2020-05-15,(09002) Consuelo,407,195,204,806
28724,2020-10-03,(09002) Consuelo,450,219,410,1079
28725,2020-02-08,(03013) RIO NEGRO,698,446,656,1800
28726,2020-02-20,(07504) TERREROS,17320,10735,8606,36661
28727,2020-02-13,(05000) Portal Américas - alimentacion,37966,22197,21008,81171
28728,2020-08-22,(05000) Portal Américas - alimentacion,7858,3956,4563,16377
28729,2020-02-28,(07505) LEON XIII,8744,4705,3814,17263
28730,2020-02-28,(07503) SAN MATEO,41152,22240,18203,81595
28731,2020-08-14,(07503) SAN MATEO,11415,6226,5202,22843
28732,2020-01-06,(05000) Portal Américas - alimentacion,7732,3187,5369,16288
28733,2020-02-05,(06107) Ciudad Universitaria,1741,1009,907,3657
28734,2020-02-14,(02201) Prado,6077,3653,3093,12823
28735,2020-02-29,(10000) Portal 20 de Julio - alimentacion,8750,3779,6566,19095
28736,2020-02-23,(10004) Policarpa,241,122,237,600
28737,2020-02-04,(05100) Banderas P. Central,8324,4889,3894,17107
28738,2020-10-02,(05100) Banderas P. Central,1214,642,1007,2863
28739,2020-07-08,(10001) Country Sur,1385,653,772,2810
28740,2020-02-18,(09000) Cabecera Usme,6149,3721,3939,13809
28741,2020-09-11,(09000) Cabecera Usme,1806,1074,1250,4130
28742,2020-09-22,(09113) Calle 22,407,231,337,975
28743,2020-02-11,(02502) Terminal,5715,3679,2979,12373
28744,2020-02-02,(09120) Calle 63,1137,726,1279,3142
28745,2020-03-17,(07113) SANTA ISABEL,1211,741,795,2747
28746,2020-04-29,(40003) Mirador del Paraiso,942,607,578,2127
28747,2020-05-29,(07505) LEON XIII,2352,1336,1073,4761
28748,2020-08-09,(07504) TERREROS,1462,763,914,3139
28749,2020-10-06,(02204) Pepe Sierra,896,649,598,2143
28750,2020-02-06,(02502) Terminal,5148,3503,2994,11645
28751,2020-01-25,(09000) Cabecera Usme,3649,1856,3007,8512
28752,2020-02-23,(05000) Portal Américas,2620,1196,2300,6116
28753,2020-03-04,(03013) RIO NEGRO,1252,820,879,2951
28754,2020-08-13,(03013) RIO NEGRO,225,138,158,521
28755,2020-01-10,(02304) Heroes,3109,2357,1875,7341
28756,2020-03-13,(07106) EL CAMPIN,673,144,235,1052
28757,2020-04-18,(09104) Restrepo,569,377,440,1386
28758,2020-07-15,(14001) La Sabana,103,63,59,225
28759,2020-06-12,(07002) MADELENA,808,446,447,1701
28760,2020-06-01,(50003) Corral Molinos,1366,697,952,3015
28761,2020-09-14,(04000) Cabecera Calle 80,1137,743,933,2813
28762,2020-08-05,(07010) Bosa,579,267,327,1173
28763,2020-09-20,(07112) COMUNEROS,247,133,313,693
28764,2020-03-02,(04106) Carrera 47,1469,819,904,3192
28765,2020-01-31,(05002) Tintal,10727,5924,5873,22524
28766,2020-03-12,(09001) Molinos,368,1831,1505,3704
28767,2020-04-14,(09001) Molinos,1282,749,897,2928
28768,2020-02-17,(04100) Carrera 77,6997,4421,4007,15425
28769,2020-04-02,(10000) Portal 20 de Julio - alimentacion,2657,968,1377,5002
28770,2020-02-04,(06000) Portal Eldorado,6857,3955,2912,13724
28771,2020-02-04,(10008) San Diego,1612,837,861,3310
28772,2020-02-14,(40003) Mirador del Paraiso,4932,2887,2590,10409
28773,2020-01-20,(02000) Cabecera Autopista Norte - intermunicipal,4476,3033,2799,10308
28774,2020-08-08,(12001) Carrera 43,231,140,175,546
28775,2020-02-13,(09107) Hortúa,2590,1544,1474,5608
28776,2020-01-30,(10005) Bicentenario - alimentacion,666,268,517,1451
28777,2020-05-07,(05100) Banderas P. Central - alimentacion,1960,973,970,3903
28778,2020-10-04,(06105) Quinta Paredes,35,39,59,133
28779,2020-01-24,(06101) El Tiempo,2773,1484,1355,5612
28780,2020-01-21,(02304) Heroes,2593,2235,1710,6538
28781,2020-05-15,(02000) Cabecera Autopista Norte - intermunicipal,375,255,231,861
28782,2020-08-03,(02000) Cabecera Autopista Norte - intermunicipal,470,318,348,1136
28783,2020-06-08,(08001) Parque el Tunal,476,275,236,987
28784,2020-09-30,(02000) Cabecera Autopista Norte - alimentacion,5332,2750,3697,11779
28785,2020-08-12,(10002) Av. Primero de Mayo,2099,1059,1257,4415
28786,2020-02-27,(09108) Hospital,257,156,196,609
28787,2020-08-21,(10000) Portal 20 de Julio,2089,1031,1096,4216
28788,2020-09-28,(02303) Calle 85,863,576,534,1973
28789,2020-10-06,(02303) Calle 85,888,574,565,2027
28790,2020-09-20,(10002) Av. Primero de Mayo,676,323,792,1791
28791,2020-03-26,(07503) SAN MATEO,5574,3074,2937,11585
28792,2020-04-15,(07503) SAN MATEO,5315,3326,2463,11104
28793,2020-09-17,(08001) Parque el Tunal,507,293,316,1116
28794,2020-06-24,(09116) Avenida 39,365,235,241,841
28795,2020-03-03,(05102) Av. Américas - Av. Boyacá,2022,1122,974,4118
28796,2020-02-11,(07007) NQS - Calle 38A Sur,2308,1408,1303,5019
28797,2020-03-17,(06103) CAN,1237,739,615,2591
28798,2020-05-15,(06108) Concejo de Bogotá,123,74,84,281
28799,2020-02-01,(03001) LA CAMPIÑA,3337,1359,2423,7119
28800,2020-02-09,(06002) Normandía,339,180,402,921
28801,2020-06-16,(03001) LA CAMPIÑA,1098,633,619,2350
28802,2020-03-22,(40003) Mirador del Paraiso,257,156,137,550
28803,2020-05-20,(09123) Calle 76,800,559,459,1818
28804,2020-01-29,(05101) Mandalay - Cr.73,1174,637,526,2337
28805,2020-05-19,(40003) Mirador del Paraiso,1396,924,800,3120
28806,2020-06-05,(02201) Prado,884,557,496,1937
28807,2020-04-17,(02300) Calle 100,782,535,429,1746
28808,2020-04-03,(07009) SENA,285,160,159,604
28809,2020-01-28,(08000) Portal Tunal,2122,1207,1055,4384
28810,2020-06-16,(07007) NQS - Calle 38A Sur,410,233,250,893
28811,2020-03-26,(08000) Portal Tunal,347,185,158,690
28812,2020-02-28,(12000) Puente Aranda,269,188,201,658
28813,2020-01-16,(04108) El Polo,1697,1057,1048,3802
28814,2020-03-24,(02201) Prado,751,501,496,1748
28815,2020-08-14,(06000) Portal Eldorado - alimentacion,3665,1794,1953,7412
28816,2020-06-03,(05001) Patio Bonito,1292,724,797,2813
28817,2020-07-26,(03007) HUMEDAL CORDOBA,35,31,23,89
28818,2020-09-01,(04104) Avenida 68,645,305,347,1297
28819,2020-02-13,(03005) SUBA - AV. BOYACA,2890,1643,1538,6071
28820,2020-08-07,(02101) Toberín,334,236,318,888
28821,2020-04-22,(02304) Heroes,448,330,253,1031
28822,2020-07-24,(07004) VENECIA,791,487,455,1733
28823,2020-02-08,(03001) LA CAMPIÑA,3526,1495,2505,7526
28824,2020-01-15,(02000) Cabecera Autopista Norte - intermunicipal,3769,2592,2684,9045
28825,2020-05-26,(05103) Marsella,355,182,215,752
28826,2020-09-04,(12001) Carrera 43,467,294,282,1043
28827,2020-08-28,(05001) Patio Bonito,1991,1087,1130,4208
28828,2020-01-19,(07109) CAD,514,387,547,1448
28829,2020-09-01,(03002) SUBA - TV- 91,825,501,525,1851
28830,2020-03-05,(04000) Cabecera Calle 80 - intermunicipal,2119,1606,2188,5913
28831,2020-02-27,(04001) Quirigua,2116,1339,1218,4673
28832,2020-08-27,(04001) Quirigua,381,234,259,874
28833,2020-07-21,(05002) Tintal,2223,1263,1204,4690
28834,2020-06-17,(02204) Pepe Sierra,849,581,417,1847
28835,2020-08-02,(02205) Calle 106,54,48,50,152
28836,2020-03-21,(05002) Tintal,698,416,412,1526
28837,2020-03-28,(02000) Cabecera Autopista Norte,345,234,192,771
28838,2020-06-03,(07009) SENA,600,354,353,1307
28839,2020-08-26,(12003) Ricaurte,391,254,174,819
28840,2020-03-07,(10010) San Bernardo,920,584,1067,2571
28841,2020-06-03,(03009) Av. Suba- Calle 116,469,319,219,1007
28842,2020-03-01,(06001) Modelia,277,174,376,827
28843,2020-04-24,(02105) Calle 142,457,279,211,947
28844,2020-06-17,(04003) Avenida Ciudad de Cali,1053,588,686,2327
28845,2020-06-14,(03006) NIZA - CALLE 127,165,102,83,350
28846,2020-09-11,(03006) NIZA - CALLE 127,523,308,275,1106
28847,2020-05-19,(09002) Consuelo,380,203,213,796
28848,2020-02-21,(04000) Cabecera Calle 80 - intermunicipal,2285,1506,2082,5873
28849,2020-08-04,(02103) Mazurén,142,88,124,354
28850,2020-10-02,(12007) Zona Industrial,396,261,230,887
28851,2020-02-19,(10005) Bicentenario,831,431,370,1632
28852,2020-03-24,(40002) Manitas,282,156,245,683
28853,2020-09-18,(02200) Alcalá,2187,1403,1323,4913
28854,2020-01-31,(07006) General Santander,2791,1575,1574,5940
28855,2020-01-21,(02102) Calle 161,1270,690,651,2611
28856,2020-06-27,(10006) San Victorino,506,279,339,1124
28857,2020-03-31,(02101) Toberín,566,403,406,1375
28858,2020-09-01,(07006) General Santander,570,349,337,1256
28859,2020-09-12,(07102) NQS - CALLE 75,307,231,287,825
28860,2020-08-24,(07004) VENECIA,899,531,446,1876
28861,2020-02-15,(09003) Socorro,1329,628,887,2844
28862,2020-09-21,(06111) Universidades,350,178,321,849
28863,2020-05-26,(09004) Santa Lucía,2270,1199,1252,4721
28864,2020-01-19,(07006) General Santander,663,329,619,1611
28865,2020-04-25,(07110) PALOQUEMAO,336,224,145,705
28866,2020-04-22,(10009) Museo Nacional,316,221,163,700
28867,2020-07-17,(07001) PERDOMO,739,454,509,1702
28868,2020-09-20,(07103) AV. CHILE,177,149,255,581
28869,2020-09-22,(04105) Carrera 53,308,179,225,712
28870,2020-02-21,(07006) General Santander - alimentacion,1512,856,928,3296
28871,2020-07-08,(07201) Guatoque -Veraguas,233,120,119,472
28872,2020-03-19,(07107) U. NACIONAL,727,530,473,1730
28873,2020-06-07,(03000) Portal Suba,275,156,284,715
28874,2020-01-04,(07105) MOVISTAR ARENA,367,280,291,938
28875,2020-06-03,(07105) MOVISTAR ARENA,256,132,123,511
28876,2020-08-06,(07009) SENA,531,295,360,1186
28877,2020-02-01,(07506) DESPENSA,1101,550,745,2396
28878,2020-09-21,(02200) Alcalá,1700,1130,964,3794
28879,2020-02-29,(07107) U. NACIONAL,791,634,937,2362
28880,2020-04-11,(06109) Centro Memoria,85,64,65,214
28881,2020-05-23,(05102) Av. Américas - Av. Boyacá,134,71,91,296
28882,2020-05-22,(03003) 21 ANGELES,288,142,133,563
28883,2020-09-05,(07107) U. NACIONAL,262,175,243,680
28884,2020-08-14,(06000) Portal Eldorado,847,581,444,1872
28885,2020-04-13,(09119) Calle 57,263,196,167,626
28886,2020-05-12,(04103) Las Ferias,254,151,128,533
28887,2020-05-26,(07110) PALOQUEMAO,663,365,282,1310
28888,2020-09-22,(08000) Portal Tunal,778,338,387,1503
28889,2020-08-20,(03011) SUBA - CALLE 100,500,224,220,944
28890,2020-07-10,(04103) Las Ferias,364,216,173,753
28891,2020-08-10,(05102) Av. Américas - Av. Boyacá,228,124,161,513
28892,2020-03-28,(08002) Biblioteca,117,67,65,249
28893,2020-07-25,(04000) Cabecera Calle 80 - intermunicipal,202,82,159,443
28894,2020-04-15,(07103) AV. CHILE,499,347,257,1103
28895,2020-06-16,(07109) CAD,667,403,332,1402
28896,2020-04-04,(02102) Calle 161,69,46,46,161
28897,2020-05-11,(02102) Calle 161,146,109,95,350
28898,2020-08-01,(07107) U. NACIONAL,218,132,146,496
28899,2020-10-07,(04106) Carrera 47,377,178,272,827
28900,2020-04-29,(09115) Calle 34,409,294,241,944
28901,2020-07-10,(07109) CAD,678,431,364,1473
28902,2020-10-04,(07008) NQS - Calle 30 Sur,137,64,156,357
28903,2020-08-24,(02000) Cabecera Autopista Norte - intermunicipal,480,317,313,1110
28904,2020-08-25,(04002) Carrera 90,669,361,409,1439
28905,2020-02-16,(09104) Restrepo,1147,719,1492,3358
28906,2020-05-23,(02302) Virrey,354,254,223,831
28907,2020-04-13,(09115) Calle 34,358,252,187,797
28908,2020-06-02,(07005) ALQUERIA,504,304,245,1053
28909,2020-03-13,(04102) Avenida Boyaca,593,353,356,1302
28910,2020-09-22,(06002) Normandía,361,232,235,828
28911,2020-08-25,(06108) Concejo de Bogotá,120,65,63,248
28912,2020-06-22,(14004) Museo del Oro,25,24,50,99
28913,2020-07-09,(09108) Hospital,80,36,63,179
28914,2020-03-15,(06102) Salitre El Greco,230,125,171,526
28915,2020-06-06,(03009) Av. Suba- Calle 116,325,223,195,743
28916,2020-03-08,(02103) Mazurén,321,149,492,962
28917,2020-04-09,(03005) SUBA - AV. BOYACA,88,58,68,214
28918,2020-04-09,(06101) El Tiempo,92,70,53,215
28919,2020-02-22,(03004) GRATAMIRA,142,65,97,304
28920,2020-09-24,(04000) Cabecera Calle 80 - intermunicipal,424,204,389,1017
28921,2020-03-28,(03009) Av. Suba- Calle 116,253,181,118,552
28922,2020-08-15,(08001) Parque el Tunal,377,187,277,841
28923,2020-03-07,(05101) Mandalay - Cr.73,493,228,380,1101
28924,2020-07-23,(14004) Museo del Oro,218,109,165,492
28925,2020-09-06,(02303) Calle 85,178,134,191,503
28926,2020-05-20,(07010) Bosa,554,317,326,1197
28927,2020-07-31,(07008) NQS - Calle 30 Sur,229,116,160,505
28928,2020-06-09,(06102) Salitre El Greco,192,97,112,401
28929,2020-06-22,(09111) Calle 19,201,150,184,535
28930,2020-04-26,(02304) Heroes,149,128,120,397
28931,2020-04-26,(02303) Calle 85,153,103,106,362
28932,2020-04-25,(05105) Pradera,308,202,100,610
28933,2020-06-12,(04001) Quirigua,416,229,258,903
28934,2020-08-06,(04001) Quirigua,303,171,198,672
28935,2020-08-07,(07008) NQS - Calle 30 Sur,126,54,80,260
28936,2020-08-30,(06101) El Tiempo,82,70,92,244
28937,2020-05-26,(07506) DESPENSA,421,223,225,869
28938,2020-06-09,(06002) Normandía,272,166,170,608
28939,2020-05-10,(04104) Avenida 68,136,87,82,305
28940,2020-08-17,(07008) NQS - Calle 30 Sur,87,60,68,215
28941,2020-05-16,(07010) Bosa,391,199,236,826
28942,2020-10-07,(06100) Av. Rojas,316,205,258,779
28943,2020-07-30,(07009) SENA,534,335,342,1211
28944,2020-05-22,(04102) Avenida Boyaca,247,163,164,574
28945,2020-05-03,(10008) San Diego,65,47,51,163
28946,2020-05-18,(04103) Las Ferias,290,164,150,604
28947,2020-03-09,(03004) GRATAMIRA,52,45,38,135
28948,2020-04-17,(04107) Escuela Militar,64,40,38,142
28949,2020-09-11,(03005) SUBA - AV. BOYACA,481,280,323,1084
28950,2020-03-31,(12004) Carrera 22,37,39,51,127
28951,2020-08-29,(09105) Río Fucha,0,55,134,189
28952,2020-05-04,(04102) Avenida Boyaca,188,114,118,420
28953,2020-06-20,(06103) CAN,218,173,129,520
28954,2020-06-19,(07108) Av. El Dorado,141,95,105,341
28955,2020-01-01,(10005) Bicentenario - alimentacion,59,36,135,230
28956,2020-08-09,(09111) Calle 19,170,123,193,486
28957,2020-04-19,(02204) Pepe Sierra,167,133,104,404
28958,2020-06-10,(07003) SEVILLANA,408,213,213,834
28959,2020-07-19,(03010) PUENTE LARGO,62,48,60,170
28960,2020-07-25,(10003) Ciudad Jardín,124,54,89,267
28961,2019-12-31,(02102) Calle 161,16,4,6,26
28962,2020-04-27,(06103) CAN,33,140,47,220
28963,2020-03-25,(06105) Quinta Paredes,62,59,34,155
28964,2020-03-29,(07002) MADELENA,114,50,59,223
28965,2020-10-11,(05101) Mandalay - Cr.73,36,19,44,99
28966,2020-05-25,(05101) Mandalay - Cr.73,27,15,19,61
28967,2020-04-08,(03014) SAN MARTIN,16,7,17,40
28968,2020-04-08,(05101) Mandalay - Cr.73,52,25,32,109
28969,2019-12-31,(04105) Carrera 53,17,12,15,44
28970,2020-04-12,(12002) CDS - Carrera 32,27,28,19,74
28971,2020-09-23,(12000) Puente Aranda,96,57,66,219
28972,2020-07-26,(06001) Modelia,69,42,57,168
28973,2020-05-03,(14005) Las Aguas,0,11,50,61
28974,2019-12-31,(14005) Las Aguas,16,8,28,52
28975,2020-05-14,(50002) Corral Calle 40 Sur,8,5,10,23
28976,2020-05-26,(03014) SAN MARTIN,24,12,28,64
28977,2020-08-22,(04000) Cabecera Calle 80 - alimentacion,2839,1414,2034,6287
28978,2020-06-01,(09002) Consuelo,439,238,252,929
28979,2020-08-15,(02502) Terminal,262,195,280,737
28980,2020-08-20,(07504) TERREROS,5764,3042,2690,11496
28981,2020-07-11,(10000) Portal 20 de Julio - alimentacion,3913,1721,2533,8167
28982,2020-01-16,(08000) Portal Tunal - alimentacion,21133,10953,10892,42978
28983,2020-01-13,(02303) Calle 85,3189,2180,1667,7036
28984,2020-01-03,(02200) Alcalá,5123,3068,3287,11478
28985,2020-01-23,(02200) Alcalá,13386,8392,6406,28184
28986,2020-07-06,(05000) Portal Américas,2645,1919,1976,6540
28987,2020-03-10,(06104) Gobernación,613,94,161,868
28988,2020-01-29,(09003) Socorro,1586,925,993,3504
28989,2020-01-22,(50003) Corral Molinos,3378,2008,3288,8674
28990,2020-09-16,(04002) Carrera 90,811,436,519,1766
28991,2020-01-22,(09100) Calle 40 Sur,6791,3772,3958,14521
28992,2020-01-14,(02000) Cabecera Autopista Norte - alimentacion,19454,10636,11846,41936
28993,2020-09-18,(02000) Cabecera Autopista Norte - alimentacion,5326,2731,3522,11579
28994,2020-07-07,(04103) Las Ferias,382,217,174,773
28995,2020-02-21,(07000) Portal Sur - alimentacion,29253,16192,14340,59785
28996,2020-01-11,(05005) Transversal 86,1052,433,687,2172
28997,2020-09-07,(07112) COMUNEROS,884,502,562,1948
28998,2020-01-11,(10004) Policarpa,465,200,413,1078
28999,2020-06-02,(10001) Country Sur,1063,483,663,2209
29000,2020-03-21,(09000) Cabecera Usme,498,273,290,1061
29001,2020-08-12,(09000) Cabecera Usme,1607,924,1179,3710
29002,2020-03-31,(06000) Portal Eldorado - alimentacion,2158,1027,936,4121
29003,2020-01-03,(09115) Calle 34,1865,1252,1417,4534
29004,2020-02-15,(02105) Calle 142,3024,1382,2435,6841
29005,2020-01-08,(07000) Portal Sur - alimentacion,21357,11796,11453,44606
29006,2020-02-06,(02204) Pepe Sierra,4892,3433,2516,10841
29007,2020-08-06,(07001) PERDOMO,828,466,583,1877
29008,2020-02-23,(05107) Américas - Cr.53,365,265,420,1050
29009,2020-03-16,(04101) Minuto de Dios,1510,946,1006,3462
29010,2020-09-08,(02204) Pepe Sierra,825,585,454,1864
29011,2020-09-24,(02204) Pepe Sierra,855,619,503,1977
29012,2020-06-05,(09101) Quiroga,463,271,337,1071
29013,2020-06-16,(07102) NQS - CALLE 75,425,279,252,956
29014,2020-01-09,(03013) RIO NEGRO,954,574,667,2195
29015,2020-06-19,(03013) RIO NEGRO,282,177,189,648
29016,2020-03-31,(09000) Cabecera Usme - alimentacion,4288,1968,2340,8596
29017,2020-05-07,(09000) Cabecera Usme - alimentacion,5320,2986,3207,11513
29018,2020-06-20,(09118) Marly,1087,698,667,2452
29019,2020-05-05,(14001) La Sabana,121,77,65,263
29020,2020-03-09,(09001) Molinos,415,2052,1687,4154
29021,2020-01-21,(50003) Corral Molinos,2827,1414,2277,6518
29022,2020-07-06,(50003) Corral Molinos,1628,887,1147,3662
29023,2020-03-09,(09110) Avenida Jimenez,2862,206,571,3639
29024,2020-04-29,(04002) Carrera 90,438,264,209,911
29025,2020-08-29,(04100) Carrera 77,995,504,748,2247
29026,2020-01-14,(06109) Centro Memoria,957,556,565,2078
29027,2020-09-29,(10006) San Victorino,812,432,423,1667
29028,2020-03-11,(06000) Portal Eldorado,6316,3718,2855,12889
29029,2020-02-27,(10000) Portal 20 de Julio,9252,4292,3787,17331
29030,2020-09-07,(02000) Cabecera Autopista Norte - alimentacion,4785,2581,3125,10491
29031,2020-10-08,(06105) Quinta Paredes,175,108,119,402
29032,2020-01-27,(09119) Calle 57,3174,2126,1934,7234
29033,2020-06-25,(07503) SAN MATEO,11313,6956,5617,23886
29034,2020-01-31,(40001) Juan Pablo II,1649,918,1005,3572
29035,2020-06-29,(09101) Quiroga,190,99,174,463
29036,2020-05-12,(03000) Portal Suba - alimentacion,4545,2725,2287,9557
29037,2020-04-23,(07000) Portal Sur - alimentacion,4294,2417,1742,8453
29038,2020-03-03,(07008) NQS - Calle 30 Sur,1960,1041,1134,4135
29039,2020-08-11,(09003) Socorro,575,315,349,1239
29040,2020-07-26,(07505) LEON XIII,656,341,343,1340
29041,2020-09-30,(06108) Concejo de Bogotá,161,87,133,381
29042,2020-08-22,(10002) Av. Primero de Mayo,1483,672,1158,3313
29043,2020-05-20,(02201) Prado,785,501,384,1670
29044,2020-08-26,(02201) Prado,821,552,465,1838
29045,2020-09-14,(07007) NQS - Calle 38A Sur,377,235,327,939
29046,2020-05-12,(40003) Mirador del Paraiso,1309,839,852,3000
29047,2020-01-13,(03011) SUBA - CALLE 100,2172,1078,1226,4476
29048,2020-01-06,(02300) Calle 100,808,617,940,2365
29049,2020-01-29,(02300) Calle 100,7576,4591,3720,15887
29050,2020-06-17,(09001) Molinos,2559,1411,1729,5699
29051,2020-07-24,(50002) Corral Calle 40 Sur,19,11,22,52
29052,2020-06-11,(05101) Mandalay - Cr.73,90,57,67,214
29053,2020-06-13,(08000) Portal Tunal,593,291,268,1152
29054,2020-01-14,(07104) Simon Bolivar,1879,1186,1118,4183
29055,2020-02-11,(07104) Simon Bolivar,2476,1566,1235,5277
29056,2020-06-05,(02202) Calle 127,1074,747,563,2384
29057,2020-06-13,(02202) Calle 127,902,622,520,2044
29058,2020-05-16,(02205) Calle 106,169,115,119,403
29059,2020-08-24,(02205) Calle 106,329,206,186,721
29060,2020-01-23,(12000) Puente Aranda,254,159,162,575
29061,2020-02-10,(12000) Puente Aranda,300,173,204,677
29062,2020-08-07,(02000) Cabecera Autopista Norte,490,322,291,1103
29063,2020-01-20,(03000) Portal Suba,7884,4734,4845,17463
29064,2020-10-10,(04108) El Polo,319,215,328,862
29065,2020-07-23,(07106) EL CAMPIN,377,241,159,777
29066,2020-03-13,(07103) AV. CHILE,1017,216,398,1631
29067,2020-09-03,(07103) AV. CHILE,940,582,524,2046
29068,2020-10-03,(03007) HUMEDAL CORDOBA,107,84,109,300
29069,2020-05-25,(05000) Portal Américas - alimentacion,3340,1525,1428,6293
29070,2020-06-24,(10003) Ciudad Jardín,214,109,138,461
29071,2020-02-02,(07110) PALOQUEMAO,354,307,480,1141
29072,2020-05-25,(09100) Calle 40 Sur,502,285,304,1091
29073,2020-04-24,(07104) Simon Bolivar,245,167,114,526
29074,2020-07-28,(07104) Simon Bolivar,550,313,277,1140
29075,2020-09-09,(04107) Escuela Militar,166,101,108,375
29076,2020-09-25,(04107) Escuela Militar,153,106,113,372
29077,2020-05-23,(07109) CAD,343,238,198,779
29078,2020-02-08,(07004) VENECIA,3018,1605,1995,6618
29079,2020-07-21,(07004) VENECIA,882,526,520,1928
29080,2020-08-18,(04104) Avenida 68,595,297,297,1189
29081,2020-06-16,(05103) Marsella,407,216,240,863
29082,2020-02-19,(09109) Tercer Milenio,1445,899,869,3213
29083,2020-03-06,(09109) Tercer Milenio,1341,827,854,3022
29084,2020-03-26,(06101) El Tiempo,267,192,125,584
29085,2020-08-20,(03002) SUBA - TV- 91,680,389,479,1548
29086,2020-10-03,(03002) SUBA - TV- 91,693,313,647,1653
29087,2020-03-28,(10001) Country Sur,383,163,259,805
29088,2020-08-20,(07101) CASTELLANA,196,102,130,428
29089,2020-04-09,(05001) Patio Bonito,347,225,190,762
29090,2020-02-09,(02202) Calle 127,1004,721,955,2680
29091,2020-09-27,(02000) Cabecera Autopista Norte,527,324,558,1409
29092,2020-04-01,(07113) SANTA ISABEL,191,117,139,447
29093,2020-05-23,(12003) Ricaurte,204,161,123,488
29094,2020-04-30,(07106) EL CAMPIN,204,141,102,447
29095,2020-09-07,(10010) San Bernardo,628,320,470,1418
29096,2020-04-23,(09001) Molinos,1146,701,922,2769
29097,2020-08-22,(04106) Carrera 47,236,116,147,499
29098,2020-09-19,(04106) Carrera 47,278,139,193,610
29099,2020-03-12,(02103) Mazurén,166,715,421,1302
29100,2020-03-22,(02105) Calle 142,142,123,106,371
29101,2020-09-09,(02105) Calle 142,834,568,604,2006
29102,2020-04-27,(09109) Tercer Milenio,64,69,35,168
29103,2020-02-14,(09113) Calle 22,1602,879,1105,3586
29104,2020-08-22,(03006) NIZA - CALLE 127,373,208,180,761
29105,2020-04-06,(05107) Américas - Cr.53,260,228,161,649
29106,2020-04-30,(05107) Américas - Cr.53,311,215,175,701
29107,2020-09-25,(05107) Américas - Cr.53,455,305,328,1088
29108,2020-04-26,(10010) San Bernardo,201,112,135,448
29109,2020-07-05,(02104) Calle 146,257,158,185,600
29110,2020-09-09,(02103) Mazurén,243,162,225,630
29111,2020-01-26,(07103) AV. CHILE,551,393,665,1609
29112,2020-07-17,(12007) Zona Industrial,374,229,132,735
29113,2020-07-30,(10005) Bicentenario,89,56,79,224
29114,2020-10-08,(10005) Bicentenario,138,64,109,311
29115,2020-02-19,(40002) Manitas,1393,793,800,2986
29116,2020-05-20,(02304) Heroes,652,467,361,1480
29117,2020-06-22,(10000) Portal 20 de Julio,799,372,460,1631
29118,2020-09-24,(07003) SEVILLANA,519,264,346,1129
29119,2020-09-09,(02200) Alcalá,2080,1351,1198,4629
29120,2020-10-09,(09122) Calle 72,1328,953,1201,3482
29121,2020-05-22,(05100) Banderas P. Central,564,295,379,1238
29122,2020-07-31,(05002) Tintal,1947,1152,1245,4344
29123,2020-09-13,(10008) San Diego,68,71,118,257
29124,2020-08-12,(02304) Heroes,858,570,434,1862
29125,2020-05-19,(40001) Juan Pablo II,453,285,253,991
29126,2020-03-23,(02204) Pepe Sierra,218,167,134,519
29127,2020-04-16,(02204) Pepe Sierra,416,318,244,978
29128,2020-08-11,(02204) Pepe Sierra,705,481,393,1579
29129,2020-06-20,(02200) Alcalá,1525,1032,802,3359
29130,2020-04-12,(07110) PALOQUEMAO,118,98,53,269
29131,2020-04-27,(05001) Patio Bonito,786,98,142,1026
29132,2020-01-06,(06105) Quinta Paredes,88,68,107,263
29133,2020-02-17,(07105) MOVISTAR ARENA,1408,843,676,2927
29134,2020-03-14,(12004) Carrera 22,416,316,347,1079
29135,2020-01-17,(14005) Las Aguas,1893,1208,1481,4582
29136,2020-02-26,(07200) Tygua-San José,790,465,589,1844
29137,2020-01-06,(03002) SUBA - TV- 91,561,289,554,1404
29138,2020-09-23,(10007) Las Nieves,760,466,444,1670
29139,2020-06-26,(14004) Museo del Oro,289,184,246,719
29140,2020-07-18,(04103) Las Ferias,230,144,124,498
29141,2020-09-05,(08000) Portal Tunal,635,325,338,1298
29142,2020-09-11,(05005) Transversal 86,426,202,293,921
29143,2020-08-27,(05102) Av. Américas - Av. Boyacá,226,126,151,503
29144,2020-04-14,(04104) Avenida 68,305,192,200,697
29145,2020-06-25,(09004) Santa Lucía,2673,1388,1438,5499
29146,2020-09-02,(06111) Universidades,414,244,364,1022
29147,2020-09-22,(07103) AV. CHILE,1041,647,595,2283
29148,2020-04-06,(08002) Biblioteca,162,106,104,372
29149,2020-05-20,(12000) Puente Aranda,73,40,23,136
29150,2020-05-08,(12001) Carrera 43,316,187,185,688
29151,2020-01-12,(50003) Corral Molinos,1043,403,1058,2504
29152,2020-03-31,(07103) AV. CHILE,375,294,216,885
29153,2020-05-17,(07506) DESPENSA,117,62,75,254
29154,2020-06-12,(07506) DESPENSA,532,270,266,1068
29155,2020-05-08,(02102) Calle 161,158,102,94,354
29156,2020-05-12,(02102) Calle 161,184,117,107,408
29157,2020-09-25,(12004) Carrera 22,306,183,172,661
29158,2020-06-15,(07107) U. NACIONAL,108,85,66,259
29159,2020-08-28,(03013) RIO NEGRO,299,183,200,682
29160,2020-03-09,(04106) Carrera 47,352,226,198,776
29161,2020-05-05,(04001) Quirigua,240,145,149,534
29162,2020-06-06,(04000) Cabecera Calle 80,709,426,573,1708
29163,2020-07-18,(03006) NIZA - CALLE 127,356,192,161,709
29164,2020-06-18,(04103) Las Ferias,366,227,164,757
29165,2020-06-05,(04001) Quirigua,384,220,252,856
29166,2020-09-01,(07200) Tygua-San José,207,135,166,508
29167,2020-02-27,(09105) Río Fucha,804,457,484,1745
29168,2020-08-25,(02000) Cabecera Autopista Norte - intermunicipal,480,303,335,1118
29169,2020-06-06,(09120) Calle 63,801,509,558,1868
29170,2020-07-17,(09117) Calle 45,578,365,377,1320
29171,2020-08-31,(04002) Carrera 90,737,404,458,1599
29172,2020-05-06,(07004) VENECIA,619,368,309,1296
29173,2020-05-16,(04003) Avenida Ciudad de Cali,555,335,428,1318
29174,2020-05-24,(06000) Portal Eldorado,177,141,138,456
29175,2020-08-27,(07108) Av. El Dorado,149,82,78,309
29176,2020-05-29,(03010) PUENTE LARGO,284,195,187,666
29177,2020-10-04,(09114) Calle 26,61,59,156,276
29178,2020-04-02,(09000) Cabecera Usme,794,404,593,1791
29179,2020-04-04,(03001) LA CAMPIÑA,316,160,156,632
29180,2020-08-02,(07110) PALOQUEMAO,151,98,81,330
29181,2020-04-01,(12001) Carrera 43,220,171,116,507
29182,2020-10-04,(09109) Tercer Milenio,137,75,179,391
29183,2020-07-05,(07005) ALQUERIA,186,85,168,439
29184,2020-08-07,(07000) Portal Sur,615,342,515,1472
29185,2020-06-10,(07008) NQS - Calle 30 Sur,277,150,167,594
29186,2020-04-27,(07006) General Santander - alimentacion,163,23,33,219
29187,2020-06-20,(07008) NQS - Calle 30 Sur,256,128,154,538
29188,2020-05-23,(10007) Las Nieves,325,196,255,776
29189,2020-01-13,(12000) Puente Aranda,223,139,165,527
29190,2020-08-07,(09121) Las Flores,229,156,208,593
29191,2020-07-11,(07007) NQS - Calle 38A Sur,353,203,241,797
29192,2020-06-20,(03004) GRATAMIRA,32,20,28,80
29193,2020-07-28,(03004) GRATAMIRA,28,16,17,61
29194,2020-05-06,(06111) Universidades,0,93,260,353
29195,2020-04-19,(08001) Parque el Tunal,79,38,55,172
29196,2020-03-13,(12000) Puente Aranda,77,25,37,139
29197,2020-07-09,(03005) SUBA - AV. BOYACA,478,275,343,1096
29198,2020-01-01,(09106) Nariño,137,83,246,466
29199,2020-05-05,(09106) Nariño,270,157,183,610
29200,2020-08-04,(09106) Nariño,348,196,266,810
29201,2020-03-15,(03014) SAN MARTIN,32,19,41,92
29202,2020-08-26,(03002) SUBA - TV- 91,738,451,448,1637
29203,2020-07-25,(07106) EL CAMPIN,269,193,160,622
29204,2020-05-01,(14001) La Sabana,62,47,48,157
29205,2020-04-18,(07506) DESPENSA,159,101,76,336
29206,2020-04-02,(07201) Guatoque -Veraguas,54,39,72,165
29207,2020-03-17,(03014) SAN MARTIN,122,73,98,293
29208,2020-04-14,(09101) Quiroga,277,153,189,619
29209,2020-04-09,(04104) Avenida 68,110,77,68,255
29210,2020-04-06,(06104) Gobernación,161,123,79,363
29211,2020-03-21,(06103) CAN,213,164,92,469
29212,2020-05-12,(04003) Avenida Ciudad de Cali,763,491,469,1723
29213,2020-04-04,(06111) Universidades,0,45,157,202
29214,2020-04-10,(09114) Calle 26,47,29,32,108
29215,2020-08-17,(09105) Río Fucha,0,22,43,65
29216,2020-05-02,(12004) Carrera 22,63,45,53,161
29217,2020-01-12,(03014) SAN MARTIN,32,22,87,141
29218,2020-04-12,(03011) SUBA - CALLE 100,105,67,56,228
29219,2020-01-05,(10005) Bicentenario,58,42,111,211
29220,2020-07-12,(50002) Corral Calle 40 Sur,5,1,4,10
29221,2020-03-28,(04000) Cabecera Calle 80 - intermunicipal,38,33,50,121
29222,2020-04-11,(03007) HUMEDAL CORDOBA,69,32,32,133
29223,2020-07-19,(10007) Las Nieves,58,47,53,158
29224,2020-05-10,(04001) Quirigua,80,46,45,171
29225,2020-06-22,(10005) Bicentenario,38,16,28,82
29226,2020-04-10,(07200) Tygua-San José,25,20,21,66
29227,2020-05-28,(50006) Corral Carrera 77,4,3,9,16
29228,2020-01-10,(09002) Consuelo,1116,553,750,2419
29229,2020-01-22,(09002) Consuelo,1349,765,849,2963
29230,2020-07-02,(09002) Consuelo,519,267,327,1113
29231,2020-07-03,(07504) TERREROS,6558,3591,3156,13305
29232,2020-02-02,(10000) Portal 20 de Julio - alimentacion,3694,1326,3224,8244
29233,2020-03-11,(10000) Portal 20 de Julio - alimentacion,10408,5113,7166,22687
29234,2020-03-02,(09119) Calle 57,3624,2257,2158,8039
29235,2020-02-07,(06000) Portal Eldorado - alimentacion,18858,9692,10098,38648
29236,2020-01-09,(09100) Calle 40 Sur,5463,2910,3418,11791
29237,2020-02-01,(10000) Portal 20 de Julio - alimentacion,8579,3852,6340,18771
29238,2020-01-26,(05000) Portal Américas - alimentacion,9423,3839,6674,19936
29239,2020-02-08,(09121) Las Flores,1664,1080,1496,4240
29240,2020-01-25,(08000) Portal Tunal - alimentacion,15600,7527,8704,31831
29241,2020-02-19,(08000) Portal Tunal - alimentacion,24562,13775,12591,50928
29242,2020-01-13,(05000) Portal Américas,12105,6912,7007,26024
29243,2020-02-24,(05005) Transversal 86,2827,1618,1322,5767
29244,2020-10-03,(07503) SAN MATEO,11300,5044,7136,23480
29245,2020-05-02,(10000) Portal 20 de Julio - alimentacion,2169,961,1232,4362
29246,2020-08-22,(10000) Portal 20 de Julio - alimentacion,3216,1365,2038,6619
29247,2020-03-24,(09104) Restrepo,1079,759,1026,2864
29248,2020-07-05,(10001) Country Sur,368,164,319,851
29249,2020-08-28,(10001) Country Sur,1227,581,777,2585
29250,2020-10-01,(10001) Country Sur,1489,674,1048,3211
29251,2020-10-05,(09100) Calle 40 Sur,1910,1131,1565,4606
29252,2020-08-30,(09113) Calle 22,213,127,215,555
29253,2020-01-28,(07009) SENA,3460,1986,1926,7372
29254,2020-01-19,(10003) Ciudad Jardín,243,101,267,611
29255,2020-03-10,(05100) Banderas P. Central,284,2306,1469,4059
29256,2020-07-23,(02105) Calle 142,646,412,375,1433
29257,2020-10-07,(40003) Mirador del Paraiso,1792,982,1371,4145
29258,2020-09-24,(04101) Minuto de Dios,393,228,327,948
29259,2020-01-16,(07505) LEON XIII,7553,3876,3717,15146
29260,2020-03-13,(09117) Calle 45,1811,273,560,2644
29261,2020-09-18,(03000) Portal Suba - alimentacion,7518,4151,4947,16616
29262,2020-02-05,(03013) RIO NEGRO,1330,844,904,3078
29263,2020-02-11,(03013) RIO NEGRO,1345,840,892,3077
29264,2020-01-28,(50003) Corral Molinos,3454,2117,3336,8907
29265,2020-05-13,(07000) Portal Sur - alimentacion,6035,3349,2535,11919
29266,2020-04-16,(07111) NQS - RICAURTE,492,339,230,1061
29267,2020-06-08,(08000) Portal Tunal - alimentacion,6169,3264,3182,12615
29268,2020-08-13,(02000) Cabecera Autopista Norte,1178,735,712,2625
29269,2020-09-22,(02000) Cabecera Autopista Norte,1707,1034,1228,3969
29270,2020-02-09,(03003) 21 ANGELES,359,137,332,828
29271,2020-02-27,(10007) Las Nieves,2166,1263,1189,4618
29272,2020-01-28,(04105) Carrera 53,1392,778,747,2917
29273,2020-01-17,(06106) Recinto Ferial,1303,718,781,2802
29274,2019-12-31,(07504) TERREROS,189,166,297,652
29275,2020-06-02,(40003) Mirador del Paraiso,1545,1030,1005,3580
29276,2020-09-30,(40003) Mirador del Paraiso,1846,1066,1300,4212
29277,2020-06-30,(04000) Cabecera Calle 80,1242,709,933,2884
29278,2020-03-15,(07000) Portal Sur - alimentacion,6233,2627,3884,12744
29279,2020-01-10,(12001) Carrera 43,1199,710,847,2756
29280,2020-10-06,(10002) Av. Primero de Mayo,2531,1249,1893,5673
29281,2020-01-12,(09107) Hortúa,493,264,567,1324
29282,2020-02-24,(06111) Universidades,5715,3548,2482,11745
29283,2020-09-29,(09000) Cabecera Usme - alimentacion,9590,4871,6025,20486
29284,2020-02-17,(09101) Quiroga,1708,1060,1184,3952
29285,2020-01-16,(06100) Av. Rojas,1930,1085,1042,4057
29286,2020-01-16,(09116) Avenida 39,2151,1458,1350,4959
29287,2020-01-15,(04002) Carrera 90,3144,1705,1838,6687
29288,2020-05-30,(09116) Avenida 39,150,127,155,432
29289,2020-01-25,(02300) Calle 100,2706,1934,2671,7311
29290,2020-05-27,(40003) Mirador del Paraiso,1506,988,939,3433
29291,2020-06-27,(09116) Avenida 39,182,161,188,531
29292,2020-02-28,(06103) CAN,2511,1577,1270,5358
29293,2020-07-31,(06108) Concejo de Bogotá,148,75,73,296
29294,2020-05-29,(09120) Calle 63,961,674,576,2211
29295,2020-01-04,(07007) NQS - Calle 38A Sur,764,459,546,1769
29296,2020-09-29,(05105) Pradera,656,392,325,1373
29297,2020-02-23,(02200) Alcalá,1883,1088,1841,4812
29298,2020-07-12,(02300) Calle 100,285,239,278,802
29299,2020-07-21,(02300) Calle 100,1092,709,567,2368
29300,2020-04-30,(09103) Olaya,577,340,317,1234
29301,2020-07-18,(10010) San Bernardo,378,184,313,875
29302,2020-01-06,(02302) Virrey,377,284,446,1107
29303,2020-06-09,(05005) Transversal 86,329,159,175,663
29304,2020-06-19,(05005) Transversal 86,454,213,237,904
29305,2020-08-18,(05005) Transversal 86,341,176,231,748
29306,2020-09-24,(05105) Pradera,657,388,338,1383
29307,2020-03-11,(10008) San Diego,1511,842,784,3137
29308,2020-02-10,(08000) Portal Tunal,2231,1278,1148,4657
29309,2020-07-06,(06109) Centro Memoria,304,168,136,608
29310,2020-08-25,(08000) Portal Tunal,788,318,282,1388
29311,2020-10-09,(06111) Universidades,495,272,580,1347
29312,2020-06-13,(04108) El Polo,316,211,209,736
29313,2020-10-02,(07106) EL CAMPIN,507,344,387,1238
29314,2020-02-27,(07103) AV. CHILE,3768,2319,1889,7976
29315,2020-05-19,(07103) AV. CHILE,787,506,347,1640
29316,2020-09-23,(07113) SANTA ISABEL,425,273,355,1053
29317,2020-04-06,(03007) HUMEDAL CORDOBA,62,54,40,156
29318,2020-03-23,(09100) Calle 40 Sur,339,239,219,797
29319,2020-09-13,(09100) Calle 40 Sur,606,279,590,1475
29320,2020-08-13,(09121) Las Flores,613,363,390,1366
29321,2020-03-03,(02000) Cabecera Autopista Norte - intermunicipal,5114,3453,3079,11646
29322,2020-06-21,(09119) Calle 57,212,113,170,495
29323,2020-06-13,(05002) Tintal,1559,840,1040,3439
29324,2020-05-25,(10001) Country Sur,318,127,198,643
29325,2020-06-14,(02205) Calle 106,59,57,72,188
29326,2020-09-16,(08000) Portal Tunal,801,364,377,1542
29327,2020-02-14,(07101) CASTELLANA,901,598,610,2109
29328,2020-02-16,(03001) LA CAMPIÑA,1177,520,1103,2800
29329,2020-09-27,(09116) Avenida 39,75,74,155,304
29330,2020-02-21,(07109) CAD,2736,1714,1450,5900
29331,2020-04-22,(02000) Cabecera Autopista Norte,549,389,333,1271
29332,2020-09-05,(06100) Av. Rojas,152,118,172,442
29333,2020-08-08,(02302) Virrey,360,267,275,902
29334,2020-08-13,(02302) Virrey,603,438,315,1356
29335,2020-06-16,(07009) SENA,651,423,395,1469
29336,2020-06-06,(09122) Calle 72,759,508,501,1768
29337,2020-08-25,(12003) Ricaurte,398,261,171,830
29338,2020-07-26,(03010) PUENTE LARGO,70,43,59,172
29339,2020-08-30,(05100) Banderas P. Central,214,109,188,511
29340,2020-03-08,(06001) Modelia,282,164,337,783
29341,2020-04-14,(09109) Tercer Milenio,133,92,120,345
29342,2020-03-28,(09116) Avenida 39,95,102,78,275
29343,2020-05-24,(05102) Av. Américas - Av. Boyacá,62,21,30,113
29344,2020-08-12,(07103) AV. CHILE,701,432,374,1507
29345,2020-04-29,(05107) Américas - Cr.53,341,244,165,750
29346,2020-10-12,(03000) Portal Suba - alimentacion,2287,1081,2211,5579
29347,2020-08-14,(02103) Mazurén,161,97,145,403
29348,2020-06-06,(07103) AV. CHILE,570,376,337,1283
29349,2020-07-18,(07103) AV. CHILE,627,399,347,1373
29350,2020-03-12,(10005) Bicentenario,319,37,75,431
29351,2020-01-02,(40002) Manitas,588,355,454,1397
29352,2020-03-04,(40002) Manitas,1319,732,789,2840
29353,2020-01-07,(12002) CDS - Carrera 32,376,264,253,893
29354,2020-02-09,(09120) Calle 63,1221,735,1273,3229
29355,2020-06-08,(06108) Concejo de Bogotá,129,76,86,291
29356,2020-01-11,(03005) SUBA - AV. BOYACA,1083,600,869,2552
29357,2020-01-21,(07102) NQS - CALLE 75,1058,713,639,2410
29358,2020-06-01,(03002) SUBA - TV- 91,698,429,392,1519
29359,2020-08-07,(09120) Calle 63,446,310,306,1062
29360,2020-09-02,(03011) SUBA - CALLE 100,602,294,271,1167
29361,2020-10-08,(03011) SUBA - CALLE 100,632,313,400,1345
29362,2020-02-16,(02303) Calle 85,400,390,680,1470
29363,2020-01-25,(02000) Cabecera Autopista Norte - intermunicipal,1905,1111,1659,4675
29364,2020-08-26,(07110) PALOQUEMAO,663,365,259,1287
29365,2020-03-08,(07006) General Santander,634,294,619,1547
29366,2020-01-15,(14005) Las Aguas,1768,1122,1417,4307
29367,2020-10-11,(07201) Guatoque -Veraguas,39,32,103,174
29368,2020-07-30,(12004) Carrera 22,246,122,125,493
29369,2020-06-21,(09123) Calle 76,204,153,170,527
29370,2020-03-26,(02001) Centro Comercial Santa Fe,156,109,177,442
29371,2020-07-24,(03012) SUBA - CALLE 95,288,150,167,605
29372,2020-07-06,(09111) Calle 19,813,481,486,1780
29373,2020-09-16,(05103) Marsella,484,284,306,1074
29374,2020-07-23,(02202) Calle 127,974,660,447,2081
29375,2020-09-19,(06102) Salitre El Greco,201,117,164,482
29376,2020-09-07,(04105) Carrera 53,305,171,217,693
29377,2020-02-26,(07006) General Santander - alimentacion,1515,858,1001,3374
29378,2020-05-05,(07105) MOVISTAR ARENA,161,121,75,357
29379,2020-05-16,(07105) MOVISTAR ARENA,132,97,88,317
29380,2020-01-13,(09105) Río Fucha,605,364,440,1409
29381,2020-08-15,(14005) Las Aguas,146,103,178,427
29382,2020-06-01,(07107) U. NACIONAL,314,194,141,649
29383,2020-09-20,(07107) U. NACIONAL,110,69,138,317
29384,2020-10-11,(07107) U. NACIONAL,100,89,145,334
29385,2020-10-06,(07009) SENA,736,465,665,1866
29386,2020-06-22,(06111) Universidades,85,50,133,268
29387,2020-04-16,(10004) Policarpa,113,76,73,262
29388,2020-04-25,(07007) NQS - Calle 38A Sur,160,89,73,322
29389,2020-10-07,(14005) Las Aguas,296,187,345,828
29390,2020-06-16,(03007) HUMEDAL CORDOBA,165,130,68,363
29391,2020-08-10,(07109) CAD,579,350,272,1201
29392,2020-09-07,(14005) Las Aguas,230,149,217,596
29393,2020-04-14,(02102) Calle 161,96,63,65,224
29394,2020-08-24,(02102) Calle 161,195,107,132,434
29395,2020-07-08,(14001) La Sabana,167,110,107,384
29396,2020-07-17,(12004) Carrera 22,137,96,110,343
29397,2020-07-27,(09111) Calle 19,715,381,418,1514
29398,2020-05-05,(06001) Modelia,295,206,191,692
29399,2020-04-29,(10009) Museo Nacional,312,200,196,708
29400,2020-09-15,(03010) PUENTE LARGO,380,219,239,838
29401,2020-06-20,(09119) Calle 57,439,314,338,1091
29402,2020-05-03,(04106) Carrera 47,74,52,41,167
29403,2020-08-10,(06111) Universidades,326,193,295,814
29404,2020-06-05,(06002) Normandía,297,173,155,625
29405,2020-08-12,(07005) ALQUERIA,512,291,314,1117
29406,2020-04-07,(10009) Museo Nacional,323,207,197,727
29407,2020-03-25,(07001) PERDOMO,484,312,281,1077
29408,2020-05-06,(12002) CDS - Carrera 32,177,132,71,380
29409,2020-09-17,(12002) CDS - Carrera 32,212,127,92,431
29410,2020-01-01,(09109) Tercer Milenio,130,76,212,418
29411,2019-12-31,(05001) Patio Bonito,36,48,97,181
29412,2020-06-28,(07108) Av. El Dorado,36,29,39,104
29413,2020-06-13,(06002) Normandía,210,114,148,472
29414,2020-07-13,(06002) Normandía,264,166,139,569
29415,2020-09-19,(06002) Normandía,249,151,216,616
29416,2020-01-01,(14004) Museo del Oro,0,47,155,202
29417,2020-02-01,(09111) Calle 19,1363,923,1294,3580
29418,2020-03-29,(07000) Portal Sur,260,150,148,558
29419,2020-06-21,(05107) Américas - Cr.53,99,87,117,303
29420,2020-05-08,(06001) Modelia,309,222,153,684
29421,2020-10-06,(09108) Hospital,65,51,73,189
29422,2020-09-27,(07002) MADELENA,297,120,315,732
29423,2020-02-16,(14004) Museo del Oro,0,130,451,581
29424,2020-04-21,(04104) Avenida 68,351,213,205,769
29425,2020-04-06,(07108) Av. El Dorado,53,38,34,125
29426,2020-05-26,(10005) Bicentenario - alimentacion,216,114,140,470
29427,2020-08-09,(07109) CAD,142,116,91,349
29428,2020-06-30,(07006) General Santander - alimentacion,412,225,279,916
29429,2020-09-12,(02102) Calle 161,185,108,167,460
29430,2020-05-16,(05102) Av. Américas - Av. Boyacá,113,68,81,262
29431,2020-05-28,(07006) General Santander - alimentacion,315,173,187,675
29432,2020-04-30,(07003) SEVILLANA,280,163,150,593
29433,2020-05-01,(07006) General Santander,148,80,82,310
29434,2020-07-30,(10004) Policarpa,230,90,157,477
29435,2020-08-08,(09109) Tercer Milenio,283,168,195,646
29436,2020-05-03,(06000) Portal Eldorado,189,159,122,470
29437,2020-03-20,(10009) Museo Nacional,437,309,229,975
29438,2020-09-02,(10003) Ciudad Jardín,213,96,138,447
29439,2020-06-11,(09105) Río Fucha,125,60,77,262
29440,2020-08-24,(04000) Cabecera Calle 80 - intermunicipal,315,149,292,756
29441,2020-06-07,(04100) Carrera 77,336,153,279,768
29442,2020-02-16,(08002) Biblioteca,229,106,249,584
29443,2020-01-01,(10003) Ciudad Jardín,103,32,113,248
29444,2020-06-15,(06102) Salitre El Greco,88,54,52,194
29445,2020-03-29,(04106) Carrera 47,71,33,37,141
29446,2020-08-20,(09116) Avenida 39,308,185,204,697
29447,2020-08-09,(05107) Américas - Cr.53,71,72,97,240
29448,2020-03-28,(12004) Carrera 22,24,21,35,80
29449,2020-04-23,(09114) Calle 26,162,140,114,416
29450,2020-07-26,(10008) San Diego,67,42,46,155
29451,2020-05-13,(04000) Cabecera Calle 80 - intermunicipal,225,124,192,541
29452,2020-08-06,(09003) Socorro,573,317,337,1227
29453,2020-09-27,(04102) Avenida Boyaca,177,101,140,418
29454,2020-06-11,(06106) Recinto Ferial,227,135,117,479
29455,2020-04-01,(10003) Ciudad Jardín,78,69,47,194
29456,2020-01-02,(14001) La Sabana,119,100,179,398
29457,2020-03-30,(05101) Mandalay - Cr.73,51,24,23,98
29458,2020-04-12,(05101) Mandalay - Cr.73,17,9,10,36
29459,2020-08-30,(02201) Prado,265,185,252,702
29460,2020-08-16,(10007) Las Nieves,86,64,102,252
29461,2020-04-11,(04003) Avenida Ciudad de Cali,293,193,179,665
29462,2020-08-02,(09109) Tercer Milenio,89,57,75,221
29463,2020-08-02,(07104) Simon Bolivar,71,52,84,207
29464,2020-03-29,(14005) Las Aguas,0,11,20,31
29465,2020-04-24,(10005) Bicentenario,57,31,38,126
29466,2020-05-04,(50002) Corral Calle 40 Sur,10,9,13,32
29467,2020-08-12,(03014) SAN MARTIN,0,15,32,47
29468,2020-08-23,(07101) CASTELLANA,24,19,29,72
29469,2020-05-05,(03004) GRATAMIRA,24,18,6,48
29470,2020-06-24,(50006) Corral Carrera 77,10,3,7,20
29471,2020-03-12,(50006) Corral Carrera 77,0,5,4,9
29472,2020-03-27,(03004) GRATAMIRA,18,12,11,41
29473,2019-12-31,(07200) Tygua-San José,5,4,11,20
29474,2020-03-05,(09002) Consuelo,1413,777,817,3007
29475,2020-07-12,(09118) Marly,519,341,361,1221
29476,2020-07-13,(09118) Marly,1269,816,568,2653
29477,2020-07-19,(09118) Marly,442,272,300,1014
29478,2020-09-22,(05000) Portal Américas - alimentacion,11900,6366,7074,25340
29479,2020-01-19,(07111) NQS - RICAURTE,499,421,655,1575
29480,2020-02-24,(08000) Portal Tunal - alimentacion,24565,13843,11835,50243
29481,2020-03-04,(07505) LEON XIII,8515,4796,3821,17132
29482,2020-09-09,(07503) SAN MATEO,12684,6951,6480,26115
29483,2020-06-22,(09000) Cabecera Usme - alimentacion,2794,1437,1673,5904
29484,2020-07-14,(07503) SAN MATEO,10152,5928,4528,20608
29485,2020-03-10,(05000) Portal Américas,326,4173,3098,7597
29486,2020-01-02,(07112) COMUNEROS,1510,883,1179,3572
29487,2020-02-06,(02201) Prado,5928,3806,3046,12780
29488,2020-08-27,(05100) Banderas P. Central,812,484,510,1806
29489,2020-02-17,(02102) Calle 161,1912,1256,1111,4279
29490,2020-05-13,(09115) Calle 34,503,374,288,1165
29491,2020-01-02,(07000) Portal Sur - alimentacion,13740,7327,8100,29167
29492,2020-03-05,(10003) Ciudad Jardín,1001,578,710,2289
29493,2020-03-09,(10003) Ciudad Jardín,57,236,170,463
29494,2020-03-18,(08000) Portal Tunal - alimentacion,15029,7722,6932,29683
29495,2020-09-05,(05100) Banderas P. Central,688,347,573,1608
29496,2020-10-09,(10005) Bicentenario - alimentacion,234,102,251,587
29497,2020-08-27,(09000) Cabecera Usme - alimentacion,8389,4318,4901,17608
29498,2020-09-24,(09104) Restrepo,1791,981,1379,4151
29499,2020-03-23,(07504) TERREROS,1212,624,698,2534
29500,2020-02-17,(04104) Avenida 68,3823,2005,1776,7604
29501,2020-03-14,(03005) SUBA - AV. BOYACA,1263,685,1009,2957
29502,2020-06-08,(09000) Cabecera Usme,1619,1052,1127,3798
29503,2020-01-31,(07102) NQS - CALLE 75,1429,949,900,3278
29504,2020-07-06,(09000) Cabecera Usme - alimentacion,9091,5029,5339,19459
29505,2020-05-06,(09110) Avenida Jimenez,543,438,442,1423
29506,2020-06-29,(09103) Olaya,394,196,243,833
29507,2020-10-07,(07111) NQS - RICAURTE,1238,764,663,2665
29508,2020-08-20,(02000) Cabecera Autopista Norte,1182,733,719,2634
29509,2020-01-22,(07107) U. NACIONAL,2401,1512,1356,5269
29510,2020-02-20,(07107) U. NACIONAL,2104,1312,1198,4614
29511,2020-09-29,(09113) Calle 22,408,255,402,1065
29512,2020-08-28,(09004) Santa Lucía,2642,1342,1481,5465
29513,2020-02-06,(07007) NQS - Calle 38A Sur,2115,1244,1204,4563
29514,2020-02-10,(50003) Corral Molinos,3624,2265,3423,9312
29515,2020-03-05,(06106) Recinto Ferial,1605,895,844,3344
29516,2020-03-19,(04002) Carrera 90,1705,930,930,3565
29517,2020-09-18,(10006) San Victorino,822,429,452,1703
29518,2020-08-21,(40003) Mirador del Paraiso,1572,1021,958,3551
29519,2020-06-27,(04000) Cabecera Calle 80,853,466,759,2078
29520,2020-03-14,(12001) Carrera 43,763,464,649,1876
29521,2020-03-01,(07106) EL CAMPIN,435,286,472,1193
29522,2020-05-28,(03000) Portal Suba,1041,637,682,2360
29523,2020-08-11,(03000) Portal Suba,1025,646,769,2440
29524,2020-07-17,(02000) Cabecera Autopista Norte - intermunicipal,479,307,346,1132
29525,2020-06-30,(09101) Quiroga,547,311,428,1286
29526,2020-03-03,(10002) Av. Primero de Mayo,8424,4333,4628,17385
29527,2020-01-10,(06111) Universidades,1799,1135,1626,4560
29528,2020-01-15,(10000) Portal 20 de Julio,7764,3478,3716,14958
29529,2020-01-26,(04002) Carrera 90,714,311,725,1750
29530,2020-04-08,(09004) Santa Lucía,1113,582,642,2337
29531,2020-05-09,(04100) Carrera 77,596,330,399,1325
29532,2020-06-17,(06108) Concejo de Bogotá,131,75,84,290
29533,2020-07-08,(04000) Cabecera Calle 80,1198,722,827,2747
29534,2020-08-22,(04000) Cabecera Calle 80,739,428,707,1874
29535,2020-02-02,(10001) Country Sur,935,374,1133,2442
29536,2020-06-15,(02000) Cabecera Autopista Norte - alimentacion,1887,1009,1148,4044
29537,2020-03-03,(02304) Heroes,4761,3332,2299,10392
29538,2020-09-20,(09114) Calle 26,67,52,128,247
29539,2020-08-07,(05103) Marsella,136,76,85,297
29540,2020-09-13,(05103) Marsella,145,75,148,368
29541,2020-02-17,(10009) Museo Nacional,4824,2470,1929,9223
29542,2020-09-14,(03012) SUBA - CALLE 95,349,205,228,782
29543,2020-07-03,(09119) Calle 57,668,417,440,1525
29544,2020-08-08,(50002) Corral Calle 40 Sur,11,7,18,36
29545,2020-02-24,(05105) Pradera,2649,1467,1277,5393
29546,2020-05-12,(09104) Restrepo,1159,698,798,2655
29547,2020-05-24,(09104) Restrepo,342,241,267,850
29548,2020-03-03,(03012) SUBA - CALLE 95,1440,957,989,3386
29549,2020-10-10,(05005) Transversal 86,338,141,323,802
29550,2020-05-23,(05105) Pradera,359,238,140,737
29551,2020-06-08,(07007) NQS - Calle 38A Sur,342,219,209,770
29552,2020-01-29,(09121) Las Flores,3149,1925,1929,7003
29553,2020-08-12,(08000) Portal Tunal,781,278,297,1356
29554,2020-07-24,(03009) Av. Suba- Calle 116,466,311,226,1003
29555,2020-01-14,(12007) Zona Industrial,1117,703,594,2414
29556,2020-01-07,(07101) CASTELLANA,637,410,419,1466
29557,2020-05-31,(06000) Portal Eldorado - alimentacion,1181,533,655,2369
29558,2020-06-18,(07106) EL CAMPIN,384,247,193,824
29559,2020-10-01,(03001) LA CAMPIÑA,1469,794,1038,3301
29560,2020-02-08,(07000) Portal Sur,4838,2395,3553,10786
29561,2020-05-23,(02000) Cabecera Autopista Norte - alimentacion,3272,1756,1628,6656
29562,2020-02-10,(06105) Quinta Paredes,1066,670,522,2258
29563,2020-04-27,(02000) Cabecera Autopista Norte - alimentacion,1702,431,311,2444
29564,2020-06-07,(10010) San Bernardo,232,116,210,558
29565,2020-03-24,(07110) PALOQUEMAO,538,418,335,1291
29566,2020-05-24,(09100) Calle 40 Sur,412,224,278,914
29567,2020-09-10,(09100) Calle 40 Sur,1801,975,1205,3981
29568,2020-08-08,(04003) Avenida Ciudad de Cali,559,317,488,1364
29569,2020-05-11,(04108) El Polo,358,234,183,775
29570,2020-09-29,(09117) Calle 45,775,498,559,1832
29571,2020-01-19,(03001) LA CAMPIÑA,1085,462,1137,2684
29572,2020-02-08,(14005) Las Aguas,1113,723,1266,3102
29573,2020-10-03,(09110) Avenida Jimenez,1351,1007,993,3351
29574,2020-04-17,(03011) SUBA - CALLE 100,273,166,124,563
29575,2020-09-18,(04001) Quirigua,482,291,382,1155
29576,2020-05-17,(02205) Calle 106,62,51,47,160
29577,2020-06-05,(03001) LA CAMPIÑA,1035,588,555,2178
29578,2020-06-12,(03001) LA CAMPIÑA,1137,581,622,2340
29579,2020-09-02,(07109) CAD,659,417,361,1437
29580,2020-01-07,(04101) Minuto de Dios,1471,909,1225,3605
29581,2020-02-02,(06100) Av. Rojas,213,147,338,698
29582,2020-01-01,(02302) Virrey,195,158,345,698
29583,2020-10-12,(02302) Virrey,182,134,202,518
29584,2020-04-29,(10010) San Bernardo,453,241,293,987
29585,2020-05-02,(10010) San Bernardo,322,158,214,694
29586,2020-07-27,(10010) San Bernardo,566,325,394,1285
29587,2020-08-24,(10010) San Bernardo,527,251,338,1116
29588,2020-07-18,(05100) Banderas P. Central,434,218,345,997
29589,2020-04-13,(03009) Av. Suba- Calle 116,342,235,167,744
29590,2020-02-14,(07003) SEVILLANA,2134,1148,1194,4476
29591,2020-09-05,(06103) CAN,225,148,200,573
29592,2020-06-18,(05002) Tintal,2525,1462,1373,5360
29593,2020-07-29,(09109) Tercer Milenio,340,189,211,740
29594,2020-09-27,(03013) RIO NEGRO,89,56,134,279
29595,2020-02-10,(09113) Calle 22,1658,901,1076,3635
29596,2020-05-30,(02502) Terminal,205,149,234,588
29597,2020-05-14,(07103) AV. CHILE,714,468,317,1499
29598,2020-10-03,(12007) Zona Industrial,278,200,202,680
29599,2020-02-26,(07105) MOVISTAR ARENA,1416,855,718,2989
29600,2020-02-27,(07105) MOVISTAR ARENA,1369,869,743,2981
29601,2020-03-19,(06109) Centro Memoria,599,376,309,1284
29602,2020-08-27,(02001) Centro Comercial Santa Fe,486,319,337,1142
29603,2020-09-10,(02001) Centro Comercial Santa Fe,488,286,355,1129
29604,2020-07-26,(05100) Banderas P. Central - alimentacion,645,272,368,1285
29605,2020-04-11,(02300) Calle 100,491,350,240,1081
29606,2020-01-22,(02102) Calle 161,1756,1058,1053,3867
29607,2020-04-01,(06103) CAN,316,264,164,744
29608,2020-09-13,(02200) Alcalá,589,371,520,1480
29609,2020-07-25,(09003) Socorro,407,181,208,796
29610,2020-08-19,(06111) Universidades,302,170,280,752
29611,2020-01-04,(12007) Zona Industrial,328,258,292,878
29612,2020-07-14,(07111) NQS - RICAURTE,788,526,333,1647
29613,2020-10-08,(07201) Guatoque -Veraguas,241,138,212,591
29614,2020-08-06,(40002) Manitas,371,234,235,840
29615,2020-07-08,(02105) Calle 142,848,548,574,1970
29616,2020-04-23,(12004) Carrera 22,82,58,81,221
29617,2020-10-12,(07200) Tygua-San José,80,46,119,245
29618,2020-08-23,(09123) Calle 76,189,151,196,536
29619,2020-05-10,(10006) San Victorino,65,46,68,179
29620,2020-04-08,(07004) VENECIA,475,272,254,1001
29621,2020-09-05,(09111) Calle 19,646,432,511,1589
29622,2020-03-22,(09123) Calle 76,189,144,124,457
29623,2020-03-20,(10000) Portal 20 de Julio,1050,586,498,2134
29624,2020-08-20,(06104) Gobernación,237,145,93,475
29625,2020-08-04,(07105) MOVISTAR ARENA,191,112,116,419
29626,2020-05-22,(06109) Centro Memoria,258,147,106,511
29627,2020-06-20,(04003) Avenida Ciudad de Cali,818,456,610,1884
29628,2020-06-24,(09121) Las Flores,788,501,392,1681
29629,2020-07-12,(02204) Pepe Sierra,225,173,181,579
29630,2020-04-24,(09119) Calle 57,282,186,183,651
29631,2020-05-04,(09119) Calle 57,314,231,166,711
29632,2020-03-24,(09119) Calle 57,470,340,395,1205
29633,2020-03-25,(09119) Calle 57,255,193,174,622
29634,2020-06-19,(02502) Terminal,447,299,360,1106
29635,2020-08-04,(40001) Juan Pablo II,514,307,336,1157
29636,2020-07-31,(40002) Manitas,379,232,245,856
29637,2020-04-28,(10007) Las Nieves,259,174,185,618
29638,2020-05-06,(10007) Las Nieves,339,204,201,744
29639,2020-09-27,(12003) Ricaurte,50,59,75,184
29640,2020-09-18,(09114) Calle 26,362,233,319,914
29641,2020-07-15,(12000) Puente Aranda,90,53,48,191
29642,2020-06-29,(07109) CAD,187,123,127,437
29643,2020-07-21,(12004) Carrera 22,116,80,84,280
29644,2020-04-23,(09111) Calle 19,318,202,295,815
29645,2020-05-23,(04107) Escuela Militar,87,67,61,215
29646,2020-06-02,(06106) Recinto Ferial,241,141,110,492
29647,2020-05-10,(07102) NQS - CALLE 75,45,34,41,120
29648,2020-03-21,(10004) Policarpa,83,43,43,169
29649,2020-05-01,(07008) NQS - Calle 30 Sur,96,39,52,187
29650,2020-03-16,(07200) Tygua-San José,566,373,390,1329
29651,2020-05-01,(07010) Bosa,177,106,134,417
29652,2020-06-27,(07006) General Santander,435,238,247,920
29653,2020-04-01,(03002) SUBA - TV- 91,405,239,220,864
29654,2020-08-02,(09113) Calle 22,216,115,187,518
29655,2020-06-11,(04102) Avenida Boyaca,316,190,194,700
29656,2020-07-29,(07108) Av. El Dorado,135,77,76,288
29657,2020-03-20,(04002) Carrera 90,330,209,122,661
29658,2020-07-15,(06002) Normandía,274,166,147,587
29659,2020-07-30,(06002) Normandía,262,173,148,583
29660,2020-05-22,(04000) Cabecera Calle 80 - intermunicipal,239,127,220,586
29661,2020-03-07,(06105) Quinta Paredes,425,247,400,1072
29662,2020-05-19,(04104) Avenida 68,504,288,257,1049
29663,2020-06-25,(07006) General Santander,589,369,338,1296
29664,2020-04-25,(04104) Avenida 68,274,183,150,607
29665,2020-04-28,(09003) Socorro,352,166,174,692
29666,2020-06-12,(04003) Avenida Ciudad de Cali,996,596,671,2263
29667,2020-08-24,(07005) ALQUERIA,465,272,294,1031
29668,2020-05-21,(09113) Calle 22,376,212,301,889
29669,2020-06-22,(07005) ALQUERIA,203,113,129,445
29670,2020-08-30,(04104) Avenida 68,199,98,177,474
29671,2020-05-04,(03010) PUENTE LARGO,233,170,144,547
29672,2020-06-29,(06101) El Tiempo,117,94,80,291
29673,2020-08-11,(04103) Las Ferias,279,134,140,553
29674,2020-04-30,(04001) Quirigua,221,145,109,475
29675,2020-08-18,(04001) Quirigua,347,206,241,794
29676,2020-05-03,(09113) Calle 22,163,90,139,392
29677,2020-04-06,(07105) MOVISTAR ARENA,149,114,88,351
29678,2020-04-09,(12007) Zona Industrial,39,27,31,97
29679,2019-12-31,(09106) Nariño,27,17,27,71
29680,2020-07-17,(10003) Ciudad Jardín,147,79,115,341
29681,2020-05-05,(06104) Gobernación,154,109,83,346
29682,2020-09-24,(10003) Ciudad Jardín,249,108,189,546
29683,2020-08-07,(06104) Gobernación,68,54,49,171
29684,2020-03-29,(12004) Carrera 22,13,9,20,42
29685,2020-03-09,(03014) SAN MARTIN,97,38,30,165
29686,2020-06-24,(06103) CAN,383,242,140,765
29687,2020-07-30,(14005) Las Aguas,174,120,190,484
29688,2020-07-11,(09114) Calle 26,172,117,188,477
29689,2020-05-02,(06107) Ciudad Universitaria,69,52,64,185
29690,2020-04-23,(06106) Recinto Ferial,164,104,77,345
29691,2020-06-14,(06101) El Tiempo,113,79,75,267
29692,2020-06-14,(04105) Carrera 53,65,41,62,168
29693,2020-07-22,(07101) CASTELLANA,198,112,104,414
29694,2020-10-04,(09108) Hospital,25,23,54,102
29695,2020-06-14,(06106) Recinto Ferial,66,41,52,159
29696,2020-04-09,(07200) Tygua-San José,24,19,26,69
29697,2020-06-07,(04103) Las Ferias,101,64,77,242
29698,2020-05-10,(10007) Las Nieves,55,32,49,136
29699,2020-08-02,(03003) 21 ANGELES,58,22,58,138
29700,2020-09-13,(04108) El Polo,123,64,127,314
29701,2020-04-05,(10004) Policarpa,62,38,37,137
29702,2020-04-19,(07006) General Santander,84,60,48,192
29703,2020-04-26,(10005) Bicentenario - alimentacion,38,26,43,107
29704,2020-07-17,(50006) Corral Carrera 77,3,0,7,10
29705,2020-08-29,(50006) Corral Carrera 77,2,3,3,8
29706,2020-04-20,(07504) TERREROS,2561,1572,1257,5390
29707,2020-08-28,(07504) TERREROS,6174,3341,3000,12515
29708,2020-06-19,(10000) Portal 20 de Julio - alimentacion,4532,2112,2617,9261
29709,2020-01-23,(03000) Portal Suba - alimentacion,25674,14525,14995,55194
29710,2020-05-04,(05000) Portal Américas - alimentacion,7722,3906,3403,15031
29711,2020-02-28,(03002) SUBA - TV- 91,4792,2536,2538,9866
29712,2020-03-10,(02200) Alcalá,2215,3092,1948,7255
29713,2020-03-14,(09003) Socorro,1148,514,787,2449
29714,2020-03-06,(10000) Portal 20 de Julio - alimentacion,10474,5469,8017,23960
29715,2020-01-05,(04000) Cabecera Calle 80 - alimentacion,3678,1498,3502,8678
29716,2020-09-26,(06107) Ciudad Universitaria,135,94,163,392
29717,2020-08-27,(09001) Molinos,2484,1275,1638,5397
29718,2020-03-23,(05000) Portal Américas,600,401,431,1432
29719,2020-10-01,(10000) Portal 20 de Julio - alimentacion,4756,1989,3262,10007
29720,2020-01-14,(09104) Restrepo,4526,2706,3609,10841
29721,2020-09-18,(05100) Banderas P. Central,1112,612,870,2594
29722,2020-03-02,(10001) Country Sur,5103,2361,2775,10239
29723,2020-01-13,(02102) Calle 161,1477,909,985,3371
29724,2020-10-10,(09000) Cabecera Usme,1464,745,1526,3735
29725,2020-01-30,(02105) Calle 142,6914,4209,3876,14999
29726,2020-10-08,(07001) PERDOMO,1172,643,947,2762
29727,2020-02-04,(40003) Mirador del Paraiso,4938,2846,2720,10504
29728,2020-08-05,(40003) Mirador del Paraiso,1596,992,995,3583
29729,2020-03-17,(09104) Restrepo,3432,2147,2591,8170
29730,2020-02-27,(04100) Carrera 77,7001,4156,3976,15133
29731,2020-01-20,(07505) LEON XIII,7649,4302,3793,15744
29732,2020-01-03,(04104) Avenida 68,1545,828,1044,3417
29733,2020-06-06,(05002) Tintal,1386,722,864,2972
29734,2020-02-03,(09123) Calle 76,5448,3657,3067,12172
29735,2020-09-07,(10000) Portal 20 de Julio - alimentacion,4164,1876,2683,8723
29736,2020-05-22,(09101) Quiroga,418,239,281,938
29737,2020-01-22,(09116) Avenida 39,2397,1596,1465,5458
29738,2020-02-15,(02103) Mazurén,1112,491,1098,2701
29739,2020-07-31,(05100) Banderas P. Central - alimentacion,2514,1296,1428,5238
29740,2020-02-18,(02000) Cabecera Autopista Norte - alimentacion,24260,14611,13983,52854
29741,2020-09-30,(02000) Cabecera Autopista Norte,1690,1063,1254,4007
29742,2020-09-26,(04102) Avenida Boyaca,345,204,311,860
29743,2020-07-06,(09113) Calle 22,435,250,372,1057
29744,2020-02-10,(03003) 21 ANGELES,1761,971,891,3623
29745,2020-01-03,(02201) Prado,2359,1405,1575,5339
29746,2020-05-06,(50003) Corral Molinos,903,455,637,1995
29747,2020-05-14,(05000) Portal Américas,1769,1267,1385,4421
29748,2020-06-23,(05000) Portal Américas,2625,1955,2051,6631
29749,2020-07-24,(05000) Portal Américas,1858,1388,1465,4711
29750,2020-10-11,(04000) Cabecera Calle 80,380,193,526,1099
29751,2020-09-12,(07010) Bosa,0,279,744,1023
29752,2020-01-09,(05100) Banderas P. Central - alimentacion,10268,5562,6136,21966
29753,2020-03-24,(09114) Calle 26,395,320,325,1040
29754,2020-09-21,(10001) Country Sur,1111,378,649,2138
29755,2020-02-08,(05002) Tintal,7122,3390,4596,15108
29756,2020-03-17,(12001) Carrera 43,1139,670,670,2479
29757,2020-04-30,(12001) Carrera 43,287,180,188,655
29758,2020-06-02,(12001) Carrera 43,368,221,205,794
29759,2020-06-04,(12001) Carrera 43,368,208,183,759
29760,2020-06-01,(09107) Hortúa,575,359,310,1244
29761,2020-03-03,(02105) Calle 142,7157,4436,3919,15512
29762,2020-01-03,(09119) Calle 57,1280,913,1019,3212
29763,2020-03-14,(03000) Portal Suba,3933,1929,3112,8974
29764,2020-02-07,(02300) Calle 100,6984,4598,4088,15670
29765,2020-07-06,(09116) Avenida 39,394,243,233,870
29766,2020-09-22,(09116) Avenida 39,465,292,351,1108
29767,2020-01-25,(03000) Portal Suba,4076,1910,3377,9363
29768,2020-03-06,(05102) Av. Américas - Av. Boyacá,1872,1062,1011,3945
29769,2020-06-12,(02101) Toberín,1431,889,853,3173
29770,2020-02-14,(06103) CAN,2625,1538,1253,5416
29771,2020-06-18,(02201) Prado,934,630,530,2094
29772,2020-02-02,(09107) Hortúa,594,339,633,1566
29773,2020-03-08,(03011) SUBA - CALLE 100,409,268,492,1169
29774,2020-04-16,(02300) Calle 100,782,566,413,1761
29775,2020-05-15,(02300) Calle 100,1052,682,535,2269
29776,2020-08-17,(02300) Calle 100,250,225,232,707
29777,2020-06-06,(03012) SUBA - CALLE 95,209,153,142,504
29778,2020-05-24,(10000) Portal 20 de Julio,616,287,315,1218
29779,2020-07-22,(09119) Calle 57,431,288,267,986
29780,2020-09-29,(50002) Corral Calle 40 Sur,27,25,43,95
29781,2020-02-23,(08000) Portal Tunal,527,358,368,1253
29782,2020-05-27,(08000) Portal Tunal,690,298,237,1225
29783,2020-05-31,(09104) Restrepo,383,239,312,934
29784,2020-02-01,(02202) Calle 127,2920,1820,2085,6825
29785,2020-04-22,(02202) Calle 127,686,487,363,1536
29786,2020-05-28,(02202) Calle 127,982,676,470,2128
29787,2020-01-03,(08000) Portal Tunal,1124,693,744,2561
29788,2020-03-02,(06109) Centro Memoria,1149,628,602,2379
29789,2020-04-30,(08000) Portal Tunal,502,217,173,892
29790,2020-02-05,(03006) NIZA - CALLE 127,2492,1579,1585,5656
29791,2020-08-11,(09101) Quiroga,535,273,370,1178
29792,2020-02-28,(04108) El Polo,1906,1203,1223,4332
29793,2020-08-03,(07201) Guatoque -Veraguas,159,91,124,374
29794,2020-01-03,(07103) AV. CHILE,1643,992,1133,3768
29795,2020-07-03,(07113) SANTA ISABEL,414,249,323,986
29796,2020-02-28,(03007) HUMEDAL CORDOBA,1038,608,486,2132
29797,2020-07-05,(03007) HUMEDAL CORDOBA,40,41,31,112
29798,2020-01-29,(03011) SUBA - CALLE 100,2587,1343,1440,5370
29799,2020-09-19,(07102) NQS - CALLE 75,314,253,315,882
29800,2020-03-21,(09100) Calle 40 Sur,470,313,325,1108
29801,2020-05-30,(09100) Calle 40 Sur,1151,688,680,2519
29802,2020-05-26,(07104) Simon Bolivar,570,353,259,1182
29803,2020-05-27,(10005) Bicentenario - alimentacion,219,103,171,493
29804,2020-08-26,(04107) Escuela Militar,133,68,86,287
29805,2020-09-08,(09121) Las Flores,754,470,489,1713
29806,2020-08-12,(04100) Carrera 77,1047,558,732,2337
29807,2020-05-05,(05103) Marsella,232,131,119,482
29808,2020-09-26,(07000) Portal Sur,1737,897,1525,4159
29809,2020-07-04,(09117) Calle 45,561,334,412,1307
29810,2020-09-04,(09117) Calle 45,708,452,575,1735
29811,2020-04-05,(04104) Avenida 68,84,75,64,223
29812,2020-02-02,(09113) Calle 22,689,337,640,1666
29813,2020-10-06,(06104) Gobernación,310,211,201,722
29814,2020-03-01,(02205) Calle 106,198,185,421,804
29815,2020-09-14,(02304) Heroes,891,581,530,2002
29816,2020-08-04,(08000) Portal Tunal,722,295,261,1278
29817,2020-06-02,(07113) SANTA ISABEL,363,228,222,813
29818,2020-08-08,(04108) El Polo,197,115,161,473
29819,2020-05-20,(02105) Calle 142,636,406,365,1407
29820,2020-04-21,(02105) Calle 142,458,271,225,954
29821,2020-01-30,(12003) Ricaurte,1222,801,613,2636
29822,2020-03-09,(12003) Ricaurte,754,34,161,949
29823,2020-05-21,(12003) Ricaurte,288,218,134,640
29824,2020-06-24,(03010) PUENTE LARGO,374,250,222,846
29825,2020-03-25,(03010) PUENTE LARGO,207,181,114,502
29826,2020-06-04,(10010) San Bernardo,591,292,363,1246
29827,2020-05-16,(05100) Banderas P. Central,330,167,245,742
29828,2020-08-24,(04106) Carrera 47,297,156,161,614
29829,2020-03-20,(07106) EL CAMPIN,134,119,76,329
29830,2020-01-04,(02502) Terminal,785,451,817,2053
29831,2020-08-18,(07103) AV. CHILE,882,534,447,1863
29832,2020-02-23,(10010) San Bernardo,390,268,545,1203
29833,2020-04-30,(06102) Salitre El Greco,142,83,102,327
29834,2020-03-28,(10005) Bicentenario,33,20,25,78
29835,2020-09-17,(10005) Bicentenario,112,65,93,270
29836,2020-03-20,(02300) Calle 100,722,562,374,1658
29837,2020-08-08,(10006) San Victorino,491,257,263,1011
29838,2020-07-14,(09004) Santa Lucía,1590,900,851,3341
29839,2020-10-04,(40001) Juan Pablo II,207,89,201,497
29840,2020-06-05,(05100) Banderas P. Central,508,292,423,1223
29841,2020-07-24,(05002) Tintal,1796,1040,1001,3837
29842,2020-03-09,(14001) La Sabana,361,42,83,486
29843,2020-08-26,(02304) Heroes,734,477,431,1642
29844,2020-08-06,(09120) Calle 63,1009,667,616,2292
29845,2020-06-13,(02200) Alcalá,1416,939,809,3164
29846,2020-06-27,(09003) Socorro,565,264,340,1169
29847,2020-07-16,(09003) Socorro,427,216,254,897
29848,2020-07-07,(40001) Juan Pablo II,579,333,367,1279
29849,2020-07-13,(07111) NQS - RICAURTE,791,532,330,1653
29850,2020-06-04,(07000) Portal Sur,1633,1027,920,3580
29851,2020-04-30,(05105) Pradera,467,299,166,932
29852,2020-03-31,(07000) Portal Sur,875,457,489,1821
29853,2020-09-13,(06000) Portal Eldorado - alimentacion,1421,638,1138,3197
29854,2020-03-17,(07101) CASTELLANA,548,369,393,1310
29855,2020-06-13,(07005) ALQUERIA,486,239,279,1004
29856,2020-06-27,(02502) Terminal,260,186,277,723
29857,2020-07-07,(09122) Calle 72,1238,817,809,2864
29858,2020-02-15,(12002) CDS - Carrera 32,296,209,248,753
29859,2020-06-09,(06104) Gobernación,252,155,98,505
29860,2020-08-19,(50003) Corral Molinos,1366,775,1090,3231
29861,2020-02-20,(50002) Corral Calle 40 Sur,126,87,164,377
29862,2020-06-28,(09114) Calle 26,60,55,76,191
29863,2020-01-27,(09105) Río Fucha,754,434,494,1682
29864,2020-03-12,(02502) Terminal,433,1041,782,2256
29865,2020-10-12,(08000) Portal Tunal,260,169,168,597
29866,2020-08-16,(07110) PALOQUEMAO,154,119,98,371
29867,2020-08-06,(50003) Corral Molinos,1434,704,954,3092
29868,2020-10-09,(03011) SUBA - CALLE 100,638,309,449,1396
29869,2020-06-16,(02200) Alcalá,1858,1365,985,4208
29870,2020-01-06,(05005) Transversal 86,351,144,274,769
29871,2020-07-14,(03010) PUENTE LARGO,305,189,170,664
29872,2020-02-16,(07006) General Santander - alimentacion,260,155,371,786
29873,2020-04-12,(07103) AV. CHILE,142,94,70,306
29874,2020-05-14,(07107) U. NACIONAL,262,161,133,556
29875,2020-06-02,(06001) Modelia,385,250,156,791
29876,2020-08-01,(10009) Museo Nacional,209,153,183,545
29877,2020-05-08,(05100) Banderas P. Central,476,267,280,1023
29878,2020-06-05,(02502) Terminal,407,258,309,974
29879,2020-04-02,(14001) La Sabana,66,58,50,174
29880,2020-06-06,(07004) VENECIA,682,377,385,1444
29881,2020-04-29,(12002) CDS - Carrera 32,190,136,46,372
29882,2020-05-01,(02502) Terminal,82,52,80,214
29883,2020-08-20,(09122) Calle 72,1119,735,678,2532
29884,2020-06-17,(07008) NQS - Calle 30 Sur,313,169,161,643
29885,2020-06-06,(02105) Calle 142,521,336,284,1141
29886,2020-07-07,(04000) Cabecera Calle 80 - intermunicipal,334,203,310,847
29887,2020-07-01,(09108) Hospital,77,42,64,183
29888,2020-04-13,(02300) Calle 100,779,574,411,1764
29889,2020-07-28,(06104) Gobernación,237,142,94,473
29890,2020-03-14,(06107) Ciudad Universitaria,560,387,602,1549
29891,2020-06-11,(14004) Museo del Oro,0,121,280,401
29892,2020-04-24,(07010) Bosa,343,200,198,741
29893,2020-06-14,(09003) Socorro,189,99,135,423
29894,2020-05-31,(02502) Terminal,67,54,96,217
29895,2020-04-04,(04103) Las Ferias,141,106,77,324
29896,2020-03-18,(07101) CASTELLANA,467,331,344,1142
29897,2020-04-20,(09101) Quiroga,286,148,199,633
29898,2020-08-05,(06105) Quinta Paredes,126,90,73,289
29899,2020-06-12,(10007) Las Nieves,604,358,384,1346
29900,2020-06-17,(04106) Carrera 47,342,200,176,718
29901,2020-04-14,(14004) Museo del Oro,0,58,110,168
29902,2020-06-03,(09111) Calle 19,711,418,409,1538
29903,2020-04-26,(10004) Policarpa,65,33,45,143
29904,2020-08-22,(09108) Hospital,61,28,53,142
29905,2020-01-01,(02205) Calle 106,109,85,188,382
29906,2020-05-02,(09117) Calle 45,363,229,179,771
29907,2020-04-28,(03010) PUENTE LARGO,216,163,121,500
29908,2020-06-29,(07005) ALQUERIA,201,101,169,471
29909,2020-06-20,(09108) Hospital,70,35,44,149
29910,2020-01-07,(03004) GRATAMIRA,141,90,93,324
29911,2020-09-10,(03004) GRATAMIRA,0,18,22,40
29912,2020-09-10,(14005) Las Aguas,206,119,210,535
29913,2020-07-13,(07007) NQS - Calle 38A Sur,375,231,199,805
29914,2020-08-05,(04101) Minuto de Dios,264,144,208,616
29915,2020-09-13,(03011) SUBA - CALLE 100,160,114,145,419
29916,2020-05-05,(03002) SUBA - TV- 91,491,296,306,1093
29917,2020-08-16,(06104) Gobernación,42,29,33,104
29918,2020-08-04,(05101) Mandalay - Cr.73,110,55,75,240
29919,2020-06-30,(14005) Las Aguas,182,116,231,529
29920,2020-07-20,(02205) Calle 106,77,58,61,196
29921,2020-04-28,(06104) Gobernación,164,119,80,363
29922,2020-05-01,(07107) U. NACIONAL,122,73,52,247
29923,2020-03-28,(02103) Mazurén,61,41,50,152
29924,2020-06-21,(04102) Avenida Boyaca,142,79,99,320
29925,2020-03-21,(07101) CASTELLANA,27,29,46,102
29926,2020-06-15,(12002) CDS - Carrera 32,47,50,20,117
29927,2020-07-17,(05103) Marsella,373,189,156,718
29928,2020-08-23,(02102) Calle 161,47,23,62,132
29929,2020-03-28,(09108) Hospital,23,14,20,57
29930,2020-04-21,(09108) Hospital,41,29,48,118
29931,2020-06-22,(09108) Hospital,36,23,22,81
29932,2020-09-14,(12000) Puente Aranda,99,46,54,199
29933,2020-05-22,(50006) Corral Carrera 77,8,5,8,21
29934,2020-01-21,(04000) Cabecera Calle 80 - alimentacion,16085,8055,8827,32967
29935,2020-02-12,(07005) ALQUERIA,2790,1564,1383,5737
29936,2020-02-10,(09002) Consuelo,1493,833,825,3151
29937,2020-01-14,(08000) Portal Tunal - alimentacion,20541,10776,10421,41738
29938,2020-02-03,(09122) Calle 72,7271,4684,4118,16073
29939,2020-07-23,(07503) SAN MATEO,9914,5744,4616,20274
29940,2020-01-23,(06104) Gobernación,1302,777,586,2665
29941,2020-03-10,(05000) Portal Américas - alimentacion,1129,9512,6666,17307
29942,2020-04-06,(05000) Portal Américas - alimentacion,6028,2771,2575,11374
29943,2020-03-05,(06107) Ciudad Universitaria,1721,1048,933,3702
29944,2020-09-18,(06107) Ciudad Universitaria,193,126,169,488
29945,2020-03-08,(09118) Marly,1405,885,1436,3726
29946,2020-02-12,(07010) Bosa,2324,1376,1459,5159
29947,2020-02-20,(07010) Bosa,2223,1347,1392,4962
29948,2020-01-07,(04100) Carrera 77,4243,2458,3039,9740
29949,2020-01-18,(05100) Banderas P. Central,2764,1260,2131,6155
29950,2020-07-15,(05100) Banderas P. Central,673,358,424,1455
29951,2020-07-29,(09100) Calle 40 Sur,1693,973,1024,3690
29952,2020-06-24,(07503) SAN MATEO,11048,6753,5625,23426
29953,2020-02-27,(07009) SENA,3773,2184,2000,7957
29954,2020-02-10,(10002) Av. Primero de Mayo,8494,4553,4590,17637
29955,2020-04-30,(10005) Bicentenario - alimentacion,145,64,138,347
29956,2020-03-18,(09000) Cabecera Usme - alimentacion,17241,9005,9640,35886
29957,2020-02-24,(07113) SANTA ISABEL,2078,1283,1394,4755
29958,2020-07-15,(04101) Minuto de Dios,279,155,176,610
29959,2020-08-14,(04101) Minuto de Dios,267,160,258,685
29960,2020-01-18,(04100) Carrera 77,3403,1643,2650,7696
29961,2020-02-20,(10006) San Victorino,2339,1290,1143,4772
29962,2020-09-18,(04100) Carrera 77,1441,819,1118,3378
29963,2020-02-04,(07102) NQS - CALLE 75,1541,920,1007,3468
29964,2020-04-11,(07102) NQS - CALLE 75,72,53,60,185
29965,2020-08-02,(07102) NQS - CALLE 75,60,40,63,163
29966,2020-02-23,(03013) RIO NEGRO,246,158,305,709
29967,2020-07-11,(06000) Portal Eldorado - alimentacion,3319,1569,1912,6800
29968,2020-01-11,(05001) Patio Bonito,3855,2029,2320,8204
29969,2020-08-01,(05100) Banderas P. Central - alimentacion,1863,871,1083,3817
29970,2020-10-09,(07106) EL CAMPIN,490,340,369,1199
29971,2020-04-21,(02000) Cabecera Autopista Norte,531,382,377,1290
29972,2020-02-15,(02104) Calle 146,3540,1628,3102,8270
29973,2020-08-12,(09113) Calle 22,374,231,320,925
29974,2020-01-09,(09117) Calle 45,2201,1625,1950,5776
29975,2020-06-12,(04000) Cabecera Calle 80,1039,640,744,2423
29976,2020-08-11,(04000) Cabecera Calle 80,914,565,719,2198
29977,2020-02-29,(09114) Calle 26,694,629,1127,2450
29978,2020-10-03,(02201) Prado,837,511,747,2095
29979,2020-07-15,(04002) Carrera 90,665,356,336,1357
29980,2020-08-18,(04100) Carrera 77,1118,628,759,2505
29981,2020-01-08,(06109) Centro Memoria,786,463,493,1742
29982,2020-06-19,(03000) Portal Suba,1358,804,915,3077
29983,2020-09-01,(50003) Corral Molinos,1498,788,1164,3450
29984,2020-01-16,(02001) Centro Comercial Santa Fe,4046,2306,2499,8851
29985,2020-02-27,(06111) Universidades,5896,3663,2566,12125
29986,2020-01-13,(02201) Prado,4453,2802,2521,9776
29987,2020-04-02,(03000) Portal Suba,581,394,368,1343
29988,2020-04-03,(03000) Portal Suba,601,367,417,1385
29989,2020-06-25,(02000) Cabecera Autopista Norte - intermunicipal,555,385,434,1374
29990,2020-03-08,(09101) Quiroga,382,229,478,1089
29991,2020-03-25,(08001) Parque el Tunal,231,138,109,478
29992,2020-02-21,(06100) Av. Rojas,2563,1399,1217,5179
29993,2020-03-03,(06111) Universidades,5863,3572,2633,12068
29994,2020-08-25,(10000) Portal 20 de Julio,2082,1074,1093,4249
29995,2020-02-26,(07000) Portal Sur,8159,4775,4334,17268
29996,2020-02-19,(07004) VENECIA,4919,2759,2515,10193
29997,2020-09-23,(09004) Santa Lucía,2848,1492,1788,6128
29998,2020-03-03,(07108) Av. El Dorado,969,608,591,2168
29999,2020-01-29,(10004) Policarpa,862,409,566,1837
30000,2020-08-31,(09003) Socorro,555,309,345,1209
30001,2020-07-31,(08001) Parque el Tunal,429,214,267,910
30002,2020-03-04,(09116) Avenida 39,3323,2100,1741,7164
30003,2020-10-05,(07007) NQS - Calle 38A Sur,466,311,383,1160
30004,2020-01-27,(06103) CAN,2484,1463,1072,5019
30005,2020-06-13,(06108) Concejo de Bogotá,72,51,74,197
30006,2020-02-19,(09113) Calle 22,1602,909,1099,3610
30007,2020-06-14,(02201) Prado,246,151,166,563
30008,2020-05-21,(02000) Cabecera Autopista Norte,1022,664,623,2309
30009,2020-05-13,(09000) Cabecera Usme,1267,799,921,2987
30010,2020-07-27,(40003) Mirador del Paraiso,1598,968,1013,3579
30011,2020-05-01,(09107) Hortúa,253,164,123,540
30012,2020-06-29,(09107) Hortúa,257,163,175,595
30013,2020-07-11,(09107) Hortúa,472,282,337,1091
30014,2020-08-23,(09107) Hortúa,200,134,177,511
30015,2020-01-19,(02204) Pepe Sierra,638,434,812,1884
30016,2020-06-15,(05103) Marsella,105,66,74,245
30017,2020-05-14,(05002) Tintal,1473,843,808,3124
30018,2020-09-18,(05002) Tintal,2982,1748,2138,6868
30019,2020-01-20,(02300) Calle 100,6537,4236,3576,14349
30020,2020-08-14,(03012) SUBA - CALLE 95,259,172,186,617
30021,2020-06-12,(09001) Molinos,2453,1395,1675,5523
30022,2020-08-13,(02202) Calle 127,852,736,609,2197
30023,2020-08-08,(05105) Pradera,387,264,233,884
30024,2020-03-12,(08000) Portal Tunal,668,272,246,1186
30025,2020-02-23,(09110) Avenida Jimenez,1027,782,974,2783
30026,2020-07-06,(03009) Av. Suba- Calle 116,537,336,271,1144
30027,2020-07-29,(03009) Av. Suba- Calle 116,470,302,219,991
30028,2020-08-29,(03009) Av. Suba- Calle 116,316,243,212,771
30029,2020-04-15,(02205) Calle 106,183,121,88,392
30030,2020-06-09,(02205) Calle 106,312,206,208,726
30031,2020-07-18,(02205) Calle 106,172,118,117,407
30032,2020-07-05,(06000) Portal Eldorado - alimentacion,1436,669,970,3075
30033,2020-01-13,(12007) Zona Industrial,1106,697,561,2364
30034,2020-09-19,(07201) Guatoque -Veraguas,187,109,183,479
30035,2020-03-19,(09118) Marly,2981,1995,1766,6742
30036,2020-06-02,(07106) EL CAMPIN,309,192,178,679
30037,2020-09-20,(07113) SANTA ISABEL,142,72,186,400
30038,2020-08-14,(03007) HUMEDAL CORDOBA,130,81,68,279
30039,2020-09-14,(08002) Biblioteca,321,170,208,699
30040,2020-05-29,(04000) Cabecera Calle 80,906,584,689,2179
30041,2020-05-06,(07000) Portal Sur,1133,758,649,2540
30042,2020-04-17,(02101) Toberín,589,423,414,1426
30043,2020-05-02,(02000) Cabecera Autopista Norte - alimentacion,2307,1232,1019,4558
30044,2020-08-01,(10003) Ciudad Jardín,156,56,94,306
30045,2020-03-26,(02304) Heroes,434,335,252,1021
30046,2020-01-17,(04000) Cabecera Calle 80 - intermunicipal,1765,1116,1829,4710
30047,2020-06-03,(07104) Simon Bolivar,578,377,258,1213
30048,2020-03-07,(14005) Las Aguas,1126,802,1406,3334
30049,2020-07-08,(02104) Calle 146,845,506,567,1918
30050,2020-08-03,(02104) Calle 146,567,380,424,1371
30051,2020-08-17,(09101) Quiroga,148,85,143,376
30052,2020-06-24,(02202) Calle 127,1184,823,572,2579
30053,2020-06-13,(05001) Patio Bonito,1322,688,822,2832
30054,2020-09-15,(07109) CAD,716,431,330,1477
30055,2020-08-12,(04108) El Polo,375,216,230,821
30056,2020-06-25,(07009) SENA,704,393,415,1512
30057,2020-07-11,(12003) Ricaurte,310,233,174,717
30058,2020-04-08,(03009) Av. Suba- Calle 116,319,247,172,738
30059,2020-06-24,(09004) Santa Lucía,2691,1455,1422,5568
30060,2020-06-30,(02104) Calle 146,830,532,567,1929
30061,2020-05-18,(07103) AV. CHILE,811,463,374,1648
30062,2020-07-09,(07103) AV. CHILE,1013,594,468,2075
30063,2020-01-25,(06107) Ciudad Universitaria,590,354,622,1566
30064,2020-09-04,(12007) Zona Industrial,381,238,181,800
30065,2020-01-11,(10005) Bicentenario,181,114,216,511
30066,2020-08-05,(10005) Bicentenario,84,52,73,209
30067,2020-02-03,(40002) Manitas,1217,753,775,2745
30068,2020-03-01,(02304) Heroes,545,457,714,1716
30069,2020-07-17,(07004) VENECIA,876,513,516,1905
30070,2020-01-19,(10008) San Diego,174,140,288,602
30071,2020-09-11,(10010) San Bernardo,571,296,448,1315
30072,2020-02-11,(10004) Policarpa,931,471,593,1995
30073,2020-02-02,(05107) Américas - Cr.53,382,281,546,1209
30074,2020-07-31,(09003) Socorro,584,290,326,1200
30075,2020-08-09,(09115) Calle 34,144,93,141,378
30076,2020-03-05,(03004) GRATAMIRA,302,155,140,597
30077,2020-09-28,(07110) PALOQUEMAO,723,427,382,1532
30078,2020-04-19,(02000) Cabecera Autopista Norte,183,141,117,441
30079,2020-06-17,(07006) General Santander,502,323,309,1134
30080,2020-10-01,(10003) Ciudad Jardín,291,125,265,681
30081,2020-03-11,(12004) Carrera 22,628,429,472,1529
30082,2020-04-26,(07004) VENECIA,168,89,80,337
30083,2020-03-27,(04100) Carrera 77,554,318,341,1213
30084,2020-01-26,(50003) Corral Molinos,1026,446,1120,2592
30085,2020-06-08,(07105) MOVISTAR ARENA,248,156,136,540
30086,2020-05-26,(12007) Zona Industrial,272,172,130,574
30087,2020-07-22,(07107) U. NACIONAL,336,195,185,716
30088,2020-08-29,(06109) Centro Memoria,180,108,144,432
30089,2020-07-30,(03003) 21 ANGELES,307,158,173,638
30090,2020-07-01,(03009) Av. Suba- Calle 116,496,321,261,1078
30091,2020-03-30,(10004) Policarpa,112,70,100,282
30092,2020-04-28,(07109) CAD,458,316,214,988
30093,2020-03-01,(07004) VENECIA,984,482,965,2431
30094,2020-03-24,(08002) Biblioteca,248,140,154,542
30095,2020-06-26,(09122) Calle 72,1266,855,838,2959
30096,2020-01-01,(02304) Heroes,264,196,335,795
30097,2020-03-28,(08001) Parque el Tunal,148,81,75,304
30098,2020-04-28,(05102) Av. Américas - Av. Boyacá,129,67,63,259
30099,2020-04-08,(02102) Calle 161,80,59,56,195
30100,2020-06-04,(02103) Mazurén,160,114,120,394
30101,2020-07-12,(10009) Museo Nacional,91,67,121,279
30102,2020-09-13,(09002) Consuelo,160,68,177,405
30103,2020-10-12,(06000) Portal Eldorado,200,195,323,718
30104,2020-03-29,(03013) RIO NEGRO,43,29,31,103
30105,2020-08-02,(07200) Tygua-San José,54,37,68,159
30106,2020-07-18,(02000) Cabecera Autopista Norte - intermunicipal,292,154,221,667
30107,2020-03-29,(10010) San Bernardo,114,76,96,286
30108,2020-07-04,(40001) Juan Pablo II,502,268,319,1089
30109,2020-10-10,(06108) Concejo de Bogotá,64,59,104,227
30110,2020-04-15,(02103) Mazurén,92,64,73,229
30111,2020-04-14,(12002) CDS - Carrera 32,179,126,57,362
30112,2020-08-14,(07108) Av. El Dorado,122,83,90,295
30113,2020-09-22,(07108) Av. El Dorado,179,104,120,403
30114,2020-08-21,(06002) Normandía,286,175,169,630
30115,2020-04-12,(04102) Avenida Boyaca,48,22,23,93
30116,2020-09-23,(03010) PUENTE LARGO,427,261,286,974
30117,2020-07-12,(07009) SENA,207,115,200,522
30118,2020-05-12,(06103) CAN,334,206,152,692
30119,2020-05-15,(02502) Terminal,306,219,234,759
30120,2020-05-17,(03009) Av. Suba- Calle 116,141,88,76,305
30121,2020-10-08,(07105) MOVISTAR ARENA,291,168,228,687
30122,2020-08-19,(05105) Pradera,516,306,250,1072
30123,2020-04-26,(10001) Country Sur,208,95,127,430
30124,2020-07-03,(07006) General Santander - alimentacion,410,252,276,938
30125,2020-08-16,(02303) Calle 85,141,116,116,373
30126,2020-06-14,(07107) U. NACIONAL,98,73,64,235
30127,2020-05-18,(05102) Av. Américas - Av. Boyacá,203,104,104,411
30128,2020-04-06,(07006) General Santander - alimentacion,180,87,119,386
30129,2020-05-08,(07003) SEVILLANA,313,173,152,638
30130,2020-04-01,(07006) General Santander,238,146,153,537
30131,2020-04-26,(04002) Carrera 90,123,57,77,257
30132,2020-05-19,(03002) SUBA - TV- 91,612,380,317,1309
30133,2020-07-05,(07007) NQS - Calle 38A Sur,170,110,129,409
30134,2020-04-19,(06111) Universidades,0,19,74,93
30135,2020-05-30,(07006) General Santander - alimentacion,248,153,158,559
30136,2020-07-12,(02103) Mazurén,35,28,55,118
30137,2020-03-08,(06104) Gobernación,116,107,227,450
30138,2020-04-12,(07104) Simon Bolivar,72,52,50,174
30139,2020-07-20,(09115) Calle 34,156,112,117,385
30140,2020-02-23,(09105) Río Fucha,131,65,229,425
30141,2020-06-08,(03005) SUBA - AV. BOYACA,412,235,272,919
30142,2019-12-31,(40002) Manitas,17,12,26,55
30143,2020-04-05,(09111) Calle 19,85,67,73,225
30144,2020-06-04,(10003) Ciudad Jardín,178,91,99,368
30145,2020-04-30,(10005) Bicentenario,61,39,40,140
30146,2020-09-20,(07108) Av. El Dorado,34,31,55,120
30147,2020-04-02,(14004) Museo del Oro,0,52,129,181
30148,2020-06-02,(06100) Av. Rojas,200,112,120,432
30149,2020-08-02,(04107) Escuela Militar,17,18,22,57
30150,2020-05-22,(50002) Corral Calle 40 Sur,22,8,21,51
30151,2020-05-31,(02102) Calle 161,45,32,45,122
30152,2020-08-07,(10005) Bicentenario - alimentacion,69,41,103,213
30153,2020-07-19,(06104) Gobernación,52,41,29,122
30154,2020-08-23,(03005) SUBA - AV. BOYACA,99,69,101,269
30155,2020-06-08,(50002) Corral Calle 40 Sur,24,9,21,54
30156,2020-07-18,(06108) Concejo de Bogotá,77,40,46,163
30157,2020-05-24,(03005) SUBA - AV. BOYACA,99,60,71,230
30158,2020-04-04,(03007) HUMEDAL CORDOBA,58,40,29,127
30159,2020-05-10,(10005) Bicentenario - alimentacion,37,32,48,117
30160,2020-06-21,(12003) Ricaurte,60,62,63,185
30161,2020-07-28,(03014) SAN MARTIN,0,6,31,37
30162,2020-04-22,(04000) Cabecera Calle 80 - alimentacion,2000,1144,1156,4300
30163,2020-03-09,(09002) Consuelo,67,315,243,625
30164,2020-09-23,(09002) Consuelo,556,279,388,1223
30165,2020-03-03,(05000) Portal Américas - alimentacion,36138,21909,22196,80243
30166,2020-08-24,(05000) Portal Américas - alimentacion,10066,5124,5041,20231
30167,2020-08-25,(05000) Portal Américas - alimentacion,10210,5423,5344,20977
30168,2020-02-27,(03000) Portal Suba - alimentacion,29571,17738,16368,63677
30169,2020-06-18,(05000) Portal Américas - alimentacion,10972,6148,5211,22331
30170,2020-03-20,(07505) LEON XIII,1266,672,431,2369
30171,2020-01-02,(07503) SAN MATEO,20518,11026,10241,41785
30172,2020-02-20,(07503) SAN MATEO,38537,23038,17192,78767
30173,2020-05-17,(07503) SAN MATEO,2276,1363,1138,4777
30174,2020-02-21,(05000) Portal Américas,15222,7708,7901,30831
30175,2020-02-19,(08001) Parque el Tunal,1653,993,1085,3731
30176,2020-02-21,(10000) Portal 20 de Julio - alimentacion,11155,5390,7514,24059
30177,2020-08-06,(09001) Molinos,2378,1237,1630,5245
30178,2020-01-24,(07010) Bosa,2132,1222,1467,4821
30179,2020-01-30,(07010) Bosa,2184,1296,1430,4910
30180,2020-03-18,(04103) Las Ferias,811,467,455,1733
30181,2020-08-17,(10001) Country Sur,355,145,278,778
30182,2020-03-05,(40001) Juan Pablo II,1572,974,933,3479
30183,2020-02-14,(09000) Cabecera Usme,6150,3603,4139,13892
30184,2020-06-14,(09115) Calle 34,156,103,138,397
30185,2020-01-28,(05100) Banderas P. Central - alimentacion,14297,8429,8450,31176
30186,2020-02-23,(07001) PERDOMO,961,399,775,2135
30187,2020-05-01,(07001) PERDOMO,231,131,137,499
30188,2020-02-10,(09120) Calle 63,7421,4696,3694,15811
30189,2020-08-11,(40003) Mirador del Paraiso,1579,1027,958,3564
30190,2020-08-26,(09104) Restrepo,1581,872,1046,3499
30191,2020-09-11,(09104) Restrepo,1648,902,1214,3764
30192,2020-08-03,(04101) Minuto de Dios,227,163,206,596
30193,2020-09-13,(07504) TERREROS,1853,848,1370,4071
30194,2020-02-21,(12003) Ricaurte,1258,810,659,2727
30195,2020-03-19,(07111) NQS - RICAURTE,2149,1410,1014,4573
30196,2020-09-18,(03005) SUBA - AV. BOYACA,556,337,368,1261
30197,2020-05-13,(09101) Quiroga,386,233,288,907
30198,2020-01-27,(02102) Calle 161,1788,1148,1024,3960
30199,2020-05-31,(07102) NQS - CALLE 75,56,49,59,164
30200,2020-09-02,(09118) Marly,1508,927,806,3241
30201,2020-02-07,(07106) EL CAMPIN,2184,1347,1288,4819
30202,2020-07-04,(14001) La Sabana,142,91,125,358
30203,2020-09-17,(14001) La Sabana,186,116,123,425
30204,2020-10-02,(14001) La Sabana,160,107,136,403
30205,2020-01-15,(07106) EL CAMPIN,1809,1165,1035,4009
30206,2020-06-01,(08000) Portal Tunal - alimentacion,6168,3294,3151,12613
30207,2020-10-05,(02000) Cabecera Autopista Norte,1686,1024,1331,4041
30208,2020-02-18,(07107) U. NACIONAL,2105,1328,1210,4643
30209,2020-01-02,(03003) 21 ANGELES,692,346,402,1440
30210,2020-02-24,(03003) 21 ANGELES,1728,900,884,3512
30211,2020-04-14,(09118) Marly,1020,737,458,2215
30212,2020-01-18,(02000) Cabecera Autopista Norte,4294,2159,3567,10020
30213,2020-04-29,(09000) Cabecera Usme - alimentacion,4995,2644,2762,10401
30214,2020-10-05,(09004) Santa Lucía,2854,1381,1909,6144
30215,2020-04-16,(05000) Portal Américas,1277,938,997,3212
30216,2020-05-28,(05000) Portal Américas,2181,1403,1564,5148
30217,2020-09-02,(07010) Bosa,691,341,437,1469
30218,2020-03-09,(02000) Cabecera Autopista Norte - alimentacion,2241,5535,3683,11459
30219,2020-07-27,(09110) Avenida Jimenez,1232,855,711,2798
30220,2020-01-06,(09120) Calle 63,754,545,876,2175
30221,2020-03-06,(03000) Portal Suba,9494,5037,5250,19781
30222,2020-08-06,(03000) Portal Suba - alimentacion,4987,2880,2970,10837
30223,2020-03-12,(12001) Carrera 43,285,288,240,813
30224,2020-05-23,(07000) Portal Sur - alimentacion,5067,2730,2312,10109
30225,2020-08-30,(50003) Corral Molinos,541,213,454,1208
30226,2020-10-05,(02105) Calle 142,931,590,817,2338
30227,2020-02-23,(06105) Quinta Paredes,113,82,154,349
30228,2020-06-03,(06105) Quinta Paredes,114,71,63,248
30229,2020-07-09,(02000) Cabecera Autopista Norte - intermunicipal,592,386,447,1425
30230,2020-07-26,(09101) Quiroga,137,67,112,316
30231,2020-06-24,(02000) Cabecera Autopista Norte - alimentacion,4960,2861,2774,10595
30232,2020-03-19,(06100) Av. Rojas,825,456,447,1728
30233,2020-02-05,(04001) Quirigua,2151,1343,1225,4719
30234,2020-06-30,(10000) Portal 20 de Julio,2422,1210,1240,4872
30235,2020-06-06,(09003) Socorro,481,235,290,1006
30236,2020-03-02,(05102) Av. Américas - Av. Boyacá,1933,1184,938,4055
30237,2020-09-26,(07007) NQS - Calle 38A Sur,405,265,319,989
30238,2020-06-10,(07010) Bosa,682,367,389,1438
30239,2020-08-26,(09107) Hortúa,584,341,316,1241
30240,2020-09-05,(09107) Hortúa,461,254,376,1091
30241,2020-08-15,(09123) Calle 76,689,525,528,1742
30242,2020-03-11,(05101) Mandalay - Cr.73,1122,619,517,2258
30243,2020-09-19,(40003) Mirador del Paraiso,1587,840,1236,3663
30244,2020-07-12,(05103) Marsella,139,76,104,319
30245,2020-03-14,(03007) HUMEDAL CORDOBA,369,215,296,880
30246,2020-05-22,(02300) Calle 100,1116,723,559,2398
30247,2020-02-27,(09106) Nariño,1964,1264,1309,4537
30248,2020-09-16,(02205) Calle 106,408,276,299,983
30249,2020-06-30,(05002) Tintal,0,1003,2520,3523
30250,2020-02-15,(04108) El Polo,1032,678,928,2638
30251,2020-01-27,(07201) Guatoque -Veraguas,984,483,622,2089
30252,2020-05-15,(07101) CASTELLANA,145,84,92,321
30253,2020-07-29,(06111) Universidades,334,215,305,854
30254,2020-08-05,(03007) HUMEDAL CORDOBA,111,65,61,237
30255,2020-10-02,(04100) Carrera 77,1570,861,1256,3687
30256,2020-06-13,(09000) Cabecera Usme,1318,756,1030,3104
30257,2020-08-13,(10003) Ciudad Jardín,203,92,135,430
30258,2020-04-01,(05107) Américas - Cr.53,299,237,179,715
30259,2020-04-17,(07104) Simon Bolivar,230,173,154,557
30260,2020-03-03,(04107) Escuela Militar,685,434,433,1552
30261,2020-04-05,(05000) Portal Américas,478,287,308,1073
30262,2020-06-10,(05000) Portal Américas,2249,1593,1672,5514
30263,2020-01-17,(04003) Avenida Ciudad de Cali,4975,2605,3277,10857
30264,2020-03-05,(09106) Nariño,2044,1220,1412,4676
30265,2020-04-07,(07001) PERDOMO,451,250,267,968
30266,2020-08-08,(05001) Patio Bonito,1373,704,811,2888
30267,2020-02-20,(04000) Cabecera Calle 80 - intermunicipal,2272,1633,1963,5868
30268,2020-05-31,(02202) Calle 127,351,290,202,843
30269,2020-10-12,(02202) Calle 127,347,328,369,1044
30270,2020-04-03,(03011) SUBA - CALLE 100,271,163,146,580
30271,2020-06-04,(05002) Tintal,1742,971,1056,3769
30272,2020-01-04,(03003) 21 ANGELES,494,186,364,1044
30273,2020-05-28,(03001) LA CAMPIÑA,942,521,531,1994
30274,2020-01-19,(06106) Recinto Ferial,240,147,252,639
30275,2020-04-17,(06000) Portal Eldorado,805,581,417,1803
30276,2020-08-21,(07009) SENA,570,358,364,1292
30277,2020-09-09,(12003) Ricaurte,416,302,208,926
30278,2020-09-26,(06000) Portal Eldorado,603,511,703,1817
30279,2020-03-25,(02302) Virrey,408,279,254,941
30280,2020-07-20,(05100) Banderas P. Central,162,87,129,378
30281,2020-04-11,(09109) Tercer Milenio,89,62,73,224
30282,2020-09-09,(07007) NQS - Calle 38A Sur,426,252,304,982
30283,2020-09-10,(05107) Américas - Cr.53,366,231,258,855
30284,2020-09-20,(10005) Bicentenario,31,19,38,88
30285,2020-10-09,(07111) NQS - RICAURTE,1222,774,695,2691
30286,2020-10-08,(09106) Nariño,522,274,478,1274
30287,2020-04-28,(10000) Portal 20 de Julio,1424,671,629,2724
30288,2020-08-31,(02102) Calle 161,237,148,179,564
30289,2020-04-24,(02200) Alcalá,974,670,505,2149
30290,2020-10-01,(03011) SUBA - CALLE 100,636,281,361,1278
30291,2020-05-30,(10009) Museo Nacional,239,171,195,605
30292,2020-07-03,(10009) Museo Nacional,510,281,382,1173
30293,2020-03-20,(09115) Calle 34,398,268,186,852
30294,2020-04-22,(07110) PALOQUEMAO,511,318,172,1001
30295,2020-10-04,(07002) MADELENA,295,133,333,761
30296,2020-02-29,(06105) Quinta Paredes,432,246,368,1046
30297,2020-03-05,(12004) Carrera 22,699,443,478,1620
30298,2020-04-08,(02101) Toberín,577,367,420,1364
30299,2020-01-02,(07111) NQS - RICAURTE,1078,743,819,2640
30300,2020-03-21,(03012) SUBA - CALLE 95,96,57,62,215
30301,2020-09-18,(06109) Centro Memoria,287,171,196,654
30302,2020-02-01,(10008) San Diego,610,432,673,1715
30303,2020-08-20,(02202) Calle 127,944,700,548,2192
30304,2020-04-18,(09103) Olaya,378,206,211,795
30305,2020-05-08,(02303) Calle 85,456,336,236,1028
30306,2020-02-15,(07006) General Santander - alimentacion,924,511,747,2182
30307,2020-02-29,(50002) Corral Calle 40 Sur,59,37,88,184
30308,2020-04-11,(04000) Cabecera Calle 80 - alimentacion,966,559,531,2056
30309,2020-04-24,(09123) Calle 76,524,410,347,1281
30310,2020-09-08,(07104) Simon Bolivar,629,378,315,1322
30311,2020-10-01,(07001) PERDOMO,1088,651,880,2619
30312,2020-06-05,(10006) San Victorino,491,271,257,1019
30313,2020-08-12,(06000) Portal Eldorado,884,557,394,1835
30314,2020-05-30,(50003) Corral Molinos,1114,553,767,2434
30315,2020-08-29,(05005) Transversal 86,322,137,211,670
30316,2020-03-30,(09119) Calle 57,238,194,181,613
30317,2020-05-27,(05102) Av. Américas - Av. Boyacá,173,87,121,381
30318,2020-05-22,(08002) Biblioteca,253,146,145,544
30319,2020-05-26,(08002) Biblioteca,268,155,147,570
30320,2020-09-05,(08002) Biblioteca,266,136,213,615
30321,2020-04-27,(12001) Carrera 43,79,106,50,235
30322,2020-07-01,(14005) Las Aguas,190,111,228,529
30323,2020-03-17,(03005) SUBA - AV. BOYACA,1476,951,861,3288
30324,2020-04-29,(03005) SUBA - AV. BOYACA,248,150,138,536
30325,2020-05-07,(03005) SUBA - AV. BOYACA,267,150,176,593
30326,2020-06-12,(07111) NQS - RICAURTE,1142,717,415,2274
30327,2020-09-10,(07107) U. NACIONAL,344,168,221,733
30328,2020-09-29,(09111) Calle 19,798,505,575,1878
30329,2020-06-12,(02502) Terminal,436,295,368,1099
30330,2020-09-03,(06001) Modelia,389,244,246,879
30331,2020-06-27,(06106) Recinto Ferial,187,124,116,427
30332,2020-04-07,(07005) ALQUERIA,232,140,128,500
30333,2020-05-31,(07005) ALQUERIA,132,66,101,299
30334,2020-04-04,(10009) Museo Nacional,146,114,111,371
30335,2020-10-04,(10009) Museo Nacional,94,97,216,407
30336,2020-05-13,(07102) NQS - CALLE 75,316,205,166,687
30337,2020-07-24,(04001) Quirigua,337,227,220,784
30338,2020-01-03,(07200) Tygua-San José,355,199,333,887
30339,2020-06-07,(10000) Portal 20 de Julio - alimentacion,1337,553,820,2710
30340,2020-04-08,(09117) Calle 45,471,301,227,999
30341,2020-08-06,(04102) Avenida Boyaca,279,173,205,657
30342,2020-04-22,(06002) Normandía,176,101,99,376
30343,2020-01-05,(14004) Museo del Oro,0,109,272,381
30344,2020-03-15,(14004) Museo del Oro,0,117,302,419
30345,2020-06-26,(04000) Cabecera Calle 80 - intermunicipal,332,199,312,843
30346,2020-08-11,(07109) CAD,541,348,276,1165
30347,2020-05-03,(07000) Portal Sur,329,193,221,743
30348,2020-03-24,(09108) Hospital,53,38,66,157
30349,2020-04-05,(06000) Portal Eldorado,174,137,108,419
30350,2020-07-20,(09117) Calle 45,235,142,154,531
30351,2020-06-11,(09116) Avenida 39,300,204,201,705
30352,2020-04-25,(03006) NIZA - CALLE 127,177,116,72,365
30353,2020-08-23,(07005) ALQUERIA,142,83,129,354
30354,2020-07-06,(07006) General Santander - alimentacion,414,244,277,935
30355,2020-08-30,(07006) General Santander,200,95,158,453
30356,2020-07-05,(03011) SUBA - CALLE 100,165,77,113,355
30357,2020-09-09,(05103) Marsella,462,297,284,1043
30358,2020-07-04,(12002) CDS - Carrera 32,107,58,81,246
30359,2020-09-24,(09113) Calle 22,443,242,361,1046
30360,2020-07-29,(09106) Nariño,344,195,258,797
30361,2020-07-26,(04106) Carrera 47,109,51,60,220
30362,2020-03-23,(07006) General Santander - alimentacion,97,56,73,226
30363,2020-05-27,(06102) Salitre El Greco,193,113,113,419
30364,2019-12-31,(05107) Américas - Cr.53,28,19,22,69
30365,2020-10-09,(09113) Calle 22,434,256,460,1150
30366,2020-01-12,(07105) MOVISTAR ARENA,183,127,260,570
30367,2020-03-30,(06108) Concejo de Bogotá,101,67,67,235
30368,2020-09-30,(06106) Recinto Ferial,303,205,183,691
30369,2020-09-15,(10003) Ciudad Jardín,225,104,145,474
30370,2020-05-03,(09121) Las Flores,148,104,125,377
30371,2020-04-03,(06111) Universidades,0,55,221,276
30372,2020-03-22,(10003) Ciudad Jardín,33,20,17,70
30373,2020-03-23,(02201) Prado,205,140,119,464
30374,2020-10-11,(03011) SUBA - CALLE 100,146,108,171,425
30375,2020-03-21,(02103) Mazurén,43,30,34,107
30376,2020-05-20,(09106) Nariño,333,196,202,731
30377,2020-03-29,(03003) 21 ANGELES,53,28,32,113
30378,2020-09-27,(03004) GRATAMIRA,0,9,30,39
30379,2020-05-06,(06104) Gobernación,163,117,73,353
30380,2020-04-10,(05005) Transversal 86,52,27,29,108
30381,2020-03-23,(09114) Calle 26,62,54,58,174
30382,2020-08-13,(07108) Av. El Dorado,142,88,97,327
30383,2020-07-01,(06100) Av. Rojas,240,137,130,507
30384,2020-04-03,(06107) Ciudad Universitaria,98,67,77,242
30385,2020-05-01,(06107) Ciudad Universitaria,58,32,64,154
30386,2020-05-10,(03010) PUENTE LARGO,77,62,54,193
30387,2020-04-09,(07107) U. NACIONAL,82,62,45,189
30388,2020-05-31,(07109) CAD,171,128,93,392
30389,2020-06-15,(07007) NQS - Calle 38A Sur,161,104,107,372
30390,2020-04-21,(03013) RIO NEGRO,143,94,89,326
30391,2020-04-16,(09108) Hospital,35,22,36,93
30392,2020-08-04,(06103) CAN,320,195,147,662
30393,2020-05-10,(07201) Guatoque -Veraguas,11,14,30,55
30394,2020-09-06,(08002) Biblioteca,110,51,89,250
30395,2020-03-01,(50006) Corral Carrera 77,11,5,15,31
30396,2020-06-07,(03005) SUBA - AV. BOYACA,89,56,68,213
30397,2020-08-09,(09108) Hospital,25,11,28,64
30398,2020-10-04,(02102) Calle 161,88,38,114,240
30399,2020-04-26,(14005) Las Aguas,0,12,28,40
30400,2020-05-01,(04000) Cabecera Calle 80 - intermunicipal,61,26,50,137
30401,2020-04-04,(50006) Corral Carrera 77,4,2,3,9
30402,2020-03-21,(03004) GRATAMIRA,14,4,10,28
30403,2020-04-05,(50006) Corral Carrera 77,2,0,1,3
30404,2020-06-08,(04000) Cabecera Calle 80 - alimentacion,3696,2215,2315,8226
30405,2020-02-20,(09002) Consuelo,1331,719,851,2901
30406,2020-09-25,(02502) Terminal,537,393,525,1455
30407,2020-01-24,(07504) TERREROS,16950,9661,9197,35808
30408,2020-02-21,(07504) TERREROS,17844,10371,9272,37487
30409,2020-01-14,(09119) Calle 57,2518,1734,1770,6022
30410,2020-06-13,(09119) Calle 57,435,286,353,1074
30411,2020-01-20,(05000) Portal Américas - alimentacion,33590,18887,19350,71827
30412,2020-01-15,(03002) SUBA - TV- 91,3739,2126,2259,8124
30413,2020-01-23,(05000) Portal Américas,13859,7817,7400,29076
30414,2020-02-19,(09100) Calle 40 Sur,7619,4461,4170,16250
30415,2020-08-18,(06107) Ciudad Universitaria,157,96,106,359
30416,2020-01-17,(08000) Portal Tunal - alimentacion,21664,11032,11260,43956
30417,2020-02-17,(07010) Bosa,2256,1332,1410,4998
30418,2020-02-25,(07010) Bosa,2296,1321,1348,4965
30419,2020-03-10,(02000) Cabecera Autopista Norte - intermunicipal,397,1339,946,2682
30420,2020-01-14,(05005) Transversal 86,2164,1191,1083,4438
30421,2020-02-26,(05005) Transversal 86,2932,1466,1386,5784
30422,2020-01-13,(03000) Portal Suba,7229,4352,4433,16014
30423,2020-01-17,(09000) Cabecera Usme - alimentacion,23649,12082,14635,50366
30424,2020-01-09,(06000) Portal Eldorado - alimentacion,12514,6541,7293,26348
30425,2020-05-13,(09100) Calle 40 Sur,1365,788,808,2961
30426,2020-08-29,(09000) Cabecera Usme,1400,751,1198,3349
30427,2020-06-11,(06000) Portal Eldorado - alimentacion,3809,1938,1920,7667
30428,2020-06-25,(09115) Calle 34,716,459,419,1594
30429,2020-03-14,(09113) Calle 22,1015,574,787,2376
30430,2020-06-23,(08000) Portal Tunal - alimentacion,6561,3832,3610,14003
30431,2020-02-25,(40003) Mirador del Paraiso,4815,2732,2580,10127
30432,2020-02-18,(09123) Calle 76,5995,3984,3265,13244
30433,2020-02-24,(03005) SUBA - AV. BOYACA,2838,1640,1486,5964
30434,2020-05-19,(09101) Quiroga,388,233,272,893
30435,2020-02-12,(06106) Recinto Ferial,1649,932,808,3389
30436,2020-08-10,(09000) Cabecera Usme - alimentacion,8142,4300,4631,17073
30437,2020-01-28,(09110) Avenida Jimenez,4416,3108,2718,10242
30438,2020-02-24,(07110) PALOQUEMAO,2775,1699,1233,5707
30439,2020-02-03,(03001) LA CAMPIÑA,6301,4102,4166,14569
30440,2020-07-24,(14001) La Sabana,101,58,72,231
30441,2020-09-17,(07111) NQS - RICAURTE,1246,746,593,2585
30442,2020-10-05,(02000) Cabecera Autopista Norte - alimentacion,5296,2792,3877,11965
30443,2020-06-15,(07002) MADELENA,235,106,164,505
30444,2020-01-12,(02200) Alcalá,1732,984,1747,4463
30445,2020-01-31,(07112) COMUNEROS,3769,2112,2407,8288
30446,2020-01-16,(09117) Calle 45,3336,2376,2562,8274
30447,2020-01-14,(04105) Carrera 53,1173,628,694,2495
30448,2020-03-27,(04105) Carrera 53,164,114,96,374
30449,2020-01-07,(09123) Calle 76,3229,2176,2065,7470
30450,2020-01-18,(07506) DESPENSA,992,526,693,2211
30451,2020-02-25,(10001) Country Sur,5268,2585,2798,10651
30452,2020-04-08,(04002) Carrera 90,301,155,167,623
30453,2020-10-11,(07000) Portal Sur - alimentacion,3167,1249,2342,6758
30454,2020-08-26,(10006) San Victorino,463,231,295,989
30455,2020-03-24,(10008) San Diego,272,196,235,703
30456,2020-04-30,(07000) Portal Sur - alimentacion,4894,2621,2001,9516
30457,2020-09-09,(10002) Av. Primero de Mayo,2286,1149,1474,4909
30458,2020-02-02,(10005) Bicentenario - alimentacion,138,96,265,499
30459,2020-01-05,(07505) LEON XIII,1573,674,1087,3334
30460,2020-01-02,(10000) Portal 20 de Julio - alimentacion,5837,2762,4659,13258
30461,2020-02-20,(02304) Heroes,4659,3255,2166,10080
30462,2020-02-14,(02000) Cabecera Autopista Norte - intermunicipal,5080,3256,3192,11528
30463,2020-02-18,(10010) San Bernardo,1885,1077,1329,4291
30464,2020-06-13,(02000) Cabecera Autopista Norte - alimentacion,4005,1981,2200,8186
30465,2020-02-07,(10010) San Bernardo,1807,1062,1389,4258
30466,2020-01-19,(08002) Biblioteca,233,85,243,561
30467,2020-01-12,(10000) Portal 20 de Julio,1944,777,1509,4230
30468,2020-03-03,(02001) Centro Comercial Santa Fe,4829,3042,2669,10540
30469,2020-09-02,(07004) VENECIA,1058,611,637,2306
30470,2020-07-05,(09003) Socorro,229,100,166,495
30471,2020-09-15,(08001) Parque el Tunal,492,292,318,1102
30472,2020-03-10,(07008) NQS - Calle 30 Sur,125,463,347,935
30473,2020-08-18,(06108) Concejo de Bogotá,137,71,69,277
30474,2020-04-09,(07503) SAN MATEO,2312,1407,982,4701
30475,2020-05-22,(02201) Prado,774,511,399,1684
30476,2020-09-04,(07001) PERDOMO,1035,599,729,2363
30477,2020-06-22,(02300) Calle 100,358,269,251,878
30478,2020-07-26,(08000) Portal Tunal,178,118,87,383
30479,2020-03-09,(07104) Simon Bolivar,931,257,276,1464
30480,2020-10-05,(02302) Virrey,811,544,501,1856
30481,2020-04-18,(05005) Transversal 86,130,75,47,252
30482,2020-04-21,(05005) Transversal 86,201,117,120,438
30483,2020-07-27,(05005) Transversal 86,254,171,182,607
30484,2020-01-26,(10007) Las Nieves,192,216,435,843
30485,2020-09-17,(04002) Carrera 90,797,431,484,1712
30486,2020-07-04,(04101) Minuto de Dios,273,160,252,685
30487,2020-08-05,(04003) Avenida Ciudad de Cali,806,458,648,1912
30488,2020-07-21,(04108) El Polo,451,260,194,905
30489,2020-05-01,(06106) Recinto Ferial,69,47,54,170
30490,2020-10-08,(02200) Alcalá,2073,1382,1538,4993
30491,2020-02-02,(06111) Universidades,457,329,797,1583
30492,2020-07-23,(08002) Biblioteca,237,132,139,508
30493,2020-07-13,(07000) Portal Sur,1491,988,880,3359
30494,2020-04-19,(02101) Toberín,122,93,134,349
30495,2020-07-19,(02101) Toberín,215,156,220,591
30496,2020-02-23,(02304) Heroes,521,448,580,1549
30497,2020-06-30,(10005) Bicentenario - alimentacion,229,127,195,551
30498,2020-08-01,(10005) Bicentenario - alimentacion,152,77,162,391
30499,2020-01-25,(08001) Parque el Tunal,1034,509,726,2269
30500,2020-10-09,(09109) Tercer Milenio,382,242,305,929
30501,2020-03-15,(09100) Calle 40 Sur,1283,609,1116,3008
30502,2020-02-23,(10009) Museo Nacional,316,275,515,1106
30503,2020-08-19,(09117) Calle 45,612,374,382,1368
30504,2020-06-08,(02104) Calle 146,690,492,467,1649
30505,2020-08-27,(06101) El Tiempo,333,198,213,744
30506,2020-05-11,(04100) Carrera 77,874,518,579,1971
30507,2020-10-03,(02200) Alcalá,1668,1012,1377,4057
30508,2020-04-03,(03001) LA CAMPIÑA,496,290,271,1057
30509,2020-07-29,(02105) Calle 142,712,453,411,1576
30510,2020-05-17,(06100) Av. Rojas,32,29,26,87
30511,2020-05-22,(06100) Av. Rojas,190,93,104,387
30512,2020-06-16,(02302) Virrey,710,473,331,1514
30513,2020-07-07,(02302) Virrey,700,466,370,1536
30514,2020-09-24,(02302) Virrey,761,518,446,1725
30515,2020-05-20,(06000) Portal Eldorado - alimentacion,3329,1722,1499,6550
30516,2020-09-07,(03012) SUBA - CALLE 95,327,199,213,739
30517,2020-06-18,(07010) Bosa,740,371,437,1548
30518,2020-01-14,(10005) Bicentenario,691,339,343,1373
30519,2020-02-14,(04103) Las Ferias,1606,921,856,3383
30520,2020-09-24,(10010) San Bernardo,635,346,501,1482
30521,2020-02-18,(04000) Cabecera Calle 80 - intermunicipal,2387,1716,2046,6149
30522,2020-04-30,(10000) Portal 20 de Julio,1469,741,682,2892
30523,2020-05-27,(10008) San Diego,236,145,143,524
30524,2020-01-16,(10004) Policarpa,716,344,575,1635
30525,2020-02-26,(09003) Socorro,1685,932,990,3607
30526,2020-06-26,(40001) Juan Pablo II,608,375,360,1343
30527,2020-07-14,(09115) Calle 34,553,336,317,1206
30528,2020-05-18,(02204) Pepe Sierra,653,474,353,1480
30529,2020-09-23,(07110) PALOQUEMAO,748,454,422,1624
30530,2020-10-04,(14004) Museo del Oro,41,44,135,220
30531,2020-06-16,(07006) General Santander,524,328,275,1127
30532,2020-08-03,(10003) Ciudad Jardín,201,94,150,445
30533,2020-03-04,(12004) Carrera 22,697,456,488,1641
30534,2020-01-01,(07001) PERDOMO,313,157,420,890
30535,2020-09-10,(06104) Gobernación,254,143,151,548
30536,2020-08-06,(09002) Consuelo,487,240,262,989
30537,2020-03-04,(07006) General Santander - alimentacion,1497,890,947,3334
30538,2020-08-11,(50003) Corral Molinos,1477,743,1047,3267
30539,2020-06-04,(07201) Guatoque -Veraguas,187,101,102,390
30540,2020-03-28,(03000) Portal Suba - alimentacion,2407,1292,1098,4797
30541,2020-07-05,(07105) MOVISTAR ARENA,75,39,66,180
30542,2020-02-06,(07506) DESPENSA,1620,928,915,3463
30543,2020-10-12,(50003) Corral Molinos,592,269,607,1468
30544,2020-06-01,(03003) 21 ANGELES,306,167,165,638
30545,2020-04-20,(07113) SANTA ISABEL,194,132,141,467
30546,2020-09-15,(02502) Terminal,443,328,436,1207
30547,2020-10-02,(04103) Las Ferias,385,228,286,899
30548,2020-06-22,(07001) PERDOMO,298,159,194,651
30549,2020-05-15,(05102) Av. Américas - Av. Boyacá,163,72,92,327
30550,2020-07-24,(40001) Juan Pablo II,370,226,273,869
30551,2020-08-10,(09122) Calle 72,1066,691,713,2470
30552,2020-07-14,(02102) Calle 161,210,132,141,483
30553,2020-08-18,(02102) Calle 161,190,113,137,440
30554,2020-10-09,(02102) Calle 161,300,174,245,719
30555,2020-04-07,(12004) Carrera 22,46,36,47,129
30556,2020-09-29,(07107) U. NACIONAL,413,260,297,970
30557,2020-09-06,(02103) Mazurén,45,41,62,148
30558,2020-05-10,(09003) Socorro,158,78,92,328
30559,2020-04-05,(07111) NQS - RICAURTE,73,89,69,231
30560,2020-06-02,(08001) Parque el Tunal,437,252,237,926
30561,2020-09-13,(10000) Portal 20 de Julio,810,329,683,1822
30562,2020-04-01,(09122) Calle 72,584,430,380,1394
30563,2020-05-02,(07008) NQS - Calle 30 Sur,107,68,56,231
30564,2020-08-09,(06106) Recinto Ferial,60,48,48,156
30565,2020-07-13,(07004) VENECIA,820,517,442,1779
30566,2020-04-25,(40001) Juan Pablo II,227,121,145,493
30567,2020-08-19,(06002) Normandía,297,167,184,648
30568,2020-08-14,(03003) 21 ANGELES,314,155,146,615
30569,2020-07-16,(07005) ALQUERIA,480,257,281,1018
30570,2020-06-16,(03010) PUENTE LARGO,367,224,198,789
30571,2020-02-06,(09108) Hospital,245,151,214,610
30572,2020-09-20,(02103) Mazurén,43,34,91,168
30573,2020-08-14,(09122) Calle 72,1082,682,736,2500
30574,2020-09-04,(07506) DESPENSA,465,295,343,1103
30575,2020-05-02,(09003) Socorro,278,142,137,557
30576,2020-06-07,(10002) Av. Primero de Mayo,522,254,421,1197
30577,2020-07-21,(03005) SUBA - AV. BOYACA,406,233,242,881
30578,2020-07-14,(05101) Mandalay - Cr.73,106,62,54,222
30579,2020-03-23,(07102) NQS - CALLE 75,38,25,42,105
30580,2020-09-29,(04000) Cabecera Calle 80 - intermunicipal,441,229,409,1079
30581,2020-08-30,(07006) General Santander - alimentacion,86,57,114,257
30582,2020-07-14,(10007) Las Nieves,325,203,215,743
30583,2020-04-27,(09003) Socorro,207,38,40,285
30584,2020-06-27,(07010) Bosa,612,287,399,1298
30585,2020-07-26,(06102) Salitre El Greco,82,47,45,174
30586,2020-09-09,(03010) PUENTE LARGO,383,243,223,849
30587,2020-04-23,(09115) Calle 34,389,271,216,876
30588,2020-07-07,(03004) GRATAMIRA,38,17,23,78
30589,2020-04-10,(06002) Normandía,44,34,27,105
30590,2020-03-10,(09105) Río Fucha,182,142,125,449
30591,2020-09-03,(07009) SENA,682,402,473,1557
30592,2020-08-07,(09106) Nariño,173,93,133,399
30593,2020-04-08,(07506) DESPENSA,201,120,117,438
30594,2020-03-22,(09000) Cabecera Usme,327,171,184,682
30595,2020-04-18,(09121) Las Flores,276,195,167,638
30596,2020-06-14,(06100) Av. Rojas,40,24,36,100
30597,2020-03-20,(08002) Biblioteca,154,93,64,311
30598,2020-05-22,(06107) Ciudad Universitaria,156,94,100,350
30599,2020-04-26,(06111) Universidades,0,26,85,111
30600,2020-07-26,(07111) NQS - RICAURTE,120,93,93,306
30601,2020-06-07,(06101) El Tiempo,82,61,56,199
30602,2020-05-14,(10003) Ciudad Jardín,147,85,117,349
30603,2020-03-25,(12002) CDS - Carrera 32,136,116,89,341
30604,2020-04-27,(07101) CASTELLANA,17,48,22,87
30605,2020-04-29,(07201) Guatoque -Veraguas,105,72,69,246
30606,2020-04-11,(06105) Quinta Paredes,47,32,25,104
30607,2020-05-23,(03007) HUMEDAL CORDOBA,91,55,40,186
30608,2020-01-05,(03014) SAN MARTIN,23,17,54,94
30609,2019-12-31,(09111) Calle 19,28,13,35,76
30610,2020-05-10,(50006) Corral Carrera 77,4,1,2,7
30611,2020-04-20,(50002) Corral Calle 40 Sur,10,5,12,27
30612,2020-05-31,(07101) CASTELLANA,24,22,35,81
30613,2020-02-09,(04000) Cabecera Calle 80 - alimentacion,4886,2138,5057,12081
30614,2020-02-13,(04000) Cabecera Calle 80 - alimentacion,25205,14869,14956,55030
30615,2020-05-09,(04000) Cabecera Calle 80 - alimentacion,1767,923,1127,3817
30616,2020-03-06,(09002) Consuelo,1426,709,897,3032
30617,2020-08-25,(09002) Consuelo,441,247,286,974
30618,2020-03-20,(09118) Marly,1140,792,459,2391
30619,2020-05-30,(07504) TERREROS,3524,2038,1963,7525
30620,2020-09-14,(07504) TERREROS,6316,3398,3274,12988
30621,2020-05-13,(05000) Portal Américas - alimentacion,8800,4535,3806,17141
30622,2020-02-24,(02101) Toberín,14925,9591,7334,31850
30623,2020-01-25,(07503) SAN MATEO,27190,12989,13660,53839
30624,2020-02-05,(08001) Parque el Tunal,1780,1020,1022,3822
30625,2020-08-21,(04002) Carrera 90,646,349,389,1384
30626,2020-07-08,(05000) Portal Américas - alimentacion,11234,6146,5634,23014
30627,2020-02-21,(09001) Molinos,7657,4061,5503,17221
30628,2020-02-12,(09118) Marly,8496,5439,4111,18046
30629,2020-02-10,(07010) Bosa,2243,1347,1445,5035
30630,2020-07-06,(05005) Transversal 86,0,206,498,704
30631,2020-01-09,(08000) Portal Tunal - alimentacion,18343,9514,9798,37655
30632,2020-03-17,(09000) Cabecera Usme,4260,2391,2634,9285
30633,2020-10-07,(40001) Juan Pablo II,599,356,491,1446
30634,2020-01-13,(09115) Calle 34,3426,2232,2110,7768
30635,2020-05-27,(09115) Calle 34,608,394,306,1308
30636,2020-02-11,(02000) Cabecera Autopista Norte,12208,7515,6196,25919
30637,2020-02-10,(07009) SENA,3868,2275,1996,8139
30638,2020-04-28,(07001) PERDOMO,513,299,268,1080
30639,2020-10-06,(40003) Mirador del Paraiso,1883,1049,1355,4287
30640,2020-07-29,(04101) Minuto de Dios,297,181,224,702
30641,2020-02-18,(07505) LEON XIII,8730,4894,3876,17500
30642,2020-05-19,(07505) LEON XIII,2012,1231,921,4164
30643,2020-06-20,(07505) LEON XIII,2249,1158,1123,4530
30644,2020-02-20,(09115) Calle 34,4481,2804,2325,9610
30645,2020-01-28,(02502) Terminal,5243,3349,2880,11472
30646,2020-02-26,(09123) Calle 76,5101,3825,3709,12635
30647,2020-01-03,(09101) Quiroga,879,497,770,2146
30648,2020-06-02,(09101) Quiroga,455,251,312,1018
30649,2020-05-04,(09000) Cabecera Usme,1020,616,693,2329
30650,2020-01-30,(06106) Recinto Ferial,1545,875,805,3225
30651,2020-08-02,(07000) Portal Sur - alimentacion,2210,1069,1313,4592
30652,2020-02-11,(50003) Corral Molinos,3546,2314,3711,9571
30653,2020-01-19,(05001) Patio Bonito,1636,757,1423,3816
30654,2020-07-15,(02103) Mazurén,175,114,130,419
30655,2020-08-06,(07000) Portal Sur - alimentacion,6994,3869,3734,14597
30656,2020-07-16,(07002) MADELENA,577,341,414,1332
30657,2020-05-07,(04000) Cabecera Calle 80,723,444,449,1616
30658,2020-09-17,(08000) Portal Tunal - alimentacion,6828,3841,4423,15092
30659,2020-06-30,(09110) Avenida Jimenez,1437,989,936,3362
30660,2020-01-13,(09114) Calle 26,2263,1556,1405,5224
30661,2020-03-25,(09114) Calle 26,213,172,164,549
30662,2020-09-09,(10001) Country Sur,1381,592,864,2837
30663,2020-01-14,(04002) Carrera 90,3004,1719,1746,6469
30664,2020-06-19,(04100) Carrera 77,1308,717,853,2878
30665,2020-07-18,(04100) Carrera 77,802,396,566,1764
30666,2020-08-05,(04100) Carrera 77,1027,554,692,2273
30667,2020-01-02,(03000) Portal Suba,3333,2167,2603,8103
30668,2020-05-28,(12001) Carrera 43,364,219,194,777
30669,2020-01-26,(40003) Mirador del Paraiso,1934,845,1288,4067
30670,2020-03-31,(03000) Portal Suba,612,389,399,1400
30671,2020-08-20,(02000) Cabecera Autopista Norte - intermunicipal,474,322,372,1168
30672,2020-01-28,(09108) Hospital,195,123,195,513
30673,2020-01-29,(09116) Avenida 39,2610,1689,1437,5736
30674,2020-07-15,(10000) Portal 20 de Julio,1520,812,824,3156
30675,2020-05-11,(07112) COMUNEROS,593,331,316,1240
30676,2020-09-18,(02303) Calle 85,842,560,529,1931
30677,2020-07-21,(07000) Portal Sur,1669,1037,996,3702
30678,2020-03-06,(02300) Calle 100,6652,4461,4013,15126
30679,2020-01-05,(10002) Av. Primero de Mayo,1301,578,1406,3285
30680,2020-10-04,(04002) Carrera 90,285,141,269,695
30681,2020-08-12,(06000) Portal Eldorado - alimentacion,3491,1760,1838,7089
30682,2020-03-13,(02502) Terminal,359,735,697,1791
30683,2020-01-28,(10004) Policarpa,807,439,565,1811
30684,2020-09-03,(09003) Socorro,635,304,367,1306
30685,2020-04-29,(07503) SAN MATEO,6209,3883,2894,12986
30686,2020-09-16,(08001) Parque el Tunal,512,285,359,1156
30687,2020-02-06,(06108) Concejo de Bogotá,947,497,533,1977
30688,2020-06-24,(07010) Bosa,752,372,419,1543
30689,2020-03-31,(10001) Country Sur,499,238,343,1080
30690,2020-09-27,(10001) Country Sur,425,184,469,1078
30691,2020-06-27,(03003) 21 ANGELES,258,116,155,529
30692,2020-08-21,(02101) Toberín,1240,802,891,2933
30693,2020-01-05,(02000) Cabecera Autopista Norte,1221,603,1104,2928
30694,2020-08-18,(06102) Salitre El Greco,197,127,116,440
30695,2020-06-12,(09000) Cabecera Usme,1629,1053,1193,3875
30696,2020-04-17,(09107) Hortúa,430,278,260,968
30697,2020-05-07,(09123) Calle 76,587,445,383,1415
30698,2020-06-22,(05100) Banderas P. Central - alimentacion,907,440,553,1900
30699,2020-02-16,(03000) Portal Suba,1476,702,1667,3845
30700,2020-08-27,(03012) SUBA - CALLE 95,347,206,199,752
30701,2020-09-27,(10000) Portal 20 de Julio,851,351,722,1924
30702,2020-06-19,(50002) Corral Calle 40 Sur,22,7,24,53
30703,2020-07-11,(10010) San Bernardo,489,241,395,1125
30704,2020-02-16,(05005) Transversal 86,490,169,432,1091
30705,2020-05-11,(05105) Pradera,426,278,163,867
30706,2020-01-30,(08000) Portal Tunal,2089,1165,1097,4351
30707,2020-10-09,(03009) Av. Suba- Calle 116,529,327,412,1268
30708,2020-10-03,(02205) Calle 106,243,194,276,713
30709,2020-08-18,(04108) El Polo,497,292,210,999
30710,2020-09-19,(04108) El Polo,328,220,328,876
30711,2020-06-30,(07101) CASTELLANA,213,119,131,463
30712,2020-03-06,(07101) CASTELLANA,862,570,682,2114
30713,2020-06-08,(02304) Heroes,756,557,411,1724
30714,2020-01-26,(07113) SANTA ISABEL,485,266,598,1349
30715,2020-04-01,(06000) Portal Eldorado,744,557,388,1689
30716,2020-08-20,(05103) Marsella,396,202,229,827
30717,2020-06-11,(04104) Avenida 68,621,307,263,1191
30718,2020-06-19,(04104) Avenida 68,663,340,347,1350
30719,2020-07-31,(03001) LA CAMPIÑA,852,496,456,1804
30720,2020-10-01,(09117) Calle 45,755,492,630,1877
30721,2020-01-14,(03010) PUENTE LARGO,1798,1125,1065,3988
30722,2020-01-05,(03005) SUBA - AV. BOYACA,312,168,438,918
30723,2020-08-26,(02204) Pepe Sierra,700,511,417,1628
30724,2020-08-03,(07000) Portal Sur,1665,1036,964,3665
30725,2020-02-24,(04103) Las Ferias,1514,867,794,3175
30726,2020-10-07,(10003) Ciudad Jardín,231,133,245,609
30727,2020-06-05,(10010) San Bernardo,575,303,357,1235
30728,2020-04-08,(05100) Banderas P. Central - alimentacion,1497,654,658,2809
30729,2020-03-28,(02304) Heroes,308,251,148,707
30730,2020-01-27,(07109) CAD,2832,1701,1416,5949
30731,2020-06-22,(10010) San Bernardo,269,121,204,594
30732,2020-07-23,(02303) Calle 85,516,346,255,1117
30733,2020-08-26,(02303) Calle 85,670,414,338,1422
30734,2020-05-28,(09000) Cabecera Usme,1427,917,961,3305
30735,2020-07-07,(09000) Cabecera Usme,1816,1120,1303,4239
30736,2020-09-17,(04003) Avenida Ciudad de Cali,1113,625,889,2627
30737,2020-03-12,(03007) HUMEDAL CORDOBA,187,124,102,413
30738,2020-04-18,(09100) Calle 40 Sur,657,416,425,1498
30739,2020-08-15,(04104) Avenida 68,404,232,316,952
30740,2020-08-31,(02104) Calle 146,758,490,495,1743
30741,2020-02-26,(04000) Cabecera Calle 80 - intermunicipal,2462,1661,2234,6357
30742,2020-04-04,(02202) Calle 127,520,386,240,1146
30743,2020-10-09,(09121) Las Flores,741,453,628,1822
30744,2020-07-02,(02204) Pepe Sierra,841,576,458,1875
30745,2020-07-16,(02204) Pepe Sierra,732,510,325,1567
30746,2020-04-18,(08000) Portal Tunal,338,188,160,686
30747,2020-04-03,(07113) SANTA ISABEL,181,125,136,442
30748,2020-08-06,(02001) Centro Comercial Santa Fe,388,213,304,905
30749,2020-02-16,(04101) Minuto de Dios,460,212,629,1301
30750,2020-06-09,(06000) Portal Eldorado,970,688,445,2103
30751,2020-02-29,(06001) Modelia,1042,620,961,2623
30752,2020-09-09,(06103) CAN,389,221,204,814
30753,2020-03-20,(07103) AV. CHILE,407,294,183,884
30754,2020-01-18,(06108) Concejo de Bogotá,278,190,332,800
30755,2020-03-25,(10010) San Bernardo,377,225,254,856
30756,2020-04-04,(10010) San Bernardo,213,151,170,534
30757,2020-08-17,(10010) San Bernardo,251,139,210,600
30758,2020-04-29,(09118) Marly,1097,782,481,2360
30759,2020-07-24,(02103) Mazurén,173,103,132,408
30760,2020-09-03,(02103) Mazurén,218,151,172,541
30761,2020-06-08,(05100) Banderas P. Central - alimentacion,2100,1115,1455,4670
30762,2020-05-20,(07103) AV. CHILE,800,510,344,1654
30763,2020-01-27,(40002) Manitas,1225,682,763,2670
30764,2020-03-23,(40002) Manitas,81,33,49,163
30765,2020-01-23,(09106) Nariño,1825,1085,1302,4212
30766,2020-03-08,(02000) Cabecera Autopista Norte - intermunicipal,650,403,815,1868
30767,2020-08-07,(03001) LA CAMPIÑA,325,160,197,682
30768,2020-06-09,(02001) Centro Comercial Santa Fe,444,292,292,1028
30769,2020-09-03,(04105) Carrera 53,280,157,191,628
30770,2020-07-13,(02102) Calle 161,194,125,138,457
30771,2020-06-07,(09110) Avenida Jimenez,163,144,227,534
30772,2020-09-05,(10008) San Diego,226,151,187,564
30773,2020-09-18,(10009) Museo Nacional,583,337,476,1396
30774,2020-09-04,(05105) Pradera,658,387,344,1389
30775,2020-06-01,(06111) Universidades,0,133,372,505
30776,2020-05-14,(40001) Juan Pablo II,433,258,249,940
30777,2020-06-20,(40001) Juan Pablo II,461,263,330,1054
30778,2020-08-30,(09115) Calle 34,173,129,205,507
30779,2020-06-22,(09001) Molinos,866,411,586,1863
30780,2020-10-03,(09103) Olaya,923,444,727,2094
30781,2020-01-16,(03004) GRATAMIRA,261,117,146,524
30782,2020-03-15,(07005) ALQUERIA,487,244,403,1134
30783,2020-06-29,(09109) Tercer Milenio,125,82,140,347
30784,2020-08-23,(07110) PALOQUEMAO,178,112,82,372
30785,2020-03-20,(06105) Quinta Paredes,71,49,31,151
30786,2020-01-25,(14005) Las Aguas,869,601,1126,2596
30787,2020-07-10,(07201) Guatoque -Veraguas,199,112,130,441
30788,2020-06-08,(07200) Tygua-San José,235,112,136,483
30789,2020-03-08,(06109) Centro Memoria,210,111,248,569
30790,2020-07-15,(04105) Carrera 53,258,135,125,518
30791,2020-08-24,(04105) Carrera 53,278,157,120,555
30792,2020-10-05,(09115) Calle 34,762,469,652,1883
30793,2020-07-14,(07107) U. NACIONAL,338,197,180,715
30794,2020-05-26,(05102) Av. Américas - Av. Boyacá,180,101,112,393
30795,2020-10-01,(03003) 21 ANGELES,404,202,299,905
30796,2020-09-16,(40001) Juan Pablo II,560,351,420,1331
30797,2020-04-14,(09119) Calle 57,259,196,162,617
30798,2020-08-22,(09119) Calle 57,399,235,333,967
30799,2020-08-20,(07110) PALOQUEMAO,648,402,267,1317
30800,2020-10-06,(03011) SUBA - CALLE 100,676,300,392,1368
30801,2020-05-06,(04104) Avenida 68,453,236,195,884
30802,2020-09-14,(40002) Manitas,192,268,432,892
30803,2020-07-09,(02304) Heroes,937,639,469,2045
30804,2020-06-17,(09122) Calle 72,1198,816,712,2726
30805,2020-02-25,(50002) Corral Calle 40 Sur,139,82,156,377
30806,2020-05-16,(12000) Puente Aranda,40,35,25,100
30807,2020-07-31,(09104) Restrepo,1394,801,993,3188
30808,2020-07-02,(07107) U. NACIONAL,336,205,184,725
30809,2020-09-14,(03010) PUENTE LARGO,382,224,244,850
30810,2020-03-01,(06002) Normandía,343,195,405,943
30811,2020-06-01,(07006) General Santander - alimentacion,339,198,234,771
30812,2020-09-26,(10007) Las Nieves,502,373,429,1304
30813,2020-06-15,(02001) Centro Comercial Santa Fe,128,86,136,350
30814,2020-06-08,(04102) Avenida Boyaca,308,167,158,633
30815,2020-09-20,(05107) Américas - Cr.53,90,90,168,348
30816,2020-07-04,(06108) Concejo de Bogotá,87,51,85,223
30817,2020-03-14,(06102) Salitre El Greco,553,396,474,1423
30818,2020-05-15,(09117) Calle 45,593,388,327,1308
30819,2020-08-07,(02105) Calle 142,264,153,200,617
30820,2020-03-22,(02502) Terminal,49,32,54,135
30821,2020-06-07,(02502) Terminal,68,53,86,207
30822,2020-06-14,(04000) Cabecera Calle 80 - intermunicipal,37,24,37,98
30823,2020-05-28,(07006) General Santander,437,272,211,920
30824,2020-06-14,(09104) Restrepo,445,267,337,1049
30825,2020-05-11,(10005) Bicentenario - alimentacion,177,82,121,380
30826,2020-05-08,(09003) Socorro,420,218,244,882
30827,2020-05-21,(06105) Quinta Paredes,113,75,54,242
30828,2020-06-16,(09113) Calle 22,392,219,358,969
30829,2020-10-04,(12001) Carrera 43,69,57,109,235
30830,2020-05-02,(06001) Modelia,182,122,126,430
30831,2020-04-01,(07004) VENECIA,483,291,284,1058
30832,2020-05-23,(10004) Policarpa,137,67,107,311
30833,2020-04-26,(09115) Calle 34,130,90,78,298
30834,2020-02-16,(10005) Bicentenario,52,65,131,248
30835,2020-06-09,(03004) GRATAMIRA,28,17,18,63
30836,2020-03-09,(07506) DESPENSA,93,425,298,816
30837,2020-05-15,(06103) CAN,331,221,143,695
30838,2020-07-27,(07113) SANTA ISABEL,307,199,251,757
30839,2020-06-14,(09106) Nariño,147,69,113,329
30840,2020-05-08,(07506) DESPENSA,335,164,191,690
30841,2020-03-27,(04104) Avenida 68,314,199,189,702
30842,2020-08-05,(07006) General Santander - alimentacion,335,176,215,726
30843,2020-06-28,(06111) Universidades,111,63,126,300
30844,2020-04-19,(04000) Cabecera Calle 80 - intermunicipal,24,10,24,58
30845,2020-10-04,(08002) Biblioteca,113,54,110,277
30846,2020-07-12,(02304) Heroes,229,198,197,624
30847,2020-05-09,(06103) CAN,190,142,95,427
30848,2020-05-31,(07006) General Santander,128,72,90,290
30849,2020-03-27,(12003) Ricaurte,84,82,63,229
30850,2020-04-27,(07008) NQS - Calle 30 Sur,105,15,18,138
30851,2020-08-09,(14005) Las Aguas,34,38,70,142
30852,2020-05-18,(06100) Av. Rojas,168,94,111,373
30853,2020-06-03,(14005) Las Aguas,0,62,176,238
30854,2020-04-05,(04102) Avenida Boyaca,35,35,30,100
30855,2020-07-05,(10003) Ciudad Jardín,87,41,74,202
30856,2020-05-23,(03005) SUBA - AV. BOYACA,282,159,186,627
30857,2020-03-19,(50002) Corral Calle 40 Sur,46,25,67,138
30858,2020-06-05,(50002) Corral Calle 40 Sur,27,6,27,60
30859,2020-04-15,(06104) Gobernación,153,123,75,351
30860,2020-07-04,(05102) Av. Américas - Av. Boyacá,159,98,142,399
30861,2020-06-14,(09105) Río Fucha,41,23,42,106
30862,2020-06-11,(03014) SAN MARTIN,30,10,32,72
30863,2020-03-23,(50006) Corral Carrera 77,3,2,4,9
30864,2020-03-29,(04107) Escuela Militar,11,15,14,40
30865,2020-04-13,(03004) GRATAMIRA,17,9,12,38
30866,2020-04-10,(03014) SAN MARTIN,2,2,7,11
30867,2020-01-11,(04000) Cabecera Calle 80 - alimentacion,9868,4556,8002,22426
30868,2020-09-12,(04000) Cabecera Calle 80 - alimentacion,3446,1618,2701,7765
30869,2020-05-18,(07005) ALQUERIA,405,247,240,892
30870,2020-09-21,(09002) Consuelo,453,186,297,936
30871,2020-10-07,(09002) Consuelo,545,295,401,1241
30872,2020-08-26,(02502) Terminal,379,251,319,949
30873,2020-07-17,(09118) Marly,1311,886,622,2819
30874,2020-02-05,(10000) Portal 20 de Julio - alimentacion,10985,5880,7888,24753
30875,2020-09-30,(02303) Calle 85,870,543,503,1916
30876,2020-01-27,(03000) Portal Suba - alimentacion,25911,15577,15566,57054
30877,2020-02-13,(03002) SUBA - TV- 91,4899,2737,2567,10203
30878,2020-01-09,(02101) Toberín,9826,5920,5660,21406
30879,2020-03-11,(05000) Portal Américas,13946,7838,7902,29686
30880,2020-08-29,(06107) Ciudad Universitaria,119,75,127,321
30881,2020-09-02,(06107) Ciudad Universitaria,202,105,135,442
30882,2020-03-03,(07010) Bosa,2241,1204,1493,4938
30883,2020-03-31,(04103) Las Ferias,159,114,99,372
30884,2020-01-14,(10004) Policarpa,687,359,565,1611
30885,2020-01-30,(06102) Salitre El Greco,1592,866,741,3199
30886,2020-03-06,(06102) Salitre El Greco,1471,856,769,3096
30887,2020-03-07,(07000) Portal Sur - alimentacion,19102,9393,11575,40070
30888,2020-09-01,(09000) Cabecera Usme - alimentacion,8684,4585,5163,18432
30889,2020-05-13,(40003) Mirador del Paraiso,1317,852,774,2943
30890,2020-02-24,(04100) Carrera 77,6877,4216,3851,14944
30891,2020-02-25,(09004) Santa Lucía,7642,4365,4210,16217
30892,2020-09-05,(07102) NQS - CALLE 75,307,248,313,868
30893,2020-04-08,(09000) Cabecera Usme - alimentacion,4501,2104,2468,9073
30894,2020-06-06,(09118) Marly,1036,705,607,2348
30895,2020-03-04,(06001) Modelia,2601,1557,1302,5460
30896,2020-07-03,(03000) Portal Suba - alimentacion,6837,4063,4224,15124
30897,2020-10-08,(07000) Portal Sur - alimentacion,9329,4864,5918,20111
30898,2020-05-16,(09103) Olaya,565,299,338,1202
30899,2020-02-29,(14001) La Sabana,306,289,346,941
30900,2020-01-13,(07111) NQS - RICAURTE,2658,1741,1578,5977
30901,2020-07-09,(08000) Portal Tunal - alimentacion,6524,3715,3727,13966
30902,2020-10-07,(02000) Cabecera Autopista Norte,1696,1053,1319,4068
30903,2020-09-14,(09113) Calle 22,386,241,355,982
30904,2020-02-06,(10007) Las Nieves,2077,1268,1253,4598
30905,2020-08-04,(07010) Bosa,573,277,355,1205
30906,2020-07-16,(09001) Molinos,1743,952,1227,3922
30907,2020-01-13,(10001) Country Sur,4219,1839,2316,8374
30908,2020-09-22,(10001) Country Sur,1423,667,942,3032
30909,2020-03-01,(10006) San Victorino,290,297,475,1062
30910,2020-08-01,(40003) Mirador del Paraiso,1375,799,969,3143
30911,2020-10-02,(02101) Toberín,1951,1087,1708,4746
30912,2020-01-13,(04001) Quirigua,1515,935,1010,3460
30913,2020-01-13,(10002) Av. Primero de Mayo,6739,3430,4183,14352
30914,2020-08-06,(10002) Av. Primero de Mayo,2054,1059,1208,4321
30915,2020-08-13,(10002) Av. Primero de Mayo,2113,1051,1300,4464
30916,2020-02-03,(06111) Universidades,5769,3505,2589,11863
30917,2020-01-10,(10000) Portal 20 de Julio,6821,2988,3439,13248
30918,2020-01-18,(40001) Juan Pablo II,1127,562,868,2557
30919,2020-05-26,(03000) Portal Suba,1044,651,721,2416
30920,2020-04-28,(03000) Portal Suba - alimentacion,3733,2123,1833,7689
30921,2020-04-14,(10000) Portal 20 de Julio - alimentacion,2746,1077,1447,5270
30922,2020-07-22,(10002) Av. Primero de Mayo,1615,808,1046,3469
30923,2020-01-26,(09108) Hospital,53,39,103,195
30924,2020-07-04,(10000) Portal 20 de Julio,1928,956,1198,4082
30925,2020-07-16,(10000) Portal 20 de Julio,1553,850,871,3274
30926,2020-09-07,(04100) Carrera 77,1269,745,942,2956
30927,2020-02-07,(09113) Calle 22,1630,904,1163,3697
30928,2020-02-07,(06103) CAN,2566,1556,1295,5417
30929,2020-06-11,(07010) Bosa,701,365,448,1514
30930,2020-04-27,(04000) Cabecera Calle 80 - alimentacion,1522,212,241,1975
30931,2020-03-26,(02201) Prado,397,284,245,926
30932,2020-03-06,(02304) Heroes,4346,3090,2490,9926
30933,2020-01-28,(06001) Modelia,2481,1549,1251,5281
30934,2020-03-17,(06001) Modelia,1368,887,676,2931
30935,2020-01-28,(03005) SUBA - AV. BOYACA,2821,1616,1545,5982
30936,2020-06-02,(09000) Cabecera Usme,1548,975,1035,3558
30937,2020-04-08,(05002) Tintal,1062,631,607,2300
30938,2020-10-09,(02103) Mazurén,288,162,281,731
30939,2020-07-02,(05100) Banderas P. Central - alimentacion,2923,1696,2019,6638
30940,2020-01-21,(07104) Simon Bolivar,1648,1018,767,3433
30941,2020-06-05,(09001) Molinos,2357,1345,1536,5238
30942,2020-06-24,(10008) San Diego,308,173,193,674
30943,2020-03-17,(03012) SUBA - CALLE 95,924,540,540,2004
30944,2020-02-06,(09106) Nariño,2069,1293,1415,4777
30945,2020-01-23,(03009) Av. Suba- Calle 116,2440,1544,1329,5313
30946,2020-07-25,(03009) Av. Suba- Calle 116,302,168,175,645
30947,2020-10-10,(03009) Av. Suba- Calle 116,320,244,311,875
30948,2020-07-14,(02205) Calle 106,352,216,199,767
30949,2020-06-19,(09101) Quiroga,606,309,373,1288
30950,2020-02-06,(07000) Portal Sur,7346,4411,4263,16020
30951,2020-08-30,(07106) EL CAMPIN,125,97,115,337
30952,2020-09-02,(07106) EL CAMPIN,437,259,261,957
30953,2020-02-15,(03007) HUMEDAL CORDOBA,484,272,374,1130
30954,2020-09-11,(03007) HUMEDAL CORDOBA,163,98,86,347
30955,2020-03-31,(10006) San Victorino,161,142,159,462
30956,2020-08-11,(10006) San Victorino,706,319,303,1328
30957,2020-03-18,(03001) LA CAMPIÑA,3052,1686,1805,6543
30958,2020-03-01,(04000) Cabecera Calle 80,1306,646,1529,3481
30959,2020-05-24,(02101) Toberín,186,133,190,509
30960,2020-08-07,(05100) Banderas P. Central - alimentacion,1112,474,620,2206
30961,2020-01-05,(10010) San Bernardo,315,201,432,948
30962,2020-01-10,(07004) VENECIA,3523,1962,2080,7565
30963,2020-03-11,(07004) VENECIA,4207,2346,2366,8919
30964,2020-03-18,(03007) HUMEDAL CORDOBA,380,258,225,863
30965,2020-01-11,(09117) Calle 45,1318,900,1505,3723
30966,2020-07-01,(09117) Calle 45,743,459,470,1672
30967,2020-07-02,(03002) SUBA - TV- 91,816,485,472,1773
30968,2020-09-23,(09110) Avenida Jimenez,1716,1189,1038,3943
30969,2020-01-02,(07007) NQS - Calle 38A Sur,970,631,651,2252
30970,2020-04-06,(05002) Tintal,1109,662,631,2402
30971,2020-10-07,(06104) Gobernación,302,207,207,716
30972,2020-04-19,(09001) Molinos,449,279,284,1012
30973,2020-05-02,(05001) Patio Bonito,812,429,439,1680
30974,2020-07-30,(09002) Consuelo,454,239,247,940
30975,2020-09-16,(04108) El Polo,536,339,326,1201
30976,2020-03-30,(09120) Calle 63,523,390,353,1266
30977,2020-03-30,(02302) Virrey,331,239,219,789
30978,2020-08-02,(03010) PUENTE LARGO,62,47,70,179
30979,2020-04-19,(09109) Tercer Milenio,63,51,64,178
30980,2020-07-20,(09116) Avenida 39,94,71,81,246
30981,2020-07-27,(07103) AV. CHILE,913,507,415,1835
30982,2020-01-03,(07007) NQS - Calle 38A Sur,1055,643,760,2458
30983,2020-10-03,(05107) Américas - Cr.53,306,235,388,929
30984,2020-06-16,(02103) Mazurén,201,131,152,484
30985,2020-01-12,(07103) AV. CHILE,464,348,666,1478
30986,2020-10-08,(07103) AV. CHILE,1010,625,673,2308
30987,2020-09-29,(12007) Zona Industrial,408,276,209,893
30988,2020-03-18,(10005) Bicentenario,448,225,214,887
30989,2020-09-06,(10005) Bicentenario,22,19,28,69
30990,2020-05-21,(02304) Heroes,651,460,387,1498
30991,2020-06-03,(04100) Carrera 77,1150,651,683,2484
30992,2020-03-13,(07104) Simon Bolivar,671,171,227,1069
30993,2020-01-12,(09110) Avenida Jimenez,921,736,1002,2659
30994,2020-09-29,(10008) San Diego,337,203,245,785
30995,2020-09-01,(05105) Pradera,570,343,276,1189
30996,2020-08-18,(06111) Universidades,302,180,268,750
30997,2020-06-23,(03006) NIZA - CALLE 127,492,313,262,1067
30998,2020-08-17,(02204) Pepe Sierra,222,177,149,548
30999,2020-07-07,(07110) PALOQUEMAO,662,406,289,1357
31000,2020-04-12,(02000) Cabecera Autopista Norte,188,134,108,430
31001,2020-05-10,(09111) Calle 19,134,84,136,354
31002,2020-02-12,(12004) Carrera 22,732,436,460,1628
31003,2020-02-19,(12004) Carrera 22,726,453,500,1679
31004,2020-08-28,(09122) Calle 72,1162,803,826,2791
31005,2020-04-04,(09111) Calle 19,170,118,168,456
31006,2020-04-14,(06109) Centro Memoria,157,101,106,364
31007,2020-06-16,(09120) Calle 63,1141,774,659,2574
31008,2020-07-03,(06104) Gobernación,250,149,124,523
31009,2020-06-11,(09121) Las Flores,702,454,399,1555
31010,2020-05-12,(02200) Alcalá,1372,961,707,3040
31011,2020-06-27,(02200) Alcalá,1559,1032,894,3485
31012,2020-08-03,(02200) Alcalá,1420,1009,818,3247
31013,2020-09-12,(07107) U. NACIONAL,270,177,211,658
31014,2020-05-09,(09123) Calle 76,423,319,281,1023
31015,2020-08-26,(09123) Calle 76,918,650,524,2092
31016,2020-08-25,(03003) 21 ANGELES,297,169,146,612
31017,2020-06-12,(07004) VENECIA,970,580,525,2075
31018,2020-01-26,(07007) NQS - Calle 38A Sur,610,343,465,1418
31019,2020-05-13,(02104) Calle 146,567,359,378,1304
31020,2020-08-10,(06000) Portal Eldorado,853,553,445,1851
31021,2020-05-21,(07110) PALOQUEMAO,603,329,211,1143
31022,2020-07-28,(07110) PALOQUEMAO,567,365,278,1210
31023,2020-10-08,(07009) SENA,742,449,634,1825
31024,2020-09-19,(40002) Manitas,345,205,308,858
31025,2020-05-15,(10007) Las Nieves,410,262,286,958
31026,2020-07-14,(08002) Biblioteca,189,112,116,417
31027,2020-08-20,(10002) Av. Primero de Mayo,1959,1027,1242,4228
31028,2020-04-15,(14005) Las Aguas,0,42,88,130
31029,2020-06-02,(03005) SUBA - AV. BOYACA,386,213,224,823
31030,2020-05-12,(07107) U. NACIONAL,259,151,126,536
31031,2020-07-30,(02103) Mazurén,161,116,162,439
31032,2020-05-04,(10009) Museo Nacional,383,219,208,810
31033,2020-05-12,(10009) Museo Nacional,410,267,223,900
31034,2020-05-18,(04106) Carrera 47,243,166,147,556
31035,2020-02-19,(07008) NQS - Calle 30 Sur,2059,1073,1021,4153
31036,2020-06-07,(50003) Corral Molinos,439,201,358,998
31037,2020-05-10,(40003) Mirador del Paraiso,393,236,304,933
31038,2020-09-19,(06106) Recinto Ferial,231,141,177,549
31039,2020-08-17,(04003) Avenida Ciudad de Cali,264,141,239,644
31040,2020-08-27,(12002) CDS - Carrera 32,193,117,82,392
31041,2020-07-31,(06002) Normandía,229,126,150,505
31042,2020-08-20,(04001) Quirigua,348,220,234,802
31043,2020-06-19,(09108) Hospital,74,49,59,182
31044,2020-04-26,(06102) Salitre El Greco,64,42,32,138
31045,2020-06-29,(02201) Prado,324,224,223,771
31046,2020-06-22,(03012) SUBA - CALLE 95,85,54,57,196
31047,2020-04-11,(05105) Pradera,163,128,77,368
31048,2020-09-02,(09111) Calle 19,776,496,545,1817
31049,2020-06-05,(09115) Calle 34,635,418,361,1414
31050,2020-05-12,(09117) Calle 45,589,358,323,1270
31051,2020-03-27,(09110) Avenida Jimenez,216,179,241,636
31052,2020-07-13,(09113) Calle 22,233,157,254,644
31053,2020-10-04,(07506) DESPENSA,124,72,154,350
31054,2020-04-13,(06001) Modelia,255,177,139,571
31055,2020-02-16,(14001) La Sabana,97,89,132,318
31056,2020-06-20,(12003) Ricaurte,304,228,151,683
31057,2020-05-02,(05100) Banderas P. Central,221,133,158,512
31058,2020-07-20,(09121) Las Flores,179,129,130,438
31059,2020-08-15,(02102) Calle 161,185,86,178,449
31060,2020-09-30,(09106) Nariño,484,295,431,1210
31061,2020-04-07,(07010) Bosa,273,155,193,621
31062,2020-05-10,(07104) Simon Bolivar,97,54,42,193
31063,2020-03-20,(04108) El Polo,167,116,107,390
31064,2020-05-20,(07007) NQS - Calle 38A Sur,283,160,189,632
31065,2020-08-02,(09116) Avenida 39,78,59,70,207
31066,2020-04-21,(06104) Gobernación,156,123,70,349
31067,2020-05-03,(12002) CDS - Carrera 32,32,37,17,86
31068,2020-05-02,(10003) Ciudad Jardín,90,51,45,186
31069,2020-06-29,(09111) Calle 19,220,142,209,571
31070,2020-08-23,(09111) Calle 19,163,122,170,455
31071,2020-07-26,(04103) Las Ferias,103,45,68,216
31072,2020-09-27,(09111) Calle 19,209,134,259,602
31073,2020-04-22,(03014) SAN MARTIN,16,7,11,34
31074,2020-06-21,(12002) CDS - Carrera 32,27,26,20,73
31075,2020-05-20,(03010) PUENTE LARGO,286,183,146,615
31076,2020-07-20,(06105) Quinta Paredes,41,20,21,82
31077,2020-09-18,(03004) GRATAMIRA,0,22,40,62
31078,2020-07-27,(50006) Corral Carrera 77,5,1,7,13
31079,2020-05-16,(03004) GRATAMIRA,24,12,15,51
31080,2020-05-12,(07005) ALQUERIA,437,272,219,928
31081,2020-09-01,(07005) ALQUERIA,541,314,339,1194
31082,2020-07-26,(09002) Consuelo,113,55,75,243
31083,2020-03-02,(02502) Terminal,5261,3427,2720,11408
31084,2020-07-16,(02502) Terminal,368,234,267,869
31085,2020-02-15,(03013) RIO NEGRO,738,456,679,1873
31086,2020-08-10,(07504) TERREROS,5666,3146,2789,11601
31087,2020-09-26,(07504) TERREROS,5617,2411,3521,11549
31088,2020-10-08,(07504) TERREROS,7079,3546,4292,14917
31089,2020-08-26,(09119) Calle 57,483,316,337,1136
31090,2020-01-24,(03002) SUBA - TV- 91,4181,2244,2282,8707
31091,2020-01-31,(09100) Calle 40 Sur,7143,3792,4186,15121
31092,2020-02-23,(06104) Gobernación,126,97,189,412
31093,2020-01-24,(09114) Calle 26,2470,1787,1610,5867
31094,2020-02-29,(04002) Carrera 90,2110,981,1566,4657
31095,2020-09-10,(04002) Carrera 90,738,395,442,1575
31096,2020-03-17,(09001) Molinos,5338,2965,3674,11977
31097,2020-01-31,(07000) Portal Sur - alimentacion,28249,15266,14749,58264
31098,2020-06-06,(07112) COMUNEROS,601,336,346,1283
31099,2020-01-24,(10004) Policarpa,806,422,528,1756
31100,2020-02-23,(03000) Portal Suba - alimentacion,6018,2848,5245,14111
31101,2020-05-13,(09109) Tercer Milenio,273,188,170,631
31102,2020-01-30,(04101) Minuto de Dios,2675,1594,1609,5878
31103,2020-01-25,(07505) LEON XIII,5769,2829,2945,11543
31104,2020-08-13,(05002) Tintal,2341,1325,1335,5001
31105,2020-03-01,(05000) Portal Américas,2687,1136,2549,6372
31106,2020-06-18,(07102) NQS - CALLE 75,434,285,242,961
31107,2020-09-07,(07102) NQS - CALLE 75,490,303,244,1037
31108,2020-05-25,(09000) Cabecera Usme - alimentacion,2518,1289,1373,5180
31109,2020-01-11,(09118) Marly,2503,1765,2100,6368
31110,2020-04-04,(09104) Restrepo,505,376,427,1308
31111,2020-02-07,(02103) Mazurén,3539,2023,1936,7498
31112,2020-01-10,(02001) Centro Comercial Santa Fe,3241,1863,2052,7156
31113,2020-07-03,(07000) Portal Sur - alimentacion,8521,4825,4414,17760
31114,2020-07-07,(07002) MADELENA,939,542,545,2026
31115,2020-08-11,(07002) MADELENA,756,438,498,1692
31116,2020-03-02,(07111) NQS - RICAURTE,3109,1908,1735,6752
31117,2020-05-13,(07111) NQS - RICAURTE,915,584,323,1822
31118,2020-02-03,(02000) Cabecera Autopista Norte - intermunicipal,4976,3472,2996,11444
31119,2020-09-16,(09004) Santa Lucía,2436,1413,1846,5695
31120,2020-02-05,(09114) Calle 26,3156,2079,1855,7090
31121,2020-01-13,(50003) Corral Molinos,3174,1808,2973,7955
31122,2020-04-30,(50003) Corral Molinos,896,397,611,1904
31123,2020-05-23,(05000) Portal Américas,1593,1026,1135,3754
31124,2020-08-09,(08000) Portal Tunal - alimentacion,1861,858,1140,3859
31125,2020-01-08,(09120) Calle 63,2985,2286,2529,7800
31126,2020-02-20,(04003) Avenida Ciudad de Cali,5606,3309,3292,12207
31127,2020-03-19,(10001) Country Sur,2549,1042,1409,5000
31128,2020-09-06,(03000) Portal Suba,404,243,471,1118
31129,2020-02-21,(10000) Portal 20 de Julio,8914,3981,3939,16834
31130,2020-02-24,(10000) Portal 20 de Julio,9066,4319,3950,17335
31131,2020-01-06,(09004) Santa Lucía,1582,666,1273,3521
31132,2020-07-01,(10002) Av. Primero de Mayo,2271,1115,1419,4805
31133,2020-09-18,(06105) Quinta Paredes,171,108,113,392
31134,2020-01-23,(06101) El Tiempo,2753,1511,1341,5605
31135,2020-01-30,(09101) Quiroga,1496,937,1238,3671
31136,2020-03-11,(08001) Parque el Tunal,1639,911,941,3491
31137,2020-07-14,(10000) Portal 20 de Julio,1483,791,764,3038
31138,2020-04-15,(07112) COMUNEROS,417,282,216,915
31139,2020-07-08,(02303) Calle 85,814,521,364,1699
31140,2020-06-20,(09004) Santa Lucía,2200,1144,1192,4536
31141,2020-01-25,(02502) Terminal,1534,879,1532,3945
31142,2020-04-08,(04100) Carrera 77,558,330,372,1260
31143,2020-05-04,(08001) Parque el Tunal,266,161,179,606
31144,2020-01-20,(06103) CAN,2410,1418,1103,4931
31145,2020-02-25,(06103) CAN,2754,1605,1146,5505
31146,2020-01-08,(06108) Concejo de Bogotá,594,296,368,1258
31147,2020-01-22,(06108) Concejo de Bogotá,855,416,460,1731
31148,2020-04-27,(06108) Concejo de Bogotá,21,43,16,80
31149,2020-05-20,(10002) Av. Primero de Mayo,1718,943,1033,3694
31150,2020-08-11,(02101) Toberín,1278,813,852,2943
31151,2020-02-12,(10009) Museo Nacional,4732,2465,2012,9209
31152,2020-05-31,(09107) Hortúa,182,133,135,450
31153,2020-07-03,(09123) Calle 76,1141,761,671,2573
31154,2020-08-11,(05002) Tintal,2325,1313,1391,5029
31155,2020-07-25,(05103) Marsella,199,100,104,403
31156,2020-04-22,(02300) Calle 100,791,564,392,1747
31157,2020-06-16,(02300) Calle 100,1372,834,651,2857
31158,2020-07-08,(09119) Calle 57,596,366,427,1389
31159,2020-01-04,(08000) Portal Tunal,876,556,580,2012
31160,2020-03-06,(03006) NIZA - CALLE 127,2402,1507,1544,5453
31161,2020-05-07,(09101) Quiroga,331,190,218,739
31162,2020-06-01,(04108) El Polo,441,288,217,946
31163,2020-03-17,(02300) Calle 100,3951,2617,2182,8750
31164,2020-02-01,(07000) Portal Sur,4675,2312,3587,10574
31165,2020-01-04,(02202) Calle 127,1705,1112,1182,3999
31166,2020-03-16,(07201) Guatoque -Veraguas,676,359,466,1501
31167,2020-02-16,(07113) SANTA ISABEL,488,265,636,1389
31168,2020-05-27,(03007) HUMEDAL CORDOBA,120,83,54,257
31169,2020-09-19,(03007) HUMEDAL CORDOBA,118,75,89,282
31170,2020-10-09,(03007) HUMEDAL CORDOBA,167,118,132,417
31171,2020-09-25,(03001) LA CAMPIÑA,1497,818,980,3295
31172,2020-06-18,(02101) Toberín,1499,963,932,3394
31173,2020-04-06,(10000) Portal 20 de Julio,1166,597,557,2320
31174,2020-01-19,(04103) Las Ferias,284,163,305,752
31175,2020-07-07,(10003) Ciudad Jardín,240,106,183,529
31176,2020-10-12,(07000) Portal Sur,596,298,654,1548
31177,2020-03-30,(07110) PALOQUEMAO,318,247,201,766
31178,2020-03-25,(09100) Calle 40 Sur,847,496,527,1870
31179,2020-06-06,(10005) Bicentenario - alimentacion,161,75,147,383
31180,2020-06-16,(10005) Bicentenario - alimentacion,229,122,165,516
31181,2020-06-09,(04107) Escuela Militar,129,85,72,286
31182,2020-01-14,(07004) VENECIA,3989,2343,2326,8658
31183,2020-03-12,(09121) Las Flores,1393,201,484,2078
31184,2020-10-07,(07000) Portal Sur,2312,1360,1746,5418
31185,2020-05-18,(09000) Cabecera Usme,1365,836,952,3153
31186,2020-02-26,(05103) Marsella,3293,1698,1471,6462
31187,2020-03-07,(09117) Calle 45,2599,1748,2422,6769
31188,2020-06-21,(04002) Carrera 90,227,94,165,486
31189,2020-07-14,(06000) Portal Eldorado,848,510,397,1755
31190,2020-01-26,(02200) Alcalá,2002,1121,2072,5195
31191,2020-04-15,(04105) Carrera 53,175,108,77,360
31192,2020-06-25,(08000) Portal Tunal - alimentacion,6452,3730,3551,13733
31193,2020-08-21,(04100) Carrera 77,1124,651,804,2579
31194,2020-05-15,(04100) Carrera 77,969,525,621,2115
31195,2020-06-06,(02204) Pepe Sierra,536,388,335,1259
31196,2020-08-01,(02204) Pepe Sierra,455,365,329,1149
31197,2020-08-28,(07101) CASTELLANA,211,127,132,470
31198,2020-06-02,(05001) Patio Bonito,1193,697,780,2670
31199,2020-01-18,(06100) Av. Rojas,660,405,681,1746
31200,2020-04-23,(06000) Portal Eldorado,847,562,347,1756
31201,2020-03-14,(09122) Calle 72,2911,2016,2773,7700
31202,2020-04-07,(03009) Av. Suba- Calle 116,326,242,194,762
31203,2020-09-29,(04104) Avenida 68,736,365,503,1604
31204,2020-03-21,(02105) Calle 142,213,163,165,541
31205,2020-05-21,(02105) Calle 142,631,384,335,1350
31206,2020-06-15,(02105) Calle 142,211,167,172,550
31207,2020-01-21,(03013) RIO NEGRO,759,502,599,1860
31208,2020-02-22,(07107) U. NACIONAL,881,670,902,2453
31209,2020-05-02,(03006) NIZA - CALLE 127,190,123,86,399
31210,2020-10-01,(03006) NIZA - CALLE 127,575,329,364,1268
31211,2020-06-23,(03002) SUBA - TV- 91,809,471,471,1751
31212,2020-07-05,(03002) SUBA - TV- 91,244,115,215,574
31213,2020-06-11,(02103) Mazurén,182,125,137,444
31214,2020-03-01,(07201) Guatoque -Veraguas,96,91,278,465
31215,2020-01-16,(40002) Manitas,1080,622,741,2443
31216,2020-05-26,(02105) Calle 142,691,461,391,1543
31217,2020-09-30,(02001) Centro Comercial Santa Fe,653,392,500,1545
31218,2020-07-17,(02102) Calle 161,242,139,141,522
31219,2020-05-19,(02200) Alcalá,1391,1008,693,3092
31220,2020-07-09,(10009) Museo Nacional,515,319,350,1184
31221,2020-07-30,(06111) Universidades,315,173,285,773
31222,2020-10-02,(06111) Universidades,496,280,488,1264
31223,2020-07-16,(03006) NIZA - CALLE 127,445,237,187,869
31224,2020-07-13,(07110) PALOQUEMAO,508,306,255,1069
31225,2020-07-18,(07110) PALOQUEMAO,370,244,190,804
31226,2020-02-10,(07104) Simon Bolivar,2477,1556,1218,5251
31227,2020-06-01,(07200) Tygua-San José,242,113,145,500
31228,2020-07-10,(09122) Calle 72,1271,850,822,2943
31229,2020-04-21,(03002) SUBA - TV- 91,412,251,205,868
31230,2020-04-07,(10001) Country Sur,551,244,366,1161
31231,2020-04-20,(03000) Portal Suba,610,364,381,1355
31232,2020-06-20,(07107) U. NACIONAL,245,156,175,576
31233,2020-02-02,(07102) NQS - CALLE 75,198,159,304,661
31234,2020-08-07,(09123) Calle 76,300,227,234,761
31235,2020-06-07,(07104) Simon Bolivar,122,66,100,288
31236,2020-07-19,(06109) Centro Memoria,75,41,55,171
31237,2020-05-07,(03003) 21 ANGELES,227,95,101,423
31238,2020-08-19,(03003) 21 ANGELES,296,170,158,624
31239,2020-07-10,(10007) Las Nieves,708,425,424,1557
31240,2020-04-05,(10001) Country Sur,208,101,111,420
31241,2020-07-17,(06107) Ciudad Universitaria,149,83,93,325
31242,2020-09-21,(03011) SUBA - CALLE 100,515,254,267,1036
31243,2020-05-12,(05102) Av. Américas - Av. Boyacá,154,94,82,330
31244,2020-09-29,(05102) Av. Américas - Av. Boyacá,280,166,252,698
31245,2020-06-21,(40001) Juan Pablo II,157,88,106,351
31246,2020-09-10,(40002) Manitas,398,241,279,918
31247,2020-08-28,(03005) SUBA - AV. BOYACA,466,263,309,1038
31248,2020-10-07,(07007) NQS - Calle 38A Sur,458,309,443,1210
31249,2020-10-09,(14005) Las Aguas,262,192,350,804
31250,2020-10-10,(14005) Las Aguas,180,132,319,631
31251,2020-08-27,(02102) Calle 161,237,145,152,534
31252,2020-09-25,(05101) Mandalay - Cr.73,183,100,120,403
31253,2020-03-28,(09119) Calle 57,157,127,161,445
31254,2020-08-26,(02300) Calle 100,1081,720,601,2402
31255,2020-05-02,(02101) Toberín,418,293,313,1024
31256,2020-04-21,(04102) Avenida Boyaca,157,88,101,346
31257,2020-10-06,(12002) CDS - Carrera 32,221,145,104,470
31258,2020-07-09,(07008) NQS - Calle 30 Sur,317,180,188,685
31259,2020-07-17,(06002) Normandía,262,160,158,580
31260,2020-05-26,(05107) Américas - Cr.53,384,256,242,882
31261,2020-04-06,(04000) Cabecera Calle 80 - intermunicipal,121,74,96,291
31262,2020-09-07,(04000) Cabecera Calle 80 - intermunicipal,400,196,373,969
31263,2020-03-21,(04001) Quirigua,102,66,45,213
31264,2020-09-15,(04001) Quirigua,433,262,298,993
31265,2020-09-07,(09108) Hospital,30,49,87,166
31266,2020-05-14,(06103) CAN,345,220,151,716
31267,2020-08-20,(07010) Bosa,645,307,374,1326
31268,2020-05-27,(02304) Heroes,686,501,362,1549
31269,2020-05-31,(09111) Calle 19,196,116,178,490
31270,2020-06-11,(06105) Quinta Paredes,138,93,66,297
31271,2020-03-23,(02001) Centro Comercial Santa Fe,69,61,63,193
31272,2020-05-04,(02303) Calle 85,413,310,261,984
31273,2020-05-27,(10005) Bicentenario,93,42,78,213
31274,2020-06-21,(10009) Museo Nacional,93,71,138,302
31275,2020-06-18,(10004) Policarpa,242,122,151,515
31276,2020-09-09,(10004) Policarpa,262,131,194,587
31277,2020-04-19,(09111) Calle 19,110,78,103,291
31278,2020-04-21,(07010) Bosa,338,185,229,752
31279,2020-09-05,(12004) Carrera 22,201,141,149,491
31280,2020-06-28,(07006) General Santander - alimentacion,89,50,91,230
31281,2020-05-02,(09121) Las Flores,286,208,193,687
31282,2020-08-05,(40002) Manitas,359,238,211,808
31283,2020-06-30,(07106) EL CAMPIN,383,254,204,841
31284,2020-10-03,(06104) Gobernación,139,120,203,462
31285,2020-02-16,(50006) Corral Carrera 77,12,8,14,34
31286,2020-04-22,(14005) Las Aguas,0,27,99,126
31287,2020-04-23,(12007) Zona Industrial,232,182,95,509
31288,2020-04-11,(06103) CAN,193,158,90,441
31289,2020-07-20,(03003) 21 ANGELES,94,34,52,180
31290,2020-03-24,(03004) GRATAMIRA,27,23,30,80
31291,2020-04-11,(03005) SUBA - AV. BOYACA,131,81,72,284
31292,2020-06-15,(04107) Escuela Militar,41,35,46,122
31293,2020-07-29,(50006) Corral Carrera 77,6,3,3,12
31294,2020-08-11,(50006) Corral Carrera 77,3,2,4,9
31295,2020-09-08,(50006) Corral Carrera 77,5,3,12,20
31296,2020-08-17,(06106) Recinto Ferial,62,46,45,153
31297,2020-04-09,(06104) Gobernación,52,48,30,130
31298,2020-06-29,(09105) Río Fucha,33,15,33,81
31299,2020-04-21,(03014) SAN MARTIN,18,12,17,47
31300,2020-03-22,(04107) Escuela Militar,21,13,15,49
31301,2020-09-17,(03004) GRATAMIRA,0,23,29,52
31302,2020-06-17,(04000) Cabecera Calle 80 - alimentacion,4064,2344,2448,8856
31303,2020-09-03,(04000) Cabecera Calle 80 - alimentacion,4442,2495,3135,10072
31304,2020-09-24,(04000) Cabecera Calle 80 - alimentacion,4809,2660,3605,11074
31305,2020-01-09,(02502) Terminal,3233,2128,2050,7411
31306,2020-02-28,(07504) TERREROS,17486,10167,9688,37341
31307,2020-07-29,(07504) TERREROS,5791,3193,2650,11634
31308,2020-08-12,(07504) TERREROS,5801,3209,2673,11683
31309,2020-01-09,(03002) SUBA - TV- 91,3092,1800,1859,6751
31310,2020-01-10,(09122) Calle 72,4529,3100,3147,10776
31311,2020-08-10,(05000) Portal Américas,2612,1728,1875,6215
31312,2020-05-23,(09000) Cabecera Usme - alimentacion,5515,3001,3193,11709
31313,2020-01-22,(04002) Carrera 90,3395,1983,1972,7350
31314,2020-01-10,(02000) Cabecera Autopista Norte - alimentacion,16680,8729,10471,35880
31315,2020-02-12,(05005) Transversal 86,2875,1647,1328,5850
31316,2020-02-27,(09000) Cabecera Usme - alimentacion,26010,14636,15483,56129
31317,2020-02-21,(10004) Policarpa,893,400,539,1832
31318,2020-09-18,(10001) Country Sur,1481,680,1051,3212
31319,2020-01-28,(09115) Calle 34,4067,2616,2351,9034
31320,2020-02-10,(02105) Calle 142,7473,4709,3823,16005
31321,2020-04-17,(06000) Portal Eldorado - alimentacion,2401,1121,1110,4632
31322,2020-02-07,(06102) Salitre El Greco,1555,895,744,3194
31323,2020-02-21,(10002) Av. Primero de Mayo,8191,3960,4666,16817
31324,2020-02-10,(02204) Pepe Sierra,5110,3428,2407,10945
31325,2020-09-21,(02105) Calle 142,732,451,521,1704
31326,2020-02-25,(02205) Calle 106,2802,1795,1374,5971
31327,2020-05-22,(09000) Cabecera Usme - alimentacion,7201,3981,4026,15208
31328,2020-08-05,(09104) Restrepo,1474,809,1020,3303
31329,2020-07-07,(04101) Minuto de Dios,353,222,278,853
31330,2020-07-14,(04101) Minuto de Dios,281,157,168,606
31331,2020-01-02,(09110) Avenida Jimenez,1547,1142,1279,3968
31332,2020-01-02,(05001) Patio Bonito,2939,1631,2042,6612
31333,2020-07-30,(09118) Marly,1370,887,715,2972
31334,2020-01-10,(02103) Mazurén,2163,1205,1331,4699
31335,2020-01-31,(14001) La Sabana,456,328,391,1175
31336,2020-02-17,(14001) La Sabana,638,403,400,1441
31337,2020-09-30,(14001) La Sabana,170,109,124,403
31338,2020-07-19,(02000) Cabecera Autopista Norte - alimentacion,1607,722,908,3237
31339,2020-06-20,(07504) TERREROS,4659,2430,2533,9622
31340,2020-03-11,(03003) 21 ANGELES,1660,818,858,3336
31341,2020-09-02,(09001) Molinos,2737,1501,1892,6130
31342,2020-07-14,(08000) Portal Tunal - alimentacion,3808,2277,2300,8385
31343,2020-02-21,(50003) Corral Molinos,1061,2555,4978,8594
31344,2020-09-20,(05000) Portal Américas,978,496,1047,2521
31345,2020-03-17,(04000) Cabecera Calle 80,3983,2271,2478,8732
31346,2020-07-30,(04000) Cabecera Calle 80,1067,696,848,2611
31347,2020-08-10,(04000) Cabecera Calle 80,862,595,741,2198
31348,2020-01-07,(04003) Avenida Ciudad de Cali,3766,2115,2484,8365
31349,2020-02-15,(10001) Country Sur,3088,1192,2290,6570
31350,2020-02-06,(10008) San Diego,1548,908,834,3290
31351,2020-07-06,(40003) Mirador del Paraiso,1829,1161,1131,4121
31352,2020-07-12,(40003) Mirador del Paraiso,823,415,566,1804
31353,2020-01-30,(02000) Cabecera Autopista Norte - intermunicipal,4868,3287,2936,11091
31354,2020-02-08,(09107) Hortúa,1294,785,1165,3244
31355,2020-07-11,(10005) Bicentenario - alimentacion,174,86,188,448
31356,2020-04-15,(09103) Olaya,483,296,296,1075
31357,2020-01-11,(02201) Prado,2412,1313,1717,5442
31358,2020-07-21,(03000) Portal Suba,1164,722,717,2603
31359,2020-03-26,(02000) Cabecera Autopista Norte - intermunicipal,129,103,83,315
31360,2020-07-01,(02000) Cabecera Autopista Norte - intermunicipal,593,395,430,1418
31361,2020-03-26,(08001) Parque el Tunal,218,123,108,449
31362,2020-01-28,(10000) Portal 20 de Julio,8723,4105,3907,16735
31363,2020-07-06,(10000) Portal 20 de Julio,2434,1233,1284,4951
31364,2020-09-26,(02300) Calle 100,729,563,849,2141
31365,2020-05-30,(07007) NQS - Calle 38A Sur,268,150,148,566
31366,2020-08-13,(09116) Avenida 39,343,218,212,773
31367,2020-07-13,(02201) Prado,808,547,444,1799
31368,2020-02-27,(03005) SUBA - AV. BOYACA,2810,1691,1538,6039
31369,2020-06-20,(09107) Hortúa,454,242,313,1009
31370,2020-08-22,(09107) Hortúa,404,242,277,923
31371,2020-07-25,(05002) Tintal,1330,733,810,2873
31372,2020-09-25,(10000) Portal 20 de Julio,2595,1214,1559,5368
31373,2020-01-16,(06000) Portal Eldorado,5439,3322,2637,11398
31374,2020-08-27,(05101) Mandalay - Cr.73,139,93,75,307
31375,2020-07-27,(05105) Pradera,464,287,253,1004
31376,2020-03-09,(10008) San Diego,921,69,184,1174
31377,2020-08-06,(03009) Av. Suba- Calle 116,418,251,192,861
31378,2020-08-08,(03009) Av. Suba- Calle 116,240,178,140,558
31379,2020-09-04,(04003) Avenida Ciudad de Cali,1146,650,935,2731
31380,2020-05-11,(05000) Portal Américas - alimentacion,8253,4201,3791,16245
31381,2020-01-31,(07201) Guatoque -Veraguas,954,497,627,2078
31382,2020-03-13,(07201) Guatoque -Veraguas,155,111,127,393
31383,2020-05-16,(09118) Marly,915,611,471,1997
31384,2020-10-07,(07106) EL CAMPIN,506,342,328,1176
31385,2020-03-24,(06106) Recinto Ferial,235,166,152,553
31386,2020-08-25,(07113) SANTA ISABEL,360,199,271,830
31387,2020-04-01,(03007) HUMEDAL CORDOBA,67,40,37,144
31388,2020-01-21,(09117) Calle 45,3706,2220,1824,7750
31389,2020-02-18,(03010) PUENTE LARGO,2166,1495,1233,4894
31390,2020-02-10,(05101) Mandalay - Cr.73,1235,718,601,2554
31391,2020-01-31,(06101) El Tiempo,2808,1586,1452,5846
31392,2020-01-30,(06105) Quinta Paredes,1043,609,460,2112
31393,2020-07-23,(09100) Calle 40 Sur,1292,723,813,2828
31394,2020-05-19,(07104) Simon Bolivar,540,342,230,1112
31395,2020-06-01,(10005) Bicentenario - alimentacion,211,115,179,505
31396,2020-09-03,(09121) Las Flores,712,449,489,1650
31397,2020-04-20,(40003) Mirador del Paraiso,802,483,551,1836
31398,2020-01-13,(09109) Tercer Milenio,1171,680,769,2620
31399,2020-01-09,(03003) 21 ANGELES,1205,573,664,2442
31400,2020-08-18,(09110) Avenida Jimenez,769,625,703,2097
31401,2020-08-23,(09101) Quiroga,160,73,144,377
31402,2020-04-09,(09001) Molinos,476,305,311,1092
31403,2020-02-16,(02205) Calle 106,209,211,400,820
31404,2020-05-19,(05001) Patio Bonito,1412,761,785,2958
31405,2020-09-06,(05001) Patio Bonito,738,338,575,1651
31406,2020-03-28,(03001) LA CAMPIÑA,287,161,160,608
31407,2020-06-04,(07113) SANTA ISABEL,374,245,270,889
31408,2020-06-05,(02105) Calle 142,747,462,392,1601
31409,2020-01-27,(09122) Calle 72,7117,4403,3883,15403
31410,2020-05-14,(12003) Ricaurte,266,199,128,593
31411,2020-07-25,(12003) Ricaurte,176,127,98,401
31412,2020-05-19,(07106) EL CAMPIN,247,181,153,581
31413,2020-01-04,(03010) PUENTE LARGO,481,359,435,1275
31414,2020-01-18,(03010) PUENTE LARGO,787,527,732,2046
31415,2020-09-03,(10010) San Bernardo,640,348,498,1486
31416,2020-01-01,(03009) Av. Suba- Calle 116,207,135,235,577
31417,2020-08-06,(10000) Portal 20 de Julio - alimentacion,4036,1726,2345,8107
31418,2020-05-14,(02105) Calle 142,574,370,334,1278
31419,2020-04-28,(09002) Consuelo,309,130,181,620
31420,2020-08-27,(03002) SUBA - TV- 91,742,444,488,1674
31421,2020-04-12,(10010) San Bernardo,207,111,130,448
31422,2020-08-16,(10010) San Bernardo,192,110,192,494
31423,2020-05-24,(07103) AV. CHILE,148,101,123,372
31424,2020-09-04,(07103) AV. CHILE,916,593,550,2059
31425,2020-06-29,(10005) Bicentenario,24,17,28,69
31426,2020-09-27,(10005) Bicentenario,36,15,53,104
31427,2020-01-24,(40002) Manitas,1250,679,734,2663
31428,2020-06-23,(40002) Manitas,437,283,272,992
31429,2020-07-26,(02001) Centro Comercial Santa Fe,119,91,102,312
31430,2020-05-24,(02200) Alcalá,461,328,266,1055
31431,2020-06-01,(03011) SUBA - CALLE 100,478,219,210,907
31432,2020-08-28,(08000) Portal Tunal,830,317,305,1452
31433,2020-09-10,(05105) Pradera,591,365,287,1243
31434,2020-09-04,(09115) Calle 34,687,453,556,1696
31435,2020-08-04,(09115) Calle 34,600,349,342,1291
31436,2020-03-26,(02204) Pepe Sierra,407,311,282,1000
31437,2020-09-02,(02204) Pepe Sierra,829,597,467,1893
31438,2020-04-28,(05105) Pradera,444,302,167,913
31439,2020-01-26,(14004) Museo del Oro,0,164,426,590
31440,2020-04-01,(03012) SUBA - CALLE 95,163,121,93,377
31441,2020-10-01,(09122) Calle 72,1346,899,1128,3373
31442,2020-05-01,(02303) Calle 85,173,132,110,415
31443,2020-08-07,(09002) Consuelo,223,106,158,487
31444,2020-08-14,(07201) Guatoque -Veraguas,195,107,125,427
31445,2020-03-16,(07107) U. NACIONAL,1186,793,693,2672
31446,2020-08-25,(07105) MOVISTAR ARENA,242,126,131,499
31447,2020-04-03,(09121) Las Flores,395,303,253,951
31448,2020-06-01,(02200) Alcalá,1634,1197,870,3701
31449,2020-08-24,(02303) Calle 85,594,407,316,1317
31450,2020-04-19,(06109) Centro Memoria,53,43,40,136
31451,2020-10-02,(03003) 21 ANGELES,400,205,275,880
31452,2020-08-10,(14004) Museo del Oro,308,173,208,689
31453,2020-07-26,(09119) Calle 57,161,80,117,358
31454,2020-10-12,(09119) Calle 57,200,136,272,608
31455,2020-08-13,(04103) Las Ferias,294,146,155,595
31456,2020-03-24,(05005) Transversal 86,393,200,236,829
31457,2020-04-16,(05005) Transversal 86,187,96,102,385
31458,2020-06-08,(05102) Av. Américas - Av. Boyacá,172,95,130,397
31459,2020-08-11,(09110) Avenida Jimenez,1444,1009,828,3281
31460,2020-08-12,(09122) Calle 72,1051,711,667,2429
31461,2020-03-17,(03010) PUENTE LARGO,1093,733,558,2384
31462,2020-06-10,(03007) HUMEDAL CORDOBA,145,98,53,296
31463,2020-06-08,(12000) Puente Aranda,75,42,37,154
31464,2020-08-24,(12000) Puente Aranda,81,37,32,150
31465,2020-09-06,(09121) Las Flores,191,149,245,585
31466,2020-06-28,(05102) Av. Américas - Av. Boyacá,57,40,39,136
31467,2020-03-26,(02102) Calle 161,88,57,63,208
31468,2020-07-25,(02102) Calle 161,141,100,103,344
31469,2020-07-29,(12004) Carrera 22,227,115,111,453
31470,2020-07-01,(10004) Policarpa,296,131,179,606
31471,2020-08-18,(06001) Modelia,332,210,169,711
31472,2020-09-13,(40003) Mirador del Paraiso,0,214,706,920
31473,2020-05-19,(06101) El Tiempo,278,174,134,586
31474,2020-07-23,(03006) NIZA - CALLE 127,445,268,169,882
31475,2020-03-28,(03013) RIO NEGRO,84,49,59,192
31476,2020-01-27,(07200) Tygua-San José,856,474,586,1916
31477,2020-03-20,(05001) Patio Bonito,871,478,412,1761
31478,2020-04-14,(09115) Calle 34,363,248,205,816
31479,2020-09-27,(04101) Minuto de Dios,107,53,197,357
31480,2020-05-13,(07004) VENECIA,787,445,426,1658
31481,2020-04-30,(02502) Terminal,221,140,191,552
31482,2020-07-06,(06101) El Tiempo,387,226,203,816
31483,2020-05-08,(06103) CAN,315,209,166,690
31484,2020-07-06,(09119) Calle 57,582,353,437,1372
31485,2020-10-01,(09108) Hospital,72,43,88,203
31486,2020-05-11,(03009) Av. Suba- Calle 116,384,247,191,822
31487,2020-06-22,(05105) Pradera,184,141,129,454
31488,2020-01-08,(03004) GRATAMIRA,186,82,134,402
31489,2020-07-11,(12002) CDS - Carrera 32,120,82,65,267
31490,2020-05-14,(04003) Avenida Ciudad de Cali,744,480,462,1686
31491,2020-04-21,(07006) General Santander,259,166,144,569
31492,2020-09-27,(07506) DESPENSA,117,71,151,339
31493,2020-08-28,(07006) General Santander - alimentacion,399,224,281,904
31494,2020-06-07,(09114) Calle 26,44,31,60,135
31495,2020-04-02,(09105) Río Fucha,65,36,42,143
31496,2020-03-21,(04106) Carrera 47,106,55,46,207
31497,2020-03-20,(09108) Hospital,16,14,12,42
31498,2020-08-24,(05103) Marsella,362,170,211,743
31499,2020-04-09,(02304) Heroes,171,135,98,404
31500,2020-04-15,(05100) Banderas P. Central,335,180,234,749
31501,2020-07-25,(03004) GRATAMIRA,32,5,12,49
31502,2020-04-11,(08000) Portal Tunal,233,130,81,444
31503,2020-06-22,(06103) CAN,174,103,80,357
31504,2020-03-28,(09121) Las Flores,282,201,165,648
31505,2020-02-08,(12004) Carrera 22,496,318,386,1200
31506,2020-08-19,(14005) Las Aguas,157,99,146,402
31507,2020-04-13,(07010) Bosa,295,175,213,683
31508,2020-01-13,(12004) Carrera 22,585,356,446,1387
31509,2020-07-07,(07113) SANTA ISABEL,394,247,323,964
31510,2020-08-07,(04107) Escuela Militar,27,25,39,91
31511,2020-05-13,(12007) Zona Industrial,267,173,92,532
31512,2020-09-27,(06103) CAN,133,90,119,342
31513,2020-07-26,(02304) Heroes,169,135,108,412
31514,2020-03-25,(07008) NQS - Calle 30 Sur,154,81,73,308
31515,2020-05-31,(10007) Las Nieves,75,67,96,238
31516,2020-06-14,(07201) Guatoque -Veraguas,26,19,60,105
31517,2020-03-23,(04107) Escuela Militar,18,20,17,55
31518,2020-08-30,(06105) Quinta Paredes,35,30,37,102
31519,2020-04-14,(07106) EL CAMPIN,174,134,117,425
31520,2020-04-24,(10003) Ciudad Jardín,97,75,64,236
31521,2020-04-01,(07201) Guatoque -Veraguas,55,43,71,169
31522,2020-10-12,(05005) Transversal 86,128,48,151,327
31523,2020-08-30,(09105) Río Fucha,0,34,54,88
31524,2020-07-05,(03014) SAN MARTIN,5,2,12,19
31525,2020-05-25,(04108) El Polo,81,65,67,213
31526,2020-04-27,(10005) Bicentenario,12,20,9,41
31527,2020-04-09,(04103) Las Ferias,62,49,45,156
31528,2020-09-13,(50002) Corral Calle 40 Sur,5,6,4,15
31529,2020-05-06,(04000) Cabecera Calle 80 - alimentacion,2533,1411,1441,5385
31530,2020-02-24,(02502) Terminal,5305,3528,2957,11790
31531,2020-07-18,(02502) Terminal,242,145,208,595
31532,2020-10-03,(02502) Terminal,317,246,497,1060
31533,2020-08-18,(09118) Marly,1345,827,674,2846
31534,2020-03-06,(04106) Carrera 47,1528,837,934,3299
31535,2020-02-27,(03002) SUBA - TV- 91,4692,2735,2398,9825
31536,2020-01-28,(02101) Toberín,14636,9250,7659,31545
31537,2020-02-11,(07505) LEON XIII,8631,4996,3884,17511
31538,2020-02-25,(02200) Alcalá,14999,9492,6736,31227
31539,2020-01-27,(09100) Calle 40 Sur,6962,3922,3971,14855
31540,2020-03-14,(10000) Portal 20 de Julio - alimentacion,7660,3296,5604,16560
31541,2020-02-15,(04101) Minuto de Dios,1576,890,1406,3872
31542,2020-06-06,(04101) Minuto de Dios,193,116,178,487
31543,2020-01-30,(09001) Molinos,7401,4329,5627,17357
31544,2020-01-16,(04103) Las Ferias,1297,734,797,2828
31545,2020-03-24,(14004) Museo del Oro,0,166,425,591
31546,2020-09-17,(07112) COMUNEROS,941,534,632,2107
31547,2020-01-26,(10004) Policarpa,238,108,247,593
31548,2020-10-06,(10001) Country Sur,1526,683,1058,3267
31549,2020-02-24,(09000) Cabecera Usme,5910,3692,4047,13649
31550,2020-03-29,(06000) Portal Eldorado - alimentacion,761,365,322,1448
31551,2020-01-28,(06102) Salitre El Greco,1569,847,710,3126
31552,2020-08-19,(09104) Restrepo,1504,828,1071,3403
31553,2020-09-02,(09104) Restrepo,1718,969,1216,3903
31554,2020-02-07,(06002) Normandía,2669,1465,1438,5572
31555,2020-02-21,(09123) Calle 76,4897,3673,3405,11975
31556,2020-02-08,(07000) Portal Sur - alimentacion,19948,9913,11602,41463
31557,2020-02-28,(03005) SUBA - AV. BOYACA,2805,1618,1631,6054
31558,2020-07-01,(03013) RIO NEGRO,314,188,229,731
31559,2020-02-28,(02302) Virrey,3721,2589,1983,8293
31560,2020-08-28,(07000) Portal Sur - alimentacion,8272,4695,4431,17398
31561,2020-08-03,(09103) Olaya,946,517,508,1971
31562,2020-05-19,(14001) La Sabana,134,94,89,317
31563,2020-05-26,(07002) MADELENA,700,396,425,1521
31564,2020-01-25,(07106) EL CAMPIN,1119,753,831,2703
31565,2020-02-20,(07112) COMUNEROS,3759,2229,2100,8088
31566,2020-02-13,(07107) U. NACIONAL,1909,1580,1798,5287
31567,2020-07-18,(03003) 21 ANGELES,209,83,126,418
31568,2020-03-24,(04105) Carrera 53,274,186,190,650
31569,2020-08-22,(04105) Carrera 53,210,115,131,456
31570,2020-07-27,(09004) Santa Lucía,2382,1274,1252,4908
31571,2020-10-06,(09004) Santa Lucía,2867,1356,1917,6140
31572,2020-01-28,(04000) Cabecera Calle 80,7244,4380,4601,16225
31573,2020-10-06,(07010) Bosa,0,384,1004,1388
31574,2020-10-02,(09110) Avenida Jimenez,1598,1162,1179,3939
31575,2020-01-08,(06106) Recinto Ferial,1001,564,577,2142
31576,2020-01-16,(06106) Recinto Ferial,1228,742,703,2673
31577,2020-01-13,(04106) Carrera 47,1190,628,791,2609
31578,2020-02-21,(02000) Cabecera Autopista Norte - intermunicipal,4758,2960,3028,10746
31579,2020-01-09,(04003) Avenida Ciudad de Cali,4010,2130,2555,8695
31580,2020-01-09,(03000) Portal Suba,6089,3578,3816,13483
31581,2020-05-16,(06000) Portal Eldorado,614,439,356,1409
31582,2020-07-17,(08000) Portal Tunal - alimentacion,4211,2448,2688,9347
31583,2020-02-20,(10008) San Diego,1625,882,727,3234
31584,2020-01-18,(10002) Av. Primero de Mayo,4404,2109,3482,9995
31585,2020-02-14,(10005) Bicentenario - alimentacion,761,314,496,1571
31586,2020-07-02,(02000) Cabecera Autopista Norte - intermunicipal,585,386,466,1437
31587,2020-08-10,(02000) Cabecera Autopista Norte - intermunicipal,523,355,348,1226
31588,2020-05-24,(07112) COMUNEROS,164,105,106,375
31589,2020-06-18,(09107) Hortúa,633,348,359,1340
31590,2020-05-12,(07503) SAN MATEO,7602,4809,3572,15983
31591,2020-05-12,(08001) Parque el Tunal,356,218,194,768
31592,2020-09-21,(09116) Avenida 39,323,246,257,826
31593,2020-08-04,(02101) Toberín,1149,730,779,2658
31594,2020-04-24,(10002) Av. Primero de Mayo,1205,712,759,2676
31595,2020-05-14,(10002) Av. Primero de Mayo,1655,835,990,3480
31596,2020-08-10,(10002) Av. Primero de Mayo,2068,1092,1193,4353
31597,2020-10-08,(14004) Museo del Oro,444,276,378,1098
31598,2020-10-10,(08001) Parque el Tunal,422,208,363,993
31599,2020-08-23,(03000) Portal Suba - alimentacion,1734,830,1255,3819
31600,2020-06-17,(09107) Hortúa,600,376,382,1358
31601,2020-06-23,(09123) Calle 76,1136,775,621,2532
31602,2020-08-01,(05002) Tintal,1452,749,957,3158
31603,2020-01-19,(05103) Marsella,432,168,405,1005
31604,2020-03-20,(03007) HUMEDAL CORDOBA,77,51,32,160
31605,2020-09-24,(02300) Calle 100,1274,877,876,3027
31606,2020-06-02,(10000) Portal 20 de Julio,2134,1071,957,4162
31607,2020-06-01,(05101) Mandalay - Cr.73,81,47,53,181
31608,2020-08-22,(05005) Transversal 86,263,134,180,577
31609,2020-04-01,(02202) Calle 127,668,487,374,1529
31610,2020-06-22,(10008) San Diego,108,57,66,231
31611,2020-06-01,(06109) Centro Memoria,261,166,126,553
31612,2020-06-25,(08000) Portal Tunal,780,346,300,1426
31613,2020-06-26,(02205) Calle 106,392,250,220,862
31614,2020-07-16,(02205) Calle 106,336,218,179,733
31615,2020-01-29,(04101) Minuto de Dios,2577,1525,1573,5675
31616,2020-08-29,(04108) El Polo,312,214,253,779
31617,2020-01-27,(10009) Museo Nacional,4240,2185,1808,8233
31618,2020-03-13,(02202) Calle 127,1378,393,514,2285
31619,2020-01-09,(07201) Guatoque -Veraguas,713,384,525,1622
31620,2020-08-14,(07106) EL CAMPIN,386,242,192,820
31621,2020-06-19,(03007) HUMEDAL CORDOBA,159,95,64,318
31622,2020-09-25,(04104) Avenida 68,739,378,469,1586
31623,2020-01-04,(04000) Cabecera Calle 80,2083,1047,1914,5044
31624,2020-01-27,(14005) Las Aguas,2999,1818,1686,6503
31625,2020-04-20,(10005) Bicentenario - alimentacion,157,67,133,357
31626,2020-10-01,(07004) VENECIA,1126,644,807,2577
31627,2020-09-19,(02303) Calle 85,499,360,434,1293
31628,2020-05-12,(05103) Marsella,247,105,140,492
31629,2020-08-15,(09109) Tercer Milenio,290,175,214,679
31630,2020-08-24,(09117) Calle 45,458,348,356,1162
31631,2020-07-08,(02202) Calle 127,1183,811,575,2569
31632,2020-03-04,(06104) Gobernación,1386,829,675,2890
31633,2020-05-14,(02001) Centro Comercial Santa Fe,327,189,237,753
31634,2020-06-29,(06000) Portal Eldorado,281,208,191,680
31635,2020-07-01,(02302) Virrey,674,470,388,1532
31636,2020-04-25,(12003) Ricaurte,109,90,65,264
31637,2020-05-27,(12003) Ricaurte,323,245,152,720
31638,2020-01-12,(03010) PUENTE LARGO,272,201,311,784
31639,2020-06-19,(10010) San Bernardo,638,336,469,1443
31640,2020-01-28,(10005) Bicentenario,801,390,388,1579
31641,2020-09-29,(05107) Américas - Cr.53,488,308,354,1150
31642,2020-01-06,(40002) Manitas,248,127,253,628
31643,2020-03-28,(40002) Manitas,107,57,71,235
31644,2020-03-16,(06109) Centro Memoria,841,486,402,1729
31645,2020-06-21,(03001) LA CAMPIÑA,278,126,187,591
31646,2020-07-09,(02001) Centro Comercial Santa Fe,558,349,351,1258
31647,2020-03-31,(05100) Banderas P. Central - alimentacion,1397,628,661,2686
31648,2020-09-25,(10008) San Diego,384,197,239,820
31649,2020-03-13,(03011) SUBA - CALLE 100,1044,173,354,1571
31650,2020-04-04,(05002) Tintal,711,428,411,1550
31651,2020-07-10,(05107) Américas - Cr.53,451,266,254,971
31652,2020-08-01,(09003) Socorro,463,229,285,977
31653,2020-10-07,(08002) Biblioteca,323,188,253,764
31654,2020-07-03,(06111) Universidades,332,212,356,900
31655,2020-08-06,(02204) Pepe Sierra,721,502,384,1607
31656,2020-01-11,(07006) General Santander,1222,670,983,2875
31657,2020-09-22,(10003) Ciudad Jardín,244,111,207,562
31658,2020-02-28,(09111) Calle 19,2362,1405,1622,5389
31659,2020-07-14,(02105) Calle 142,700,437,391,1528
31660,2020-01-11,(12004) Carrera 22,370,260,272,902
31661,2020-01-23,(12004) Carrera 22,678,397,401,1476
31662,2020-01-31,(12004) Carrera 22,687,403,529,1619
31663,2020-03-31,(09111) Calle 19,148,152,248,548
31664,2020-07-18,(07105) MOVISTAR ARENA,183,105,129,417
31665,2020-09-24,(07105) MOVISTAR ARENA,252,149,199,600
31666,2020-06-12,(07107) U. NACIONAL,354,198,156,708
31667,2020-03-23,(09123) Calle 76,196,163,138,497
31668,2020-08-07,(07104) Simon Bolivar,139,90,126,355
31669,2020-09-10,(04102) Avenida Boyaca,396,220,278,894
31670,2020-09-22,(03003) 21 ANGELES,416,202,269,887
31671,2020-03-23,(03001) LA CAMPIÑA,207,124,121,452
31672,2020-06-17,(07004) VENECIA,995,627,550,2172
31673,2020-05-04,(10006) San Victorino,249,159,199,607
31674,2020-05-20,(02104) Calle 146,589,388,386,1363
31675,2020-08-18,(10007) Las Nieves,536,331,311,1178
31676,2020-07-21,(03009) Av. Suba- Calle 116,498,304,200,1002
31677,2020-04-22,(10007) Las Nieves,233,161,139,533
31678,2020-07-15,(10007) Las Nieves,357,190,221,768
31679,2020-10-06,(03007) HUMEDAL CORDOBA,159,113,112,384
31680,2020-07-24,(07009) SENA,458,273,327,1058
31681,2020-03-30,(12000) Puente Aranda,43,36,46,125
31682,2020-06-05,(12000) Puente Aranda,72,42,32,146
31683,2020-06-27,(03005) SUBA - AV. BOYACA,367,196,251,814
31684,2020-03-31,(02102) Calle 161,89,59,59,207
31685,2020-06-28,(02102) Calle 161,69,36,47,152
31686,2020-04-13,(07002) MADELENA,361,194,202,757
31687,2020-05-22,(12004) Carrera 22,190,113,114,417
31688,2020-09-14,(06000) Portal Eldorado,926,613,638,2177
31689,2019-12-31,(09119) Calle 57,37,16,38,91
31690,2020-06-06,(09110) Avenida Jimenez,796,573,577,1946
31691,2020-02-23,(05100) Banderas P. Central,827,357,885,2069
31692,2020-04-25,(04106) Carrera 47,133,77,61,271
31693,2020-07-22,(09113) Calle 22,319,174,278,771
31694,2020-09-07,(10004) Policarpa,234,126,177,537
31695,2020-05-30,(07113) SANTA ISABEL,257,159,191,607
31696,2020-08-05,(07109) CAD,534,349,248,1131
31697,2020-01-25,(07200) Tygua-San José,478,257,458,1193
31698,2020-10-03,(07200) Tygua-San José,197,118,188,503
31699,2020-03-28,(14004) Museo del Oro,0,28,49,77
31700,2020-07-23,(10010) San Bernardo,503,248,321,1072
31701,2020-09-11,(09117) Calle 45,669,427,492,1588
31702,2020-02-23,(14001) La Sabana,93,89,124,306
31703,2020-03-01,(07008) NQS - Calle 30 Sur,436,190,429,1055
31704,2020-05-12,(12002) CDS - Carrera 32,195,124,57,376
31705,2020-03-15,(06104) Gobernación,96,88,173,357
31706,2020-04-30,(04000) Cabecera Calle 80 - intermunicipal,167,96,122,385
31707,2020-05-09,(07108) Av. El Dorado,43,29,38,110
31708,2020-07-11,(07108) Av. El Dorado,96,59,79,234
31709,2020-08-28,(06002) Normandía,319,171,207,697
31710,2020-08-11,(05107) Américas - Cr.53,393,229,252,874
31711,2020-04-01,(04000) Cabecera Calle 80 - intermunicipal,84,56,89,229
31712,2020-07-14,(14004) Museo del Oro,268,157,151,576
31713,2020-08-14,(06001) Modelia,349,212,165,726
31714,2020-06-09,(09108) Hospital,63,34,52,149
31715,2020-04-10,(07505) LEON XIII,445,278,175,898
31716,2020-03-15,(02000) Cabecera Autopista Norte - intermunicipal,492,297,520,1309
31717,2020-05-20,(04000) Cabecera Calle 80 - intermunicipal,234,132,201,567
31718,2020-10-09,(07105) MOVISTAR ARENA,300,182,225,707
31719,2020-07-25,(04104) Avenida 68,414,195,250,859
31720,2020-05-03,(09003) Socorro,130,56,68,254
31721,2020-10-04,(09003) Socorro,249,93,221,563
31722,2020-08-09,(03011) SUBA - CALLE 100,104,72,95,271
31723,2020-06-14,(05107) Américas - Cr.53,87,64,90,241
31724,2020-09-03,(12002) CDS - Carrera 32,210,116,75,401
31725,2020-09-10,(07506) DESPENSA,0,193,523,716
31726,2020-04-15,(07005) ALQUERIA,282,168,151,601
31727,2020-02-09,(07101) CASTELLANA,69,78,159,306
31728,2020-07-21,(06102) Salitre El Greco,221,128,119,468
31729,2020-08-08,(06102) Salitre El Greco,150,98,94,342
31730,2020-04-15,(03010) PUENTE LARGO,191,137,84,412
31731,2020-05-07,(06111) Universidades,0,98,224,322
31732,2020-08-17,(07010) Bosa,195,83,143,421
31733,2020-06-13,(07003) SEVILLANA,324,164,197,685
31734,2020-05-25,(10010) San Bernardo,240,129,159,528
31735,2020-07-23,(06001) Modelia,305,203,162,670
31736,2020-07-06,(07007) NQS - Calle 38A Sur,427,252,256,935
31737,2020-05-14,(09106) Nariño,301,183,183,667
31738,2020-03-21,(07003) SEVILLANA,154,93,62,309
31739,2020-07-26,(09117) Calle 45,207,124,143,474
31740,2020-07-30,(06103) CAN,342,201,172,715
31741,2020-04-04,(07200) Tygua-San José,44,34,43,121
31742,2020-01-11,(07201) Guatoque -Veraguas,374,221,406,1001
31743,2020-04-23,(03006) NIZA - CALLE 127,229,162,124,515
31744,2020-03-31,(08002) Biblioteca,142,86,96,324
31745,2020-09-07,(03005) SUBA - AV. BOYACA,503,302,336,1141
31746,2020-03-27,(07104) Simon Bolivar,153,138,114,405
31747,2020-08-09,(04105) Carrera 53,63,35,62,160
31748,2020-05-16,(04105) Carrera 53,167,101,110,378
31749,2020-04-11,(06100) Av. Rojas,44,28,35,107
31750,2020-09-16,(07108) Av. El Dorado,162,96,103,361
31751,2020-05-07,(04105) Carrera 53,216,119,111,446
31752,2020-08-01,(03005) SUBA - AV. BOYACA,227,148,168,543
31753,2020-04-12,(02201) Prado,136,111,81,328
31754,2020-04-15,(12002) CDS - Carrera 32,169,135,50,354
31755,2020-07-17,(06108) Concejo de Bogotá,119,60,52,231
31756,2020-04-05,(06105) Quinta Paredes,24,26,19,69
31757,2020-05-03,(06105) Quinta Paredes,29,17,15,61
31758,2020-07-09,(50002) Corral Calle 40 Sur,27,16,42,85
31759,2020-08-01,(08002) Biblioteca,219,118,124,461
31760,2020-06-29,(04107) Escuela Militar,41,30,35,106
31761,2020-08-02,(04102) Avenida Boyaca,84,54,79,217
31762,2020-06-09,(14005) Las Aguas,0,61,187,248
31763,2020-05-16,(06104) Gobernación,122,74,66,262
31764,2020-06-29,(50002) Corral Calle 40 Sur,8,2,10,20
31765,2019-12-23,(04103) Las Ferias,0,0,1,1
31766,2020-10-13,(09115) Calle 34,0,0,1,1
31767,2020-09-11,(04000) Cabecera Calle 80 - alimentacion,4311,2324,3005,9640
31768,2020-03-13,(07005) ALQUERIA,258,428,343,1029
31769,2020-01-11,(08000) Portal Tunal - alimentacion,13528,6389,7646,27563
31770,2020-07-06,(07503) SAN MATEO,12134,7237,6055,25426
31771,2020-02-04,(06000) Portal Eldorado - alimentacion,18862,10194,9792,38848
31772,2020-02-11,(05000) Portal Américas,15553,9077,8011,32641
31773,2020-01-02,(09100) Calle 40 Sur,3533,1830,2380,7743
31774,2020-02-02,(09003) Socorro,543,238,447,1228
31775,2020-01-16,(08001) Parque el Tunal,1533,813,897,3243
31776,2020-05-24,(09000) Cabecera Usme - alimentacion,1972,1035,1173,4180
31777,2020-10-08,(04002) Carrera 90,843,419,583,1845
31778,2020-02-07,(07111) NQS - RICAURTE,3070,2060,1932,7062
31779,2020-04-05,(05000) Portal Américas - alimentacion,2388,1090,984,4462
31780,2020-01-20,(06107) Ciudad Universitaria,1345,803,824,2972
31781,2020-07-27,(09001) Molinos,2320,1295,1597,5212
31782,2020-02-19,(07112) COMUNEROS,3867,2321,2299,8487
31783,2020-01-14,(04100) Carrera 77,5343,3028,3518,11889
31784,2020-01-16,(05100) Banderas P. Central,6427,3523,3436,13386
31785,2020-08-11,(05100) Banderas P. Central,799,442,494,1735
31786,2020-01-02,(10001) Country Sur,2435,1005,1515,4955
31787,2020-02-08,(09000) Cabecera Usme,3905,2091,3306,9302
31788,2020-02-23,(09000) Cabecera Usme,1272,612,1192,3076
31789,2020-09-02,(09000) Cabecera Usme,1854,1133,1407,4394
31790,2020-09-09,(09000) Cabecera Usme,1853,1151,1358,4362
31791,2020-10-01,(09000) Cabecera Usme,2000,1158,1548,4706
31792,2020-03-07,(06000) Portal Eldorado - alimentacion,10624,4816,7126,22566
31793,2020-07-08,(09115) Calle 34,715,445,449,1609
31794,2020-03-17,(05100) Banderas P. Central - alimentacion,8530,4677,4845,18052
31795,2020-02-07,(02205) Calle 106,2760,1685,1428,5873
31796,2020-03-05,(10005) Bicentenario - alimentacion,705,355,522,1582
31797,2020-02-25,(09120) Calle 63,7653,4876,3768,16297
31798,2020-02-29,(06104) Gobernación,376,307,506,1189
31799,2020-01-29,(09104) Restrepo,5218,2991,3894,12103
31800,2020-01-11,(07505) LEON XIII,4966,2383,2615,9964
31801,2020-08-20,(07505) LEON XIII,2565,1382,1146,5093
31802,2020-02-27,(06002) Normandía,2577,1486,1364,5427
31803,2020-02-13,(07110) PALOQUEMAO,2027,1609,1501,5137
31804,2020-06-01,(07102) NQS - CALLE 75,370,258,200,828
31805,2020-09-11,(07102) NQS - CALLE 75,441,272,279,992
31806,2020-07-10,(03013) RIO NEGRO,288,183,237,708
31807,2020-01-29,(02103) Mazurén,3434,2169,1802,7405
31808,2020-06-01,(02103) Mazurén,164,121,137,422
31809,2020-09-29,(14001) La Sabana,181,110,128,419
31810,2020-05-24,(07002) MADELENA,142,64,97,303
31811,2020-06-09,(07002) MADELENA,740,422,467,1629
31812,2020-08-25,(02200) Alcalá,1672,1161,940,3773
31813,2020-02-21,(07107) U. NACIONAL,1924,1244,1201,4369
31814,2020-02-26,(09113) Calle 22,1371,915,1118,3404
31815,2020-09-27,(09113) Calle 22,233,118,228,579
31816,2020-02-18,(10007) Las Nieves,2175,1288,1198,4661
31817,2020-02-14,(07007) NQS - Calle 38A Sur,2281,1289,1193,4763
31818,2020-01-05,(07112) COMUNEROS,628,314,604,1546
31819,2020-05-09,(09000) Cabecera Usme - alimentacion,4038,2205,2466,8709
31820,2020-01-17,(10008) San Diego,1175,726,749,2650
31821,2020-02-22,(06002) Normandía,997,584,920,2501
31822,2020-03-05,(40003) Mirador del Paraiso,4632,2614,2588,9834
31823,2020-07-17,(12001) Carrera 43,374,242,217,833
31824,2020-08-16,(50003) Corral Molinos,513,205,397,1115
31825,2020-06-24,(10002) Av. Primero de Mayo,2248,1155,1378,4781
31826,2020-01-13,(02302) Virrey,3371,2161,1646,7178
31827,2020-02-06,(02302) Virrey,3829,2686,2029,8544
31828,2020-02-11,(07106) EL CAMPIN,2246,1432,1203,4881
31829,2020-03-11,(07106) EL CAMPIN,1944,1251,1163,4358
31830,2020-02-20,(08001) Parque el Tunal,1668,972,915,3555
31831,2020-02-17,(09115) Calle 34,4711,2901,2421,10033
31832,2020-01-02,(09108) Hospital,102,64,127,293
31833,2020-05-10,(03000) Portal Suba - alimentacion,1444,812,766,3022
31834,2020-08-09,(03000) Portal Suba - alimentacion,1442,782,1019,3243
31835,2020-02-02,(07010) Bosa,479,269,641,1389
31836,2020-06-01,(07112) COMUNEROS,724,429,397,1550
31837,2020-08-10,(02303) Calle 85,657,472,370,1499
31838,2020-09-21,(02303) Calle 85,678,475,402,1555
31839,2020-01-12,(09116) Avenida 39,169,168,358,695
31840,2020-03-06,(07108) Av. El Dorado,848,546,643,2037
31841,2020-03-09,(02000) Cabecera Autopista Norte,1219,2704,1766,5689
31842,2020-02-17,(09116) Avenida 39,3385,2101,1664,7150
31843,2020-03-05,(06108) Concejo de Bogotá,900,414,429,1743
31844,2020-09-10,(06108) Concejo de Bogotá,136,69,95,300
31845,2020-09-19,(14004) Museo del Oro,177,174,257,608
31846,2020-09-21,(02201) Prado,824,545,535,1904
31847,2020-05-06,(02000) Cabecera Autopista Norte,754,520,463,1737
31848,2020-08-12,(06102) Salitre El Greco,238,123,109,470
31849,2020-04-14,(02300) Calle 100,802,558,419,1779
31850,2020-08-23,(02300) Calle 100,211,200,225,636
31851,2020-02-23,(10000) Portal 20 de Julio,1998,801,1532,4331
31852,2020-03-07,(02104) Calle 146,3647,1650,3277,8574
31853,2020-02-25,(08000) Portal Tunal,2258,1276,1069,4603
31854,2020-09-28,(04000) Cabecera Calle 80,1281,805,1182,3268
31855,2020-03-06,(07104) Simon Bolivar,2416,1497,1322,5235
31856,2020-08-08,(07104) Simon Bolivar,236,174,187,597
31857,2020-06-02,(09001) Molinos,2196,1307,1340,4843
31858,2020-08-16,(05005) Transversal 86,82,36,76,194
31859,2020-02-28,(06109) Centro Memoria,1117,675,619,2411
31860,2020-04-06,(08000) Portal Tunal,365,215,210,790
31861,2020-05-14,(02205) Calle 106,257,158,156,571
31862,2020-07-31,(02205) Calle 106,309,208,168,685
31863,2020-05-25,(12000) Puente Aranda,12,9,10,31
31864,2020-06-18,(09101) Quiroga,617,295,359,1271
31865,2020-10-05,(04108) El Polo,551,344,361,1256
31866,2020-01-23,(12007) Zona Industrial,1234,766,585,2585
31867,2020-02-16,(09118) Marly,1481,857,1525,3863
31868,2020-07-25,(08000) Portal Tunal - alimentacion,3700,1977,2198,7875
31869,2020-03-09,(03000) Portal Suba,505,2641,1769,4915
31870,2020-09-03,(04104) Avenida 68,654,353,385,1392
31871,2020-03-14,(09117) Calle 45,2204,1494,1938,5636
31872,2020-09-05,(09117) Calle 45,521,329,509,1359
31873,2020-02-29,(04000) Cabecera Calle 80 - intermunicipal,966,681,1283,2930
31874,2020-05-07,(07104) Simon Bolivar,352,226,174,752
31875,2020-01-21,(07109) CAD,2019,1142,1006,4167
31876,2020-05-11,(09000) Cabecera Usme,1165,775,869,2809
31877,2020-05-21,(09000) Cabecera Usme,1383,844,913,3140
31878,2020-09-06,(04003) Avenida Ciudad de Cali,314,169,383,866
31879,2020-05-04,(09001) Molinos,1545,885,1030,3460
31880,2020-03-09,(04104) Avenida 68,1391,460,439,2290
31881,2020-06-28,(10009) Museo Nacional,73,73,111,257
31882,2020-09-04,(03007) HUMEDAL CORDOBA,177,100,87,364
31883,2020-01-07,(07002) MADELENA,3112,1828,1913,6853
31884,2020-10-03,(06101) El Tiempo,223,185,281,689
31885,2020-10-04,(04104) Avenida 68,242,127,260,629
31886,2020-04-13,(02202) Calle 127,636,443,309,1388
31887,2020-03-23,(03000) Portal Suba - alimentacion,1524,827,793,3144
31888,2020-05-24,(09001) Molinos,598,329,413,1340
31889,2020-09-02,(05002) Tintal,2705,1623,1742,6070
31890,2020-03-18,(07109) CAD,1651,1060,796,3507
31891,2020-08-04,(04108) El Polo,351,211,175,737
31892,2020-08-18,(02105) Calle 142,676,473,433,1582
31893,2020-07-11,(06100) Av. Rojas,157,90,129,376
31894,2020-05-27,(02302) Virrey,558,387,259,1204
31895,2020-02-23,(04101) Minuto de Dios,423,205,497,1125
31896,2020-03-14,(04106) Carrera 47,793,417,606,1816
31897,2020-03-01,(06103) CAN,257,180,330,767
31898,2020-08-15,(02105) Calle 142,570,336,406,1312
31899,2020-07-27,(09109) Tercer Milenio,320,199,275,794
31900,2020-06-21,(03002) SUBA - TV- 91,236,126,183,545
31901,2020-04-09,(10010) San Bernardo,148,101,125,374
31902,2020-08-14,(05100) Banderas P. Central - alimentacion,2988,1594,1740,6322
31903,2020-08-09,(07103) AV. CHILE,132,102,147,381
31904,2020-08-13,(12007) Zona Industrial,366,216,159,741
31905,2020-09-23,(12007) Zona Industrial,386,283,221,890
31906,2020-08-29,(07004) VENECIA,832,448,529,1809
31907,2020-09-09,(10005) Bicentenario,98,58,92,248
31908,2020-06-02,(09106) Nariño,359,209,263,831
31909,2020-08-21,(09106) Nariño,405,224,290,919
31910,2020-09-16,(09106) Nariño,478,266,412,1156
31911,2020-01-17,(04102) Avenida Boyaca,2502,1404,1500,5406
31912,2020-07-29,(02304) Heroes,780,542,415,1737
31913,2020-03-31,(06103) CAN,318,251,160,729
31914,2020-04-17,(40003) Mirador del Paraiso,859,472,564,1895
31915,2020-09-19,(10005) Bicentenario - alimentacion,142,97,206,445
31916,2020-03-08,(09120) Calle 63,1176,747,1290,3213
31917,2020-10-09,(08000) Portal Tunal,825,370,436,1631
31918,2020-05-05,(09002) Consuelo,301,150,200,651
31919,2020-04-10,(03000) Portal Suba - alimentacion,1148,684,495,2327
31920,2020-08-20,(12007) Zona Industrial,326,176,134,636
31921,2020-08-15,(06111) Universidades,257,159,326,742
31922,2020-09-01,(06111) Universidades,378,230,340,948
31923,2020-09-09,(06111) Universidades,403,257,374,1034
31924,2020-04-06,(03012) SUBA - CALLE 95,158,122,108,388
31925,2020-08-21,(40001) Juan Pablo II,539,341,302,1182
31926,2020-07-24,(04002) Carrera 90,648,350,360,1358
31927,2020-08-19,(02204) Pepe Sierra,682,517,381,1580
31928,2020-08-19,(03013) RIO NEGRO,262,152,168,582
31929,2020-06-10,(07110) PALOQUEMAO,619,366,252,1237
31930,2020-01-19,(10005) Bicentenario - alimentacion,136,75,265,476
31931,2020-06-05,(09111) Calle 19,727,429,473,1629
31932,2020-07-31,(12004) Carrera 22,226,123,116,465
31933,2020-01-20,(07200) Tygua-San José,736,421,567,1724
31934,2020-07-06,(07200) Tygua-San José,264,144,179,587
31935,2020-10-02,(09107) Hortúa,644,392,561,1597
31936,2020-08-16,(03012) SUBA - CALLE 95,74,53,65,192
31937,2020-07-04,(06102) Salitre El Greco,196,105,122,423
31938,2020-09-02,(04105) Carrera 53,312,170,213,695
31939,2020-07-08,(06104) Gobernación,261,146,120,527
31940,2020-07-31,(07105) MOVISTAR ARENA,211,118,113,442
31941,2020-08-19,(07105) MOVISTAR ARENA,229,133,148,510
31942,2020-03-19,(07008) NQS - Calle 30 Sur,802,432,423,1657
31943,2020-01-01,(07004) VENECIA,335,186,452,973
31944,2020-05-12,(06107) Ciudad Universitaria,153,99,110,362
31945,2020-08-06,(04103) Las Ferias,297,162,179,638
31946,2020-08-25,(03011) SUBA - CALLE 100,525,230,229,984
31947,2020-09-23,(05102) Av. Américas - Av. Boyacá,274,169,210,653
31948,2020-06-30,(40001) Juan Pablo II,595,368,370,1333
31949,2020-05-29,(04104) Avenida 68,548,279,255,1082
31950,2020-08-21,(09114) Calle 26,305,203,197,705
31951,2020-02-16,(12000) Puente Aranda,51,36,71,158
31952,2020-08-24,(50003) Corral Molinos,1358,691,926,2975
31953,2020-04-21,(07103) AV. CHILE,530,392,257,1179
31954,2020-04-13,(07005) ALQUERIA,260,182,148,590
31955,2020-05-16,(07005) ALQUERIA,349,197,199,745
31956,2020-04-06,(05100) Banderas P. Central,333,180,238,751
31957,2020-07-27,(07110) PALOQUEMAO,535,381,255,1171
31958,2020-05-27,(07102) NQS - CALLE 75,363,234,181,778
31959,2020-08-14,(09115) Calle 34,611,365,408,1384
31960,2020-07-17,(07109) CAD,562,373,266,1201
31961,2020-07-24,(50003) Corral Molinos,1164,591,801,2556
31962,2020-10-04,(09120) Calle 63,421,285,537,1243
31963,2020-08-06,(07008) NQS - Calle 30 Sur,257,119,140,516
31964,2020-08-21,(12002) CDS - Carrera 32,189,119,82,390
31965,2020-09-19,(10009) Museo Nacional,301,235,445,981
31966,2020-04-04,(04000) Cabecera Calle 80 - intermunicipal,44,32,44,120
31967,2020-09-02,(04001) Quirigua,415,278,305,998
31968,2020-07-07,(07200) Tygua-San José,268,150,180,598
31969,2020-03-24,(09120) Calle 63,897,676,745,2318
31970,2020-04-22,(03003) 21 ANGELES,170,75,74,319
31971,2020-07-17,(40001) Juan Pablo II,353,202,228,783
31972,2020-04-24,(02103) Mazurén,109,58,93,260
31973,2020-10-05,(04002) Carrera 90,859,434,628,1921
31974,2020-06-13,(07200) Tygua-San José,169,96,147,412
31975,2020-05-16,(07200) Tygua-San José,141,74,92,307
31976,2020-03-29,(09002) Consuelo,63,33,35,131
31977,2020-05-06,(05102) Av. Américas - Av. Boyacá,145,76,76,297
31978,2020-05-16,(02201) Prado,505,335,323,1163
31979,2020-04-02,(06001) Modelia,225,169,138,532
31980,2020-04-25,(07107) U. NACIONAL,157,107,80,344
31981,2020-04-03,(04101) Minuto de Dios,154,113,108,375
31982,2020-06-03,(03004) GRATAMIRA,27,16,13,56
31983,2020-04-05,(50003) Corral Molinos,332,128,197,657
31984,2020-06-01,(09105) Río Fucha,117,63,84,264
31985,2020-06-29,(07010) Bosa,253,116,157,526
31986,2020-04-28,(09106) Nariño,228,134,165,527
31987,2020-07-19,(04106) Carrera 47,103,36,66,205
31988,2020-06-27,(14005) Las Aguas,161,91,178,430
31989,2020-03-20,(10003) Ciudad Jardín,95,64,56,215
31990,2020-04-25,(07101) CASTELLANA,59,37,51,147
31991,2020-04-26,(06107) Ciudad Universitaria,28,26,23,77
31992,2020-04-10,(07108) Av. El Dorado,21,16,14,51
31993,2020-06-05,(07108) Av. El Dorado,115,86,100,301
31994,2020-08-23,(06102) Salitre El Greco,48,43,58,149
31995,2020-03-28,(07004) VENECIA,358,224,176,758
31996,2020-05-27,(14004) Museo del Oro,0,97,210,307
31997,2020-05-27,(07010) Bosa,588,328,309,1225
31998,2020-03-29,(07003) SEVILLANA,78,44,41,163
31999,2020-04-26,(10006) San Victorino,57,42,55,154
32000,2020-05-24,(10007) Las Nieves,77,61,69,207
32001,2020-09-28,(50002) Corral Calle 40 Sur,29,19,32,80
32002,2020-06-21,(07003) SEVILLANA,92,55,99,246
32003,2019-12-31,(09118) Marly,81,30,77,188
32004,2020-08-23,(06108) Concejo de Bogotá,41,23,26,90
32005,2020-04-02,(07106) EL CAMPIN,136,119,90,345
32006,2020-10-11,(09105) Río Fucha,0,32,80,112
32007,2020-01-27,(04000) Cabecera Calle 80 - alimentacion,22194,13380,13874,49448
32008,2020-02-22,(02502) Terminal,1706,1018,1828,4552
32009,2020-01-01,(09118) Marly,598,414,730,1742
32010,2020-02-26,(09118) Marly,7680,5376,4206,17262
32011,2020-07-14,(09118) Marly,1238,802,603,2643
32012,2020-07-23,(09118) Marly,1280,826,593,2699
32013,2020-03-04,(03000) Portal Suba - alimentacion,29447,17148,16621,63216
32014,2020-01-16,(02303) Calle 85,3252,2195,1672,7119
32015,2020-03-03,(02303) Calle 85,3862,2581,2023,8466
32016,2020-01-20,(03002) SUBA - TV- 91,4019,2312,2353,8684
32017,2020-02-03,(02101) Toberín,14932,9601,7830,32363
32018,2020-08-31,(05000) Portal Américas,3016,1872,2048,6936
32019,2020-03-08,(09100) Calle 40 Sur,1528,697,1469,3694
32020,2020-01-15,(08001) Parque el Tunal,1475,831,889,3195
32021,2020-02-17,(02201) Prado,6009,3903,3012,12924
32022,2020-01-15,(09000) Cabecera Usme - alimentacion,23127,12022,14367,49516
32023,2020-09-16,(09100) Calle 40 Sur,1938,1109,1399,4446
32024,2020-02-05,(40001) Juan Pablo II,1691,1001,1073,3765
32025,2020-09-06,(07503) SAN MATEO,3676,1813,2434,7923
32026,2020-02-21,(09115) Calle 34,3586,2670,2725,8981
32027,2020-03-06,(05100) Banderas P. Central - alimentacion,14806,8554,9639,32999
32028,2020-01-22,(10003) Ciudad Jardín,946,531,643,2120
32029,2020-02-13,(10002) Av. Primero de Mayo,8707,4361,4554,17622
32030,2020-02-18,(02205) Calle 106,2917,1769,1388,6074
32031,2020-06-16,(09000) Cabecera Usme - alimentacion,8485,4873,4787,18145
32032,2020-07-14,(09104) Restrepo,1088,638,747,2473
32033,2020-01-24,(07505) LEON XIII,8146,4416,3742,16304
32034,2020-06-13,(07505) LEON XIII,2062,1050,1059,4171
32035,2020-10-04,(07504) TERREROS,2187,890,1824,4901
32036,2020-02-19,(05103) Marsella,3331,1914,1421,6666
32037,2020-03-17,(04104) Avenida 68,1813,1044,1072,3929
32038,2020-03-03,(06002) Normandía,2629,1620,1368,5617
32039,2020-02-03,(09117) Calle 45,6225,3974,3007,13206
32040,2020-02-18,(09117) Calle 45,6937,4493,3014,14444
32041,2020-01-11,(03000) Portal Suba - alimentacion,13369,6346,8874,28589
32042,2020-01-30,(02502) Terminal,5098,3293,2822,11213
32043,2020-07-16,(02000) Cabecera Autopista Norte - alimentacion,4247,2319,2247,8813
32044,2020-09-29,(09101) Quiroga,552,292,471,1315
32045,2020-01-30,(07102) NQS - CALLE 75,1525,955,874,3354
32046,2020-03-09,(07102) NQS - CALLE 75,754,105,272,1131
32047,2020-04-23,(07102) NQS - CALLE 75,174,132,102,408
32048,2020-02-16,(07000) Portal Sur - alimentacion,7745,3312,5346,16403
32049,2020-06-30,(03001) LA CAMPIÑA,1149,687,657,2493
32050,2020-03-03,(07106) EL CAMPIN,2137,1360,1164,4661
32051,2020-05-05,(07503) SAN MATEO,6508,4069,3269,13846
32052,2020-06-24,(14001) La Sabana,171,123,108,402
32053,2020-10-02,(07002) MADELENA,1164,609,909,2682
32054,2020-05-05,(08000) Portal Tunal - alimentacion,4036,2178,2221,8435
32055,2020-09-17,(02000) Cabecera Autopista Norte,1573,959,1091,3623
32056,2020-01-21,(09113) Calle 22,1061,589,715,2365
32057,2020-03-04,(10007) Las Nieves,2028,1248,1210,4486
32058,2020-03-11,(02000) Cabecera Autopista Norte - intermunicipal,4649,3173,2924,10746
32059,2020-01-30,(09117) Calle 45,5696,3703,2825,12224
32060,2020-08-18,(08000) Portal Tunal - alimentacion,5789,3089,3315,12193
32061,2020-10-01,(08000) Portal Tunal - alimentacion,6891,3713,4820,15424
32062,2020-08-31,(50003) Corral Molinos,1469,725,1071,3265
32063,2020-06-03,(04000) Cabecera Calle 80,963,575,683,2221
32064,2020-05-21,(08000) Portal Tunal - alimentacion,5226,2820,2588,10634
32065,2020-08-08,(09110) Avenida Jimenez,1175,806,680,2661
32066,2020-01-02,(07009) SENA,1387,877,1073,3337
32067,2020-01-10,(05100) Banderas P. Central - alimentacion,10603,5487,6613,22703
32068,2020-03-16,(10001) Country Sur,3765,1613,1853,7231
32069,2020-07-12,(10006) San Victorino,209,139,146,494
32070,2020-06-10,(40003) Mirador del Paraiso,1688,1077,1026,3791
32071,2020-02-17,(12001) Carrera 43,1792,1113,1147,4052
32072,2020-04-27,(07000) Portal Sur - alimentacion,3408,336,410,4154
32073,2020-07-03,(02000) Cabecera Autopista Norte,1423,864,959,3246
32074,2020-01-02,(09119) Calle 57,1184,886,956,3026
32075,2020-09-07,(02304) Heroes,896,613,546,2055
32076,2020-06-24,(02000) Cabecera Autopista Norte - intermunicipal,588,396,467,1451
32077,2020-09-07,(10000) Portal 20 de Julio,2263,1173,1273,4709
32078,2020-03-24,(07112) COMUNEROS,563,415,393,1371
32079,2020-03-20,(07000) Portal Sur - alimentacion,3746,1998,1380,7124
32080,2020-08-16,(09004) Santa Lucía,804,320,550,1674
32081,2020-06-06,(10007) Las Nieves,403,258,264,925
32082,2020-03-11,(07008) NQS - Calle 30 Sur,1853,1016,1063,3932
32083,2020-01-16,(02300) Calle 100,6052,3909,3474,13435
32084,2020-03-25,(04000) Cabecera Calle 80,534,399,422,1355
32085,2020-03-10,(10001) Country Sur,173,1108,800,2081
32086,2020-05-08,(10002) Av. Primero de Mayo,1511,804,899,3214
32087,2020-06-03,(10002) Av. Primero de Mayo,1865,980,1109,3954
32088,2020-08-26,(09100) Calle 40 Sur,1644,983,1080,3707
32089,2020-02-07,(02202) Calle 127,5997,3800,3059,12856
32090,2020-08-19,(05002) Tintal,2300,1307,1304,4911
32091,2020-04-21,(50002) Corral Calle 40 Sur,10,5,17,32
32092,2020-08-20,(02000) Cabecera Autopista Norte - alimentacion,4128,2230,2402,8760
32093,2020-01-21,(07006) General Santander,2077,1075,907,4059
32094,2020-03-01,(07104) Simon Bolivar,397,261,494,1152
32095,2020-02-27,(07006) General Santander,2977,1681,1561,6219
32096,2020-04-29,(05005) Transversal 86,220,122,107,449
32097,2020-09-03,(05001) Patio Bonito,2119,1141,1213,4473
32098,2020-05-09,(05105) Pradera,328,239,151,718
32099,2020-02-09,(02104) Calle 146,1230,535,1293,3058
32100,2020-02-28,(09121) Las Flores,3308,2117,2153,7578
32101,2020-05-28,(08000) Portal Tunal,711,270,230,1211
32102,2020-03-31,(05002) Tintal,1040,621,625,2286
32103,2020-07-23,(05002) Tintal,1666,1021,1047,3734
32104,2020-09-10,(04108) El Polo,486,263,262,1011
32105,2020-02-27,(02202) Calle 127,5947,3882,2912,12741
32106,2020-02-18,(07201) Guatoque -Veraguas,1094,516,629,2239
32107,2020-04-23,(06102) Salitre El Greco,156,79,95,330
32108,2020-06-29,(07113) SANTA ISABEL,142,65,123,330
32109,2020-04-07,(06000) Portal Eldorado,759,542,374,1675
32110,2020-07-11,(06111) Universidades,282,170,277,729
32111,2020-07-02,(03007) HUMEDAL CORDOBA,155,107,82,344
32112,2020-09-10,(03007) HUMEDAL CORDOBA,132,97,96,325
32113,2020-09-08,(04100) Carrera 77,1301,764,913,2978
32114,2020-01-16,(03010) PUENTE LARGO,1766,1131,1154,4051
32115,2020-09-05,(02101) Toberín,1087,639,1077,2803
32116,2020-02-24,(05103) Marsella,3295,1880,1465,6640
32117,2020-04-10,(10000) Portal 20 de Julio,435,211,196,842
32118,2020-04-20,(10000) Portal 20 de Julio,1290,650,630,2570
32119,2020-07-14,(04107) Escuela Militar,125,80,68,273
32120,2020-08-15,(09121) Las Flores,474,342,392,1208
32121,2020-04-22,(02000) Cabecera Autopista Norte - alimentacion,2856,1545,1255,5656
32122,2020-09-21,(09109) Tercer Milenio,229,185,207,621
32123,2020-01-18,(03001) LA CAMPIÑA,3031,1232,2191,6454
32124,2020-07-12,(07505) LEON XIII,876,418,482,1776
32125,2020-06-22,(05000) Portal Américas - alimentacion,3924,1804,1786,7514
32126,2020-05-18,(04104) Avenida 68,506,280,249,1035
32127,2020-05-21,(02202) Calle 127,957,663,449,2069
32128,2020-02-08,(04000) Cabecera Calle 80 - intermunicipal,1018,666,1203,2887
32129,2020-01-14,(40001) Juan Pablo II,1385,793,929,3107
32130,2020-01-11,(07109) CAD,1105,753,932,2790
32131,2020-01-07,(02105) Calle 142,4150,2576,2687,9413
32132,2020-05-04,(06000) Portal Eldorado,908,567,404,1879
32133,2020-04-14,(09122) Calle 72,609,468,365,1442
32134,2020-07-04,(12003) Ricaurte,284,173,220,677
32135,2020-04-03,(05100) Banderas P. Central,351,200,231,782
32136,2020-05-24,(06001) Modelia,85,51,72,208
32137,2020-08-30,(03013) RIO NEGRO,78,32,100,210
32138,2020-06-06,(04003) Avenida Ciudad de Cali,682,390,518,1590
32139,2020-01-04,(06107) Ciudad Universitaria,228,162,315,705
32140,2020-03-21,(08000) Portal Tunal - alimentacion,2294,1066,976,4336
32141,2020-03-14,(03006) NIZA - CALLE 127,1099,699,894,2692
32142,2020-05-11,(05107) Américas - Cr.53,330,230,224,784
32143,2020-05-29,(04003) Avenida Ciudad de Cali,934,536,555,2025
32144,2020-04-03,(07004) VENECIA,494,300,269,1063
32145,2020-08-23,(10005) Bicentenario,20,21,32,73
32146,2020-08-12,(02001) Centro Comercial Santa Fe,406,255,309,970
32147,2020-08-18,(02001) Centro Comercial Santa Fe,442,277,283,1002
32148,2020-05-29,(04100) Carrera 77,1121,611,706,2438
32149,2020-07-18,(07102) NQS - CALLE 75,274,216,188,678
32150,2020-09-28,(02200) Alcalá,2103,1396,1413,4912
32151,2020-08-24,(02304) Heroes,704,492,369,1565
32152,2020-01-04,(06102) Salitre El Greco,458,281,316,1055
32153,2020-09-23,(06111) Universidades,458,269,452,1179
32154,2020-03-31,(03009) Av. Suba- Calle 116,368,225,158,751
32155,2020-08-21,(07110) PALOQUEMAO,615,375,276,1266
32156,2020-03-19,(09111) Calle 19,1413,851,956,3220
32157,2020-04-24,(09106) Nariño,226,126,147,499
32158,2020-02-22,(05101) Mandalay - Cr.73,531,224,342,1097
32159,2020-05-08,(09122) Calle 72,825,585,458,1868
32160,2020-07-18,(09122) Calle 72,712,456,510,1678
32161,2020-09-27,(09122) Calle 72,326,279,492,1097
32162,2020-08-31,(09111) Calle 19,702,412,438,1552
32163,2020-09-14,(06104) Gobernación,310,146,170,626
32164,2020-03-25,(07107) U. NACIONAL,217,177,139,533
32165,2020-08-16,(09123) Calle 76,185,146,177,508
32166,2020-04-24,(09113) Calle 22,228,154,177,559
32167,2020-09-14,(03003) 21 ANGELES,364,181,232,777
32168,2020-06-03,(07110) PALOQUEMAO,650,363,238,1251
32169,2020-10-10,(09121) Las Flores,469,327,564,1360
32170,2020-04-23,(10006) San Victorino,210,149,159,518
32171,2020-03-23,(09119) Calle 57,125,99,97,321
32172,2020-01-03,(05005) Transversal 86,1166,607,628,2401
32173,2020-02-21,(40001) Juan Pablo II,1638,903,926,3467
32174,2020-05-17,(40002) Manitas,93,45,82,220
32175,2020-05-30,(06111) Universidades,0,102,305,407
32176,2020-07-25,(10007) Las Nieves,283,177,237,697
32177,2020-08-03,(02304) Heroes,774,527,383,1684
32178,2020-02-08,(12000) Puente Aranda,192,121,144,457
32179,2020-06-22,(12000) Puente Aranda,13,6,18,37
32180,2020-08-06,(12000) Puente Aranda,86,56,42,184
32181,2020-10-11,(09104) Restrepo,523,281,657,1461
32182,2020-08-02,(07004) VENECIA,251,134,174,559
32183,2020-09-12,(07506) DESPENSA,364,199,299,862
32184,2020-01-22,(12004) Carrera 22,639,441,513,1593
32185,2020-08-04,(12004) Carrera 22,236,147,125,508
32186,2020-08-05,(12004) Carrera 22,247,134,123,504
32187,2020-08-22,(10004) Policarpa,169,89,134,392
32188,2020-06-01,(06106) Recinto Ferial,243,152,109,504
32189,2020-01-06,(09122) Calle 72,773,564,997,2334
32190,2020-10-03,(09003) Socorro,589,241,419,1249
32191,2020-07-15,(07009) SENA,615,367,339,1321
32192,2020-07-21,(07009) SENA,563,362,318,1243
32193,2020-08-02,(03013) RIO NEGRO,67,44,76,187
32194,2020-08-04,(09120) Calle 63,982,666,628,2276
32195,2020-09-23,(09120) Calle 63,1334,882,914,3130
32196,2020-04-12,(02101) Toberín,90,98,114,302
32197,2020-02-10,(12002) CDS - Carrera 32,675,375,347,1397
32198,2020-01-01,(40001) Juan Pablo II,215,81,184,480
32199,2020-03-26,(09113) Calle 22,164,108,121,393
32200,2020-09-18,(06002) Normandía,354,212,262,828
32201,2020-09-10,(07006) General Santander,534,261,324,1119
32202,2020-03-30,(04000) Cabecera Calle 80 - intermunicipal,96,80,109,285
32203,2020-04-18,(04000) Cabecera Calle 80 - intermunicipal,72,30,62,164
32204,2020-06-12,(05107) Américas - Cr.53,404,282,228,914
32205,2020-08-29,(09108) Hospital,45,35,84,164
32206,2020-01-03,(14004) Museo del Oro,941,691,758,2390
32207,2020-08-01,(07104) Simon Bolivar,228,172,183,583
32208,2020-04-02,(07010) Bosa,266,175,182,623
32209,2020-05-02,(02502) Terminal,117,76,99,292
32210,2020-08-02,(09104) Restrepo,411,232,418,1061
32211,2020-05-24,(07000) Portal Sur,364,211,310,885
32212,2020-10-12,(07008) NQS - Calle 30 Sur,137,60,123,320
32213,2020-04-17,(07009) SENA,346,201,216,763
32214,2020-03-30,(04003) Avenida Ciudad de Cali,502,325,345,1172
32215,2020-05-04,(12007) Zona Industrial,212,145,112,469
32216,2020-07-21,(10004) Policarpa,196,103,130,429
32217,2020-08-16,(09109) Tercer Milenio,83,47,104,234
32218,2020-05-17,(05105) Pradera,88,86,58,232
32219,2020-05-28,(09113) Calle 22,270,204,265,739
32220,2020-06-27,(06108) Concejo de Bogotá,75,55,81,211
32221,2020-05-02,(07006) General Santander,171,100,102,373
32222,2020-08-23,(07010) Bosa,175,75,119,369
32223,2020-10-11,(06102) Salitre El Greco,89,59,100,248
32224,2020-08-25,(14005) Las Aguas,167,97,167,431
32225,2020-08-07,(07007) NQS - Calle 38A Sur,227,122,137,486
32226,2020-04-10,(02103) Mazurén,32,21,22,75
32227,2020-03-20,(09110) Avenida Jimenez,218,186,189,593
32228,2020-09-13,(04000) Cabecera Calle 80 - intermunicipal,86,50,94,230
32229,2020-04-07,(10008) San Diego,142,91,86,319
32230,2020-04-14,(40002) Manitas,188,94,121,403
32231,2020-06-01,(06107) Ciudad Universitaria,177,96,101,374
32232,2020-09-27,(12007) Zona Industrial,64,47,78,189
32233,2020-06-22,(06106) Recinto Ferial,84,54,55,193
32234,2020-06-21,(07104) Simon Bolivar,117,80,129,326
32235,2020-03-30,(04001) Quirigua,170,109,87,366
32236,2020-03-21,(05103) Marsella,91,62,67,220
32237,2020-03-29,(04102) Avenida Boyaca,33,14,25,72
32238,2020-02-08,(03014) SAN MARTIN,111,78,143,332
32239,2020-04-07,(03014) SAN MARTIN,12,8,12,32
32240,2020-09-27,(09106) Nariño,168,95,181,444
32241,2020-08-17,(05102) Av. Américas - Av. Boyacá,80,50,43,173
32242,2020-03-24,(03014) SAN MARTIN,35,32,37,104
32243,2020-08-16,(05101) Mandalay - Cr.73,22,4,16,42
32244,2020-07-19,(50006) Corral Carrera 77,1,2,0,3
32245,2020-07-23,(50006) Corral Carrera 77,3,3,5,11
32246,2020-08-08,(50006) Corral Carrera 77,2,1,1,4
32247,2020-06-02,(50006) Corral Carrera 77,6,3,11,20
32248,2020-04-05,(50002) Corral Calle 40 Sur,3,2,2,7
32249,2020-06-04,(04000) Cabecera Calle 80 - alimentacion,3594,2067,2074,7735
32250,2020-01-17,(09002) Consuelo,1307,650,821,2778
32251,2020-09-17,(02502) Terminal,472,332,463,1267
32252,2020-04-03,(07504) TERREROS,2391,1368,1346,5105
32253,2020-05-05,(07504) TERREROS,3224,1990,1650,6864
32254,2020-09-01,(07504) TERREROS,6131,3409,3121,12661
32255,2020-09-15,(10000) Portal 20 de Julio - alimentacion,4367,1943,2793,9103
32256,2020-01-15,(04106) Carrera 47,1214,682,810,2706
32257,2020-02-27,(04106) Carrera 47,1521,865,836,3222
32258,2020-02-02,(07111) NQS - RICAURTE,500,452,605,1557
32259,2020-01-16,(07503) SAN MATEO,37004,19050,16664,72718
32260,2020-02-20,(06107) Ciudad Universitaria,1543,871,890,3304
32261,2020-02-21,(05001) Patio Bonito,7149,3734,3666,14549
32262,2020-01-18,(02000) Cabecera Autopista Norte - alimentacion,13197,6104,8949,28250
32263,2020-05-02,(07112) COMUNEROS,329,199,186,714
32264,2020-01-26,(05005) Transversal 86,476,170,407,1053
32265,2020-05-04,(10000) Portal 20 de Julio - alimentacion,2638,1262,1661,5561
32266,2020-02-05,(07103) AV. CHILE,3771,2317,1947,8035
32267,2020-02-07,(09104) Restrepo,5378,3149,4193,12720
32268,2020-02-13,(05100) Banderas P. Central,8453,4858,3961,17272
32269,2020-08-11,(09100) Calle 40 Sur,1653,966,1080,3699
32270,2020-02-06,(07503) SAN MATEO,39188,22393,17682,79263
32271,2020-06-09,(06000) Portal Eldorado - alimentacion,3772,1922,1853,7547
32272,2020-02-24,(02000) Cabecera Autopista Norte,11571,7208,5912,24691
32273,2020-03-04,(02105) Calle 142,7133,4274,3923,15330
32274,2020-06-24,(05100) Banderas P. Central,808,455,542,1805
32275,2020-05-23,(07001) PERDOMO,542,294,321,1157
32276,2020-01-23,(04100) Carrera 77,6048,3462,3695,13205
32277,2020-01-15,(05103) Marsella,2491,1291,1289,5071
32278,2020-08-22,(05002) Tintal,1674,856,1174,3704
32279,2020-07-10,(10000) Portal 20 de Julio - alimentacion,4509,1978,2614,9101
32280,2020-07-26,(07102) NQS - CALLE 75,77,55,65,197
32281,2020-09-20,(07102) NQS - CALLE 75,81,69,134,284
32282,2020-01-10,(03013) RIO NEGRO,906,561,645,2112
32283,2020-07-13,(09000) Cabecera Usme - alimentacion,4938,2974,2991,10903
32284,2020-01-15,(03001) LA CAMPIÑA,5674,3150,3545,12369
32285,2020-08-08,(05100) Banderas P. Central - alimentacion,2078,954,1184,4216
32286,2020-08-31,(09103) Olaya,994,570,577,2141
32287,2020-10-06,(09103) Olaya,1184,654,843,2681
32288,2020-06-05,(07002) MADELENA,751,416,449,1616
32289,2020-04-13,(02200) Alcalá,886,643,503,2032
32290,2020-06-27,(02000) Cabecera Autopista Norte,1038,646,727,2411
32291,2020-02-24,(07107) U. NACIONAL,2249,1370,1248,4867
32292,2020-03-08,(02201) Prado,1071,554,1148,2773
32293,2020-07-10,(04000) Cabecera Calle 80,1190,734,929,2853
32294,2020-03-10,(09110) Avenida Jimenez,3057,224,597,3878
32295,2020-01-31,(02000) Cabecera Autopista Norte - intermunicipal,4754,3045,3076,10875
32296,2020-07-09,(09001) Molinos,2654,1483,1837,5974
32297,2020-02-26,(04002) Carrera 90,3758,2152,2058,7968
32298,2020-02-24,(03000) Portal Suba,9862,5790,4925,20577
32299,2020-01-17,(04001) Quirigua,1685,954,1160,3799
32300,2020-10-02,(07505) LEON XIII,3289,1622,1778,6689
32301,2020-01-14,(06111) Universidades,2294,1497,1834,5625
32302,2020-01-10,(02201) Prado,3929,2353,2321,8603
32303,2020-07-03,(03000) Portal Suba,1427,858,980,3265
32304,2020-08-12,(03000) Portal Suba,983,651,714,2348
32305,2020-01-07,(10010) San Bernardo,1253,686,1136,3075
32306,2020-04-21,(07112) COMUNEROS,463,291,256,1010
32307,2020-10-02,(02303) Calle 85,842,579,576,1997
32308,2020-01-23,(07000) Portal Sur,7410,4426,4142,15978
32309,2020-05-20,(09116) Avenida 39,288,198,173,659
32310,2020-09-12,(10002) Av. Primero de Mayo,1730,761,1447,3938
32311,2020-06-29,(04002) Carrera 90,255,129,163,547
32312,2020-03-01,(05100) Banderas P. Central - alimentacion,3192,1167,2561,6920
32313,2020-01-11,(09107) Hortúa,1068,599,904,2571
32314,2020-05-07,(04100) Carrera 77,872,472,570,1914
32315,2020-08-14,(08001) Parque el Tunal,451,237,286,974
32316,2020-09-25,(08001) Parque el Tunal,528,268,357,1153
32317,2020-09-11,(07505) LEON XIII,2411,1341,1495,5247
32318,2020-06-08,(07010) Bosa,678,340,376,1394
32319,2020-01-23,(07001) PERDOMO,4370,2574,2462,9406
32320,2020-03-24,(02101) Toberín,1356,952,934,3242
32321,2020-04-23,(02201) Prado,472,334,265,1071
32322,2020-07-18,(09107) Hortúa,365,220,266,851
32323,2020-09-09,(05002) Tintal,2914,1708,1819,6441
32324,2020-09-29,(05002) Tintal,2808,1700,1999,6507
32325,2020-02-27,(02300) Calle 100,6919,4709,3799,15427
32326,2020-01-08,(06000) Portal Eldorado,4811,2864,2350,10025
32327,2020-02-09,(07007) NQS - Calle 38A Sur,648,346,490,1484
32328,2020-02-04,(07006) General Santander,2941,1724,1648,6313
32329,2020-05-19,(08000) Portal Tunal,628,278,232,1138
32330,2020-02-28,(07104) Simon Bolivar,2399,1474,1329,5202
32331,2020-06-11,(07104) Simon Bolivar,602,368,257,1227
32332,2020-01-22,(09121) Las Flores,2902,1832,1836,6570
32333,2020-07-04,(03009) Av. Suba- Calle 116,359,227,240,826
32334,2020-07-08,(03009) Av. Suba- Calle 116,531,327,259,1117
32335,2020-05-26,(09118) Marly,1396,940,639,2975
32336,2020-06-02,(04108) El Polo,448,263,222,933
32337,2020-02-28,(12007) Zona Industrial,1247,748,658,2653
32338,2020-09-29,(07106) EL CAMPIN,510,326,353,1189
32339,2020-03-20,(07503) SAN MATEO,5712,3155,2244,11111
32340,2020-08-12,(03007) HUMEDAL CORDOBA,116,73,65,254
32341,2020-07-15,(10006) San Victorino,394,214,230,838
32342,2020-06-30,(07000) Portal Sur,1908,1280,1187,4375
32343,2020-09-22,(07000) Portal Sur,2242,1392,1579,5213
32344,2020-09-28,(07000) Portal Sur,2233,1394,1569,5196
32345,2020-03-02,(06105) Quinta Paredes,1020,593,485,2098
32346,2020-03-27,(07110) PALOQUEMAO,298,250,208,756
32347,2020-02-06,(04107) Escuela Militar,684,448,461,1593
32348,2020-08-30,(04003) Avenida Ciudad de Cali,286,163,329,778
32349,2020-08-17,(04104) Avenida 68,202,125,121,448
32350,2020-05-15,(09106) Nariño,316,192,198,706
32351,2020-01-02,(09109) Tercer Milenio,617,371,472,1460
32352,2020-02-15,(09109) Tercer Milenio,862,505,746,2113
32353,2020-02-05,(03007) HUMEDAL CORDOBA,1024,673,544,2241
32354,2020-04-07,(04105) Carrera 53,172,112,79,363
32355,2020-05-07,(02202) Calle 127,759,551,377,1687
32356,2020-02-12,(06104) Gobernación,1495,896,646,3037
32357,2020-10-01,(02304) Heroes,1000,702,681,2383
32358,2020-10-01,(08000) Portal Tunal,779,399,394,1572
32359,2020-03-18,(07004) VENECIA,2624,1432,1301,5357
32360,2020-05-04,(09118) Marly,1115,825,552,2492
32361,2020-08-09,(09000) Cabecera Usme - alimentacion,2371,1071,1483,4925
32362,2020-09-13,(02001) Centro Comercial Santa Fe,132,103,187,422
32363,2020-05-27,(07009) SENA,593,331,362,1286
32364,2020-03-01,(09120) Calle 63,1229,773,1302,3304
32365,2020-04-18,(06000) Portal Eldorado,504,368,277,1149
32366,2020-04-21,(02302) Virrey,326,250,192,768
32367,2020-06-24,(02302) Virrey,675,484,321,1480
32368,2020-03-25,(03009) Av. Suba- Calle 116,405,278,206,889
32369,2020-08-01,(10010) San Bernardo,426,199,349,974
32370,2020-07-12,(05100) Banderas P. Central,230,110,183,523
32371,2020-03-02,(10007) Las Nieves,2076,1227,1183,4486
32372,2020-08-21,(04106) Carrera 47,326,181,169,676
32373,2020-08-09,(04100) Carrera 77,287,143,268,698
32374,2020-04-07,(09116) Avenida 39,172,116,111,399
32375,2020-09-19,(09116) Avenida 39,248,184,309,741
32376,2020-03-26,(04104) Avenida 68,333,203,175,711
32377,2020-04-03,(05107) Américas - Cr.53,248,229,159,636
32378,2020-06-29,(10002) Av. Primero de Mayo,728,345,516,1589
32379,2020-08-27,(12007) Zona Industrial,398,237,138,773
32380,2020-03-26,(06102) Salitre El Greco,180,138,85,403
32381,2020-02-06,(07105) MOVISTAR ARENA,1350,862,709,2921
32382,2020-05-05,(02304) Heroes,527,378,275,1180
32383,2020-02-22,(09114) Calle 26,716,602,1014,2332
32384,2020-02-01,(10009) Museo Nacional,997,854,1380,3231
32385,2020-09-20,(09120) Calle 63,433,301,462,1196
32386,2020-03-25,(05105) Pradera,437,282,199,918
32387,2020-10-04,(09115) Calle 34,150,116,257,523
32388,2020-09-24,(03006) NIZA - CALLE 127,569,339,316,1224
32389,2020-05-21,(02200) Alcalá,1407,1040,721,3168
32390,2020-02-19,(09111) Calle 19,2431,1403,1531,5365
32391,2020-06-25,(09111) Calle 19,822,517,471,1810
32392,2020-03-15,(07101) CASTELLANA,49,53,137,239
32393,2020-06-23,(02101) Toberín,1613,1034,971,3618
32394,2020-08-18,(12004) Carrera 22,270,158,136,564
32395,2020-04-26,(07111) NQS - RICAURTE,99,97,82,278
32396,2020-01-22,(05101) Mandalay - Cr.73,1003,557,483,2043
32397,2020-04-13,(09122) Calle 72,610,475,341,1426
32398,2020-04-18,(09122) Calle 72,433,288,272,993
32399,2020-04-02,(09111) Calle 19,211,160,213,584
32400,2020-07-03,(09111) Calle 19,801,511,550,1862
32401,2020-07-31,(06104) Gobernación,236,147,119,502
32402,2020-02-16,(09121) Las Flores,611,402,759,1772
32403,2020-06-15,(50003) Corral Molinos,569,270,427,1266
32404,2020-02-02,(09114) Calle 26,237,200,461,898
32405,2020-04-08,(10001) Country Sur,581,226,354,1161
32406,2020-08-14,(07003) SEVILLANA,456,247,249,952
32407,2020-08-06,(14005) Las Aguas,168,99,175,442
32408,2020-10-06,(03003) 21 ANGELES,381,197,282,860
32409,2020-09-08,(10007) Las Nieves,682,397,368,1447
32410,2020-03-30,(07107) U. NACIONAL,197,164,109,470
32411,2020-03-22,(02104) Calle 146,169,126,93,388
32412,2020-09-12,(06102) Salitre El Greco,187,121,136,444
32413,2020-04-29,(09119) Calle 57,317,236,223,776
32414,2020-09-08,(05005) Transversal 86,418,205,296,919
32415,2020-09-21,(10007) Las Nieves,130,308,425,863
32416,2020-07-17,(09114) Calle 26,269,177,182,628
32417,2020-04-15,(08002) Biblioteca,161,106,84,351
32418,2020-04-18,(07109) CAD,284,213,125,622
32419,2020-08-20,(09121) Las Flores,643,407,428,1478
32420,2020-01-01,(03011) SUBA - CALLE 100,153,122,230,505
32421,2020-09-03,(02502) Terminal,452,313,409,1174
32422,2020-05-06,(10009) Museo Nacional,379,236,190,805
32423,2020-08-01,(07102) NQS - CALLE 75,171,136,158,465
32424,2020-07-28,(07109) CAD,550,331,244,1125
32425,2020-10-11,(02303) Calle 85,173,141,207,521
32426,2020-05-17,(04108) El Polo,67,45,52,164
32427,2020-03-30,(09113) Calle 22,183,110,138,431
32428,2020-08-05,(07006) General Santander,446,268,277,991
32429,2020-02-16,(03003) 21 ANGELES,376,122,347,845
32430,2020-05-29,(04105) Carrera 53,253,141,137,531
32431,2020-03-12,(04102) Avenida Boyaca,616,517,346,1479
32432,2020-07-30,(07108) Av. El Dorado,131,74,67,272
32433,2020-03-28,(06002) Normandía,102,57,67,226
32434,2020-05-28,(04102) Avenida Boyaca,267,172,170,609
32435,2020-03-13,(07109) CAD,822,153,368,1343
32436,2020-04-01,(03003) 21 ANGELES,164,75,81,320
32437,2020-08-30,(02103) Mazurén,40,34,79,153
32438,2020-07-16,(07106) EL CAMPIN,372,254,168,794
32439,2020-04-02,(09117) Calle 45,473,300,230,1003
32440,2020-09-08,(12002) CDS - Carrera 32,209,130,79,418
32441,2019-12-31,(09002) Consuelo,21,12,28,61
32442,2020-08-08,(10007) Las Nieves,411,299,269,979
32443,2020-08-16,(14001) La Sabana,56,44,51,151
32444,2020-09-03,(10004) Policarpa,256,134,189,579
32445,2020-05-25,(06002) Normandía,78,54,74,206
32446,2020-07-08,(07007) NQS - Calle 38A Sur,416,237,273,926
32447,2020-01-06,(12002) CDS - Carrera 32,60,52,59,171
32448,2020-09-23,(04102) Avenida Boyaca,451,252,363,1066
32449,2020-04-09,(10006) San Victorino,65,39,40,144
32450,2020-08-18,(06106) Recinto Ferial,219,137,105,461
32451,2020-04-12,(06101) El Tiempo,78,54,39,171
32452,2020-04-07,(09106) Nariño,164,112,147,423
32453,2020-08-02,(04105) Carrera 53,66,37,56,159
32454,2020-08-09,(07104) Simon Bolivar,83,57,91,231
32455,2020-09-27,(05102) Av. Américas - Av. Boyacá,77,46,72,195
32456,2020-05-16,(02304) Heroes,378,318,236,932
32457,2020-05-24,(07107) U. NACIONAL,80,62,57,199
32458,2020-07-07,(06106) Recinto Ferial,279,168,121,568
32459,2020-06-26,(07006) General Santander - alimentacion,424,218,284,926
32460,2020-06-06,(08002) Biblioteca,231,106,137,474
32461,2020-04-05,(06107) Ciudad Universitaria,28,20,32,80
32462,2020-07-19,(09107) Hortúa,184,109,113,406
32463,2020-04-21,(10003) Ciudad Jardín,106,69,86,261
32464,2020-04-24,(09105) Río Fucha,77,42,44,163
32465,2020-02-02,(10004) Policarpa,234,103,268,605
32466,2020-08-30,(12002) CDS - Carrera 32,32,28,33,93
32467,2020-03-27,(07113) SANTA ISABEL,168,127,101,396
32468,2020-06-14,(09002) Consuelo,140,59,108,307
32469,2020-04-10,(04107) Escuela Militar,11,14,8,33
32470,2020-04-12,(03005) SUBA - AV. BOYACA,79,41,46,166
32471,2020-09-27,(03014) SAN MARTIN,0,5,26,31
32472,2020-04-10,(07102) NQS - CALLE 75,34,18,18,70
32473,2020-07-31,(50006) Corral Carrera 77,4,3,9,16
32474,2020-08-02,(50006) Corral Carrera 77,1,1,0,2
32475,2020-06-06,(04000) Cabecera Calle 80 - alimentacion,2589,1339,1772,5700
32476,2020-02-06,(09002) Consuelo,1448,788,888,3124
32477,2020-10-05,(07504) TERREROS,7187,3697,4172,15056
32478,2020-03-16,(09119) Calle 57,2515,1581,1464,5560
32479,2020-09-02,(09119) Calle 57,617,374,415,1406
32480,2020-01-08,(03002) SUBA - TV- 91,2987,1770,1775,6532
32481,2020-09-26,(03002) SUBA - TV- 91,680,328,612,1620
32482,2020-03-06,(07505) LEON XIII,8497,4518,3983,16998
32483,2020-01-23,(08001) Parque el Tunal,1558,866,887,3311
32484,2020-02-26,(10000) Portal 20 de Julio - alimentacion,10895,5658,7772,24325
32485,2020-02-11,(04101) Minuto de Dios,3730,2284,1963,7977
32486,2020-02-22,(09121) Las Flores,1711,1144,1480,4335
32487,2020-09-06,(09001) Molinos,878,384,789,2051
32488,2020-02-21,(07503) SAN MATEO,40911,22412,17770,81093
32489,2020-05-22,(07503) SAN MATEO,8892,5366,4239,18497
32490,2020-05-27,(08000) Portal Tunal - alimentacion,5631,3029,2868,11528
32491,2020-09-25,(07112) COMUNEROS,957,536,725,2218
32492,2020-09-26,(07112) COMUNEROS,650,371,617,1638
32493,2020-01-08,(04100) Carrera 77,4529,2497,3167,10193
32494,2020-05-27,(10001) Country Sur,1005,458,616,2079
32495,2020-02-27,(02102) Calle 161,1854,1132,1107,4093
32496,2020-09-15,(09000) Cabecera Usme,1867,1104,1414,4385
32497,2020-01-11,(06000) Portal Eldorado - alimentacion,8452,3909,5416,17777
32498,2020-02-03,(06102) Salitre El Greco,1587,885,739,3211
32499,2020-02-05,(10003) Ciudad Jardín,1087,629,715,2431
32500,2020-03-16,(05100) Banderas P. Central,4934,2800,2356,10090
32501,2020-09-23,(07001) PERDOMO,1067,653,852,2572
32502,2020-01-15,(04000) Cabecera Calle 80 - intermunicipal,1685,1100,1723,4508
32503,2020-05-21,(04101) Minuto de Dios,253,149,160,562
32504,2020-03-06,(04100) Carrera 77,6773,3831,4118,14722
32505,2020-02-14,(07505) LEON XIII,8747,4818,3842,17407
32506,2020-04-10,(07504) TERREROS,833,503,428,1764
32507,2020-02-05,(04104) Avenida 68,3909,2038,1874,7821
32508,2020-03-06,(09117) Calle 45,6042,4059,3386,13487
32509,2020-02-26,(07102) NQS - CALLE 75,1467,987,1020,3474
32510,2020-03-07,(07102) NQS - CALLE 75,763,623,753,2139
32511,2020-10-10,(09103) Olaya,942,429,752,2123
32512,2020-02-27,(02302) Virrey,3867,2662,1804,8333
32513,2020-02-04,(07110) PALOQUEMAO,2552,1467,1219,5238
32514,2020-02-27,(02303) Calle 85,3891,2639,1936,8466
32515,2020-08-19,(09103) Olaya,992,516,539,2047
32516,2020-03-02,(14001) La Sabana,620,397,396,1413
32517,2020-03-04,(14001) La Sabana,597,388,381,1366
32518,2020-08-10,(14001) La Sabana,146,104,93,343
32519,2020-09-19,(02000) Cabecera Autopista Norte - alimentacion,4426,2018,3126,9570
32520,2020-04-15,(08000) Portal Tunal - alimentacion,3420,1850,1821,7091
32521,2020-03-17,(07002) MADELENA,2735,1542,1498,5775
32522,2020-06-16,(02000) Cabecera Autopista Norte,1324,886,813,3023
32523,2020-04-06,(04105) Carrera 53,166,108,97,371
32524,2020-09-06,(08000) Portal Tunal - alimentacion,2277,1051,1703,5031
32525,2020-09-29,(08000) Portal Tunal - alimentacion,6939,3762,4651,15352
32526,2020-02-11,(04000) Cabecera Calle 80,7908,4948,5089,17945
32527,2020-06-30,(04100) Carrera 77,1319,737,863,2919
32528,2020-04-08,(10000) Portal 20 de Julio - alimentacion,2671,1004,1502,5177
32529,2020-06-12,(40003) Mirador del Paraiso,1749,1116,1028,3893
32530,2020-06-19,(02101) Toberín,1515,926,1033,3474
32531,2020-05-21,(02000) Cabecera Autopista Norte - alimentacion,3803,2268,1975,8046
32532,2020-03-16,(12001) Carrera 43,1273,753,770,2796
32533,2020-01-15,(02201) Prado,4731,2939,2719,10389
32534,2020-07-08,(02000) Cabecera Autopista Norte - intermunicipal,608,379,416,1403
32535,2020-05-08,(02000) Cabecera Autopista Norte - intermunicipal,278,180,196,654
32536,2020-10-06,(10000) Portal 20 de Julio - alimentacion,4754,1971,3301,10026
32537,2020-03-02,(08001) Parque el Tunal,1639,990,977,3606
32538,2020-04-11,(10000) Portal 20 de Julio - alimentacion,1774,698,838,3310
32539,2020-04-25,(08000) Portal Tunal - alimentacion,2537,1440,1375,5352
32540,2020-01-30,(03007) HUMEDAL CORDOBA,1005,630,571,2206
32541,2020-02-06,(04108) El Polo,1930,1285,1241,4456
32542,2020-07-21,(07112) COMUNEROS,792,455,398,1645
32543,2020-09-14,(07000) Portal Sur,2170,1322,1352,4844
32544,2020-08-14,(10002) Av. Primero de Mayo,2182,1051,1260,4493
32545,2020-02-09,(09004) Santa Lucía,2268,873,1727,4868
32546,2020-02-19,(06103) CAN,2715,1543,1267,5525
32547,2020-03-06,(06103) CAN,2353,1472,1286,5111
32548,2020-03-26,(06108) Concejo de Bogotá,99,74,73,246
32549,2020-01-12,(03003) 21 ANGELES,306,96,297,699
32550,2020-01-31,(03003) 21 ANGELES,1730,787,920,3437
32551,2020-03-30,(02201) Prado,413,286,255,954
32552,2020-08-04,(02201) Prado,706,494,421,1621
32553,2020-06-25,(09123) Calle 76,1080,757,601,2438
32554,2020-08-17,(05002) Tintal,595,335,426,1356
32555,2020-09-19,(05002) Tintal,2338,1170,1800,5308
32556,2020-01-09,(02300) Calle 100,5432,3412,2985,11829
32557,2020-04-27,(02300) Calle 100,147,392,190,729
32558,2020-09-08,(02300) Calle 100,1280,848,725,2853
32559,2020-02-10,(03012) SUBA - CALLE 95,1400,896,1003,3299
32560,2020-03-06,(50002) Corral Calle 40 Sur,104,95,173,372
32561,2020-05-23,(10002) Av. Primero de Mayo,1252,671,852,2775
32562,2020-06-22,(05005) Transversal 86,107,52,84,243
32563,2020-09-12,(02202) Calle 127,845,576,631,2052
32564,2020-03-05,(06109) Centro Memoria,1161,619,607,2387
32565,2020-06-01,(07007) NQS - Calle 38A Sur,365,190,231,786
32566,2020-08-15,(03009) Av. Suba- Calle 116,329,235,213,777
32567,2020-09-29,(03009) Av. Suba- Calle 116,541,336,320,1197
32568,2020-05-22,(02205) Calle 106,284,180,190,654
32569,2020-08-13,(06000) Portal Eldorado - alimentacion,3528,1793,1813,7134
32570,2020-03-04,(03006) NIZA - CALLE 127,2489,1567,1452,5508
32571,2020-06-05,(06000) Portal Eldorado - alimentacion,3764,1850,1807,7421
32572,2020-01-21,(06000) Portal Eldorado,4257,2796,2006,9059
32573,2020-09-14,(05001) Patio Bonito,2069,1091,1210,4370
32574,2020-08-07,(07106) EL CAMPIN,159,112,79,350
32575,2020-04-23,(09100) Calle 40 Sur,917,566,517,2000
32576,2020-07-09,(06000) Portal Eldorado - alimentacion,4090,2169,2093,8352
32577,2020-09-15,(03007) HUMEDAL CORDOBA,161,113,106,380
32578,2020-10-10,(03011) SUBA - CALLE 100,351,249,348,948
32579,2020-05-19,(07000) Portal Sur,1418,909,813,3140
32580,2020-03-02,(05103) Marsella,3168,1800,1452,6420
32581,2020-03-30,(05100) Banderas P. Central - alimentacion,1509,701,723,2933
32582,2020-05-18,(09100) Calle 40 Sur,1401,804,868,3073
32583,2020-05-04,(10005) Bicentenario - alimentacion,182,75,109,366
32584,2020-02-09,(08000) Portal Tunal,593,389,395,1377
32585,2020-01-23,(02000) Cabecera Autopista Norte - intermunicipal,4522,3071,2916,10509
32586,2020-09-22,(09117) Calle 45,742,481,573,1796
32587,2020-06-05,(10001) Country Sur,1118,508,723,2349
32588,2020-07-15,(07002) MADELENA,589,350,379,1318
32589,2020-07-24,(07002) MADELENA,572,317,345,1234
32590,2020-03-22,(04105) Carrera 53,44,30,38,112
32591,2020-04-10,(40003) Mirador del Paraiso,229,150,147,526
32592,2020-08-30,(09101) Quiroga,180,87,211,478
32593,2020-01-10,(07007) NQS - Calle 38A Sur,1535,853,986,3374
32594,2020-07-13,(02204) Pepe Sierra,710,516,335,1561
32595,2020-10-04,(02104) Calle 146,325,159,352,836
32596,2020-09-10,(08000) Portal Tunal,755,339,346,1440
32597,2020-02-16,(03006) NIZA - CALLE 127,502,312,464,1278
32598,2020-04-08,(07109) CAD,379,254,174,807
32599,2020-06-29,(02302) Virrey,200,138,128,466
32600,2020-06-30,(02302) Virrey,687,456,395,1538
32601,2020-08-19,(02302) Virrey,569,399,295,1263
32602,2020-05-06,(03009) Av. Suba- Calle 116,362,243,190,795
32603,2020-01-05,(02104) Calle 146,847,377,885,2109
32604,2020-10-04,(02105) Calle 142,214,155,333,702
32605,2020-03-13,(06108) Concejo de Bogotá,172,43,86,301
32606,2020-03-22,(10010) San Bernardo,128,100,110,338
32607,2020-07-01,(02104) Calle 146,790,491,551,1832
32608,2020-03-08,(07103) AV. CHILE,496,340,703,1539
32609,2020-08-03,(40002) Manitas,370,222,243,835
32610,2020-01-12,(02105) Calle 142,800,393,956,2149
32611,2020-04-14,(05100) Banderas P. Central - alimentacion,1564,738,647,2949
32612,2020-06-07,(09001) Molinos,628,319,494,1441
32613,2020-03-18,(14005) Las Aguas,849,587,682,2118
32614,2020-03-23,(05001) Patio Bonito,357,226,233,816
32615,2020-06-12,(05100) Banderas P. Central,562,337,448,1347
32616,2020-02-22,(14001) La Sabana,259,254,333,846
32617,2020-06-04,(03011) SUBA - CALLE 100,461,198,196,855
32618,2020-08-31,(03011) SUBA - CALLE 100,571,270,283,1124
32619,2020-06-16,(04101) Minuto de Dios,323,208,202,733
32620,2020-06-20,(12007) Zona Industrial,289,191,171,651
32621,2020-04-03,(03012) SUBA - CALLE 95,178,118,102,398
32622,2020-07-06,(07111) NQS - RICAURTE,1230,745,495,2470
32623,2020-09-27,(09115) Calle 34,163,106,235,504
32624,2020-10-06,(09115) Calle 34,764,477,595,1836
32625,2020-05-06,(02200) Alcalá,1137,809,556,2502
32626,2020-09-17,(07110) PALOQUEMAO,727,423,375,1525
32627,2020-09-11,(14004) Museo del Oro,349,233,316,898
32628,2020-07-04,(09122) Calle 72,940,624,764,2328
32629,2020-05-28,(03010) PUENTE LARGO,314,211,141,666
32630,2020-09-23,(50003) Corral Molinos,1634,851,1289,3774
32631,2020-09-05,(07105) MOVISTAR ARENA,177,143,147,467
32632,2020-09-07,(07105) MOVISTAR ARENA,257,133,156,546
32633,2020-10-11,(07105) MOVISTAR ARENA,57,43,106,206
32634,2020-05-16,(02302) Virrey,338,261,191,790
32635,2020-07-10,(09113) Calle 22,474,272,333,1079
32636,2020-08-22,(04102) Avenida Boyaca,290,162,210,662
32637,2020-07-21,(03002) SUBA - TV- 91,696,414,428,1538
32638,2020-04-02,(07113) SANTA ISABEL,187,126,138,451
32639,2020-03-13,(09121) Las Flores,1076,170,418,1664
32640,2020-07-28,(03009) Av. Suba- Calle 116,474,290,185,949
32641,2020-06-03,(09110) Avenida Jimenez,1015,658,683,2356
32642,2020-03-23,(07008) NQS - Calle 30 Sur,59,37,28,124
32643,2020-01-06,(10004) Policarpa,179,82,182,443
32644,2020-04-06,(10004) Policarpa,115,70,91,276
32645,2020-08-31,(07001) PERDOMO,947,560,637,2144
32646,2020-01-03,(50002) Corral Calle 40 Sur,55,29,77,161
32647,2020-05-18,(07111) NQS - RICAURTE,874,568,357,1799
32648,2020-03-16,(07006) General Santander - alimentacion,1133,654,712,2499
32649,2020-06-22,(04000) Cabecera Calle 80 - intermunicipal,81,40,83,204
32650,2020-05-05,(07109) CAD,445,298,198,941
32651,2020-05-07,(02102) Calle 161,141,88,98,327
32652,2020-06-12,(06001) Modelia,395,257,192,844
32653,2020-05-28,(07102) NQS - CALLE 75,371,238,184,793
32654,2020-01-09,(07506) DESPENSA,1273,721,762,2756
32655,2020-03-28,(10000) Portal 20 de Julio,810,388,341,1539
32656,2020-02-28,(07008) NQS - Calle 30 Sur,1969,996,1163,4128
32657,2020-07-17,(50003) Corral Molinos,1133,638,847,2618
32658,2020-08-27,(09120) Calle 63,1089,718,685,2492
32659,2020-05-23,(07003) SEVILLANA,286,143,135,564
32660,2020-05-05,(03006) NIZA - CALLE 127,273,178,149,600
32661,2020-06-02,(04000) Cabecera Calle 80 - intermunicipal,284,141,230,655
32662,2020-07-09,(04000) Cabecera Calle 80 - intermunicipal,336,191,277,804
32663,2020-07-11,(06002) Normandía,214,134,149,497
32664,2020-05-15,(04101) Minuto de Dios,234,159,163,556
32665,2020-04-08,(04000) Cabecera Calle 80 - intermunicipal,105,63,77,245
32666,2020-08-22,(04000) Cabecera Calle 80 - intermunicipal,220,95,202,517
32667,2020-06-21,(03010) PUENTE LARGO,87,63,55,205
32668,2020-07-12,(09113) Calle 22,255,134,228,617
32669,2020-09-18,(09108) Hospital,70,47,75,192
32670,2020-08-10,(03006) NIZA - CALLE 127,346,229,193,768
32671,2020-03-08,(03009) Av. Suba- Calle 116,361,255,446,1062
32672,2020-06-22,(03009) Av. Suba- Calle 116,161,116,87,364
32673,2020-09-25,(09003) Socorro,652,357,418,1427
32674,2020-09-09,(07003) SEVILLANA,487,253,297,1037
32675,2020-08-12,(09106) Nariño,388,212,300,900
32676,2020-01-02,(07506) DESPENSA,768,424,540,1732
32677,2020-05-11,(05102) Av. Américas - Av. Boyacá,167,85,112,364
32678,2020-05-10,(07000) Portal Sur,319,209,204,732
32679,2020-04-18,(06001) Modelia,169,123,104,396
32680,2020-08-30,(07107) U. NACIONAL,112,67,104,283
32681,2020-09-18,(07108) Av. El Dorado,156,102,126,384
32682,2020-03-31,(06111) Universidades,0,72,222,294
32683,2020-08-30,(10007) Las Nieves,151,106,141,398
32684,2020-03-31,(04104) Avenida 68,296,199,184,679
32685,2020-08-02,(04000) Cabecera Calle 80,195,145,206,546
32686,2020-05-17,(05100) Banderas P. Central,103,50,83,236
32687,2020-05-02,(07506) DESPENSA,197,115,131,443
32688,2019-12-31,(06111) Universidades,16,18,35,69
32689,2020-03-27,(07106) EL CAMPIN,127,100,114,341
32690,2020-09-14,(06105) Quinta Paredes,174,105,109,388
32691,2020-08-14,(09116) Avenida 39,339,190,236,765
32692,2020-06-07,(06108) Concejo de Bogotá,29,18,28,75
32693,2020-06-13,(02103) Mazurén,135,74,100,309
32694,2020-03-28,(10008) San Diego,80,63,72,215
32695,2020-09-25,(06106) Recinto Ferial,292,186,199,677
32696,2020-05-25,(06103) CAN,162,107,67,336
32697,2020-04-18,(02204) Pepe Sierra,337,241,174,752
32698,2020-05-04,(06107) Ciudad Universitaria,139,90,104,333
32699,2020-04-09,(06111) Universidades,0,27,59,86
32700,2020-07-23,(06103) CAN,339,195,114,648
32701,2020-07-14,(07003) SEVILLANA,369,211,187,767
32702,2020-08-16,(04105) Carrera 53,71,33,66,170
32703,2020-05-04,(09105) Río Fucha,100,41,68,209
32704,2020-04-04,(05102) Av. Américas - Av. Boyacá,96,39,38,173
32705,2020-05-25,(06102) Salitre El Greco,71,39,45,155
32706,2020-08-17,(50002) Corral Calle 40 Sur,5,3,8,16
32707,2020-04-17,(03007) HUMEDAL CORDOBA,76,50,27,153
32708,2020-04-10,(09105) Río Fucha,29,14,16,59
32709,2020-06-02,(07108) Av. El Dorado,109,74,96,279
32710,2020-08-30,(03014) SAN MARTIN,0,3,20,23
32711,2020-04-07,(06104) Gobernación,146,115,87,348
32712,2020-04-29,(10005) Bicentenario,58,37,42,137
32713,2020-05-07,(50006) Corral Carrera 77,8,2,7,17
32714,2020-05-31,(12000) Puente Aranda,3,9,5,17
32715,2020-09-14,(07005) ALQUERIA,541,328,372,1241
32716,2020-01-20,(09002) Consuelo,1368,721,815,2904
32717,2020-06-30,(09002) Consuelo,541,279,306,1126
32718,2020-01-18,(03013) RIO NEGRO,638,394,588,1620
32719,2020-04-25,(07504) TERREROS,1762,1168,871,3801
32720,2020-08-04,(05000) Portal Américas - alimentacion,9463,4849,4956,19268
32721,2020-01-26,(07111) NQS - RICAURTE,492,404,607,1503
32722,2020-09-14,(07503) SAN MATEO,12071,6647,6166,24884
32723,2020-01-29,(02200) Alcalá,14616,9146,6572,30334
32724,2020-02-11,(06000) Portal Eldorado - alimentacion,19451,10669,9909,40029
32725,2020-09-15,(03000) Portal Suba - alimentacion,6823,3779,4440,15042
32726,2020-04-21,(04000) Cabecera Calle 80 - alimentacion,1985,1152,1143,4280
32727,2020-10-09,(07112) COMUNEROS,964,547,772,2283
32728,2020-01-28,(50006) Corral Carrera 77,36,20,51,107
32729,2020-01-26,(10000) Portal 20 de Julio - alimentacion,3512,1337,2765,7614
32730,2020-10-10,(09004) Santa Lucía,2395,1015,1711,5121
32731,2020-07-16,(05100) Banderas P. Central,649,346,431,1426
32732,2020-08-13,(05100) Banderas P. Central,793,463,527,1783
32733,2020-06-14,(10001) Country Sur,258,139,230,627
32734,2020-02-27,(05100) Banderas P. Central - alimentacion,16053,9315,8648,34016
32735,2020-10-10,(05100) Banderas P. Central - alimentacion,2668,1160,2138,5966
32736,2020-02-06,(09113) Calle 22,1549,891,1117,3557
32737,2020-02-25,(07009) SENA,3808,2298,1997,8103
32738,2020-01-18,(07000) Portal Sur - alimentacion,17884,8800,10623,37307
32739,2020-06-16,(07001) PERDOMO,934,548,533,2015
32740,2020-07-31,(09000) Cabecera Usme - alimentacion,7867,4185,4366,16418
32741,2020-04-24,(07504) TERREROS,2643,1667,1316,5626
32742,2020-08-04,(09101) Quiroga,491,247,337,1075
32743,2020-01-28,(07102) NQS - CALLE 75,1462,949,907,3318
32744,2020-07-03,(07102) NQS - CALLE 75,449,305,272,1026
32745,2020-09-29,(07102) NQS - CALLE 75,488,323,320,1131
32746,2020-01-07,(03013) RIO NEGRO,853,525,632,2010
32747,2020-01-17,(03013) RIO NEGRO,1054,684,796,2534
32748,2020-05-05,(09118) Marly,1148,812,506,2466
32749,2020-08-22,(02103) Mazurén,130,79,123,332
32750,2020-09-02,(07000) Portal Sur - alimentacion,8704,4982,4852,18538
32751,2020-08-24,(05100) Banderas P. Central - alimentacion,2742,1338,1441,5521
32752,2020-07-02,(14001) La Sabana,179,105,130,414
32753,2020-08-10,(07002) MADELENA,730,438,470,1638
32754,2020-08-27,(07002) MADELENA,826,479,525,1830
32755,2020-02-22,(07106) EL CAMPIN,1259,849,895,3003
32756,2020-02-17,(03003) 21 ANGELES,1772,939,871,3582
32757,2020-01-16,(09004) Santa Lucía,6518,3503,3924,13945
32758,2020-04-15,(50003) Corral Molinos,787,392,536,1715
32759,2020-06-17,(09110) Avenida Jimenez,1247,915,853,3015
32760,2020-07-05,(09110) Avenida Jimenez,374,284,404,1062
32761,2020-06-26,(07112) COMUNEROS,837,458,494,1789
32762,2020-03-02,(09114) Calle 26,3357,2157,1787,7301
32763,2020-03-18,(04002) Carrera 90,1901,1084,970,3955
32764,2020-06-10,(04100) Carrera 77,1206,675,783,2664
32765,2020-06-20,(04100) Carrera 77,954,517,665,2136
32766,2020-01-08,(10001) Country Sur,3653,1569,2088,7310
32767,2020-03-15,(07504) TERREROS,3822,1645,2564,8031
32768,2020-03-07,(03000) Portal Suba,4524,2108,3661,10293
32769,2020-01-09,(05002) Tintal,8178,4552,4676,17406
32770,2020-02-08,(02101) Toberín,6045,2749,5058,13852
32771,2020-01-16,(10005) Bicentenario - alimentacion,598,269,465,1332
32772,2020-02-25,(10005) Bicentenario - alimentacion,717,367,529,1613
32773,2020-07-29,(09000) Cabecera Usme - alimentacion,8017,4401,4469,16887
32774,2020-03-15,(05001) Patio Bonito,1361,640,1072,3073
32775,2020-02-19,(02304) Heroes,4853,3378,2289,10520
32776,2020-02-26,(02304) Heroes,4640,3404,2411,10455
32777,2020-04-14,(03000) Portal Suba,599,384,374,1357
32778,2020-09-03,(03000) Portal Suba,1467,938,1026,3431
32779,2020-06-19,(02000) Cabecera Autopista Norte - intermunicipal,605,373,426,1404
32780,2020-01-17,(06100) Av. Rojas,1992,1114,1118,4224
32781,2020-03-13,(06111) Universidades,1227,321,529,2077
32782,2020-01-26,(02300) Calle 100,894,775,1264,2933
32783,2020-10-04,(02300) Calle 100,227,254,462,943
32784,2020-01-26,(02502) Terminal,304,327,755,1386
32785,2020-04-30,(08001) Parque el Tunal,279,152,133,564
32786,2020-02-11,(05102) Av. Américas - Av. Boyacá,2069,1231,985,4285
32787,2020-02-20,(06103) CAN,2671,1535,1108,5314
32788,2020-09-19,(06108) Concejo de Bogotá,75,57,111,243
32789,2020-05-11,(09116) Avenida 39,248,158,146,552
32790,2020-03-13,(10001) Country Sur,142,753,689,1584
32791,2020-06-12,(02000) Cabecera Autopista Norte - alimentacion,4832,2656,2520,10008
32792,2020-01-19,(07001) PERDOMO,947,366,851,2164
32793,2020-02-06,(02202) Calle 127,5932,4035,3106,13073
32794,2020-07-11,(02201) Prado,760,485,462,1707
32795,2020-02-04,(03005) SUBA - AV. BOYACA,2896,1690,1662,6248
32796,2020-02-05,(04003) Avenida Ciudad de Cali,5708,3423,3630,12761
32797,2020-02-12,(05101) Mandalay - Cr.73,1283,735,540,2558
32798,2020-08-12,(05002) Tintal,2276,1377,1457,5110
32799,2020-08-15,(05002) Tintal,1963,934,1365,4262
32800,2020-03-06,(05105) Pradera,2506,1563,1276,5345
32801,2020-06-29,(05103) Marsella,127,74,76,277
32802,2020-07-16,(03012) SUBA - CALLE 95,287,177,132,596
32803,2020-01-13,(07104) Simon Bolivar,1800,1141,1074,4015
32804,2020-09-15,(07104) Simon Bolivar,672,370,320,1362
32805,2020-01-07,(02202) Calle 127,3654,2475,2141,8270
32806,2020-05-02,(05105) Pradera,299,201,136,636
32807,2020-01-10,(09121) Las Flores,2361,1497,1532,5390
32808,2020-01-11,(09121) Las Flores,1388,891,1208,3487
32809,2020-07-08,(04003) Avenida Ciudad de Cali,1130,636,785,2551
32810,2020-06-18,(04108) El Polo,500,276,224,1000
32811,2020-09-05,(04108) El Polo,354,210,253,817
32812,2020-02-18,(12007) Zona Industrial,1278,790,639,2707
32813,2020-02-01,(06102) Salitre El Greco,677,435,501,1613
32814,2020-03-13,(07113) SANTA ISABEL,200,335,329,864
32815,2020-10-10,(07113) SANTA ISABEL,311,170,368,849
32816,2020-08-06,(10006) San Victorino,692,336,333,1361
32817,2020-08-21,(08002) Biblioteca,294,187,185,666
32818,2020-02-15,(04100) Carrera 77,3970,1978,2958,8906
32819,2020-02-27,(05103) Marsella,3251,1866,1486,6603
32820,2020-09-08,(09100) Calle 40 Sur,1751,1032,1284,4067
32821,2020-07-17,(07104) Simon Bolivar,571,360,249,1180
32822,2020-03-26,(10005) Bicentenario - alimentacion,131,62,110,303
32823,2020-09-18,(04107) Escuela Militar,165,112,120,397
32824,2020-05-25,(07000) Portal Sur,437,242,306,985
32825,2020-01-06,(09117) Calle 45,503,383,681,1567
32826,2020-01-04,(07002) MADELENA,1325,575,976,2876
32827,2020-10-03,(03001) LA CAMPIÑA,1083,460,868,2411
32828,2020-01-09,(02104) Calle 146,5780,3506,3549,12835
32829,2020-03-28,(09001) Molinos,797,424,603,1824
32830,2020-01-14,(03003) 21 ANGELES,1434,668,832,2934
32831,2020-01-28,(40001) Juan Pablo II,1635,948,966,3549
32832,2020-10-04,(02001) Centro Comercial Santa Fe,168,95,244,507
32833,2020-04-04,(06100) Av. Rojas,65,50,54,169
32834,2020-08-11,(02302) Virrey,595,421,327,1343
32835,2020-09-14,(02302) Virrey,740,507,404,1651
32836,2020-04-27,(12003) Ricaurte,14,124,58,196
32837,2020-08-01,(12003) Ricaurte,257,174,138,569
32838,2020-03-03,(04103) Las Ferias,1509,908,894,3311
32839,2020-02-26,(03013) RIO NEGRO,1259,797,879,2935
32840,2020-09-07,(06103) CAN,398,225,212,835
32841,2020-06-08,(04100) Carrera 77,1221,700,754,2675
32842,2020-08-23,(03002) SUBA - TV- 91,182,94,186,462
32843,2020-09-20,(02104) Calle 146,339,179,337,855
32844,2020-07-11,(09123) Calle 76,729,579,550,1858
32845,2020-10-08,(12007) Zona Industrial,385,275,223,883
32846,2020-03-27,(06102) Salitre El Greco,163,120,90,373
32847,2020-08-29,(10005) Bicentenario,64,45,62,171
32848,2020-03-27,(40002) Manitas,160,88,118,366
32849,2020-06-04,(06108) Concejo de Bogotá,149,70,68,287
32850,2020-06-15,(10003) Ciudad Jardín,76,30,43,149
32851,2020-03-14,(07001) PERDOMO,2198,1069,1731,4998
32852,2020-06-21,(09110) Avenida Jimenez,358,303,339,1000
32853,2020-07-09,(05102) Av. Américas - Av. Boyacá,242,132,157,531
32854,2020-08-19,(05102) Av. Américas - Av. Boyacá,212,108,142,462
32855,2020-04-10,(02202) Calle 127,340,242,136,718
32856,2020-07-14,(05107) Américas - Cr.53,376,238,229,843
32857,2020-04-05,(10000) Portal 20 de Julio - alimentacion,1130,372,496,1998
32858,2020-09-07,(07111) NQS - RICAURTE,1132,689,535,2356
32859,2020-04-12,(09115) Calle 34,122,84,83,289
32860,2020-07-14,(07110) PALOQUEMAO,499,329,232,1060
32861,2020-08-29,(07110) PALOQUEMAO,493,307,294,1094
32862,2020-02-22,(04107) Escuela Militar,366,253,390,1009
32863,2020-05-24,(10000) Portal 20 de Julio - alimentacion,1254,496,735,2485
32864,2020-01-05,(05101) Mandalay - Cr.73,102,40,95,237
32865,2020-08-05,(06102) Salitre El Greco,212,115,108,435
32866,2020-05-29,(09103) Olaya,865,497,470,1832
32867,2020-07-01,(06104) Gobernación,263,156,128,547
32868,2020-05-19,(09100) Calle 40 Sur,1335,819,780,2934
32869,2020-08-02,(02000) Cabecera Autopista Norte,342,237,259,838
32870,2020-04-18,(03000) Portal Suba,377,250,242,869
32871,2020-04-27,(07105) MOVISTAR ARENA,27,76,41,144
32872,2020-06-01,(07105) MOVISTAR ARENA,238,161,123,522
32873,2020-09-02,(07105) MOVISTAR ARENA,286,140,156,582
32874,2020-06-05,(05105) Pradera,523,344,219,1086
32875,2020-06-09,(07107) U. NACIONAL,303,175,155,633
32876,2020-05-13,(09113) Calle 22,371,214,245,830
32877,2020-06-16,(10007) Las Nieves,671,376,379,1426
32878,2020-04-07,(07113) SANTA ISABEL,190,124,125,439
32879,2020-08-05,(03011) SUBA - CALLE 100,378,187,193,758
32880,2020-08-30,(03000) Portal Suba,372,204,419,995
32881,2020-05-29,(04101) Minuto de Dios,295,174,231,700
32882,2020-03-21,(12000) Puente Aranda,25,13,19,57
32883,2020-05-14,(12000) Puente Aranda,68,39,26,133
32884,2020-09-03,(14005) Las Aguas,223,128,241,592
32885,2020-10-08,(09121) Las Flores,733,473,659,1865
32886,2020-01-25,(07108) Av. El Dorado,380,273,416,1069
32887,2020-10-12,(02103) Mazurén,52,46,86,184
32888,2020-04-24,(10009) Museo Nacional,323,214,164,701
32889,2020-05-08,(10009) Museo Nacional,386,240,228,854
32890,2020-09-19,(06000) Portal Eldorado,588,515,731,1834
32891,2020-07-31,(07110) PALOQUEMAO,576,363,252,1191
32892,2020-01-07,(09003) Socorro,1203,669,848,2720
32893,2020-04-28,(07112) COMUNEROS,497,300,271,1068
32894,2020-08-23,(04108) El Polo,82,42,87,211
32895,2020-07-04,(06101) El Tiempo,230,166,203,599
32896,2020-08-24,(06002) Normandía,269,152,164,585
32897,2020-07-01,(07506) DESPENSA,512,261,299,1072
32898,2020-10-12,(07006) General Santander,208,91,215,514
32899,2020-06-25,(07200) Tygua-San José,247,120,165,532
32900,2020-04-22,(07001) PERDOMO,402,249,288,939
32901,2020-03-02,(09108) Hospital,229,135,202,566
32902,2020-05-07,(03006) NIZA - CALLE 127,253,176,155,584
32903,2020-06-05,(07006) General Santander,493,307,257,1057
32904,2020-04-01,(04103) Las Ferias,158,107,93,358
32905,2020-04-17,(04104) Avenida 68,334,199,207,740
32906,2020-07-29,(07113) SANTA ISABEL,316,209,241,766
32907,2020-10-09,(07006) General Santander - alimentacion,410,240,393,1043
32908,2020-04-15,(09110) Avenida Jimenez,288,242,299,829
32909,2020-04-02,(06000) Portal Eldorado,729,521,356,1606
32910,2020-08-11,(05101) Mandalay - Cr.73,138,80,66,284
32911,2020-06-01,(07010) Bosa,630,336,359,1325
32912,2020-08-28,(07009) SENA,620,375,473,1468
32913,2020-09-11,(09121) Las Flores,662,429,477,1568
32914,2020-04-13,(07006) General Santander - alimentacion,178,117,120,415
32915,2020-04-04,(12007) Zona Industrial,106,81,59,246
32916,2020-05-27,(12007) Zona Industrial,289,182,144,615
32917,2020-05-02,(04003) Avenida Ciudad de Cali,413,241,317,971
32918,2020-03-08,(07200) Tygua-San José,143,111,243,497
32919,2020-09-13,(09108) Hospital,30,18,31,79
32920,2020-09-17,(06101) El Tiempo,367,224,232,823
32921,2020-09-25,(07006) General Santander,671,382,458,1511
32922,2020-04-11,(07106) EL CAMPIN,104,84,50,238
32923,2020-02-09,(06105) Quinta Paredes,148,82,176,406
32924,2020-06-21,(12004) Carrera 22,54,35,49,138
32925,2020-04-10,(09000) Cabecera Usme,274,181,163,618
32926,2020-10-04,(07007) NQS - Calle 38A Sur,219,145,203,567
32927,2020-04-13,(06103) CAN,311,243,141,695
32928,2020-03-10,(50002) Corral Calle 40 Sur,12,31,48,91
32929,2020-04-11,(14005) Las Aguas,0,19,47,66
32930,2020-05-23,(06104) Gobernación,99,67,63,229
32931,2020-04-04,(04107) Escuela Militar,35,28,27,90
32932,2020-06-29,(07200) Tygua-San José,81,48,78,207
32933,2020-07-11,(04001) Quirigua,355,196,246,797
32934,2020-09-22,(06106) Recinto Ferial,291,183,173,647
32935,2020-08-01,(06103) CAN,194,124,118,436
32936,2020-06-07,(40002) Manitas,107,53,84,244
32937,2020-04-19,(07107) U. NACIONAL,93,69,54,216
32938,2020-09-12,(04000) Cabecera Calle 80 - intermunicipal,258,113,274,645
32939,2020-01-04,(09108) Hospital,95,60,94,249
32940,2020-09-06,(06104) Gobernación,40,39,56,135
32941,2020-02-08,(50002) Corral Calle 40 Sur,66,41,103,210
32942,2020-07-20,(05102) Av. Américas - Av. Boyacá,61,43,49,153
32943,2020-06-29,(04103) Las Ferias,139,89,76,304
32944,2020-03-22,(04103) Las Ferias,63,45,27,135
32945,2020-04-28,(03014) SAN MARTIN,17,6,23,46
32946,2020-04-26,(50006) Corral Carrera 77,5,0,1,6
32947,2020-04-25,(50006) Corral Carrera 77,5,3,3,11
32948,2020-07-13,(50002) Corral Calle 40 Sur,11,11,12,34
32949,2020-08-26,(50006) Corral Carrera 77,5,1,4,10
32950,2020-08-04,(50004) Corral Avenida Ciudad de Cali,0,0,2,2
32951,2020-08-14,(07005) ALQUERIA,548,310,325,1183
32952,2020-03-07,(02502) Terminal,1696,977,1890,4563
32953,2020-07-03,(02502) Terminal,448,314,381,1143
32954,2020-03-27,(09118) Marly,1067,711,452,2230
32955,2020-09-03,(07504) TERREROS,6502,3574,3130,13206
32956,2020-05-14,(10000) Portal 20 de Julio - alimentacion,3305,1587,1853,6745
32957,2020-05-01,(05000) Portal Américas - alimentacion,3598,1668,1501,6767
32958,2020-07-06,(05000) Portal Américas - alimentacion,11390,6308,5753,23451
32959,2020-03-03,(06000) Portal Eldorado - alimentacion,17900,10075,10079,38054
32960,2020-02-07,(05000) Portal Américas,15468,8302,8109,31879
32961,2020-06-10,(10000) Portal 20 de Julio - alimentacion,4068,1929,2255,8252
32962,2020-06-01,(04101) Minuto de Dios,274,169,202,645
32963,2020-06-10,(04101) Minuto de Dios,285,189,201,675
32964,2020-03-01,(07503) SAN MATEO,9276,4154,6310,19740
32965,2020-05-18,(05005) Transversal 86,307,161,164,632
32966,2020-09-19,(07112) COMUNEROS,733,369,597,1699
32967,2020-01-14,(03000) Portal Suba,7404,4413,4620,16437
32968,2020-01-31,(09004) Santa Lucía,7336,3877,4167,15380
32969,2020-01-27,(03009) Av. Suba- Calle 116,2499,1581,1387,5467
32970,2020-01-29,(09000) Cabecera Usme,5811,3443,3852,13106
32971,2020-02-26,(40001) Juan Pablo II,1662,895,936,3493
32972,2020-01-05,(02102) Calle 161,214,103,247,564
32973,2020-04-22,(06000) Portal Eldorado - alimentacion,2395,1186,950,4531
32974,2020-02-28,(07002) MADELENA,5242,2805,2682,10729
32975,2020-01-29,(02502) Terminal,5115,3309,2852,11276
32976,2020-05-26,(09000) Cabecera Usme - alimentacion,7621,4232,4342,16195
32977,2020-08-29,(07001) PERDOMO,741,369,615,1725
32978,2020-02-21,(09000) Cabecera Usme - alimentacion,24944,13367,15016,53327
32979,2020-03-02,(09000) Cabecera Usme - alimentacion,25446,14315,15787,55548
32980,2020-02-03,(40003) Mirador del Paraiso,4800,2723,2781,10304
32981,2020-07-31,(40003) Mirador del Paraiso,1636,981,993,3610
32982,2020-07-14,(07505) LEON XIII,2470,1327,983,4780
32983,2020-09-16,(03000) Portal Suba - alimentacion,7098,3957,4707,15762
32984,2020-03-18,(12003) Ricaurte,811,639,434,1884
32985,2020-05-06,(07102) NQS - CALLE 75,262,178,137,577
32986,2020-01-14,(03013) RIO NEGRO,1047,636,747,2430
32987,2020-03-01,(03013) RIO NEGRO,240,159,323,722
32988,2020-01-12,(02304) Heroes,537,431,646,1614
32989,2020-04-02,(09104) Restrepo,678,511,560,1749
32990,2020-04-08,(09104) Restrepo,693,471,605,1769
32991,2020-03-06,(02103) Mazurén,3250,1839,1872,6961
32992,2020-08-12,(02103) Mazurén,157,99,158,414
32993,2020-02-12,(02303) Calle 85,3929,2640,1909,8478
32994,2020-03-02,(02303) Calle 85,3761,2523,1907,8191
32995,2020-05-19,(07000) Portal Sur - alimentacion,6311,3665,2776,12752
32996,2020-08-03,(05100) Banderas P. Central - alimentacion,2542,1346,1444,5332
32997,2020-07-25,(09103) Olaya,594,324,345,1263
32998,2020-07-26,(09103) Olaya,290,152,192,634
32999,2020-05-13,(14001) La Sabana,129,85,66,280
33000,2020-07-30,(07002) MADELENA,744,435,475,1654
33001,2020-01-21,(07107) U. NACIONAL,1378,815,841,3034
33002,2020-02-17,(07107) U. NACIONAL,2080,1324,1257,4661
33003,2020-04-11,(04105) Carrera 53,106,74,62,242
33004,2020-07-22,(09004) Santa Lucía,1822,953,1020,3795
33005,2020-09-03,(09004) Santa Lucía,2672,1413,1448,5533
33006,2020-09-19,(07109) CAD,427,325,386,1138
33007,2020-01-25,(07007) NQS - Calle 38A Sur,1336,705,866,2907
33008,2020-04-17,(50003) Corral Molinos,725,410,593,1728
33009,2020-09-12,(05000) Portal Américas,2400,1297,2148,5845
33010,2020-09-04,(07010) Bosa,721,321,506,1548
33011,2020-08-10,(02000) Cabecera Autopista Norte - alimentacion,4310,2455,2514,9279
33012,2020-02-26,(05002) Tintal,11193,6145,6115,23453
33013,2020-09-27,(02201) Prado,308,193,378,879
33014,2020-02-12,(10001) Country Sur,5252,2387,2815,10454
33015,2020-07-08,(06000) Portal Eldorado,989,679,513,2181
33016,2020-05-20,(40003) Mirador del Paraiso,1483,947,815,3245
33017,2020-01-13,(10000) Portal 20 de Julio,7498,3362,3626,14486
33018,2020-05-02,(12001) Carrera 43,151,100,105,356
33019,2020-07-25,(07000) Portal Sur - alimentacion,4871,2734,2432,10037
33020,2020-02-23,(06000) Portal Eldorado - alimentacion,4279,1827,3238,9344
33021,2020-01-31,(02105) Calle 142,7021,3882,3775,14678
33022,2020-02-10,(03000) Portal Suba,9717,5973,5095,20785
33023,2020-08-29,(09101) Quiroga,455,188,354,997
33024,2020-07-10,(08001) Parque el Tunal,530,314,315,1159
33025,2020-03-05,(10010) San Bernardo,1715,1023,1276,4014
33026,2020-01-17,(08002) Biblioteca,888,477,655,2020
33027,2020-01-21,(09114) Calle 26,1923,1205,1177,4305
33028,2020-08-04,(07112) COMUNEROS,706,376,406,1488
33029,2020-09-01,(07000) Portal Sur,2042,1248,1324,4614
33030,2020-08-10,(02300) Calle 100,1091,719,626,2436
33031,2020-04-17,(07503) SAN MATEO,5367,3439,2447,11253
33032,2020-01-24,(06108) Concejo de Bogotá,819,428,452,1699
33033,2020-05-04,(06108) Concejo de Bogotá,99,59,62,220
33034,2020-05-11,(06108) Concejo de Bogotá,133,75,78,286
33035,2020-08-15,(09000) Cabecera Usme - alimentacion,7046,3424,4619,15089
33036,2020-01-19,(10001) Country Sur,883,396,1033,2312
33037,2020-02-21,(02202) Calle 127,5822,3609,2938,12369
33038,2020-06-01,(02000) Cabecera Autopista Norte,1127,755,738,2620
33039,2020-03-04,(02304) Heroes,4641,3305,2296,10242
33040,2020-08-05,(03000) Portal Suba - alimentacion,4903,2817,2821,10541
33041,2020-07-08,(09114) Calle 26,351,215,219,785
33042,2020-03-16,(09107) Hortúa,1786,1051,979,3816
33043,2020-06-11,(09107) Hortúa,583,364,317,1264
33044,2020-08-25,(09107) Hortúa,572,367,359,1298
33045,2020-10-08,(09123) Calle 76,1159,811,860,2830
33046,2020-07-28,(40003) Mirador del Paraiso,1604,1028,962,3594
33047,2020-05-17,(02300) Calle 100,304,215,175,694
33048,2020-09-04,(02300) Calle 100,1262,839,831,2932
33049,2020-09-09,(02300) Calle 100,1252,855,787,2894
33050,2020-05-06,(03012) SUBA - CALLE 95,241,131,112,484
33051,2020-06-01,(09119) Calle 57,492,326,319,1137
33052,2020-02-01,(05107) Américas - Cr.53,1304,829,1146,3279
33053,2020-05-16,(09104) Restrepo,911,541,665,2117
33054,2020-07-19,(09104) Restrepo,363,195,304,862
33055,2020-08-14,(05005) Transversal 86,365,196,257,818
33056,2020-07-31,(02000) Cabecera Autopista Norte,1152,701,690,2543
33057,2020-06-29,(02202) Calle 127,434,311,255,1000
33058,2020-01-04,(10008) San Diego,424,245,394,1063
33059,2020-03-13,(08000) Portal Tunal,573,195,248,1016
33060,2020-06-17,(06109) Centro Memoria,277,157,151,585
33061,2020-10-03,(04104) Avenida 68,496,280,517,1293
33062,2020-04-08,(08000) Portal Tunal,369,183,171,723
33063,2020-05-15,(04000) Cabecera Calle 80,868,536,548,1952
33064,2020-02-01,(02001) Centro Comercial Santa Fe,2034,909,1717,4660
33065,2020-03-11,(04003) Avenida Ciudad de Cali,5162,2931,3410,11503
33066,2020-06-24,(07106) EL CAMPIN,357,262,223,842
33067,2020-06-30,(07103) AV. CHILE,972,584,521,2077
33068,2020-06-22,(07113) SANTA ISABEL,132,93,117,342
33069,2020-08-24,(04100) Carrera 77,1085,625,741,2451
33070,2020-06-30,(05103) Marsella,472,234,257,963
33071,2020-06-15,(08002) Biblioteca,106,54,57,217
33072,2020-09-01,(08002) Biblioteca,307,167,196,670
33073,2020-01-04,(07000) Portal Sur,2736,1304,2069,6109
33074,2020-04-26,(07110) PALOQUEMAO,135,87,83,305
33075,2020-06-27,(09100) Calle 40 Sur,1508,829,1036,3373
33076,2020-01-09,(07104) Simon Bolivar,1606,993,979,3578
33077,2020-07-24,(10005) Bicentenario - alimentacion,178,75,138,391
33078,2020-01-08,(04107) Escuela Militar,427,250,340,1017
33079,2020-04-30,(05103) Marsella,208,95,95,398
33080,2020-06-01,(09109) Tercer Milenio,316,202,216,734
33081,2020-01-08,(09117) Calle 45,1982,1515,1924,5421
33082,2020-09-08,(04002) Carrera 90,715,399,476,1590
33083,2020-01-19,(06101) El Tiempo,294,228,428,950
33084,2020-06-10,(03001) LA CAMPIÑA,1072,611,572,2255
33085,2020-08-24,(02104) Calle 146,651,407,442,1500
33086,2020-05-08,(09110) Avenida Jimenez,609,499,496,1604
33087,2020-07-17,(02101) Toberín,1284,839,834,2957
33088,2020-09-30,(04000) Cabecera Calle 80 - intermunicipal,416,226,448,1090
33089,2020-04-21,(05002) Tintal,1386,785,665,2836
33090,2020-05-04,(03001) LA CAMPIÑA,626,384,361,1371
33091,2020-05-12,(03001) LA CAMPIÑA,772,444,423,1639
33092,2020-03-16,(07103) AV. CHILE,2690,1744,1308,5742
33093,2020-10-02,(02105) Calle 142,1029,591,817,2437
33094,2020-05-14,(09120) Calle 63,811,559,473,1843
33095,2020-04-27,(06000) Portal Eldorado,129,322,162,613
33096,2020-06-23,(12003) Ricaurte,411,284,179,874
33097,2020-06-20,(05100) Banderas P. Central,501,288,428,1217
33098,2020-03-17,(04106) Carrera 47,882,479,486,1847
33099,2020-06-17,(06103) CAN,387,233,153,773
33100,2020-04-16,(02105) Calle 142,402,245,233,880
33101,2020-07-20,(05002) Tintal,644,320,363,1327
33102,2020-07-21,(02104) Calle 146,684,467,441,1592
33103,2020-08-12,(12007) Zona Industrial,363,215,165,743
33104,2020-02-15,(10005) Bicentenario,220,167,316,703
33105,2020-08-12,(10005) Bicentenario,111,53,68,232
33106,2020-06-02,(06109) Centro Memoria,285,170,108,563
33107,2020-03-09,(14005) Las Aguas,1200,266,405,1871
33108,2020-01-06,(07006) General Santander - alimentacion,221,147,298,666
33109,2020-08-04,(02001) Centro Comercial Santa Fe,396,241,303,940
33110,2020-09-29,(10009) Museo Nacional,555,336,413,1304
33111,2020-06-24,(09003) Socorro,606,320,322,1248
33112,2020-08-13,(08002) Biblioteca,281,166,173,620
33113,2020-08-21,(06111) Universidades,325,176,290,791
33114,2020-04-03,(07003) SEVILLANA,248,125,104,477
33115,2020-01-02,(06106) Recinto Ferial,551,328,374,1253
33116,2020-04-15,(07110) PALOQUEMAO,428,271,184,883
33117,2020-07-28,(09110) Avenida Jimenez,1295,902,774,2971
33118,2020-09-10,(02200) Alcalá,1791,1064,1176,4031
33119,2020-06-18,(06109) Centro Memoria,279,159,119,557
33120,2020-09-12,(07111) NQS - RICAURTE,936,608,502,2046
33121,2020-06-30,(06102) Salitre El Greco,250,144,110,504
33122,2020-09-15,(04105) Carrera 53,289,163,184,636
33123,2020-04-26,(09103) Olaya,210,114,138,462
33124,2020-09-09,(06104) Gobernación,320,163,162,645
33125,2020-09-30,(50003) Corral Molinos,1627,861,1418,3906
33126,2020-06-02,(09114) Calle 26,282,187,177,646
33127,2020-06-04,(07105) MOVISTAR ARENA,243,131,136,510
33128,2020-08-05,(07105) MOVISTAR ARENA,191,113,115,419
33129,2020-07-03,(05105) Pradera,589,322,306,1217
33130,2020-09-29,(09114) Calle 26,396,245,329,970
33131,2020-05-31,(07104) Simon Bolivar,104,73,95,272
33132,2020-04-12,(06109) Centro Memoria,60,37,31,128
33133,2020-03-15,(07008) NQS - Calle 30 Sur,359,144,349,852
33134,2020-09-30,(04102) Avenida Boyaca,479,293,361,1133
33135,2020-03-01,(09119) Calle 57,664,363,831,1858
33136,2020-06-18,(10007) Las Nieves,662,380,356,1398
33137,2020-06-25,(09121) Las Flores,746,478,448,1672
33138,2020-07-02,(09121) Las Flores,716,482,518,1716
33139,2020-05-27,(10006) San Victorino,453,272,245,970
33140,2020-08-07,(02104) Calle 146,308,184,177,669
33141,2020-09-19,(02204) Pepe Sierra,601,423,479,1503
33142,2020-07-13,(04103) Las Ferias,321,156,154,631
33143,2020-10-12,(10007) Las Nieves,94,89,174,357
33144,2020-07-21,(07110) PALOQUEMAO,522,340,255,1117
33145,2020-06-11,(03011) SUBA - CALLE 100,461,229,217,907
33146,2020-03-28,(10004) Policarpa,81,42,49,172
33147,2020-03-17,(12000) Puente Aranda,198,110,123,431
33148,2020-05-22,(07109) CAD,542,347,213,1102
33149,2020-04-15,(03005) SUBA - AV. BOYACA,187,141,149,477
33150,2020-04-23,(02102) Calle 161,98,59,61,218
33151,2020-09-11,(09113) Calle 22,373,223,281,877
33152,2020-02-28,(07108) Av. El Dorado,959,576,695,2230
33153,2020-09-11,(04001) Quirigua,412,247,283,942
33154,2020-04-20,(10009) Museo Nacional,301,204,164,669
33155,2020-08-22,(10009) Museo Nacional,209,144,267,620
33156,2020-07-28,(03013) RIO NEGRO,246,166,171,583
33157,2020-09-06,(09003) Socorro,255,131,192,578
33158,2020-07-12,(10004) Policarpa,110,48,100,258
33159,2020-09-30,(10004) Policarpa,270,156,223,649
33160,2020-07-19,(08001) Parque el Tunal,99,46,67,212
33161,2020-02-01,(07200) Tygua-San José,468,274,470,1212
33162,2020-08-15,(02000) Cabecera Autopista Norte - intermunicipal,392,215,299,906
33163,2020-09-12,(09106) Nariño,380,191,362,933
33164,2020-04-10,(14001) La Sabana,28,23,23,74
33165,2020-07-29,(12002) CDS - Carrera 32,163,98,48,309
33166,2020-05-12,(02502) Terminal,298,192,236,726
33167,2020-07-12,(09119) Calle 57,233,129,204,566
33168,2020-09-12,(10009) Museo Nacional,226,214,401,841
33169,2020-10-05,(07006) General Santander,625,393,458,1476
33170,2020-08-30,(14004) Museo del Oro,38,39,91,168
33171,2020-08-16,(40002) Manitas,110,53,92,255
33172,2020-07-19,(09108) Hospital,24,13,16,53
33173,2020-10-08,(09108) Hospital,55,54,60,169
33174,2020-04-23,(07009) SENA,341,217,192,750
33175,2020-05-09,(03009) Av. Suba- Calle 116,235,164,137,536
33176,2020-05-31,(09113) Calle 22,211,124,202,537
33177,2020-08-05,(07506) DESPENSA,368,235,221,824
33178,2020-08-29,(07006) General Santander - alimentacion,269,155,246,670
33179,2020-07-03,(09105) Río Fucha,141,54,106,301
33180,2020-09-15,(04106) Carrera 47,366,189,194,749
33181,2020-06-23,(05101) Mandalay - Cr.73,143,79,69,291
33182,2020-10-03,(12002) CDS - Carrera 32,132,94,89,315
33183,2020-08-20,(14004) Museo del Oro,212,145,169,526
33184,2020-07-29,(10007) Las Nieves,635,377,316,1328
33185,2020-09-21,(04101) Minuto de Dios,304,170,235,709
33186,2020-06-24,(07109) CAD,649,413,287,1349
33187,2020-04-28,(06103) CAN,304,216,126,646
33188,2020-07-18,(02102) Calle 161,152,87,103,342
33189,2020-05-09,(14001) La Sabana,107,65,78,250
33190,2020-07-03,(03005) SUBA - AV. BOYACA,487,303,345,1135
33191,2020-05-16,(03009) Av. Suba- Calle 116,266,204,161,631
33192,2020-10-04,(04000) Cabecera Calle 80 - intermunicipal,102,55,146,303
33193,2020-07-20,(05105) Pradera,174,127,74,375
33194,2020-06-14,(12004) Carrera 22,45,29,51,125
33195,2020-07-19,(07007) NQS - Calle 38A Sur,175,96,99,370
33196,2020-10-06,(04102) Avenida Boyaca,479,273,336,1088
33197,2020-06-20,(06104) Gobernación,118,82,107,307
33198,2020-09-13,(03005) SUBA - AV. BOYACA,120,73,134,327
33199,2020-04-21,(06103) CAN,288,207,118,613
33200,2020-08-02,(05103) Marsella,91,55,67,213
33201,2020-03-23,(07002) MADELENA,166,76,69,311
33202,2020-03-30,(07201) Guatoque -Veraguas,42,40,68,150
33203,2020-09-21,(09105) Río Fucha,0,51,108,159
33204,2020-03-20,(10005) Bicentenario - alimentacion,101,45,64,210
33205,2020-10-11,(14001) La Sabana,39,24,77,140
33206,2020-05-24,(09114) Calle 26,45,28,34,107
33207,2020-03-22,(08001) Parque el Tunal,69,43,31,143
33208,2020-08-30,(07003) SEVILLANA,109,60,116,285
33209,2020-07-19,(08002) Biblioteca,90,42,57,189
33210,2020-09-12,(50002) Corral Calle 40 Sur,14,7,15,36
33211,2020-04-26,(07200) Tygua-San José,40,30,33,103
33212,2020-05-03,(09111) Calle 19,125,93,127,345
33213,2020-03-23,(12001) Carrera 43,50,37,55,142
33214,2020-07-30,(50006) Corral Carrera 77,5,2,8,15
33215,2020-08-22,(50006) Corral Carrera 77,5,2,4,11
33216,2020-04-04,(07105) MOVISTAR ARENA,81,67,57,205
33217,2020-05-03,(12007) Zona Industrial,15,27,44,86
33218,2020-01-02,(09002) Consuelo,711,373,542,1626
33219,2020-01-27,(09002) Consuelo,1367,762,809,2938
33220,2020-02-26,(08000) Portal Tunal - alimentacion,24873,12236,11957,49066
33221,2020-01-23,(04106) Carrera 47,1353,742,738,2833
33222,2020-02-03,(04106) Carrera 47,1476,803,905,3184
33223,2020-01-29,(06000) Portal Eldorado - alimentacion,17483,9455,9155,36093
33224,2020-10-06,(05000) Portal Américas,4039,2179,2923,9141
33225,2020-02-05,(09100) Calle 40 Sur,7800,4458,4312,16570
33226,2020-01-22,(07503) SAN MATEO,37425,21958,17427,76810
33227,2020-10-01,(06107) Ciudad Universitaria,195,133,188,516
33228,2020-01-31,(05001) Patio Bonito,6905,3703,3638,14246
33229,2020-02-21,(07010) Bosa,2305,1297,1360,4962
33230,2020-02-24,(05000) Portal Américas,12183,8408,8894,29485
33231,2020-01-13,(05005) Transversal 86,2079,1201,1088,4368
33232,2020-09-08,(10000) Portal 20 de Julio - alimentacion,4342,1944,2676,8962
33233,2020-09-24,(05100) Banderas P. Central,1098,628,808,2534
33234,2020-01-21,(02204) Pepe Sierra,3444,2431,1643,7518
33235,2020-02-12,(02205) Calle 106,2877,1786,1440,6103
33236,2020-08-25,(40003) Mirador del Paraiso,1565,956,1023,3544
33237,2020-06-16,(09104) Restrepo,1500,939,1080,3519
33238,2020-09-01,(09104) Restrepo,1631,919,1176,3726
33239,2020-05-27,(07505) LEON XIII,2179,1272,977,4428
33240,2020-01-05,(02204) Pepe Sierra,463,349,599,1411
33241,2020-02-19,(10006) San Victorino,2561,1365,1280,5206
33242,2020-08-27,(05002) Tintal,2421,1452,1464,5337
33243,2020-03-11,(07111) NQS - RICAURTE,2963,2003,1761,6727
33244,2020-07-29,(09101) Quiroga,420,256,333,1009
33245,2020-07-01,(07102) NQS - CALLE 75,445,280,247,972
33246,2020-08-17,(09118) Marly,482,304,311,1097
33247,2020-06-06,(07002) MADELENA,513,262,326,1101
33248,2020-03-17,(07112) COMUNEROS,2294,1351,1343,4988
33249,2020-09-19,(02000) Cabecera Autopista Norte,1220,692,1019,2931
33250,2020-02-29,(04105) Carrera 53,830,439,577,1846
33251,2020-02-07,(50003) Corral Molinos,3167,2207,3597,8971
33252,2020-08-04,(50003) Corral Molinos,1379,671,992,3042
33253,2020-04-18,(05000) Portal Américas,915,618,697,2230
33254,2020-02-14,(04000) Cabecera Calle 80,7581,4408,5083,17072
33255,2020-07-31,(09110) Avenida Jimenez,1310,858,779,2947
33256,2020-02-04,(04003) Avenida Ciudad de Cali,5632,3423,3492,12547
33257,2020-04-02,(04002) Carrera 90,307,183,167,657
33258,2020-07-08,(04002) Carrera 90,765,441,452,1658
33259,2020-02-03,(10006) San Victorino,2475,1219,1295,4989
33260,2020-03-18,(10006) San Victorino,1127,809,731,2667
33261,2020-01-15,(10008) San Diego,1207,713,721,2641
33262,2020-05-25,(12001) Carrera 43,62,46,71,179
33263,2020-07-10,(12001) Carrera 43,489,278,217,984
33264,2020-01-27,(04104) Avenida 68,3594,1843,1731,7168
33265,2020-06-03,(09107) Hortúa,586,359,324,1269
33266,2020-04-01,(09000) Cabecera Usme - alimentacion,4552,2095,2586,9233
33267,2020-04-07,(03000) Portal Suba,568,364,407,1339
33268,2020-10-06,(03000) Portal Suba,1719,1009,1448,4176
33269,2020-07-07,(02000) Cabecera Autopista Norte - intermunicipal,587,407,409,1403
33270,2020-07-25,(03000) Portal Suba - alimentacion,3992,2109,2242,8343
33271,2020-03-10,(10010) San Bernardo,238,292,337,867
33272,2020-02-11,(06100) Av. Rojas,2965,1713,1304,5982
33273,2020-01-17,(09108) Hospital,203,117,184,504
33274,2020-01-08,(10000) Portal 20 de Julio,6552,2883,3256,12691
33275,2020-03-06,(10010) San Bernardo,1647,981,1426,4054
33276,2020-05-17,(07010) Bosa,147,74,126,347
33277,2020-02-01,(02303) Calle 85,1471,1082,1366,3919
33278,2020-02-28,(02001) Centro Comercial Santa Fe,4843,2820,2809,10472
33279,2020-01-25,(07004) VENECIA,2851,1449,1825,6125
33280,2020-06-22,(09004) Santa Lucía,953,455,550,1958
33281,2020-01-21,(09110) Avenida Jimenez,2675,2129,2028,6832
33282,2020-01-03,(02502) Terminal,1821,1170,1424,4415
33283,2020-04-26,(07503) SAN MATEO,1991,1323,862,4176
33284,2020-09-11,(09116) Avenida 39,372,219,282,873
33285,2020-02-21,(05102) Av. Américas - Av. Boyacá,1869,987,1037,3893
33286,2020-02-26,(07008) NQS - Calle 30 Sur,2011,1013,1122,4146
33287,2020-02-24,(07007) NQS - Calle 38A Sur,2253,1327,1161,4741
33288,2020-09-12,(06001) Modelia,263,148,244,655
33289,2020-01-31,(05105) Pradera,2420,1461,1237,5118
33290,2020-04-25,(02300) Calle 100,585,430,283,1298
33291,2020-05-23,(02300) Calle 100,727,469,445,1641
33292,2020-05-21,(08000) Portal Tunal,640,274,243,1157
33293,2020-06-25,(05105) Pradera,597,373,243,1213
33294,2020-05-30,(06109) Centro Memoria,225,110,119,454
33295,2020-03-24,(08000) Portal Tunal,498,320,351,1169
33296,2020-08-01,(08000) Portal Tunal,553,270,231,1054
33297,2020-07-16,(03000) Portal Suba - alimentacion,5507,3156,2961,11624
33298,2020-07-28,(04002) Carrera 90,688,400,365,1453
33299,2020-04-09,(10002) Av. Primero de Mayo,450,236,247,933
33300,2020-02-27,(04003) Avenida Ciudad de Cali,5649,3402,3467,12518
33301,2020-02-17,(04108) El Polo,2000,1213,1203,4416
33302,2020-07-09,(07000) Portal Sur,1948,1263,1171,4382
33303,2020-06-06,(02201) Prado,686,406,391,1483
33304,2020-09-28,(07106) EL CAMPIN,479,328,310,1117
33305,2020-03-18,(06106) Recinto Ferial,784,477,392,1653
33306,2020-09-27,(07113) SANTA ISABEL,141,66,198,405
33307,2020-07-03,(02200) Alcalá,2031,1279,1102,4412
33308,2020-07-07,(06101) El Tiempo,370,233,216,819
33309,2020-05-30,(03007) HUMEDAL CORDOBA,102,71,54,227
33310,2020-07-10,(04104) Avenida 68,636,347,334,1317
33311,2020-08-05,(03001) LA CAMPIÑA,853,491,505,1849
33312,2020-02-03,(07108) Av. El Dorado,939,614,570,2123
33313,2020-03-12,(06001) Modelia,515,370,337,1222
33314,2020-07-31,(07000) Portal Sur,1653,1028,1057,3738
33315,2020-01-25,(10010) San Bernardo,917,552,1039,2508
33316,2020-04-22,(10005) Bicentenario - alimentacion,144,73,111,328
33317,2020-09-18,(07109) CAD,707,426,388,1521
33318,2020-08-09,(02000) Cabecera Autopista Norte - intermunicipal,88,78,104,270
33319,2020-03-13,(10009) Museo Nacional,1589,154,391,2134
33320,2020-07-02,(09109) Tercer Milenio,371,191,280,842
33321,2020-09-18,(09109) Tercer Milenio,386,233,281,900
33322,2020-03-28,(07505) LEON XIII,888,503,488,1879
33323,2020-06-01,(07009) SENA,611,354,349,1314
33324,2020-08-22,(06100) Av. Rojas,111,73,113,297
33325,2020-03-18,(07106) EL CAMPIN,1042,770,585,2397
33326,2020-03-29,(02105) Calle 142,130,114,86,330
33327,2020-07-15,(02105) Calle 142,697,431,414,1542
33328,2020-08-23,(02105) Calle 142,159,118,171,448
33329,2020-03-29,(05102) Av. Américas - Av. Boyacá,53,30,22,105
33330,2020-09-26,(05107) Américas - Cr.53,320,220,335,875
33331,2020-07-07,(02104) Calle 146,848,522,618,1988
33332,2020-08-11,(12007) Zona Industrial,365,207,155,727
33333,2020-03-19,(10005) Bicentenario,341,187,201,729
33334,2020-07-09,(40002) Manitas,428,260,259,947
33335,2020-03-07,(40001) Juan Pablo II,1207,609,761,2577
33336,2020-06-10,(10008) San Diego,265,154,141,560
33337,2020-07-31,(05107) Américas - Cr.53,342,219,215,776
33338,2020-09-06,(12007) Zona Industrial,58,54,82,194
33339,2020-03-10,(06100) Av. Rojas,601,461,359,1421
33340,2020-07-08,(40001) Juan Pablo II,563,343,366,1272
33341,2020-08-25,(09115) Calle 34,597,359,358,1314
33342,2020-04-16,(09115) Calle 34,367,265,221,853
33343,2020-05-22,(04002) Carrera 90,598,331,335,1264
33344,2020-05-15,(03006) NIZA - CALLE 127,309,217,182,708
33345,2020-08-21,(03013) RIO NEGRO,289,160,212,661
33346,2020-09-09,(07110) PALOQUEMAO,702,405,305,1412
33347,2020-06-08,(06100) Av. Rojas,222,133,118,473
33348,2020-03-13,(12004) Carrera 22,243,33,81,357
33349,2020-01-19,(09122) Calle 72,1048,710,1426,3184
33350,2020-02-22,(09106) Nariño,1175,636,1029,2840
33351,2020-05-10,(09106) Nariño,94,59,61,214
33352,2020-06-02,(09111) Calle 19,705,433,422,1560
33353,2020-09-05,(07111) NQS - RICAURTE,906,607,542,2055
33354,2020-04-14,(09103) Olaya,474,275,277,1026
33355,2020-04-05,(04000) Cabecera Calle 80,121,89,101,311
33356,2020-05-28,(07201) Guatoque -Veraguas,174,89,105,368
33357,2020-06-22,(07105) MOVISTAR ARENA,73,49,74,196
33358,2020-07-13,(07003) SEVILLANA,368,209,177,754
33359,2020-01-07,(07506) DESPENSA,1206,676,756,2638
33360,2020-03-14,(07506) DESPENSA,722,491,639,1852
33361,2020-06-02,(02200) Alcalá,1612,1143,835,3590
33362,2020-10-02,(09114) Calle 26,378,265,384,1027
33363,2020-08-03,(09113) Calle 22,367,200,321,888
33364,2020-03-13,(07008) NQS - Calle 30 Sur,120,269,302,691
33365,2020-06-17,(09111) Calle 19,765,476,467,1708
33366,2020-05-29,(09110) Avenida Jimenez,970,731,677,2378
33367,2020-04-29,(07112) COMUNEROS,495,311,260,1066
33368,2020-01-29,(12000) Puente Aranda,282,185,202,669
33369,2020-05-27,(07109) CAD,605,369,281,1255
33370,2020-05-29,(03005) SUBA - AV. BOYACA,375,253,195,823
33371,2020-03-10,(08001) Parque el Tunal,83,448,332,863
33372,2020-05-10,(07506) DESPENSA,101,51,56,208
33373,2020-03-01,(14001) La Sabana,87,81,161,329
33374,2020-05-31,(09003) Socorro,196,87,152,435
33375,2020-03-15,(04108) El Polo,245,143,369,757
33376,2020-07-14,(10010) San Bernardo,498,247,289,1034
33377,2020-08-14,(03006) NIZA - CALLE 127,352,242,237,831
33378,2020-01-26,(09110) Avenida Jimenez,993,819,1032,2844
33379,2020-07-13,(40001) Juan Pablo II,297,203,197,697
33380,2020-10-07,(06103) CAN,407,258,278,943
33381,2020-09-10,(06002) Normandía,298,174,200,672
33382,2020-04-21,(09119) Calle 57,289,207,210,706
33383,2020-04-03,(07006) General Santander - alimentacion,159,103,123,385
33384,2020-03-08,(06102) Salitre El Greco,270,178,247,695
33385,2020-04-09,(07111) NQS - RICAURTE,116,100,76,292
33386,2020-05-26,(05105) Pradera,527,336,263,1126
33387,2020-06-06,(03001) LA CAMPIÑA,682,344,437,1463
33388,2020-02-23,(09121) Las Flores,593,414,658,1665
33389,2020-04-02,(12001) Carrera 43,221,178,111,510
33390,2020-05-29,(10004) Policarpa,200,110,111,421
33391,2020-07-14,(09108) Hospital,54,35,53,142
33392,2020-03-27,(09117) Calle 45,497,350,257,1104
33393,2020-05-08,(12007) Zona Industrial,230,148,99,477
33394,2020-07-16,(02304) Heroes,614,463,356,1433
33395,2020-09-20,(10008) San Diego,113,73,109,295
33396,2020-03-25,(12007) Zona Industrial,182,159,79,420
33397,2020-05-01,(05107) Américas - Cr.53,125,92,82,299
33398,2020-08-31,(05105) Pradera,575,362,284,1221
33399,2020-09-21,(40002) Manitas,355,182,281,818
33400,2020-06-07,(09109) Tercer Milenio,105,60,97,262
33401,2020-08-23,(09121) Las Flores,157,105,172,434
33402,2020-05-10,(06002) Normandía,56,29,38,123
33403,2020-07-13,(03005) SUBA - AV. BOYACA,414,248,244,906
33404,2020-05-13,(09106) Nariño,314,194,211,719
33405,2020-05-02,(03002) SUBA - TV- 91,315,180,195,690
33406,2020-07-27,(07006) General Santander - alimentacion,358,206,213,777
33407,2020-04-10,(05001) Patio Bonito,267,158,154,579
33408,2020-03-21,(04108) El Polo,82,57,72,211
33409,2020-06-15,(07201) Guatoque -Veraguas,27,24,47,98
33410,2020-05-10,(07101) CASTELLANA,22,12,27,61
33411,2020-08-16,(14005) Las Aguas,45,41,66,152
33412,2020-04-23,(09113) Calle 22,240,145,229,614
33413,2019-12-31,(12003) Ricaurte,12,5,13,30
33414,2020-09-08,(05101) Mandalay - Cr.73,155,88,100,343
33415,2020-07-10,(10003) Ciudad Jardín,234,102,172,508
33416,2020-04-21,(14004) Museo del Oro,0,51,126,177
33417,2020-08-17,(02304) Heroes,162,134,135,431
33418,2020-05-13,(03007) HUMEDAL CORDOBA,98,63,53,214
33419,2020-03-08,(12004) Carrera 22,117,107,175,399
33420,2020-02-22,(03014) SAN MARTIN,108,80,107,295
33421,2020-08-01,(05103) Marsella,235,121,151,507
33422,2020-06-22,(08002) Biblioteca,102,59,74,235
33423,2020-07-26,(06107) Ciudad Universitaria,29,21,37,87
33424,2020-09-18,(03007) HUMEDAL CORDOBA,192,114,94,400
33425,2020-04-05,(10007) Las Nieves,42,37,50,129
33426,2020-04-23,(14004) Museo del Oro,0,56,114,170
33427,2020-05-27,(03010) PUENTE LARGO,300,196,152,648
33428,2020-06-22,(09114) Calle 26,56,57,94,207
33429,2020-08-10,(06100) Av. Rojas,208,122,109,439
33430,2020-07-30,(06105) Quinta Paredes,126,86,80,292
33431,2020-07-26,(07201) Guatoque -Veraguas,25,10,30,65
33432,2020-04-08,(06105) Quinta Paredes,52,53,43,148
33433,2020-09-12,(14005) Las Aguas,181,104,229,514
33434,2020-04-11,(12007) Zona Industrial,60,53,41,154
33435,2020-04-10,(09108) Hospital,10,7,20,37
33436,2020-04-10,(50006) Corral Carrera 77,1,1,0,2
33437,2020-07-22,(04000) Cabecera Calle 80 - alimentacion,3651,2064,2334,8049
33438,2020-07-23,(04000) Cabecera Calle 80 - alimentacion,3460,1913,2094,7467
33439,2020-01-25,(09002) Consuelo,951,433,687,2071
33440,2020-07-13,(09002) Consuelo,294,157,164,615
33441,2020-07-24,(09002) Consuelo,357,183,188,728
33442,2020-07-18,(09118) Marly,950,632,533,2115
33443,2020-07-31,(05000) Portal Américas - alimentacion,9318,4912,4666,18896
33444,2020-01-11,(05000) Portal Américas - alimentacion,21411,10282,12531,44224
33445,2020-03-03,(03002) SUBA - TV- 91,4678,2730,2473,9881
33446,2020-07-06,(07505) LEON XIII,2881,1557,1305,5743
33447,2020-01-16,(02200) Alcalá,11875,7030,6125,25030
33448,2020-03-17,(05000) Portal Américas,9842,5234,4976,20052
33449,2020-08-11,(05000) Portal Américas,2709,1710,1850,6269
33450,2020-03-03,(09000) Cabecera Usme - alimentacion,25908,14791,16063,56762
33451,2020-09-19,(09000) Cabecera Usme - alimentacion,7828,3653,5510,16991
33452,2020-03-24,(05000) Portal Américas - alimentacion,8973,4206,4909,18088
33453,2020-07-16,(05000) Portal Américas - alimentacion,9809,5114,4786,19709
33454,2020-04-10,(04000) Cabecera Calle 80 - alimentacion,497,332,264,1093
33455,2020-03-19,(06107) Ciudad Universitaria,458,279,342,1079
33456,2020-07-29,(09001) Molinos,2341,1295,1549,5185
33457,2020-01-21,(02000) Cabecera Autopista Norte - alimentacion,16727,8301,8277,33305
33458,2020-02-11,(02000) Cabecera Autopista Norte - intermunicipal,5386,3664,3082,12132
33459,2020-02-14,(14004) Museo del Oro,3882,2560,2094,8536
33460,2020-02-11,(05005) Transversal 86,2852,1713,1261,5826
33461,2020-04-12,(09000) Cabecera Usme,271,180,176,627
33462,2020-03-08,(09000) Cabecera Usme,1227,519,1292,3038
33463,2020-01-29,(10002) Av. Primero de Mayo,8070,4054,4441,16565
33464,2020-06-17,(09000) Cabecera Usme - alimentacion,8521,4802,4778,18101
33465,2020-07-06,(02000) Cabecera Autopista Norte,1422,876,918,3216
33466,2020-07-08,(02000) Cabecera Autopista Norte,1449,892,869,3210
33467,2020-07-23,(09104) Restrepo,1119,651,807,2577
33468,2020-01-14,(07505) LEON XIII,7506,4107,3602,15215
33469,2020-03-08,(02204) Pepe Sierra,611,427,773,1811
33470,2020-09-10,(02204) Pepe Sierra,726,484,509,1719
33471,2020-02-19,(09110) Avenida Jimenez,5612,3443,2935,11990
33472,2020-03-15,(03005) SUBA - AV. BOYACA,300,202,383,885
33473,2020-04-15,(07102) NQS - CALLE 75,179,131,105,415
33474,2020-04-05,(09103) Olaya,167,96,92,355
33475,2020-05-26,(14001) La Sabana,139,104,83,326
33476,2020-09-18,(14001) La Sabana,166,119,133,418
33477,2020-09-10,(07111) NQS - RICAURTE,1055,463,608,2126
33478,2020-09-03,(07002) MADELENA,932,554,598,2084
33479,2020-01-07,(02201) Prado,3558,2217,2257,8032
33480,2020-01-19,(02000) Cabecera Autopista Norte,1685,861,1738,4284
33481,2020-02-17,(10002) Av. Primero de Mayo,8541,4440,4593,17574
33482,2020-07-15,(50003) Corral Molinos,1049,585,804,2438
33483,2020-07-24,(07010) Bosa,588,302,325,1215
33484,2020-01-09,(06106) Recinto Ferial,989,568,605,2162
33485,2020-01-06,(04106) Carrera 47,283,146,231,660
33486,2020-01-01,(09114) Calle 26,89,75,227,391
33487,2020-06-17,(40003) Mirador del Paraiso,1761,1101,1049,3911
33488,2020-08-19,(40003) Mirador del Paraiso,1580,969,999,3548
33489,2020-03-18,(04001) Quirigua,1017,643,614,2274
33490,2020-01-21,(12001) Carrera 43,788,513,654,1955
33491,2020-05-29,(12001) Carrera 43,377,217,211,805
33492,2020-03-10,(07113) SANTA ISABEL,262,510,412,1184
33493,2020-07-09,(07113) SANTA ISABEL,400,245,278,923
33494,2020-02-10,(09107) Hortúa,2479,1517,1518,5514
33495,2020-03-05,(06105) Quinta Paredes,1021,570,505,2096
33496,2020-01-04,(02000) Cabecera Autopista Norte - intermunicipal,1020,567,878,2465
33497,2020-08-21,(03000) Portal Suba,1198,759,781,2738
33498,2020-01-04,(09100) Calle 40 Sur,2645,1248,1953,5846
33499,2020-03-01,(02300) Calle 100,843,735,1310,2888
33500,2020-03-08,(09003) Socorro,502,204,421,1127
33501,2020-05-11,(08001) Parque el Tunal,347,196,224,767
33502,2020-02-02,(07505) LEON XIII,2272,934,1608,4814
33503,2020-08-27,(02302) Virrey,632,453,308,1393
33504,2020-10-10,(02101) Toberín,1133,604,1200,2937
33505,2020-02-12,(06103) CAN,2738,1603,1180,5521
33506,2020-02-19,(06108) Concejo de Bogotá,934,427,462,1823
33507,2020-06-30,(06108) Concejo de Bogotá,148,87,99,334
33508,2020-09-09,(07010) Bosa,681,303,483,1467
33509,2020-04-27,(09004) Santa Lucía,925,110,156,1191
33510,2020-01-08,(03003) 21 ANGELES,1151,555,682,2388
33511,2020-07-13,(10002) Av. Primero de Mayo,1428,785,860,3073
33512,2020-05-04,(09120) Calle 63,734,517,432,1683
33513,2020-10-05,(09120) Calle 63,1254,885,1068,3207
33514,2020-07-12,(02201) Prado,293,207,250,750
33515,2020-02-08,(14004) Museo del Oro,801,776,1166,2743
33516,2020-01-17,(03005) SUBA - AV. BOYACA,2430,1390,1452,5272
33517,2020-01-18,(10000) Portal 20 de Julio,5055,2191,3259,10505
33518,2020-07-31,(09107) Hortúa,519,306,333,1158
33519,2020-07-21,(40003) Mirador del Paraiso,1232,768,855,2855
33520,2020-02-22,(06106) Recinto Ferial,789,459,583,1831
33521,2020-01-15,(03011) SUBA - CALLE 100,2176,1152,1321,4649
33522,2020-02-01,(03011) SUBA - CALLE 100,1134,736,1118,2988
33523,2020-05-10,(02300) Calle 100,282,202,177,661
33524,2020-06-20,(02000) Cabecera Autopista Norte - alimentacion,4157,2190,2314,8661
33525,2020-01-05,(09000) Cabecera Usme - alimentacion,4872,2080,4024,10976
33526,2020-04-14,(08000) Portal Tunal,385,198,212,795
33527,2020-05-19,(02205) Calle 106,271,174,152,597
33528,2020-01-21,(04002) Carrera 90,2699,1313,1255,5267
33529,2020-07-04,(03006) NIZA - CALLE 127,404,217,232,853
33530,2020-03-12,(10008) San Diego,808,68,168,1044
33531,2020-07-06,(02304) Heroes,942,644,558,2144
33532,2020-06-03,(07106) EL CAMPIN,321,206,154,681
33533,2020-04-11,(09004) Santa Lucía,688,365,380,1433
33534,2020-02-10,(07108) Av. El Dorado,962,610,606,2178
33535,2020-01-28,(03010) PUENTE LARGO,2126,1428,1205,4759
33536,2020-09-09,(05101) Mandalay - Cr.73,165,95,93,353
33537,2020-01-02,(04103) Las Ferias,630,356,470,1456
33538,2020-05-22,(02101) Toberín,1154,727,737,2618
33539,2020-06-21,(07102) NQS - CALLE 75,74,63,79,216
33540,2020-03-26,(09100) Calle 40 Sur,796,475,417,1688
33541,2020-01-29,(07104) Simon Bolivar,2393,1509,1268,5170
33542,2020-05-02,(07104) Simon Bolivar,184,122,101,407
33543,2020-01-18,(07109) CAD,1244,852,1058,3154
33544,2020-06-22,(02000) Cabecera Autopista Norte - alimentacion,1965,996,1202,4163
33545,2020-03-20,(09106) Nariño,178,121,112,411
33546,2020-02-11,(03007) HUMEDAL CORDOBA,1059,695,541,2295
33547,2020-09-23,(03001) LA CAMPIÑA,1402,825,934,3161
33548,2020-04-20,(07000) Portal Sur - alimentacion,4317,2361,1706,8384
33549,2020-07-02,(09117) Calle 45,748,470,458,1676
33550,2020-07-29,(09117) Calle 45,674,432,373,1479
33551,2020-09-06,(02200) Alcalá,632,446,524,1602
33552,2020-04-07,(02202) Calle 127,610,442,340,1392
33553,2020-03-03,(04001) Quirigua,2131,1300,1189,4620
33554,2020-02-16,(04100) Carrera 77,1440,616,1489,3545
33555,2020-10-04,(08000) Portal Tunal,217,153,208,578
33556,2020-04-26,(03000) Portal Suba - alimentacion,1306,721,659,2686
33557,2020-08-09,(02200) Alcalá,436,313,311,1060
33558,2020-10-09,(07109) CAD,731,475,507,1713
33559,2020-08-26,(07109) CAD,629,354,258,1241
33560,2020-06-10,(07113) SANTA ISABEL,381,227,263,871
33561,2020-09-15,(02105) Calle 142,862,522,613,1997
33562,2020-07-10,(07009) SENA,721,441,467,1629
33563,2020-07-11,(09104) Restrepo,1319,765,1093,3177
33564,2020-06-21,(02302) Virrey,153,111,124,388
33565,2020-05-09,(10010) San Bernardo,353,165,260,778
33566,2020-09-21,(07106) EL CAMPIN,376,256,246,878
33567,2020-01-10,(06107) Ciudad Universitaria,675,382,594,1651
33568,2020-05-06,(09002) Consuelo,318,166,182,666
33569,2020-01-30,(10005) Bicentenario,776,417,408,1601
33570,2020-09-14,(05107) Américas - Cr.53,440,267,295,1002
33571,2020-08-29,(02104) Calle 146,618,370,467,1455
33572,2020-09-04,(02103) Mazurén,238,141,197,576
33573,2020-09-22,(06109) Centro Memoria,299,166,198,663
33574,2020-07-09,(10005) Bicentenario,114,65,81,260
33575,2020-07-24,(02304) Heroes,626,430,363,1419
33576,2020-06-13,(02001) Centro Comercial Santa Fe,323,204,272,799
33577,2020-08-18,(09107) Hortúa,494,311,339,1144
33578,2020-08-07,(07004) VENECIA,373,213,224,810
33579,2020-10-02,(09113) Calle 22,492,251,447,1190
33580,2020-07-02,(07111) NQS - RICAURTE,1181,725,473,2379
33581,2020-09-27,(09103) Olaya,377,193,317,887
33582,2020-03-31,(02204) Pepe Sierra,359,314,233,906
33583,2020-07-01,(07006) General Santander,584,363,342,1289
33584,2020-05-28,(07000) Portal Sur,1581,993,895,3469
33585,2020-08-16,(04108) El Polo,78,47,79,204
33586,2020-05-23,(02304) Heroes,384,322,273,979
33587,2020-01-12,(12004) Carrera 22,97,94,167,358
33588,2020-01-29,(12004) Carrera 22,681,447,523,1651
33589,2020-04-20,(02101) Toberín,651,496,424,1571
33590,2020-10-08,(07200) Tygua-San José,282,174,234,690
33591,2020-08-18,(06109) Centro Memoria,252,126,130,508
33592,2020-04-04,(09123) Calle 76,321,249,218,788
33593,2020-08-09,(06102) Salitre El Greco,71,46,55,172
33594,2020-07-06,(07201) Guatoque -Veraguas,211,120,126,457
33595,2020-05-11,(03000) Portal Suba,868,531,522,1921
33596,2020-05-31,(03000) Portal Suba,266,139,266,671
33597,2020-05-30,(09121) Las Flores,480,305,330,1115
33598,2020-06-23,(09121) Las Flores,765,465,440,1670
33599,2020-02-17,(07506) DESPENSA,1446,956,919,3321
33600,2020-06-30,(02200) Alcalá,1996,1354,1096,4446
33601,2020-10-03,(07105) MOVISTAR ARENA,200,146,224,570
33602,2020-08-30,(10006) San Victorino,223,142,166,531
33603,2020-05-19,(04001) Quirigua,332,211,186,729
33604,2020-05-30,(02104) Calle 146,462,320,325,1107
33605,2020-05-20,(07110) PALOQUEMAO,566,343,222,1131
33606,2020-07-17,(08002) Biblioteca,234,135,137,506
33607,2020-08-08,(08002) Biblioteca,214,107,110,431
33608,2020-07-24,(03010) PUENTE LARGO,315,188,169,672
33609,2020-05-19,(12000) Puente Aranda,63,39,23,125
33610,2020-02-09,(09121) Las Flores,604,392,668,1664
33611,2020-09-28,(07506) DESPENSA,515,274,359,1148
33612,2020-05-06,(07002) MADELENA,457,266,248,971
33613,2020-07-26,(06108) Concejo de Bogotá,42,22,19,83
33614,2020-10-03,(06001) Modelia,251,174,294,719
33615,2020-03-24,(09002) Consuelo,377,172,254,803
33616,2020-09-21,(09114) Calle 26,251,188,230,669
33617,2020-03-27,(07005) ALQUERIA,235,149,132,516
33618,2020-06-17,(09119) Calle 57,585,355,376,1316
33619,2020-03-30,(02300) Calle 100,733,561,433,1727
33620,2020-08-02,(10004) Policarpa,78,26,67,171
33621,2020-02-12,(07200) Tygua-San José,851,504,594,1949
33622,2020-07-24,(02201) Prado,722,490,384,1596
33623,2020-05-02,(02302) Virrey,293,220,141,654
33624,2020-03-12,(03012) SUBA - CALLE 95,529,129,207,865
33625,2020-07-16,(10010) San Bernardo,502,250,298,1050
33626,2020-04-07,(07003) SEVILLANA,213,109,114,436
33627,2020-07-28,(12002) CDS - Carrera 32,157,92,49,298
33628,2020-06-30,(07108) Av. El Dorado,150,93,98,341
33629,2020-06-02,(06002) Normandía,299,168,179,646
33630,2020-10-03,(06002) Normandía,269,163,308,740
33631,2020-04-22,(04101) Minuto de Dios,168,111,109,388
33632,2020-07-09,(03010) PUENTE LARGO,373,227,212,812
33633,2020-04-07,(07505) LEON XIII,1131,664,543,2338
33634,2020-08-23,(07004) VENECIA,279,119,207,605
33635,2020-07-19,(03012) SUBA - CALLE 95,71,46,50,167
33636,2020-03-30,(02502) Terminal,121,100,130,351
33637,2020-08-08,(07010) Bosa,447,193,313,953
33638,2020-06-09,(06106) Recinto Ferial,234,134,121,489
33639,2020-07-18,(07006) General Santander - alimentacion,202,112,164,478
33640,2020-09-05,(04106) Carrera 47,290,142,242,674
33641,2020-05-26,(40002) Manitas,351,228,212,791
33642,2020-06-24,(04106) Carrera 47,325,168,168,661
33643,2020-07-08,(04106) Carrera 47,336,181,172,689
33644,2020-09-07,(07107) U. NACIONAL,421,246,209,876
33645,2020-04-24,(05102) Av. Américas - Av. Boyacá,136,86,73,295
33646,2020-05-23,(07006) General Santander - alimentacion,220,135,123,478
33647,2020-06-11,(07007) NQS - Calle 38A Sur,381,215,233,829
33648,2020-03-24,(09003) Socorro,416,206,297,919
33649,2020-03-30,(12007) Zona Industrial,162,132,74,368
33650,2020-06-06,(12007) Zona Industrial,245,159,122,526
33651,2020-09-10,(10003) Ciudad Jardín,228,94,151,473
33652,2020-07-17,(03005) SUBA - AV. BOYACA,402,260,239,901
33653,2020-10-11,(03013) RIO NEGRO,79,52,122,253
33654,2020-09-13,(09121) Las Flores,178,124,220,522
33655,2020-06-21,(02103) Mazurén,52,34,61,147
33656,2020-05-27,(05101) Mandalay - Cr.73,98,49,48,195
33657,2020-06-13,(10003) Ciudad Jardín,170,80,114,364
33658,2020-03-20,(02000) Cabecera Autopista Norte - intermunicipal,133,102,78,313
33659,2020-06-15,(12007) Zona Industrial,57,37,49,143
33660,2020-03-27,(12004) Carrera 22,40,25,36,101
33661,2020-04-16,(09106) Nariño,200,113,123,436
33662,2020-05-19,(04105) Carrera 53,246,129,122,497
33663,2020-03-21,(07201) Guatoque -Veraguas,19,30,29,78
33664,2020-04-15,(05103) Marsella,165,96,121,382
33665,2020-05-15,(03007) HUMEDAL CORDOBA,105,63,51,219
33666,2020-07-12,(12002) CDS - Carrera 32,38,27,29,94
33667,2020-09-13,(06108) Concejo de Bogotá,43,15,51,109
33668,2020-04-18,(06106) Recinto Ferial,128,88,49,265
33669,2020-02-05,(50006) Corral Carrera 77,28,25,44,97
33670,2020-07-16,(50006) Corral Carrera 77,5,2,5,12
33671,2020-04-12,(14004) Museo del Oro,0,8,29,37
33672,2020-04-29,(04000) Cabecera Calle 80 - alimentacion,2232,1265,1294,4791
33673,2020-09-09,(07005) ALQUERIA,601,355,406,1362
33674,2020-05-11,(07504) TERREROS,3734,2254,1887,7875
33675,2020-03-07,(03000) Portal Suba - alimentacion,16950,8141,12001,37092
33676,2020-02-19,(04101) Minuto de Dios,3676,2226,1784,7686
33677,2020-06-04,(04002) Carrera 90,664,356,335,1355
33678,2020-03-31,(05000) Portal Américas - alimentacion,5992,2624,2601,11217
33679,2020-01-06,(04000) Cabecera Calle 80 - alimentacion,3379,1593,3530,8502
33680,2020-01-31,(07010) Bosa,2216,1212,1468,4896
33681,2020-03-18,(07010) Bosa,1418,785,891,3094
33682,2020-01-06,(05000) Portal Américas,2051,1036,2018,5105
33683,2020-03-17,(07000) Portal Sur - alimentacion,19282,10612,9403,39297
33684,2020-02-20,(05100) Banderas P. Central,8069,4727,3590,16386
33685,2020-07-09,(05100) Banderas P. Central,876,472,560,1908
33686,2020-10-12,(10001) Country Sur,426,172,471,1069
33687,2020-02-25,(04000) Cabecera Calle 80,7565,4695,5026,17286
33688,2020-01-02,(06102) Salitre El Greco,707,400,401,1508
33689,2020-01-06,(07005) ALQUERIA,448,234,404,1086
33690,2020-07-31,(02105) Calle 142,678,450,398,1526
33691,2020-01-29,(09000) Cabecera Usme - alimentacion,24747,14018,15308,54073
33692,2020-02-24,(09000) Cabecera Usme - alimentacion,25275,14856,16338,56469
33693,2020-02-26,(09120) Calle 63,6874,4786,4035,15695
33694,2020-08-28,(09000) Cabecera Usme - alimentacion,8846,4632,5146,18624
33695,2020-02-05,(09104) Restrepo,5476,3228,4030,12734
33696,2020-07-20,(04101) Minuto de Dios,71,47,99,217
33697,2020-02-08,(10006) San Victorino,1148,852,1071,3071
33698,2020-03-06,(09123) Calle 76,5211,3549,3335,12095
33699,2020-01-16,(03009) Av. Suba- Calle 116,2250,1404,1286,4940
33700,2020-09-11,(05000) Portal Américas,176,2196,4851,7223
33701,2020-04-04,(07102) NQS - CALLE 75,106,88,53,247
33702,2020-03-10,(09103) Olaya,392,1172,801,2365
33703,2020-02-08,(02302) Virrey,1357,1082,1359,3798
33704,2020-07-11,(07000) Portal Sur - alimentacion,6783,3654,3741,14178
33705,2020-02-28,(03001) LA CAMPIÑA,6794,3762,4276,14832
33706,2020-04-02,(09100) Calle 40 Sur,793,472,508,1773
33707,2020-08-29,(05100) Banderas P. Central - alimentacion,2469,1135,1592,5196
33708,2020-09-15,(05100) Banderas P. Central - alimentacion,3258,1815,2058,7131
33709,2020-01-08,(09103) Olaya,2827,1631,1858,6316
33710,2020-05-09,(07111) NQS - RICAURTE,562,374,228,1164
33711,2020-07-06,(08000) Portal Tunal - alimentacion,6557,3811,3756,14124
33712,2020-03-13,(02200) Alcalá,1810,1674,1364,4848
33713,2020-09-08,(07002) MADELENA,855,541,585,1981
33714,2020-07-26,(09113) Calle 22,199,84,170,453
33715,2020-08-17,(09113) Calle 22,213,109,212,534
33716,2020-01-07,(02001) Centro Comercial Santa Fe,2957,1815,2003,6775
33717,2020-07-08,(50003) Corral Molinos,1637,823,1173,3633
33718,2020-02-04,(04000) Cabecera Calle 80,7778,4704,4993,17475
33719,2020-06-27,(02000) Cabecera Autopista Norte - alimentacion,4230,2273,2438,8941
33720,2020-06-29,(02000) Cabecera Autopista Norte - alimentacion,1971,1035,1196,4202
33721,2020-06-17,(08000) Portal Tunal - alimentacion,6238,3529,3439,13206
33722,2020-01-23,(05002) Tintal,10431,5871,5522,21824
33723,2020-03-02,(10006) San Victorino,2461,1275,1271,5007
33724,2020-05-15,(06000) Portal Eldorado,959,601,399,1959
33725,2020-09-03,(09123) Calle 76,1115,760,680,2555
33726,2020-06-20,(10002) Av. Primero de Mayo,1697,858,1201,3756
33727,2020-07-07,(10002) Av. Primero de Mayo,2338,1202,1426,4966
33728,2020-09-28,(10002) Av. Primero de Mayo,2398,1229,1735,5362
33729,2020-06-25,(10005) Bicentenario - alimentacion,223,124,175,522
33730,2020-03-10,(06111) Universidades,2194,478,607,3279
33731,2020-05-02,(05100) Banderas P. Central - alimentacion,1183,545,557,2285
33732,2020-07-11,(05001) Patio Bonito,1421,810,995,3226
33733,2020-09-23,(09101) Quiroga,584,321,462,1367
33734,2020-09-03,(10002) Av. Primero de Mayo,2261,1131,1533,4925
33735,2020-03-09,(06111) Universidades,1962,470,532,2964
33736,2020-01-23,(10010) San Bernardo,1660,924,1271,3855
33737,2020-01-27,(10000) Portal 20 de Julio,8484,4051,3815,16350
33738,2020-04-21,(09116) Avenida 39,188,132,120,440
33739,2020-01-29,(02001) Centro Comercial Santa Fe,4737,2976,2596,10309
33740,2020-03-26,(09004) Santa Lucía,986,514,527,2027
33741,2020-07-07,(09004) Santa Lucía,2750,1455,1432,5637
33742,2020-04-20,(09003) Socorro,276,144,173,593
33743,2020-10-01,(09116) Avenida 39,422,259,339,1020
33744,2020-07-02,(07010) Bosa,759,376,462,1597
33745,2020-02-12,(09120) Calle 63,7672,4912,3862,16446
33746,2020-06-23,(09107) Hortúa,644,398,378,1420
33747,2020-01-09,(03012) SUBA - CALLE 95,1034,652,713,2399
33748,2020-06-13,(03012) SUBA - CALLE 95,225,160,148,533
33749,2020-07-04,(03012) SUBA - CALLE 95,232,155,172,559
33750,2020-07-11,(09119) Calle 57,513,320,375,1208
33751,2020-06-25,(05005) Transversal 86,415,208,240,863
33752,2020-08-03,(02202) Calle 127,980,702,517,2199
33753,2020-07-23,(06109) Centro Memoria,224,114,104,442
33754,2020-08-14,(08000) Portal Tunal,764,309,329,1402
33755,2020-09-22,(03009) Av. Suba- Calle 116,564,332,327,1223
33756,2020-04-06,(02205) Calle 106,190,141,116,447
33757,2020-01-31,(09101) Quiroga,1557,880,1216,3653
33758,2020-02-26,(04108) El Polo,1886,1224,1316,4426
33759,2020-06-25,(07101) CASTELLANA,212,122,136,470
33760,2020-01-21,(07101) CASTELLANA,527,430,412,1369
33761,2020-01-05,(06000) Portal Eldorado - alimentacion,3382,1346,2682,7410
33762,2020-06-16,(02201) Prado,927,630,513,2070
33763,2020-01-04,(07113) SANTA ISABEL,635,377,633,1645
33764,2020-03-07,(07113) SANTA ISABEL,1273,663,1141,3077
33765,2020-06-23,(10006) San Victorino,715,321,337,1373
33766,2020-06-14,(04000) Cabecera Calle 80 - alimentacion,1054,523,800,2377
33767,2020-06-03,(09103) Olaya,916,513,476,1905
33768,2020-01-02,(04102) Avenida Boyaca,1142,693,758,2593
33769,2020-02-13,(04102) Avenida Boyaca,3168,1923,1711,6802
33770,2020-02-01,(04000) Cabecera Calle 80 - intermunicipal,964,652,1194,2810
33771,2020-04-23,(07104) Simon Bolivar,250,186,127,563
33772,2020-08-03,(04107) Escuela Militar,80,51,60,191
33773,2020-01-24,(07109) CAD,2730,1629,1580,5939
33774,2020-02-15,(06111) Universidades,2020,1293,1937,5250
33775,2020-03-16,(05103) Marsella,1958,1064,936,3958
33776,2020-03-18,(09109) Tercer Milenio,843,537,485,1865
33777,2020-03-21,(40003) Mirador del Paraiso,386,239,232,857
33778,2020-04-11,(09001) Molinos,699,408,485,1592
33779,2020-05-03,(02202) Calle 127,329,220,143,692
33780,2020-05-08,(03011) SUBA - CALLE 100,310,176,160,646
33781,2020-05-13,(09121) Las Flores,552,386,321,1259
33782,2020-04-19,(05002) Tintal,460,262,207,929
33783,2020-07-14,(03001) LA CAMPIÑA,994,606,523,2123
33784,2020-09-22,(07109) CAD,727,444,362,1533
33785,2020-03-28,(09002) Consuelo,138,72,70,280
33786,2020-06-17,(07113) SANTA ISABEL,415,256,272,943
33787,2020-08-21,(04108) El Polo,503,308,237,1048
33788,2020-09-11,(02001) Centro Comercial Santa Fe,519,308,372,1199
33789,2020-08-15,(06100) Av. Rojas,138,90,134,362
33790,2020-05-28,(06000) Portal Eldorado,942,629,407,1978
33791,2020-09-16,(02302) Virrey,717,510,389,1616
33792,2020-07-20,(03010) PUENTE LARGO,87,66,69,222
33793,2020-08-03,(05002) Tintal,1957,1124,1213,4294
33794,2020-09-27,(05100) Banderas P. Central,260,125,291,676
33795,2020-06-24,(04104) Avenida 68,668,336,365,1369
33796,2020-08-11,(09109) Tercer Milenio,351,201,202,754
33797,2020-04-15,(09116) Avenida 39,200,143,119,462
33798,2020-08-25,(09116) Avenida 39,335,192,230,757
33799,2020-03-15,(05102) Av. Américas - Av. Boyacá,187,96,165,448
33800,2020-09-06,(03006) NIZA - CALLE 127,203,127,137,467
33801,2020-08-01,(09104) Restrepo,1055,620,864,2539
33802,2020-05-16,(05107) Américas - Cr.53,217,144,150,511
33803,2020-10-08,(09122) Calle 72,1310,905,1143,3358
33804,2020-07-14,(10005) Bicentenario,96,43,44,183
33805,2020-08-08,(10005) Bicentenario,76,45,66,187
33806,2020-03-07,(40002) Manitas,959,467,678,2104
33807,2020-06-24,(02001) Centro Comercial Santa Fe,547,315,366,1228
33808,2020-04-22,(04000) Cabecera Calle 80,563,384,348,1295
33809,2020-04-03,(07505) LEON XIII,1203,649,636,2488
33810,2020-03-09,(06103) CAN,1070,202,264,1536
33811,2020-08-14,(10008) San Diego,291,163,191,645
33812,2020-05-24,(09120) Calle 63,279,154,200,633
33813,2020-09-03,(09117) Calle 45,710,446,500,1656
33814,2020-07-09,(09003) Socorro,639,358,364,1361
33815,2020-05-29,(07111) NQS - RICAURTE,1038,654,414,2106
33816,2020-05-16,(09115) Calle 34,350,239,246,835
33817,2020-09-08,(09115) Calle 34,711,450,474,1635
33818,2020-09-09,(03006) NIZA - CALLE 127,551,284,309,1144
33819,2020-09-23,(03006) NIZA - CALLE 127,569,332,339,1240
33820,2020-06-13,(07110) PALOQUEMAO,446,276,250,972
33821,2020-03-07,(10009) Museo Nacional,1020,963,1428,3411
33822,2020-02-15,(04107) Escuela Militar,347,242,392,981
33823,2020-06-28,(12004) Carrera 22,66,44,51,161
33824,2020-02-09,(07200) Tygua-San José,156,109,263,528
33825,2020-03-28,(09111) Calle 19,153,98,129,380
33826,2020-04-03,(06102) Salitre El Greco,171,113,89,373
33827,2020-09-09,(04105) Carrera 53,306,148,181,635
33828,2020-05-07,(02302) Virrey,414,301,211,926
33829,2020-07-01,(09114) Calle 26,328,210,233,771
33830,2020-08-11,(07201) Guatoque -Veraguas,205,98,117,420
33831,2020-09-15,(14005) Las Aguas,246,136,236,618
33832,2020-08-21,(50003) Corral Molinos,1504,771,1031,3306
33833,2020-07-16,(09114) Calle 26,257,162,148,567
33834,2020-05-16,(10007) Las Nieves,296,184,227,707
33835,2020-07-13,(03003) 21 ANGELES,290,163,167,620
33836,2020-04-22,(07004) VENECIA,502,313,257,1072
33837,2020-05-22,(04001) Quirigua,315,200,203,718
33838,2020-07-14,(03006) NIZA - CALLE 127,445,240,191,876
33839,2020-08-20,(03005) SUBA - AV. BOYACA,436,247,261,944
33840,2020-06-08,(09122) Calle 72,1076,761,652,2489
33841,2020-02-22,(03010) PUENTE LARGO,920,605,796,2321
33842,2020-01-20,(12000) Puente Aranda,244,157,165,566
33843,2020-02-07,(12000) Puente Aranda,283,158,206,647
33844,2020-03-31,(12000) Puente Aranda,52,38,32,122
33845,2020-06-06,(03005) SUBA - AV. BOYACA,321,171,196,688
33846,2020-09-06,(05102) Av. Américas - Av. Boyacá,76,32,76,184
33847,2020-05-13,(07506) DESPENSA,378,208,190,776
33848,2020-09-21,(07506) DESPENSA,372,192,255,819
33849,2020-08-06,(02102) Calle 161,225,128,155,508
33850,2020-07-18,(14001) La Sabana,102,68,67,237
33851,2020-04-16,(12004) Carrera 22,57,53,69,179
33852,2020-06-05,(07111) NQS - RICAURTE,1067,675,412,2154
33853,2020-02-12,(09111) Calle 19,2450,1436,1549,5435
33854,2020-01-26,(02105) Calle 142,878,463,1113,2454
33855,2020-08-07,(03006) NIZA - CALLE 127,158,114,108,380
33856,2020-05-04,(09115) Calle 34,437,341,246,1024
33857,2020-09-06,(50003) Corral Molinos,537,279,559,1375
33858,2020-02-16,(04108) El Polo,316,175,450,941
33859,2020-08-08,(05101) Mandalay - Cr.73,88,46,58,192
33860,2020-07-14,(06106) Recinto Ferial,229,116,86,431
33861,2020-05-20,(07004) VENECIA,776,493,416,1685
33862,2020-07-18,(06000) Portal Eldorado,567,383,433,1383
33863,2020-08-24,(12002) CDS - Carrera 32,201,116,75,392
33864,2020-08-05,(03006) NIZA - CALLE 127,331,207,190,728
33865,2020-04-03,(06001) Modelia,226,152,175,553
33866,2020-03-02,(03014) SAN MARTIN,234,145,201,580
33867,2020-05-09,(03006) NIZA - CALLE 127,195,136,121,452
33868,2020-07-20,(06104) Gobernación,52,37,39,128
33869,2020-07-05,(02502) Terminal,85,76,116,277
33870,2020-03-26,(04000) Cabecera Calle 80 - intermunicipal,78,58,94,230
33871,2020-08-25,(07506) DESPENSA,416,262,235,913
33872,2020-08-03,(07006) General Santander - alimentacion,341,188,204,733
33873,2020-07-25,(04106) Carrera 47,211,107,132,450
33874,2020-06-13,(03011) SUBA - CALLE 100,331,189,202,722
33875,2020-01-05,(12001) Carrera 43,122,94,211,427
33876,2020-04-27,(10005) Bicentenario - alimentacion,99,25,35,159
33877,2020-05-05,(05102) Av. Américas - Av. Boyacá,135,72,68,275
33878,2020-09-20,(03005) SUBA - AV. BOYACA,126,81,178,385
33879,2020-05-19,(07003) SEVILLANA,388,193,173,754
33880,2020-03-10,(12000) Puente Aranda,112,27,55,194
33881,2020-03-24,(12007) Zona Industrial,253,204,145,602
33882,2020-08-02,(04001) Quirigua,84,51,73,208
33883,2020-02-29,(03004) GRATAMIRA,135,72,107,314
33884,2020-07-15,(03004) GRATAMIRA,36,12,21,69
33885,2020-01-12,(09105) Río Fucha,112,80,182,374
33886,2020-05-13,(07008) NQS - Calle 30 Sur,195,122,115,432
33887,2020-03-29,(09121) Las Flores,140,98,84,322
33888,2020-04-17,(02104) Calle 146,387,261,203,851
33889,2020-04-23,(09117) Calle 45,467,305,237,1009
33890,2020-04-09,(07506) DESPENSA,84,44,49,177
33891,2020-07-27,(07007) NQS - Calle 38A Sur,274,193,215,682
33892,2020-07-24,(09114) Calle 26,255,165,162,582
33893,2020-06-15,(40001) Juan Pablo II,183,98,140,421
33894,2020-07-02,(05101) Mandalay - Cr.73,142,87,64,293
33895,2020-06-18,(06106) Recinto Ferial,247,161,122,530
33896,2020-04-03,(12003) Ricaurte,92,83,53,228
33897,2020-04-20,(09105) Río Fucha,64,37,57,158
33898,2020-06-05,(07003) SEVILLANA,405,213,221,839
33899,2020-06-18,(07201) Guatoque -Veraguas,202,108,143,453
33900,2020-07-19,(04107) Escuela Militar,24,18,30,72
33901,2020-09-13,(40001) Juan Pablo II,0,64,194,258
33902,2020-05-08,(06105) Quinta Paredes,87,63,42,192
33903,2019-12-31,(07001) PERDOMO,34,33,55,122
33904,2020-05-17,(06111) Universidades,0,30,79,109
33905,2020-06-18,(04000) Cabecera Calle 80 - alimentacion,4161,2425,2552,9138
33906,2020-01-30,(07005) ALQUERIA,2567,1455,1416,5438
33907,2020-06-12,(07005) ALQUERIA,618,348,323,1289
33908,2020-09-25,(07005) ALQUERIA,658,373,450,1481
33909,2020-02-13,(09118) Marly,8407,5352,4015,17774
33910,2020-07-08,(09118) Marly,1524,991,807,3322
33911,2020-06-06,(07504) TERREROS,3898,2133,2057,8088
33912,2020-02-27,(09119) Calle 57,4015,2475,2025,8515
33913,2020-03-05,(09119) Calle 57,3742,2268,2272,8282
33914,2020-10-04,(07505) LEON XIII,960,415,770,2145
33915,2020-03-05,(09100) Calle 40 Sur,7499,4193,4180,15872
33916,2020-06-21,(06104) Gobernación,41,39,39,119
33917,2020-02-10,(09114) Calle 26,3411,2165,1777,7353
33918,2020-02-27,(04002) Carrera 90,3850,2282,2001,8133
33919,2020-02-01,(06107) Ciudad Universitaria,612,391,711,1714
33920,2020-07-27,(06107) Ciudad Universitaria,178,93,105,376
33921,2020-09-09,(06107) Ciudad Universitaria,194,106,130,430
33922,2020-03-07,(05000) Portal Américas,8977,3989,6068,19034
33923,2020-01-27,(09118) Marly,6086,3990,3626,13702
33924,2020-02-15,(07010) Bosa,1560,799,1202,3561
33925,2020-03-05,(02201) Prado,5856,3532,3014,12402
33926,2020-02-14,(07000) Portal Sur - alimentacion,29923,16712,14563,61198
33927,2020-10-05,(05100) Banderas P. Central,1139,648,898,2685
33928,2020-03-13,(09100) Calle 40 Sur,349,1323,1135,2807
33929,2020-01-12,(02102) Calle 161,228,141,302,671
33930,2020-03-06,(02102) Calle 161,1844,1058,1148,4050
33931,2020-03-02,(02105) Calle 142,6986,4373,3794,15153
33932,2020-02-21,(06102) Salitre El Greco,1469,817,703,2989
33933,2020-02-25,(10003) Ciudad Jardín,1110,605,661,2376
33934,2020-03-12,(10003) Ciudad Jardín,56,176,149,381
33935,2020-08-07,(07001) PERDOMO,357,148,235,740
33936,2020-07-22,(09104) Restrepo,1229,710,923,2862
33937,2020-02-25,(04100) Carrera 77,6998,4276,4011,15285
33938,2020-02-26,(07505) LEON XIII,8730,4756,3810,17296
33939,2020-02-21,(10006) San Victorino,1879,1203,1286,4368
33940,2020-01-29,(06002) Normandía,2510,1476,1360,5346
33941,2020-03-19,(06002) Normandía,850,447,553,1850
33942,2020-02-24,(09110) Avenida Jimenez,5136,3490,2768,11394
33943,2020-03-14,(07111) NQS - RICAURTE,1952,1303,1284,4539
33944,2020-02-24,(09004) Santa Lucía,7706,4403,4192,16301
33945,2020-04-29,(09101) Quiroga,333,175,247,755
33946,2020-08-05,(09101) Quiroga,539,243,348,1130
33947,2020-03-01,(04100) Carrera 77,1467,628,1525,3620
33948,2020-04-30,(07102) NQS - CALLE 75,232,185,159,576
33949,2020-07-15,(07102) NQS - CALLE 75,425,272,194,891
33950,2020-08-05,(07102) NQS - CALLE 75,313,194,175,682
33951,2020-04-13,(09000) Cabecera Usme - alimentacion,4557,2338,2386,9281
33952,2020-06-01,(09000) Cabecera Usme - alimentacion,7806,4355,4607,16768
33953,2020-02-17,(03001) LA CAMPIÑA,6511,4295,4138,14944
33954,2020-06-01,(07000) Portal Sur - alimentacion,7196,4076,3239,14511
33955,2020-07-30,(07000) Portal Sur - alimentacion,7020,4045,3621,14686
33956,2020-09-01,(07111) NQS - RICAURTE,1153,659,521,2333
33957,2020-08-21,(07106) EL CAMPIN,354,224,211,789
33958,2020-09-18,(09004) Santa Lucía,2683,1443,1826,5952
33959,2020-01-02,(10002) Av. Primero de Mayo,4095,2014,2763,8872
33960,2020-03-10,(04000) Cabecera Calle 80,1011,1991,1654,4656
33961,2020-01-02,(09123) Calle 76,2021,1407,1451,4879
33962,2020-09-23,(02201) Prado,1040,677,738,2455
33963,2020-07-28,(09111) Calle 19,723,421,394,1538
33964,2020-02-11,(03000) Portal Suba,10147,6025,5375,21547
33965,2020-05-18,(06000) Portal Eldorado,988,618,429,2035
33966,2020-02-19,(10000) Portal 20 de Julio,9284,4372,4032,17688
33967,2020-02-06,(04001) Quirigua,2046,1276,1177,4499
33968,2020-05-23,(03000) Portal Suba,632,338,469,1439
33969,2020-03-23,(09101) Quiroga,64,43,66,173
33970,2020-04-16,(10000) Portal 20 de Julio - alimentacion,2568,1090,1623,5281
33971,2020-04-11,(07000) Portal Sur - alimentacion,2416,1295,923,4634
33972,2020-02-03,(07000) Portal Sur,7733,4754,4302,16789
33973,2020-03-04,(09004) Santa Lucía,7567,4233,4257,16057
33974,2020-03-04,(06108) Concejo de Bogotá,882,438,414,1734
33975,2020-04-17,(06108) Concejo de Bogotá,101,66,63,230
33976,2020-04-22,(06108) Concejo de Bogotá,101,73,58,232
33977,2020-06-23,(07010) Bosa,765,377,463,1605
33978,2020-03-27,(02201) Prado,428,270,247,945
33979,2020-02-29,(04003) Avenida Ciudad de Cali,3333,1526,2593,7452
33980,2020-06-08,(05002) Tintal,1949,1102,1088,4139
33981,2020-02-16,(10009) Museo Nacional,327,283,602,1212
33982,2020-09-24,(05002) Tintal,2883,1651,1889,6423
33983,2020-01-24,(03011) SUBA - CALLE 100,2324,1187,1413,4924
33984,2020-02-19,(02300) Calle 100,7303,4732,3804,15839
33985,2020-01-30,(03012) SUBA - CALLE 95,1416,863,959,3238
33986,2020-07-18,(03012) SUBA - CALLE 95,205,123,142,470
33987,2020-03-07,(05107) Américas - Cr.53,1317,798,1061,3176
33988,2020-09-01,(08000) Portal Tunal,786,316,350,1452
33989,2020-08-04,(02000) Cabecera Autopista Norte,1142,695,741,2578
33990,2020-02-17,(10008) San Diego,1601,857,803,3261
33991,2020-01-20,(08000) Portal Tunal,1963,1115,998,4076
33992,2020-09-30,(02205) Calle 106,437,292,319,1048
33993,2020-08-10,(06000) Portal Eldorado - alimentacion,3527,1845,1814,7186
33994,2020-09-30,(09101) Quiroga,554,301,468,1323
33995,2020-09-20,(05000) Portal Américas - alimentacion,3981,1686,2941,8608
33996,2020-02-13,(04108) El Polo,2010,1251,1144,4405
33997,2020-06-03,(02201) Prado,829,549,424,1802
33998,2020-08-01,(07010) Bosa,448,184,298,930
33999,2020-03-10,(06000) Portal Eldorado,2756,649,863,4268
34000,2020-04-13,(06000) Portal Eldorado,803,554,336,1693
34001,2020-08-26,(03003) 21 ANGELES,325,178,158,661
34002,2020-09-11,(05103) Marsella,435,227,282,944
34003,2020-05-03,(03007) HUMEDAL CORDOBA,40,25,14,79
34004,2020-05-08,(10000) Portal 20 de Julio,1556,803,743,3102
34005,2020-01-26,(09116) Avenida 39,184,188,358,730
34006,2020-05-09,(02000) Cabecera Autopista Norte - alimentacion,2664,1417,1294,5375
34007,2020-04-03,(02101) Toberín,555,375,401,1331
34008,2020-02-15,(06101) El Tiempo,1019,635,1084,2738
34009,2020-05-13,(07104) Simon Bolivar,441,278,214,933
34010,2020-01-15,(04107) Escuela Militar,547,338,380,1265
34011,2020-01-18,(07004) VENECIA,2783,1400,1831,6014
34012,2020-01-17,(07109) CAD,2498,1501,1461,5460
34013,2020-03-16,(07109) CAD,2160,1365,1007,4532
34014,2020-03-16,(09121) Las Flores,2409,1518,1426,5353
34015,2020-10-11,(02000) Cabecera Autopista Norte - intermunicipal,173,88,210,471
34016,2020-03-25,(02000) Cabecera Autopista Norte,565,392,362,1319
34017,2020-05-26,(09000) Cabecera Usme,1516,956,1053,3525
34018,2020-08-29,(07000) Portal Sur,1512,854,1215,3581
34019,2020-04-06,(05103) Marsella,161,93,120,374
34020,2020-02-24,(09109) Tercer Milenio,1411,898,862,3171
34021,2020-08-21,(09109) Tercer Milenio,344,219,239,802
34022,2020-09-30,(04002) Carrera 90,876,469,582,1927
34023,2020-02-29,(07103) AV. CHILE,1985,1369,1625,4979
34024,2020-03-07,(07103) AV. CHILE,2028,1415,1623,5066
34025,2020-05-21,(09117) Calle 45,630,389,368,1387
34026,2020-03-08,(04003) Avenida Ciudad de Cali,994,456,1095,2545
34027,2020-07-14,(02204) Pepe Sierra,733,503,328,1564
34028,2020-09-28,(02304) Heroes,986,668,701,2355
34029,2020-07-24,(02200) Alcalá,1620,1011,833,3464
34030,2020-04-27,(03001) LA CAMPIÑA,392,46,47,485
34031,2020-01-18,(07003) SEVILLANA,1093,527,754,2374
34032,2020-01-06,(09002) Consuelo,349,135,277,761
34033,2020-01-18,(02105) Calle 142,2510,1176,2180,5866
34034,2020-04-18,(06100) Av. Rojas,57,44,34,135
34035,2020-06-13,(07009) SENA,554,293,369,1216
34036,2020-03-26,(09122) Calle 72,606,441,338,1385
34037,2020-02-29,(12003) Ricaurte,789,600,592,1981
34038,2020-06-17,(12003) Ricaurte,388,275,204,867
34039,2020-07-08,(12003) Ricaurte,409,268,192,869
34040,2020-05-16,(07106) EL CAMPIN,187,127,135,449
34041,2020-03-09,(09004) Santa Lucía,445,1913,1372,3730
34042,2020-02-29,(03010) PUENTE LARGO,902,583,811,2296
34043,2020-02-15,(05107) Américas - Cr.53,1354,843,1084,3281
34044,2020-03-18,(05107) Américas - Cr.53,1332,792,722,2846
34045,2020-09-04,(06103) CAN,380,245,249,874
34046,2020-01-31,(07003) SEVILLANA,2054,1029,1188,4271
34047,2020-05-03,(07005) ALQUERIA,104,52,74,230
34048,2020-03-25,(06002) Normandía,164,105,100,369
34049,2020-08-06,(03002) SUBA - TV- 91,581,344,416,1341
34050,2020-09-03,(03002) SUBA - TV- 91,845,531,536,1912
34051,2020-04-20,(05107) Américas - Cr.53,321,223,161,705
34052,2020-03-23,(10002) Av. Primero de Mayo,510,264,269,1043
34053,2020-07-06,(07103) AV. CHILE,1020,589,494,2103
34054,2020-06-10,(07004) VENECIA,931,552,510,1993
34055,2020-02-04,(40002) Manitas,1332,750,850,2932
34056,2020-07-27,(02304) Heroes,784,522,412,1718
34057,2020-01-20,(10003) Ciudad Jardín,952,501,689,2142
34058,2020-06-21,(02000) Cabecera Autopista Norte,404,263,270,937
34059,2020-09-07,(10009) Museo Nacional,572,295,382,1249
34060,2020-04-05,(05107) Américas - Cr.53,74,69,57,200
34061,2020-10-09,(09115) Calle 34,713,466,674,1853
34062,2020-05-20,(03006) NIZA - CALLE 127,357,224,151,732
34063,2020-08-19,(03006) NIZA - CALLE 127,460,259,219,938
34064,2020-04-27,(07000) Portal Sur,765,101,136,1002
34065,2020-09-03,(06000) Portal Eldorado,946,622,548,2116
34066,2020-02-29,(09106) Nariño,1172,604,1076,2852
34067,2020-03-16,(12004) Carrera 22,562,353,362,1277
34068,2020-09-19,(09103) Olaya,959,456,641,2056
34069,2020-07-01,(02200) Alcalá,1917,1249,1094,4260
34070,2020-06-08,(07110) PALOQUEMAO,606,380,242,1228
34071,2020-04-06,(09103) Olaya,469,256,291,1016
34072,2020-05-27,(02303) Calle 85,601,427,268,1296
34073,2020-07-15,(06104) Gobernación,224,131,89,444
34074,2020-07-27,(06104) Gobernación,240,151,109,500
34075,2020-05-04,(07201) Guatoque -Veraguas,116,69,83,268
34076,2020-07-06,(06108) Concejo de Bogotá,165,75,81,321
34077,2020-08-31,(07105) MOVISTAR ARENA,258,135,152,545
34078,2020-09-15,(07107) U. NACIONAL,408,238,254,900
34079,2020-04-23,(07506) DESPENSA,248,155,131,534
34080,2020-06-14,(03002) SUBA - TV- 91,194,113,184,491
34081,2020-08-11,(10007) Las Nieves,675,403,351,1429
34082,2020-03-24,(06111) Universidades,0,152,450,602
34083,2020-05-16,(10004) Policarpa,132,74,119,325
34084,2020-05-12,(07109) CAD,509,311,217,1037
34085,2020-08-05,(09122) Calle 72,1022,682,690,2394
34086,2020-01-19,(09117) Calle 45,663,428,971,2062
34087,2020-02-28,(05101) Mandalay - Cr.73,1186,564,571,2321
34088,2020-09-03,(04000) Cabecera Calle 80 - intermunicipal,392,191,377,960
34089,2020-09-24,(02102) Calle 161,285,190,197,672
34090,2020-07-06,(12004) Carrera 22,314,141,147,602
34091,2020-06-18,(02502) Terminal,412,285,315,1012
34092,2020-05-31,(10009) Museo Nacional,89,49,86,224
34093,2020-07-19,(10009) Museo Nacional,62,56,62,180
34094,2020-07-14,(04105) Carrera 53,256,139,130,525
34095,2020-07-02,(07008) NQS - Calle 30 Sur,330,197,198,725
34096,2020-07-04,(09113) Calle 22,416,245,328,989
34097,2020-04-19,(10010) San Bernardo,188,98,127,413
34098,2020-04-22,(40001) Juan Pablo II,259,142,180,581
34099,2020-07-18,(14005) Las Aguas,125,74,148,347
34100,2020-05-28,(04000) Cabecera Calle 80 - intermunicipal,248,145,194,587
34101,2020-08-14,(07109) CAD,567,346,274,1187
34102,2020-07-12,(03001) LA CAMPIÑA,320,160,286,766
34103,2020-05-07,(06001) Modelia,304,197,186,687
34104,2020-06-18,(06001) Modelia,386,255,197,838
34105,2020-06-25,(09108) Hospital,82,41,62,185
34106,2020-04-10,(06103) CAN,153,117,56,326
34107,2020-06-06,(04000) Cabecera Calle 80 - intermunicipal,142,76,136,354
34108,2020-07-19,(07112) COMUNEROS,204,111,148,463
34109,2020-04-27,(07505) LEON XIII,610,148,496,1254
34110,2020-05-12,(09116) Avenida 39,241,182,145,568
34111,2020-07-04,(04106) Carrera 47,291,139,191,621
34112,2020-07-22,(05105) Pradera,604,328,252,1184
34113,2020-05-16,(14004) Museo del Oro,0,38,78,116
34114,2020-06-02,(14004) Museo del Oro,0,111,211,322
34115,2020-06-13,(02000) Cabecera Autopista Norte - intermunicipal,310,170,257,737
34116,2020-08-11,(10004) Policarpa,235,116,164,515
34117,2020-08-25,(06100) Av. Rojas,223,123,155,501
34118,2020-04-01,(03010) PUENTE LARGO,188,147,107,442
34119,2020-08-17,(04000) Cabecera Calle 80,275,185,285,745
34120,2020-08-05,(06000) Portal Eldorado,783,527,421,1731
34121,2020-06-26,(04001) Quirigua,449,275,293,1017
34122,2020-05-03,(07112) COMUNEROS,136,89,86,311
34123,2020-04-18,(09114) Calle 26,79,69,73,221
34124,2020-05-18,(07108) Av. El Dorado,108,72,55,235
34125,2020-04-25,(09117) Calle 45,349,214,166,729
34126,2020-08-11,(09121) Las Flores,609,377,420,1406
34127,2020-07-05,(06102) Salitre El Greco,102,49,57,208
34128,2020-05-25,(12004) Carrera 22,41,21,27,89
34129,2020-10-11,(09116) Avenida 39,76,88,149,313
34130,2020-10-04,(04107) Escuela Militar,41,29,66,136
34131,2020-07-31,(09106) Nariño,342,189,260,791
34132,2020-04-06,(09114) Calle 26,152,130,135,417
34133,2020-04-02,(12000) Puente Aranda,48,24,32,104
34134,2020-04-14,(07506) DESPENSA,215,120,135,470
34135,2020-03-26,(12004) Carrera 22,36,32,33,101
34136,2020-05-18,(04000) Cabecera Calle 80 - intermunicipal,231,125,199,555
34137,2020-08-06,(07006) General Santander - alimentacion,347,203,228,778
34138,2020-03-23,(10005) Bicentenario,25,16,17,58
34139,2020-10-11,(10005) Bicentenario,21,19,43,83
34140,2020-09-28,(09105) Río Fucha,0,90,177,267
34141,2020-10-10,(07108) Av. El Dorado,98,76,127,301
34142,2020-10-06,(07101) CASTELLANA,285,154,199,638
34143,2020-05-07,(07200) Tygua-San José,153,68,106,327
34144,2020-03-28,(07113) SANTA ISABEL,115,77,84,276
34145,2020-04-26,(03000) Portal Suba,205,116,153,474
34146,2020-10-12,(07506) DESPENSA,178,89,162,429
34147,2020-10-05,(50002) Corral Calle 40 Sur,34,22,46,102
34148,2020-06-07,(06109) Centro Memoria,71,49,55,175
34149,2020-04-20,(03007) HUMEDAL CORDOBA,72,53,42,167
34150,2020-09-16,(50006) Corral Carrera 77,3,4,8,15
34151,2020-06-07,(12003) Ricaurte,49,43,41,133
34152,2020-04-05,(14005) Las Aguas,0,11,22,33
34153,2020-05-18,(10005) Bicentenario,95,51,63,209
34154,2020-10-02,(03014) SAN MARTIN,0,17,72,89
34155,2020-05-14,(50006) Corral Carrera 77,3,2,8,13
34156,2020-06-07,(50006) Corral Carrera 77,4,0,1,5
34157,2020-08-30,(50006) Corral Carrera 77,2,1,3,6
34158,2020-04-28,(03004) GRATAMIRA,21,12,13,46
34159,2020-03-23,(50002) Corral Calle 40 Sur,2,5,7,14
34160,2020-05-23,(50006) Corral Carrera 77,2,0,5,7
34161,2020-07-21,(07005) ALQUERIA,460,281,275,1016
34162,2020-04-30,(07504) TERREROS,3028,1868,1625,6521
34163,2020-02-28,(05000) Portal Américas - alimentacion,35505,21444,23529,80478
34164,2020-02-15,(03000) Portal Suba - alimentacion,17038,8557,12228,37823
34165,2020-01-07,(03002) SUBA - TV- 91,2878,1693,1820,6391
34166,2020-07-22,(07503) SAN MATEO,10432,5935,4992,21359
34167,2020-03-03,(02200) Alcalá,14555,9223,6869,30647
34168,2020-01-30,(05000) Portal Américas,14663,8321,7506,30490
34169,2020-01-10,(07003) SEVILLANA,1508,770,957,3235
34170,2020-01-27,(09003) Socorro,1576,907,975,3458
34171,2020-01-30,(09003) Socorro,1625,912,976,3513
34172,2020-07-05,(10000) Portal 20 de Julio - alimentacion,1510,620,1144,3274
34173,2020-01-10,(07112) COMUNEROS,2700,1570,1897,6167
34174,2020-09-28,(10001) Country Sur,1454,652,981,3087
34175,2020-07-11,(07503) SAN MATEO,9675,5131,5102,19908
34176,2020-01-22,(05100) Banderas P. Central - alimentacion,13685,7712,7775,29172
34177,2020-03-19,(05100) Banderas P. Central - alimentacion,6386,3324,4431,14141
34178,2020-01-31,(10003) Ciudad Jardín,1012,498,694,2204
34179,2020-01-30,(07113) SANTA ISABEL,2049,1226,1383,4658
34180,2020-01-13,(09104) Restrepo,4317,2786,3568,10671
34181,2020-05-07,(04101) Minuto de Dios,197,117,140,454
34182,2020-09-28,(04100) Carrera 77,1396,821,1094,3311
34183,2020-05-05,(03000) Portal Suba - alimentacion,3974,2349,2148,8471
34184,2020-07-05,(02204) Pepe Sierra,212,169,190,571
34185,2020-02-08,(09110) Avenida Jimenez,3440,2414,2197,8051
34186,2020-02-18,(05002) Tintal,11450,6829,5902,24181
34187,2020-09-26,(05002) Tintal,2305,1112,1769,5186
34188,2020-01-28,(06106) Recinto Ferial,1565,883,801,3249
34189,2020-09-24,(05000) Portal Américas - alimentacion,12138,6328,7230,25696
34190,2020-01-27,(07102) NQS - CALLE 75,1463,953,829,3245
34191,2020-08-22,(09103) Olaya,802,396,460,1658
34192,2020-06-16,(14001) La Sabana,165,126,107,398
34193,2020-07-25,(14001) La Sabana,89,61,63,213
34194,2020-06-20,(07000) Portal Sur - alimentacion,6549,3490,3475,13514
34195,2020-09-16,(07106) EL CAMPIN,449,312,277,1038
34196,2020-05-12,(02000) Cabecera Autopista Norte,916,598,566,2080
34197,2020-01-20,(07107) U. NACIONAL,2221,1395,1361,4977
34198,2020-02-28,(07107) U. NACIONAL,1886,1302,1306,4494
34199,2020-03-01,(09113) Calle 22,676,310,596,1582
34200,2020-02-04,(09004) Santa Lucía,7689,4326,4357,16372
34201,2020-10-06,(08000) Portal Tunal - alimentacion,6946,3756,4961,15663
34202,2020-09-09,(04000) Cabecera Calle 80,1135,729,1040,2904
34203,2020-02-19,(05002) Tintal,11122,6851,6260,24233
34204,2020-07-26,(09114) Calle 26,62,36,42,140
34205,2020-02-03,(04003) Avenida Ciudad de Cali,5617,3333,3458,12408
34206,2020-05-19,(04100) Carrera 77,1010,564,615,2189
34207,2020-08-30,(04100) Carrera 77,403,207,392,1002
34208,2020-05-02,(09000) Cabecera Usme - alimentacion,3563,1914,2004,7481
34209,2020-01-09,(04001) Quirigua,1408,772,974,3154
34210,2020-03-14,(04001) Quirigua,997,508,824,2329
34211,2020-02-10,(12001) Carrera 43,1781,1053,1050,3884
34212,2020-01-30,(06101) El Tiempo,2894,1627,1340,5861
34213,2020-01-27,(09101) Quiroga,1439,901,1154,3494
34214,2020-06-26,(02000) Cabecera Autopista Norte - alimentacion,5163,2842,2907,10912
34215,2020-01-18,(06111) Universidades,1206,715,1392,3313
34216,2020-03-05,(04001) Quirigua,2103,1272,1255,4630
34217,2020-04-05,(07000) Portal Sur - alimentacion,1527,749,631,2907
34218,2020-09-13,(07000) Portal Sur,505,268,526,1299
34219,2020-10-11,(09004) Santa Lucía,1054,377,849,2280
34220,2020-03-09,(06102) Salitre El Greco,621,136,141,898
34221,2020-02-02,(40003) Mirador del Paraiso,1985,926,1471,4382
34222,2020-02-13,(04003) Avenida Ciudad de Cali,5769,3390,3612,12771
34223,2020-09-16,(09116) Avenida 39,408,240,302,950
34224,2020-07-23,(02101) Toberín,1150,740,772,2662
34225,2020-08-28,(09120) Calle 63,1145,752,730,2627
34226,2020-10-09,(09120) Calle 63,1277,931,1138,3346
34227,2020-03-08,(08001) Parque el Tunal,375,163,335,873
34228,2020-03-13,(02105) Calle 142,495,968,789,2252
34229,2020-02-12,(05103) Marsella,3377,1979,1509,6865
34230,2020-04-01,(02000) Cabecera Autopista Norte,491,359,310,1160
34231,2020-02-08,(07001) PERDOMO,2686,1241,2038,5965
34232,2020-02-07,(06001) Modelia,2575,1525,1400,5500
34233,2020-01-09,(10009) Museo Nacional,2941,1591,1509,6041
34234,2020-02-23,(09107) Hortúa,514,328,578,1420
34235,2020-08-09,(40003) Mirador del Paraiso,501,290,363,1154
34236,2020-09-26,(07005) ALQUERIA,520,266,402,1188
34237,2020-05-24,(10006) San Victorino,87,61,75,223
34238,2020-08-27,(06106) Recinto Ferial,250,141,131,522
34239,2020-08-30,(02000) Cabecera Autopista Norte - alimentacion,1959,869,1435,4263
34240,2020-09-12,(03012) SUBA - CALLE 95,238,162,211,611
34241,2020-02-03,(05107) Américas - Cr.53,2657,1540,1486,5683
34242,2020-02-07,(07104) Simon Bolivar,2499,1480,1379,5358
34243,2020-02-14,(07104) Simon Bolivar,2430,1497,1259,5186
34244,2020-06-05,(05005) Transversal 86,296,166,171,633
34245,2020-08-22,(02202) Calle 127,757,592,513,1862
34246,2020-09-21,(02202) Calle 127,1006,738,661,2405
34247,2020-08-22,(05105) Pradera,413,274,252,939
34248,2020-09-03,(05105) Pradera,643,396,327,1366
34249,2020-07-11,(04003) Avenida Ciudad de Cali,769,425,629,1823
34250,2020-03-04,(09121) Las Flores,3384,2151,2114,7649
34251,2020-10-12,(07113) SANTA ISABEL,138,90,197,425
34252,2020-08-18,(14004) Museo del Oro,200,141,217,558
34253,2020-02-15,(03011) SUBA - CALLE 100,1188,737,1116,3041
34254,2020-03-26,(02000) Cabecera Autopista Norte - alimentacion,2465,1308,1012,4785
34255,2020-08-01,(07000) Portal Sur,1245,663,874,2782
34256,2020-03-21,(02101) Toberín,376,295,235,906
34257,2020-06-08,(10010) San Bernardo,594,315,373,1282
34258,2020-05-29,(09100) Calle 40 Sur,1517,873,930,3320
34259,2020-06-04,(10005) Bicentenario - alimentacion,201,102,138,441
34260,2020-04-27,(05000) Portal Américas,1021,245,334,1600
34261,2020-05-15,(09001) Molinos,1970,1078,1278,4326
34262,2020-07-01,(09106) Nariño,428,247,309,984
34263,2020-06-25,(09118) Marly,1529,967,780,3276
34264,2020-02-20,(09109) Tercer Milenio,1402,888,793,3083
34265,2020-04-28,(09001) Molinos,1487,804,998,3289
34266,2020-08-10,(02304) Heroes,817,575,444,1836
34267,2020-01-02,(40001) Juan Pablo II,800,434,522,1756
34268,2020-03-25,(05001) Patio Bonito,878,499,519,1896
34269,2020-03-21,(02000) Cabecera Autopista Norte,360,218,211,789
34270,2020-08-09,(05000) Portal Américas - alimentacion,3144,1441,1715,6300
34271,2020-04-20,(06000) Portal Eldorado,810,556,342,1708
34272,2020-03-10,(12003) Ricaurte,790,50,151,991
34273,2020-05-29,(07106) EL CAMPIN,300,198,194,692
34274,2020-08-28,(03010) PUENTE LARGO,355,218,178,751
34275,2020-10-03,(03010) PUENTE LARGO,248,165,274,687
34276,2020-09-25,(05002) Tintal,2993,1722,2004,6719
34277,2020-08-12,(10010) San Bernardo,586,309,392,1287
34278,2020-08-19,(10010) San Bernardo,578,308,386,1272
34279,2020-05-06,(07200) Tygua-San José,142,67,99,308
34280,2020-09-15,(07106) EL CAMPIN,424,279,273,976
34281,2020-09-25,(06103) CAN,399,259,237,895
34282,2020-01-06,(07003) SEVILLANA,275,132,278,685
34283,2020-03-13,(05001) Patio Bonito,208,1368,1027,2603
34284,2020-06-22,(09116) Avenida 39,94,77,88,259
34285,2020-06-05,(07007) NQS - Calle 38A Sur,361,218,228,807
34286,2020-08-11,(07007) NQS - Calle 38A Sur,359,264,224,847
34287,2020-09-28,(05107) Américas - Cr.53,498,307,350,1155
34288,2020-05-09,(10002) Av. Primero de Mayo,1046,567,637,2250
34289,2020-10-08,(10010) San Bernardo,678,328,565,1571
34290,2020-01-26,(04000) Cabecera Calle 80 - intermunicipal,282,160,408,850
34291,2020-08-06,(04000) Cabecera Calle 80 - intermunicipal,282,156,247,685
34292,2020-01-20,(09122) Calle 72,6088,3947,3611,13646
34293,2020-03-27,(04103) Las Ferias,171,112,89,372
34294,2020-02-03,(07105) MOVISTAR ARENA,1342,825,762,2929
34295,2020-03-09,(10005) Bicentenario,389,51,82,522
34296,2020-06-18,(40002) Manitas,402,261,282,945
34297,2020-02-16,(07003) SEVILLANA,410,191,389,990
34298,2020-03-26,(05100) Banderas P. Central - alimentacion,1537,685,702,2924
34299,2020-08-15,(08000) Portal Tunal,657,279,267,1203
34300,2020-03-19,(05102) Av. Américas - Av. Boyacá,695,337,444,1476
34301,2020-07-21,(05107) Américas - Cr.53,405,223,238,866
34302,2020-07-17,(05105) Pradera,601,352,255,1208
34303,2020-04-02,(02104) Calle 146,323,239,206,768
34304,2020-01-09,(12004) Carrera 22,488,326,332,1146
34305,2020-10-05,(09122) Calle 72,1347,929,1102,3378
34306,2020-01-23,(05101) Mandalay - Cr.73,1048,568,493,2109
34307,2020-04-02,(04100) Carrera 77,576,310,389,1275
34308,2020-09-08,(06102) Salitre El Greco,227,136,135,498
34309,2020-07-04,(06104) Gobernación,140,101,100,341
34310,2020-05-15,(07105) MOVISTAR ARENA,213,134,129,476
34311,2020-06-27,(07201) Guatoque -Veraguas,152,113,129,394
34312,2020-02-09,(09123) Calle 76,538,509,849,1896
34313,2020-08-06,(07105) MOVISTAR ARENA,187,110,129,426
34314,2020-06-14,(06109) Centro Memoria,60,40,55,155
34315,2020-07-01,(10006) San Victorino,787,356,358,1501
34316,2020-06-19,(04001) Quirigua,457,286,258,1001
34317,2020-07-24,(04103) Las Ferias,316,159,147,622
34318,2020-04-21,(07005) ALQUERIA,314,188,189,691
34319,2020-03-24,(04100) Carrera 77,1010,631,710,2351
34320,2020-09-30,(05102) Av. Américas - Av. Boyacá,281,183,245,709
34321,2020-04-12,(12003) Ricaurte,36,25,26,87
34322,2020-06-11,(08002) Biblioteca,317,167,161,645
34323,2020-07-22,(03010) PUENTE LARGO,324,186,182,692
34324,2020-09-14,(09122) Calle 72,1248,829,930,3007
34325,2020-03-27,(12000) Puente Aranda,45,34,29,108
34326,2020-07-20,(12000) Puente Aranda,12,12,15,39
34327,2020-07-09,(07109) CAD,646,413,305,1364
34328,2020-03-16,(05101) Mandalay - Cr.73,686,383,325,1394
34329,2020-09-19,(02102) Calle 161,210,121,196,527
34330,2020-06-08,(06106) Recinto Ferial,259,142,109,510
34331,2020-06-06,(07102) NQS - CALLE 75,247,186,196,629
34332,2020-07-11,(40001) Juan Pablo II,530,272,365,1167
34333,2020-10-11,(07005) ALQUERIA,207,103,237,547
34334,2020-07-24,(06106) Recinto Ferial,225,116,105,446
34335,2020-07-08,(07108) Av. El Dorado,157,102,103,362
34336,2020-07-13,(07108) Av. El Dorado,154,85,75,314
34337,2020-08-15,(07108) Av. El Dorado,83,67,90,240
34338,2020-08-06,(07506) DESPENSA,406,245,221,872
34339,2020-05-20,(06108) Concejo de Bogotá,117,63,59,239
34340,2020-04-07,(06100) Av. Rojas,99,79,87,265
34341,2020-07-27,(04000) Cabecera Calle 80 - intermunicipal,325,173,297,795
34342,2020-08-20,(09108) Hospital,71,42,51,164
34343,2020-05-12,(03009) Av. Suba- Calle 116,400,262,167,829
34344,2020-10-05,(09105) Río Fucha,0,83,178,261
34345,2020-03-26,(07010) Bosa,246,148,244,638
34346,2020-05-04,(02502) Terminal,243,171,166,580
34347,2020-04-10,(02304) Heroes,156,128,93,377
34348,2020-06-28,(03009) Av. Suba- Calle 116,140,92,83,315
34349,2020-08-31,(07200) Tygua-San José,220,125,165,510
34350,2020-03-20,(07108) Av. El Dorado,68,45,39,152
34351,2020-10-10,(07006) General Santander - alimentacion,289,162,311,762
34352,2020-04-04,(09116) Avenida 39,115,80,88,283
34353,2020-08-09,(03006) NIZA - CALLE 127,126,73,74,273
34354,2020-09-20,(05005) Transversal 86,134,40,156,330
34355,2020-07-29,(05101) Mandalay - Cr.73,117,69,65,251
34356,2020-07-20,(05107) Américas - Cr.53,104,86,81,271
34357,2020-06-16,(14004) Museo del Oro,211,160,212,583
34358,2020-06-04,(07008) NQS - Calle 30 Sur,254,131,136,521
34359,2020-06-11,(07008) NQS - Calle 30 Sur,281,135,170,586
34360,2020-05-16,(09108) Hospital,39,24,32,95
34361,2020-09-24,(07101) CASTELLANA,267,157,176,600
34362,2020-10-12,(04104) Avenida 68,223,121,238,582
34363,2020-03-30,(03005) SUBA - AV. BOYACA,208,148,138,494
34364,2020-09-21,(09106) Nariño,384,202,256,842
34365,2020-07-07,(09116) Avenida 39,389,238,295,922
34366,2020-06-10,(04103) Las Ferias,330,173,154,657
34367,2020-03-22,(02201) Prado,162,118,92,372
34368,2020-03-28,(07007) NQS - Calle 38A Sur,114,70,58,242
34369,2020-08-06,(06103) CAN,313,198,151,662
34370,2020-04-16,(04106) Carrera 47,168,100,78,346
34371,2020-04-29,(02103) Mazurén,99,76,81,256
34372,2020-09-02,(03002) SUBA - TV- 91,850,537,563,1950
34373,2020-02-12,(50006) Corral Carrera 77,30,21,39,90
34374,2020-04-19,(02000) Cabecera Autopista Norte - intermunicipal,27,32,41,100
34375,2020-08-28,(14005) Las Aguas,201,134,200,535
34376,2020-07-12,(08002) Biblioteca,128,58,81,267
34377,2020-08-08,(05103) Marsella,250,123,181,554
34378,2020-08-23,(03012) SUBA - CALLE 95,65,42,65,172
34379,2020-05-07,(06104) Gobernación,183,111,90,384
34380,2020-08-02,(06104) Gobernación,47,36,41,124
34381,2020-04-21,(12002) CDS - Carrera 32,195,132,51,378
34382,2020-09-28,(10005) Bicentenario,116,80,93,289
34383,2020-08-01,(06106) Recinto Ferial,172,116,100,388
34384,2020-05-30,(06107) Ciudad Universitaria,115,83,94,292
34385,2020-05-29,(50002) Corral Calle 40 Sur,19,8,16,43
34386,2020-04-11,(09106) Nariño,121,68,71,260
34387,2020-04-19,(07008) NQS - Calle 30 Sur,58,35,30,123
34388,2020-08-17,(08002) Biblioteca,133,61,66,260
34389,2020-05-10,(06106) Recinto Ferial,53,30,30,113
34390,2020-05-08,(05101) Mandalay - Cr.73,81,45,42,168
34391,2020-05-27,(50006) Corral Carrera 77,4,2,2,8
34392,2020-10-13,(10000) Portal 20 de Julio,0,0,1,1
34393,2020-02-28,(03000) Portal Suba - alimentacion,29870,16543,17007,63420
34394,2020-09-21,(05000) Portal Américas,3177,1330,1807,6314
34395,2020-09-23,(05000) Portal Américas,3962,2293,2688,8943
34396,2020-02-07,(07003) SEVILLANA,2178,1123,1228,4529
34397,2020-01-06,(06104) Gobernación,83,83,130,296
34398,2020-01-09,(06104) Gobernación,911,563,496,1970
34399,2020-07-24,(09000) Cabecera Usme - alimentacion,6267,3378,3586,13231
34400,2020-01-30,(04002) Carrera 90,3617,2166,1963,7746
34401,2020-02-10,(04002) Carrera 90,3808,2298,2122,8228
34402,2020-06-04,(10000) Portal 20 de Julio - alimentacion,3938,1826,2157,7921
34403,2020-04-14,(05000) Portal Américas - alimentacion,6239,3222,2564,12025
34404,2020-04-19,(05000) Portal Américas - alimentacion,2328,1293,955,4576
34405,2020-08-29,(04000) Cabecera Calle 80 - alimentacion,3158,1619,2381,7158
34406,2020-10-03,(05001) Patio Bonito,1985,882,1387,4254
34407,2020-06-27,(04103) Las Ferias,303,183,149,635
34408,2020-10-03,(04103) Las Ferias,299,165,251,715
34409,2020-01-20,(05005) Transversal 86,2369,1359,1213,4941
34410,2020-08-06,(07112) COMUNEROS,747,410,440,1597
34411,2020-02-06,(07002) MADELENA,4944,2810,2621,10375
34412,2020-03-11,(09100) Calle 40 Sur,7032,4060,3932,15024
34413,2020-02-01,(09000) Cabecera Usme,3796,1895,3317,9008
34414,2020-03-09,(06000) Portal Eldorado - alimentacion,2002,3885,2695,8582
34415,2020-01-04,(07001) PERDOMO,1439,664,1073,3176
34416,2020-01-19,(09000) Cabecera Usme,1246,588,1369,3203
34417,2020-07-15,(09104) Restrepo,1171,693,754,2618
34418,2020-07-02,(07505) LEON XIII,2902,1516,1293,5711
34419,2020-03-04,(06002) Normandía,2614,1590,1359,5563
34420,2020-02-10,(05002) Tintal,11370,6916,6194,24480
34421,2020-07-01,(09104) Restrepo,1597,995,1129,3721
34422,2020-03-14,(02200) Alcalá,5550,2962,3812,12324
34423,2020-01-16,(02102) Calle 161,1639,937,1028,3604
34424,2020-03-02,(07102) NQS - CALLE 75,1519,1004,914,3437
34425,2020-07-07,(07102) NQS - CALLE 75,464,283,258,1005
34426,2020-07-22,(07102) NQS - CALLE 75,434,266,200,900
34427,2020-02-07,(03013) RIO NEGRO,1265,762,941,2968
34428,2020-01-31,(02302) Virrey,3529,2520,1764,7813
34429,2020-03-10,(04100) Carrera 77,486,1839,1258,3583
34430,2020-03-15,(10000) Portal 20 de Julio - alimentacion,3021,1065,2359,6445
34431,2020-06-10,(07000) Portal Sur - alimentacion,7433,4296,3334,15063
34432,2020-10-05,(07000) Portal Sur - alimentacion,9258,4954,5713,19925
34433,2020-08-05,(09103) Olaya,939,505,523,1967
34434,2020-10-12,(09103) Olaya,418,190,419,1027
34435,2020-08-31,(14001) La Sabana,162,93,97,352
34436,2020-09-23,(14001) La Sabana,179,99,130,408
34437,2020-08-25,(07111) NQS - RICAURTE,1126,673,410,2209
34438,2020-09-18,(07111) NQS - RICAURTE,1222,768,655,2645
34439,2020-08-17,(02000) Cabecera Autopista Norte - alimentacion,1639,852,1058,3549
34440,2020-02-15,(07112) COMUNEROS,2403,1312,1866,5581
34441,2020-02-07,(07107) U. NACIONAL,2307,1512,1502,5321
34442,2020-08-15,(04000) Cabecera Calle 80 - alimentacion,3001,1489,2263,6753
34443,2020-02-22,(02104) Calle 146,3418,1580,2874,7872
34444,2020-07-16,(50003) Corral Molinos,1081,584,835,2500
34445,2020-02-05,(04000) Cabecera Calle 80,7863,4763,5073,17699
34446,2020-07-28,(07010) Bosa,621,291,375,1287
34447,2020-09-01,(09123) Calle 76,1091,694,661,2446
34448,2020-05-13,(08000) Portal Tunal - alimentacion,5008,2705,2547,10260
34449,2020-09-30,(09111) Calle 19,789,492,565,1846
34450,2020-07-30,(40003) Mirador del Paraiso,1613,1010,993,3616
34451,2020-06-17,(12001) Carrera 43,462,283,276,1021
34452,2020-10-07,(10002) Av. Primero de Mayo,2527,1250,1915,5692
34453,2020-07-10,(07113) SANTA ISABEL,418,251,309,978
34454,2020-05-27,(09107) Hortúa,547,363,312,1222
34455,2020-03-13,(07503) SAN MATEO,1324,8197,5269,14790
34456,2020-02-20,(02302) Virrey,3800,2571,1730,8101
34457,2020-09-11,(03000) Portal Suba,1422,847,1024,3293
34458,2020-08-07,(09000) Cabecera Usme - alimentacion,3582,1745,2001,7328
34459,2020-07-27,(09101) Quiroga,421,252,358,1031
34460,2020-01-22,(06100) Av. Rojas,2360,1382,1200,4942
34461,2020-03-06,(06100) Av. Rojas,2593,1433,1394,5420
34462,2020-08-27,(02000) Cabecera Autopista Norte - alimentacion,4529,2442,2658,9629
34463,2020-01-11,(04106) Carrera 47,713,371,564,1648
34464,2020-07-21,(10000) Portal 20 de Julio,1699,882,952,3533
34465,2020-07-01,(09004) Santa Lucía,2672,1422,1425,5519
34466,2020-02-11,(09109) Tercer Milenio,1524,894,913,3331
34467,2020-04-30,(07503) SAN MATEO,6337,3955,3036,13328
34468,2020-08-22,(07503) SAN MATEO,8284,4387,4256,16927
34469,2020-02-29,(06108) Concejo de Bogotá,323,213,349,885
34470,2020-08-21,(06108) Concejo de Bogotá,123,55,67,245
34471,2020-01-24,(14004) Museo del Oro,2971,1971,1941,6883
34472,2020-05-22,(14004) Museo del Oro,0,91,203,294
34473,2020-04-27,(02000) Cabecera Autopista Norte,283,179,102,564
34474,2020-01-15,(07001) PERDOMO,4093,2356,2361,8810
34475,2020-07-05,(09000) Cabecera Usme,485,253,404,1142
34476,2020-04-16,(09107) Hortúa,422,269,243,934
34477,2020-03-09,(09123) Calle 76,3054,247,741,4042
34478,2020-04-29,(05002) Tintal,1487,779,724,2990
34479,2020-02-01,(02103) Mazurén,1001,490,1128,2619
34480,2020-04-17,(10000) Portal 20 de Julio,1264,644,645,2553
34481,2020-10-07,(02300) Calle 100,1328,966,1048,3342
34482,2020-05-19,(03012) SUBA - CALLE 95,278,176,153,607
34483,2020-08-24,(03012) SUBA - CALLE 95,290,179,162,631
34484,2020-01-19,(05100) Banderas P. Central,801,348,878,2027
34485,2020-05-04,(07104) Simon Bolivar,295,199,144,638
34486,2020-02-09,(05005) Transversal 86,473,164,419,1056
34487,2020-03-07,(05005) Transversal 86,1413,554,977,2944
34488,2020-06-16,(05001) Patio Bonito,1834,1017,1070,3921
34489,2020-07-24,(10008) San Diego,197,123,133,453
34490,2020-03-18,(07009) SENA,1937,1077,982,3996
34491,2020-07-07,(02205) Calle 106,390,241,250,881
34492,2020-05-21,(03000) Portal Suba - alimentacion,4811,2856,2493,10160
34493,2020-01-10,(07101) CASTELLANA,669,425,456,1550
34494,2020-01-14,(07101) CASTELLANA,850,532,541,1923
34495,2020-07-13,(07101) CASTELLANA,201,109,105,415
34496,2020-09-20,(07106) EL CAMPIN,139,107,161,407
34497,2020-08-14,(04104) Avenida 68,535,279,310,1124
34498,2020-08-08,(03007) HUMEDAL CORDOBA,74,55,53,182
34499,2020-07-24,(10006) San Victorino,399,223,238,860
34500,2020-02-21,(07108) Av. El Dorado,904,580,594,2078
34501,2020-03-12,(07010) Bosa,53,516,456,1025
34502,2020-01-08,(04103) Las Ferias,1101,604,742,2447
34503,2020-01-02,(10010) San Bernardo,884,492,867,2243
34504,2020-03-09,(02105) Calle 142,627,1709,1010,3346
34505,2020-06-07,(09100) Calle 40 Sur,421,234,369,1024
34506,2020-05-07,(10005) Bicentenario - alimentacion,163,76,145,384
34507,2020-02-27,(07109) CAD,2821,1742,1488,6051
34508,2020-05-06,(02303) Calle 85,442,292,233,967
34509,2020-05-29,(09000) Cabecera Usme,1473,947,999,3419
34510,2020-08-10,(04104) Avenida 68,494,243,327,1064
34511,2020-01-08,(09109) Tercer Milenio,1041,584,681,2306
34512,2020-03-07,(09100) Calle 40 Sur,4595,2127,3406,10128
34513,2020-05-05,(10010) San Bernardo,494,260,306,1060
34514,2020-08-22,(09117) Calle 45,468,303,338,1109
34515,2020-04-02,(40003) Mirador del Paraiso,773,436,537,1746
34516,2020-09-23,(02104) Calle 146,968,647,739,2354
34517,2020-05-14,(04100) Carrera 77,958,505,563,2026
34518,2020-10-11,(02205) Calle 106,62,74,136,272
34519,2020-02-17,(07101) CASTELLANA,1003,591,567,2161
34520,2020-05-19,(02105) Calle 142,667,417,348,1432
34521,2020-04-15,(09120) Calle 63,558,405,356,1319
34522,2020-07-20,(06100) Av. Rojas,43,20,35,98
34523,2020-08-01,(06000) Portal Eldorado,577,380,395,1352
34524,2020-07-06,(02302) Virrey,718,480,383,1581
34525,2020-02-16,(06001) Modelia,299,187,380,866
34526,2020-10-06,(06103) CAN,414,278,232,924
34527,2020-07-31,(09109) Tercer Milenio,334,184,233,751
34528,2020-04-09,(09123) Calle 76,180,160,89,429
34529,2020-07-03,(02103) Mazurén,218,130,191,539
34530,2020-08-03,(07103) AV. CHILE,617,425,353,1395
34531,2020-10-03,(10005) Bicentenario,72,62,116,250
34532,2020-03-01,(02103) Mazurén,317,158,468,943
34533,2020-07-04,(07003) SEVILLANA,350,171,220,741
34534,2020-09-08,(04105) Carrera 53,319,161,170,650
34535,2020-09-15,(02102) Calle 161,277,161,197,635
34536,2020-06-25,(10008) San Diego,315,169,181,665
34537,2020-09-12,(10008) San Diego,138,153,226,517
34538,2020-03-29,(09120) Calle 63,215,147,122,484
34539,2020-07-12,(10010) San Bernardo,261,122,257,640
34540,2020-06-06,(05105) Pradera,382,260,180,822
34541,2020-03-20,(12007) Zona Industrial,231,157,113,501
34542,2020-06-13,(05100) Banderas P. Central,395,209,381,985
34543,2020-03-27,(09004) Santa Lucía,1048,526,517,2091
34544,2020-07-11,(03006) NIZA - CALLE 127,393,229,222,844
34545,2020-06-28,(07110) PALOQUEMAO,139,98,106,343
34546,2020-06-30,(07110) PALOQUEMAO,681,417,289,1387
34547,2020-10-04,(07110) PALOQUEMAO,179,153,176,508
34548,2020-05-05,(07002) MADELENA,449,263,296,1008
34549,2020-09-23,(02105) Calle 142,949,593,718,2260
34550,2020-08-09,(03012) SUBA - CALLE 95,72,35,54,161
34551,2020-02-24,(12002) CDS - Carrera 32,661,373,338,1372
34552,2020-09-27,(09100) Calle 40 Sur,667,326,679,1672
34553,2020-05-16,(09114) Calle 26,109,92,137,338
34554,2020-07-16,(10001) Country Sur,843,421,529,1793
34555,2020-06-11,(02200) Alcalá,1712,1206,868,3786
34556,2020-09-03,(02200) Alcalá,2014,1315,1210,4539
34557,2020-04-09,(06109) Centro Memoria,53,42,44,139
34558,2020-10-10,(07004) VENECIA,946,489,803,2238
34559,2020-10-02,(05103) Marsella,584,311,372,1267
34560,2020-08-01,(06107) Ciudad Universitaria,107,82,72,261
34561,2020-07-30,(03011) SUBA - CALLE 100,523,247,230,1000
34562,2020-10-05,(03011) SUBA - CALLE 100,683,309,386,1378
34563,2020-08-06,(12007) Zona Industrial,210,142,129,481
34564,2020-05-28,(10007) Las Nieves,504,294,258,1056
34565,2020-10-09,(40002) Manitas,442,258,385,1085
34566,2020-05-15,(08002) Biblioteca,241,135,127,503
34567,2020-08-15,(03007) HUMEDAL CORDOBA,91,77,73,241
34568,2020-04-05,(07001) PERDOMO,139,73,89,301
34569,2020-10-11,(07002) MADELENA,310,113,338,761
34570,2020-03-06,(12004) Carrera 22,683,459,503,1645
34571,2020-08-08,(07102) NQS - CALLE 75,168,130,154,452
34572,2020-05-14,(09003) Socorro,430,224,270,924
34573,2020-03-12,(09105) Río Fucha,173,129,127,429
34574,2020-04-30,(02303) Calle 85,412,299,210,921
34575,2020-08-12,(09120) Calle 63,1087,663,674,2424
34576,2020-06-20,(06102) Salitre El Greco,198,128,107,433
34577,2020-09-22,(02102) Calle 161,298,176,218,692
34578,2020-04-08,(09115) Calle 34,319,244,245,808
34579,2020-07-28,(06106) Recinto Ferial,214,115,126,455
34580,2020-03-20,(02001) Centro Comercial Santa Fe,225,143,121,489
34581,2020-04-20,(02001) Centro Comercial Santa Fe,187,139,139,465
34582,2020-04-25,(02001) Centro Comercial Santa Fe,130,92,109,331
34583,2020-05-17,(09113) Calle 22,186,93,169,448
34584,2020-03-24,(09100) Calle 40 Sur,1380,719,1054,3153
34585,2020-08-17,(07108) Av. El Dorado,44,23,41,108
34586,2020-06-23,(04000) Cabecera Calle 80 - intermunicipal,340,202,308,850
34587,2020-01-30,(09111) Calle 19,2289,1339,1459,5087
34588,2020-08-10,(03010) PUENTE LARGO,249,181,176,606
34589,2020-09-06,(10005) Bicentenario - alimentacion,50,42,111,203
34590,2020-05-22,(04003) Avenida Ciudad de Cali,860,528,551,1939
34591,2020-08-11,(09108) Hospital,69,35,50,154
34592,2020-05-06,(06101) El Tiempo,236,148,107,491
34593,2020-07-15,(09117) Calle 45,593,362,361,1316
34594,2020-04-25,(02103) Mazurén,75,34,49,158
34595,2020-06-29,(05105) Pradera,200,133,125,458
34596,2020-05-02,(07009) SENA,255,145,141,541
34597,2020-02-09,(03004) GRATAMIRA,67,28,63,158
34598,2020-06-15,(05100) Banderas P. Central,170,87,163,420
34599,2020-01-19,(07006) General Santander - alimentacion,267,162,383,812
34600,2020-09-27,(09110) Avenida Jimenez,494,421,458,1373
34601,2020-02-09,(07201) Guatoque -Veraguas,94,89,281,464
34602,2020-09-08,(04106) Carrera 47,351,185,214,750
34603,2020-08-07,(07506) DESPENSA,213,118,115,446
34604,2020-08-04,(05102) Av. Américas - Av. Boyacá,204,132,141,477
34605,2020-08-10,(10004) Policarpa,235,128,158,521
34606,2020-10-10,(03005) SUBA - AV. BOYACA,376,237,364,977
34607,2020-08-05,(07107) U. NACIONAL,300,179,180,659
34608,2020-08-19,(07107) U. NACIONAL,310,182,184,676
34609,2020-04-13,(06101) El Tiempo,249,175,92,516
34610,2020-05-06,(04003) Avenida Ciudad de Cali,671,428,389,1488
34611,2020-05-07,(04001) Quirigua,278,164,161,603
34612,2020-09-12,(07003) SEVILLANA,376,149,253,778
34613,2020-05-29,(03004) GRATAMIRA,25,13,17,55
34614,2020-07-19,(09121) Las Flores,153,88,125,366
34615,2020-02-23,(06103) CAN,262,207,322,791
34616,2020-06-06,(03002) SUBA - TV- 91,529,293,346,1168
34617,2020-05-23,(03004) GRATAMIRA,24,12,11,47
34618,2020-08-07,(02000) Cabecera Autopista Norte - intermunicipal,160,96,114,370
34619,2020-06-29,(07506) DESPENSA,193,82,92,367
34620,2020-07-31,(10003) Ciudad Jardín,188,90,147,425
34621,2020-04-18,(07008) NQS - Calle 30 Sur,118,66,72,256
34622,2020-04-05,(40001) Juan Pablo II,94,54,57,205
34623,2020-05-24,(03003) 21 ANGELES,77,27,55,159
34624,2020-08-09,(03004) GRATAMIRA,0,4,13,17
34625,2020-06-03,(03005) SUBA - AV. BOYACA,403,243,241,887
34626,2020-07-24,(03005) SUBA - AV. BOYACA,369,231,208,808
34627,2020-05-19,(10003) Ciudad Jardín,162,87,105,354
34628,2020-04-04,(09114) Calle 26,68,50,64,182
34629,2020-03-22,(10007) Las Nieves,38,37,40,115
34630,2020-04-18,(09003) Socorro,230,121,122,473
34631,2020-04-28,(05101) Mandalay - Cr.73,58,37,34,129
34632,2019-12-31,(12007) Zona Industrial,6,9,11,26
34633,2020-04-12,(09003) Socorro,113,59,69,241
34634,2020-05-24,(12007) Zona Industrial,35,31,28,94
34635,2020-08-09,(12003) Ricaurte,40,47,49,136
34636,2020-09-06,(14001) La Sabana,48,36,64,148
34637,2020-04-12,(06105) Quinta Paredes,22,20,14,56
34638,2020-10-04,(06108) Concejo de Bogotá,36,20,50,106
34639,2020-04-26,(03005) SUBA - AV. BOYACA,71,48,42,161
34640,2020-10-11,(07101) CASTELLANA,34,23,63,120
34641,2020-08-07,(06106) Recinto Ferial,75,50,53,178
34642,2020-04-09,(06106) Recinto Ferial,45,38,8,91
34643,2020-10-12,(12000) Puente Aranda,7,9,25,41
34644,2020-05-11,(03004) GRATAMIRA,27,23,15,65
34645,2020-04-15,(03004) GRATAMIRA,18,10,14,42
34646,2020-02-22,(04000) Cabecera Calle 80 - alimentacion,13254,6044,10494,29792
34647,2020-07-24,(04000) Cabecera Calle 80 - alimentacion,3613,1960,2184,7757
34648,2020-07-29,(10000) Portal 20 de Julio - alimentacion,4021,1817,2227,8065
34649,2020-02-19,(09119) Calle 57,3994,2349,2134,8477
34650,2020-02-24,(07505) LEON XIII,8769,5016,3667,17452
34651,2020-03-29,(07503) SAN MATEO,2440,1238,1085,4763
34652,2020-01-22,(06000) Portal Eldorado - alimentacion,16532,8596,8835,33963
34653,2020-05-27,(05000) Portal Américas,2159,1485,1615,5259
34654,2020-01-30,(06104) Gobernación,1354,789,647,2790
34655,2020-02-12,(03010) PUENTE LARGO,2233,1473,1286,4992
34656,2020-02-04,(09003) Socorro,1727,969,1068,3764
34657,2020-02-04,(10000) Portal 20 de Julio - alimentacion,10994,5696,7759,24449
34658,2020-01-16,(06107) Ciudad Universitaria,1080,636,773,2489
34659,2020-07-02,(06107) Ciudad Universitaria,157,126,132,415
34660,2020-02-10,(08000) Portal Tunal - alimentacion,25143,14054,12068,51265
34661,2020-01-09,(07010) Bosa,1746,1006,1205,3957
34662,2020-01-20,(07112) COMUNEROS,3417,2056,2266,7739
34663,2020-01-02,(08000) Portal Tunal - alimentacion,11723,6100,6993,24816
34664,2020-02-13,(09004) Santa Lucía,7783,4376,4168,16327
34665,2020-09-12,(10001) Country Sur,1059,397,770,2226
34666,2020-08-14,(09100) Calle 40 Sur,1688,948,1103,3739
34667,2020-05-21,(09115) Calle 34,574,379,311,1264
34668,2020-07-01,(09115) Calle 34,688,442,451,1581
34669,2020-08-23,(05100) Banderas P. Central - alimentacion,779,332,477,1588
34670,2020-02-28,(07009) SENA,3766,2112,2166,8044
34671,2020-02-17,(02101) Toberín,15304,9908,7539,32751
34672,2020-04-18,(07001) PERDOMO,267,170,183,620
34673,2020-05-26,(09109) Tercer Milenio,339,212,228,779
34674,2020-09-04,(04101) Minuto de Dios,370,213,336,919
34675,2020-06-27,(07505) LEON XIII,2288,1141,1045,4474
34676,2020-09-20,(07504) TERREROS,1983,842,1570,4395
34677,2020-03-19,(05001) Patio Bonito,4241,2141,2222,8604
34678,2020-02-27,(06106) Recinto Ferial,1478,889,787,3154
34679,2020-08-28,(05000) Portal Américas,3148,1882,2209,7239
34680,2020-07-16,(04100) Carrera 77,1140,621,725,2486
34681,2020-06-09,(07102) NQS - CALLE 75,429,270,202,901
34682,2020-01-15,(03013) RIO NEGRO,1110,674,767,2551
34683,2020-01-26,(09118) Marly,1303,803,1339,3445
34684,2020-04-24,(09110) Avenida Jimenez,375,295,337,1007
34685,2020-01-30,(03001) LA CAMPIÑA,6478,3859,4015,14352
34686,2020-01-22,(06001) Modelia,2276,1431,1238,4945
34687,2020-01-05,(09104) Restrepo,904,590,1131,2625
34688,2020-05-04,(07000) Portal Sur - alimentacion,5060,2744,2132,9936
34689,2020-07-10,(07000) Portal Sur - alimentacion,8562,4906,4436,17904
34690,2020-08-27,(07000) Portal Sur - alimentacion,7847,4463,4120,16430
34691,2020-07-08,(09103) Olaya,1095,647,609,2351
34692,2020-08-13,(09103) Olaya,1003,542,587,2132
34693,2020-05-04,(07111) NQS - RICAURTE,692,491,290,1473
34694,2020-08-28,(07106) EL CAMPIN,416,264,242,922
34695,2020-08-26,(08000) Portal Tunal - alimentacion,5870,3164,3273,12307
34696,2020-09-21,(02000) Cabecera Autopista Norte,1253,775,865,2893
34697,2020-03-11,(02104) Calle 146,8823,5570,4715,19108
34698,2020-02-29,(09113) Calle 22,1221,708,877,2806
34699,2020-06-20,(09113) Calle 22,403,239,351,993
34700,2020-03-05,(02001) Centro Comercial Santa Fe,4839,2919,2590,10348
34701,2020-03-31,(04105) Carrera 53,156,103,73,332
34702,2020-01-16,(06105) Quinta Paredes,835,494,441,1770
34703,2020-03-31,(50003) Corral Molinos,750,321,479,1550
34704,2020-01-26,(04000) Cabecera Calle 80,1186,619,1466,3271
34705,2020-08-25,(04000) Cabecera Calle 80,1027,632,781,2440
34706,2020-03-07,(40003) Mirador del Paraiso,3789,1939,2415,8143
34707,2020-09-03,(40003) Mirador del Paraiso,1783,1104,1143,4030
34708,2020-09-08,(40003) Mirador del Paraiso,1715,1066,1152,3933
34709,2020-07-01,(04000) Cabecera Calle 80,1191,722,902,2815
34710,2020-03-04,(12001) Carrera 43,1660,1011,1080,3751
34711,2020-08-13,(02000) Cabecera Autopista Norte - intermunicipal,509,332,333,1174
34712,2020-04-08,(08001) Parque el Tunal,220,116,141,477
34713,2020-04-16,(07000) Portal Sur - alimentacion,3992,2156,1630,7778
34714,2020-08-22,(02201) Prado,653,442,410,1505
34715,2020-09-25,(07004) VENECIA,1115,688,849,2652
34716,2020-10-09,(07004) VENECIA,1252,686,931,2869
34717,2020-10-10,(09000) Cabecera Usme - alimentacion,7829,3565,5870,17264
34718,2020-07-14,(09003) Socorro,397,201,233,831
34719,2020-06-18,(09116) Avenida 39,345,220,218,783
34720,2020-08-16,(07505) LEON XIII,747,342,440,1529
34721,2020-03-13,(07007) NQS - Calle 38A Sur,404,279,295,978
34722,2020-03-03,(07001) PERDOMO,4543,2822,2684,10049
34723,2020-01-06,(05002) Tintal,1612,817,1411,3840
34724,2020-09-28,(14004) Museo del Oro,128,272,561,961
34725,2020-07-11,(05000) Portal Américas,2083,1348,1791,5222
34726,2020-08-08,(06002) Normandía,178,122,149,449
34727,2020-08-15,(06102) Salitre El Greco,177,100,105,382
34728,2020-09-22,(09123) Calle 76,1141,790,761,2692
34729,2020-02-09,(02200) Alcalá,1996,1164,2015,5175
34730,2020-05-16,(03012) SUBA - CALLE 95,179,122,119,420
34731,2020-05-23,(10010) San Bernardo,431,195,288,914
34732,2020-04-22,(05105) Pradera,415,294,153,862
34733,2020-04-22,(08000) Portal Tunal,391,196,178,765
34734,2020-08-31,(04003) Avenida Ciudad de Cali,1000,576,736,2312
34735,2020-04-04,(09101) Quiroga,103,80,95,278
34736,2020-07-13,(06000) Portal Eldorado - alimentacion,3491,1759,1744,6994
34737,2020-07-20,(05001) Patio Bonito,495,273,299,1067
34738,2020-06-20,(07201) Guatoque -Veraguas,150,94,115,359
34739,2020-09-08,(06000) Portal Eldorado - alimentacion,3985,2027,2315,8327
34740,2020-05-10,(07010) Bosa,148,86,98,332
34741,2020-01-14,(07108) Av. El Dorado,748,487,511,1746
34742,2020-02-17,(07108) Av. El Dorado,999,619,627,2245
34743,2020-01-01,(07000) Portal Sur,479,239,683,1401
34744,2020-01-07,(04102) Avenida Boyaca,1814,1086,1123,4023
34745,2020-01-25,(10005) Bicentenario - alimentacion,426,199,415,1040
34746,2020-01-22,(04107) Escuela Militar,631,374,432,1437
34747,2020-05-29,(04107) Escuela Militar,120,91,56,267
34748,2020-07-28,(04107) Escuela Militar,137,88,73,298
34749,2020-01-07,(09121) Las Flores,2162,1372,1549,5083
34750,2020-01-02,(10000) Portal 20 de Julio,4381,2029,2502,8912
34751,2020-01-25,(09109) Tercer Milenio,831,445,690,1966
34752,2020-09-14,(02202) Calle 127,1167,820,703,2690
34753,2020-03-05,(07003) SEVILLANA,2095,1139,1069,4303
34754,2020-03-02,(06104) Gobernación,1452,816,654,2922
34755,2020-08-06,(02200) Alcalá,1522,993,885,3400
34756,2020-08-08,(09120) Calle 63,788,541,570,1899
34757,2020-02-18,(04101) Minuto de Dios,3712,2237,1738,7687
34758,2020-06-12,(12003) Ricaurte,362,243,199,804
34759,2020-08-10,(12003) Ricaurte,361,244,150,755
34760,2020-08-23,(03010) PUENTE LARGO,78,53,77,208
34761,2020-06-07,(02302) Virrey,165,130,97,392
34762,2020-04-21,(10008) San Diego,157,114,122,393
34763,2020-04-17,(09109) Tercer Milenio,173,117,127,417
34764,2020-04-12,(05102) Av. Américas - Av. Boyacá,47,28,31,106
34765,2020-01-23,(10005) Bicentenario,719,388,381,1488
34766,2020-07-22,(07007) NQS - Calle 38A Sur,384,224,214,822
34767,2020-07-10,(02103) Mazurén,195,139,169,503
34768,2020-01-18,(07103) AV. CHILE,1934,1233,1374,4541
34769,2020-07-20,(07103) AV. CHILE,211,164,159,534
34770,2020-01-02,(07201) Guatoque -Veraguas,368,215,348,931
34771,2020-05-07,(06102) Salitre El Greco,163,87,74,324
34772,2020-07-22,(10005) Bicentenario,100,50,64,214
34773,2020-01-21,(07111) NQS - RICAURTE,2257,1329,1149,4735
34774,2020-07-25,(02304) Heroes,394,316,260,970
34775,2020-10-05,(02001) Centro Comercial Santa Fe,602,397,532,1531
34776,2020-05-05,(09004) Santa Lucía,1606,787,923,3316
34777,2020-06-09,(10003) Ciudad Jardín,208,108,140,456
34778,2020-04-15,(06002) Normandía,189,112,97,398
34779,2020-04-15,(02104) Calle 146,377,260,247,884
34780,2020-10-04,(10008) San Diego,93,62,105,260
34781,2020-01-08,(08002) Biblioteca,740,394,523,1657
34782,2020-09-15,(03011) SUBA - CALLE 100,579,257,264,1100
34783,2020-04-25,(08000) Portal Tunal,379,181,163,723
34784,2020-09-10,(10010) San Bernardo,596,283,453,1332
34785,2020-01-05,(02303) Calle 85,374,306,442,1122
34786,2020-06-20,(09117) Calle 45,581,345,402,1328
34787,2020-02-22,(06105) Quinta Paredes,424,232,352,1008
34788,2020-03-15,(09115) Calle 34,442,313,545,1300
34789,2020-08-15,(07006) General Santander,430,254,256,940
34790,2020-09-12,(07006) General Santander,499,234,367,1100
34791,2020-03-07,(09111) Calle 19,1396,997,1320,3713
34792,2020-05-31,(09123) Calle 76,194,143,170,507
34793,2020-07-05,(02202) Calle 127,354,272,246,872
34794,2020-06-19,(04105) Carrera 53,305,157,162,624
34795,2020-06-23,(04105) Carrera 53,289,164,163,616
34796,2020-03-24,(02303) Calle 85,550,418,390,1358
34797,2020-01-04,(50002) Corral Calle 40 Sur,42,20,44,106
34798,2020-05-24,(07105) MOVISTAR ARENA,50,34,47,131
34799,2020-06-26,(09121) Las Flores,771,475,431,1677
34800,2020-07-14,(09121) Las Flores,568,342,338,1248
34801,2020-01-19,(09105) Río Fucha,125,76,212,413
34802,2020-08-04,(14005) Las Aguas,161,95,181,437
34803,2020-06-12,(03003) 21 ANGELES,341,159,154,654
34804,2020-04-29,(10006) San Victorino,232,166,186,584
34805,2020-04-26,(40002) Manitas,80,48,64,192
34806,2020-05-18,(06107) Ciudad Universitaria,168,86,92,346
34807,2020-05-05,(09110) Avenida Jimenez,576,443,539,1558
34808,2020-05-01,(12003) Ricaurte,77,61,57,195
34809,2020-08-18,(07001) PERDOMO,852,530,556,1938
34810,2020-10-09,(09107) Hortúa,628,395,576,1599
34811,2020-02-07,(07006) General Santander - alimentacion,1544,922,1037,3503
34812,2020-08-28,(05102) Av. Américas - Av. Boyacá,260,131,168,559
34813,2020-04-03,(02102) Calle 161,89,77,59,225
34814,2020-08-01,(02102) Calle 161,156,88,119,363
34815,2020-06-09,(12004) Carrera 22,221,109,121,451
34816,2020-03-29,(07004) VENECIA,159,71,86,316
34817,2020-05-26,(06001) Modelia,385,243,188,816
34818,2020-07-10,(06001) Modelia,376,238,246,860
34819,2020-07-15,(04106) Carrera 47,323,169,159,651
34820,2020-05-24,(09119) Calle 57,131,96,91,318
34821,2020-05-06,(04106) Carrera 47,214,130,131,475
34822,2020-09-22,(10004) Policarpa,287,126,201,614
34823,2020-06-14,(03013) RIO NEGRO,74,45,65,184
34824,2020-10-07,(03010) PUENTE LARGO,426,262,328,1016
34825,2020-01-10,(12002) CDS - Carrera 32,400,274,311,985
34826,2020-09-01,(06002) Normandía,296,189,191,676
34827,2020-06-15,(05107) Américas - Cr.53,116,98,107,321
34828,2020-01-12,(07008) NQS - Calle 30 Sur,371,165,387,923
34829,2020-07-29,(04001) Quirigua,388,259,256,903
34830,2020-05-01,(07109) CAD,204,152,102,458
34831,2020-03-30,(14004) Museo del Oro,0,54,101,155
34832,2020-04-28,(06001) Modelia,286,188,176,650
34833,2020-08-06,(09108) Hospital,74,32,53,159
34834,2020-08-12,(02102) Calle 161,231,133,159,523
34835,2020-02-27,(03014) SAN MARTIN,270,151,191,612
34836,2020-07-20,(03012) SUBA - CALLE 95,78,42,63,183
34837,2020-06-17,(09003) Socorro,553,326,301,1180
34838,2020-02-22,(07101) CASTELLANA,372,300,415,1087
34839,2020-07-15,(02304) Heroes,622,434,366,1422
34840,2020-09-06,(03009) Av. Suba- Calle 116,133,117,133,383
34841,2020-08-18,(07105) MOVISTAR ARENA,239,123,120,482
34842,2020-06-29,(10003) Ciudad Jardín,84,37,73,194
34843,2020-08-10,(07506) DESPENSA,428,239,262,929
34844,2020-08-01,(03011) SUBA - CALLE 100,250,141,174,565
34845,2020-03-24,(10007) Las Nieves,333,279,333,945
34846,2020-05-01,(06102) Salitre El Greco,66,51,43,160
34847,2020-09-14,(05103) Marsella,434,253,296,983
34848,2020-04-04,(12001) Carrera 43,158,123,77,358
34849,2020-04-04,(10004) Policarpa,97,61,50,208
34850,2020-05-07,(09108) Hospital,49,44,29,122
34851,2020-06-05,(10005) Bicentenario,103,56,77,236
34852,2020-03-01,(07200) Tygua-San José,159,115,278,552
34853,2020-06-20,(02304) Heroes,565,427,388,1380
34854,2020-04-20,(06107) Ciudad Universitaria,96,61,83,240
34855,2020-08-01,(12007) Zona Industrial,166,103,115,384
34856,2020-09-19,(09003) Socorro,539,250,404,1193
34857,2020-05-08,(06111) Universidades,0,101,256,357
34858,2020-05-13,(06111) Universidades,0,118,321,439
34859,2020-04-24,(07106) EL CAMPIN,183,126,97,406
34860,2020-04-27,(07010) Bosa,276,34,77,387
34861,2020-09-06,(03007) HUMEDAL CORDOBA,33,38,35,106
34862,2020-01-27,(03014) SAN MARTIN,258,135,170,563
34863,2020-04-09,(04108) El Polo,65,39,44,148
34864,2020-03-20,(12004) Carrera 22,24,18,24,66
34865,2020-08-16,(04107) Escuela Militar,31,25,40,96
34866,2020-05-01,(07104) Simon Bolivar,132,93,85,310
34867,2020-05-04,(07113) SANTA ISABEL,226,142,154,522
34868,2020-07-26,(12004) Carrera 22,26,16,31,73
34869,2020-08-06,(04105) Carrera 53,233,111,155,499
34870,2020-10-04,(04105) Carrera 53,129,69,142,340
34871,2020-03-25,(07002) MADELENA,389,218,170,777
34872,2020-06-07,(07200) Tygua-San José,51,29,47,127
34873,2020-07-05,(14001) La Sabana,53,33,57,143
34874,2020-07-06,(10005) Bicentenario - alimentacion,222,112,211,545
34875,2020-05-17,(03003) 21 ANGELES,75,30,55,160
34876,2020-04-02,(14005) Las Aguas,0,33,95,128
34877,2020-10-03,(03014) SAN MARTIN,0,14,55,69
34878,2020-04-09,(07002) MADELENA,129,54,73,256
34879,2020-04-24,(07101) CASTELLANA,101,85,63,249
34880,2020-05-01,(04101) Minuto de Dios,78,62,59,199
34881,2020-09-20,(07506) DESPENSA,140,70,142,352
34882,2020-04-05,(07201) Guatoque -Veraguas,13,14,35,62
34883,2020-03-31,(07106) EL CAMPIN,143,122,101,366
34884,2020-04-05,(02104) Calle 146,141,105,69,315
34885,2020-10-07,(50006) Corral Carrera 77,5,4,7,16
34886,2019-12-31,(03003) 21 ANGELES,14,7,17,38
34887,2020-06-28,(06107) Ciudad Universitaria,52,38,56,146
34888,2020-04-13,(10005) Bicentenario,42,25,36,103
34889,2020-08-03,(03004) GRATAMIRA,0,10,26,36
34890,2020-07-11,(50006) Corral Carrera 77,1,2,3,6
34891,2019-12-31,(05101) Mandalay - Cr.73,3,4,5,12
34892,2020-05-16,(50002) Corral Calle 40 Sur,9,5,8,22
34893,2020-08-16,(03014) SAN MARTIN,0,4,10,14
34894,2020-04-12,(50002) Corral Calle 40 Sur,3,1,2,6
34895,2020-05-10,(50002) Corral Calle 40 Sur,0,2,1,3
34896,2020-08-28,(04000) Cabecera Calle 80 - alimentacion,4243,2328,2857,9428
34897,2020-01-20,(07005) ALQUERIA,2299,1303,1320,4922
34898,2020-01-14,(09002) Consuelo,1291,697,759,2747
34899,2020-09-23,(02502) Terminal,498,372,512,1382
34900,2020-02-14,(09118) Marly,7965,5271,4342,17578
34901,2020-02-03,(07504) TERREROS,17389,10733,9479,37601
34902,2020-07-23,(05000) Portal Américas - alimentacion,8211,4430,3755,16396
34903,2020-01-24,(02303) Calle 85,3341,2371,1942,7654
34904,2020-02-10,(07503) SAN MATEO,41766,23919,17763,83448
34905,2020-02-26,(09100) Calle 40 Sur,7637,3962,4126,15725
34906,2020-07-14,(05000) Portal Américas - alimentacion,9517,5206,4554,19277
34907,2020-05-07,(05000) Portal Américas - alimentacion,7587,3953,3472,15012
34908,2020-05-21,(05000) Portal Américas - alimentacion,8828,4528,4065,17421
34909,2020-01-29,(05001) Patio Bonito,6884,3920,3602,14406
34910,2020-02-11,(05001) Patio Bonito,7381,4244,3745,15370
34911,2020-05-19,(08000) Portal Tunal - alimentacion,5181,2783,2528,10492
34912,2020-09-14,(07112) COMUNEROS,855,506,538,1899
34913,2020-02-24,(14004) Museo del Oro,4411,2489,1987,8887
34914,2020-03-09,(14004) Museo del Oro,2147,124,384,2655
34915,2020-09-03,(10000) Portal 20 de Julio - alimentacion,4498,1962,2832,9292
34916,2020-03-04,(05100) Banderas P. Central,8129,4699,3721,16549
34917,2020-03-02,(02205) Calle 106,2661,1715,1311,5687
34918,2020-04-23,(10005) Bicentenario - alimentacion,147,76,118,341
34919,2020-02-18,(07001) PERDOMO,4789,2861,2666,10316
34920,2020-08-25,(07001) PERDOMO,870,531,589,1990
34921,2020-02-01,(09120) Calle 63,3111,2074,2687,7872
34922,2020-03-26,(40003) Mirador del Paraiso,625,369,414,1408
34923,2020-08-18,(40003) Mirador del Paraiso,1585,963,1031,3579
34924,2020-01-20,(04000) Cabecera Calle 80 - intermunicipal,1923,1292,1940,5155
34925,2020-09-21,(09104) Restrepo,1347,720,993,3060
34926,2020-03-15,(02204) Pepe Sierra,545,402,599,1546
34927,2020-03-01,(02502) Terminal,327,312,804,1443
34928,2020-02-11,(06106) Recinto Ferial,1620,919,841,3380
34929,2020-09-23,(04100) Carrera 77,1494,837,1157,3488
34930,2020-08-25,(07102) NQS - CALLE 75,429,275,228,932
34931,2020-08-28,(07102) NQS - CALLE 75,477,284,249,1010
34932,2020-07-17,(07000) Portal Sur - alimentacion,7415,4259,3657,15331
34933,2020-09-28,(05100) Banderas P. Central - alimentacion,3636,1845,2394,7875
34934,2020-10-08,(05100) Banderas P. Central - alimentacion,3739,1895,2692,8326
34935,2020-04-19,(09103) Olaya,177,109,112,398
34936,2020-10-09,(07002) MADELENA,1105,581,917,2603
34937,2020-05-14,(09001) Molinos,1874,1080,1152,4106
34938,2020-06-18,(07112) COMUNEROS,818,461,453,1732
34939,2020-03-18,(05002) Tintal,6256,3410,3078,12744
34940,2020-04-22,(04002) Carrera 90,383,212,181,776
34941,2020-02-02,(04100) Carrera 77,1488,649,1553,3690
34942,2020-02-10,(02000) Cabecera Autopista Norte - intermunicipal,5273,3705,3036,12014
34943,2020-08-14,(12001) Carrera 43,444,229,228,901
34944,2020-01-31,(10005) Bicentenario - alimentacion,677,319,510,1506
34945,2020-09-15,(10005) Bicentenario - alimentacion,215,115,226,556
34946,2020-01-30,(02302) Virrey,3760,2495,1814,8069
34947,2020-08-20,(03000) Portal Suba,1142,739,783,2664
34948,2020-03-18,(02000) Cabecera Autopista Norte - intermunicipal,1743,1190,1224,4157
34949,2020-07-24,(02000) Cabecera Autopista Norte - intermunicipal,446,288,320,1054
34950,2020-09-01,(02000) Cabecera Autopista Norte - alimentacion,4831,2524,3099,10454
34951,2020-01-29,(10000) Portal 20 de Julio,8774,4110,3843,16727
34952,2020-05-29,(02303) Calle 85,601,440,306,1347
34953,2020-09-29,(02303) Calle 85,886,587,510,1983
34954,2020-02-02,(05100) Banderas P. Central - alimentacion,3159,1229,2596,6984
34955,2020-06-09,(09003) Socorro,564,307,297,1168
34956,2020-06-04,(09116) Avenida 39,312,201,207,720
34957,2020-03-12,(10001) Country Sur,158,879,703,1740
34958,2020-03-21,(03003) 21 ANGELES,100,46,46,192
34959,2020-04-08,(02000) Cabecera Autopista Norte,499,339,324,1162
34960,2020-02-29,(06106) Recinto Ferial,764,450,604,1818
34961,2020-02-18,(03011) SUBA - CALLE 100,2766,1421,1478,5665
34962,2020-09-29,(02300) Calle 100,1301,923,958,3182
34963,2020-06-26,(09119) Calle 57,658,413,424,1495
34964,2020-03-22,(07007) NQS - Calle 38A Sur,76,44,35,155
34965,2020-03-02,(07006) General Santander,2854,1604,1554,6012
34966,2020-05-10,(08000) Portal Tunal,172,96,101,369
34967,2020-09-19,(09104) Restrepo,1398,784,1262,3444
34968,2020-05-26,(05005) Transversal 86,343,161,201,705
34969,2020-02-09,(05001) Patio Bonito,1755,794,1544,4093
34970,2020-06-08,(02202) Calle 127,1079,737,537,2353
34971,2020-09-18,(05105) Pradera,679,405,382,1466
34972,2020-02-02,(07009) SENA,893,452,921,2266
34973,2020-05-19,(06109) Centro Memoria,257,131,91,479
34974,2020-09-18,(07007) NQS - Calle 38A Sur,485,290,344,1119
34975,2020-04-08,(05107) Américas - Cr.53,253,189,126,568
34976,2020-01-12,(08000) Portal Tunal,495,345,357,1197
34977,2020-04-30,(02205) Calle 106,205,157,111,473
34978,2020-06-25,(02205) Calle 106,368,247,241,856
34979,2020-07-14,(09101) Quiroga,369,200,258,827
34980,2020-05-20,(02300) Calle 100,1075,686,528,2289
34981,2020-08-17,(06000) Portal Eldorado - alimentacion,1351,629,787,2767
34982,2020-07-29,(07106) EL CAMPIN,368,235,172,775
34983,2020-03-05,(07103) AV. CHILE,3635,2211,1923,7769
34984,2020-09-17,(07010) Bosa,0,422,1008,1430
34985,2020-06-20,(07113) SANTA ISABEL,300,162,261,723
34986,2020-01-04,(06111) Universidades,557,442,876,1875
34987,2020-01-13,(03007) HUMEDAL CORDOBA,749,447,430,1626
34988,2020-07-03,(03007) HUMEDAL CORDOBA,181,105,96,382
34989,2020-07-21,(10006) San Victorino,410,226,250,886
34990,2020-01-27,(09117) Calle 45,5456,3528,2798,11782
34991,2020-06-16,(09103) Olaya,1041,578,562,2181
34992,2020-01-09,(04107) Escuela Militar,475,281,318,1074
34993,2020-02-04,(07109) CAD,2949,1750,1529,6228
34994,2020-01-28,(07004) VENECIA,4533,2653,2443,9629
34995,2020-09-23,(04003) Avenida Ciudad de Cali,1243,664,930,2837
34996,2020-05-22,(09123) Calle 76,831,549,473,1853
34997,2020-03-12,(10009) Museo Nacional,2023,164,414,2601
34998,2020-02-17,(09109) Tercer Milenio,1464,908,878,3250
34999,2020-05-05,(05001) Patio Bonito,1251,658,682,2591
35000,2020-07-22,(07002) MADELENA,587,344,448,1379
35001,2020-01-13,(06105) Quinta Paredes,783,441,421,1645
35002,2020-02-11,(09111) Calle 19,2557,1484,1591,5632
35003,2020-01-08,(04000) Cabecera Calle 80 - intermunicipal,1324,897,1465,3686
35004,2020-03-04,(04000) Cabecera Calle 80 - intermunicipal,2248,1664,2223,6135
35005,2020-10-10,(02202) Calle 127,788,635,724,2147
35006,2020-01-26,(07003) SEVILLANA,408,176,402,986
35007,2020-03-16,(07101) CASTELLANA,663,427,449,1539
35008,2020-02-09,(07003) SEVILLANA,369,188,370,927
35009,2020-06-16,(07113) SANTA ISABEL,418,258,274,950
35010,2020-08-23,(02302) Virrey,134,109,115,358
35011,2020-02-01,(09122) Calle 72,3027,2100,2930,8057
35012,2020-06-25,(12003) Ricaurte,415,269,194,878
35013,2020-08-15,(12003) Ricaurte,282,220,184,686
35014,2020-10-05,(09113) Calle 22,425,260,396,1081
35015,2020-10-08,(03013) RIO NEGRO,301,193,271,765
35016,2020-07-26,(03002) SUBA - TV- 91,185,102,133,420
35017,2020-08-21,(02103) Mazurén,173,106,155,434
35018,2020-09-08,(02103) Mazurén,228,162,226,616
35019,2020-10-05,(12007) Zona Industrial,381,262,242,885
35020,2020-08-07,(10005) Bicentenario,30,21,24,75
35021,2020-02-28,(40002) Manitas,1336,748,691,2775
35022,2020-09-22,(09106) Nariño,504,302,375,1181
35023,2020-07-23,(02304) Heroes,622,455,353,1430
35024,2020-05-12,(02001) Centro Comercial Santa Fe,325,212,213,750
35025,2020-06-26,(02104) Calle 146,841,533,506,1880
35026,2020-06-17,(02200) Alcalá,1910,1336,975,4221
35027,2020-08-30,(02304) Heroes,219,182,171,572
35028,2020-04-11,(09120) Calle 63,333,248,218,799
35029,2020-08-10,(09120) Calle 63,1044,706,677,2427
35030,2020-06-12,(03002) SUBA - TV- 91,751,418,459,1628
35031,2020-08-29,(09115) Calle 34,403,268,406,1077
35032,2020-06-18,(02104) Calle 146,777,502,486,1765
35033,2020-08-23,(07006) General Santander,159,71,118,348
35034,2020-03-12,(09111) Calle 19,935,143,322,1400
35035,2020-01-21,(07201) Guatoque -Veraguas,777,348,373,1498
35036,2020-02-16,(02105) Calle 142,914,484,1140,2538
35037,2020-05-23,(06109) Centro Memoria,193,116,96,405
35038,2020-10-10,(07110) PALOQUEMAO,449,312,398,1159
35039,2020-09-09,(07009) SENA,684,422,482,1588
35040,2020-06-17,(03003) 21 ANGELES,362,181,176,719
35041,2020-06-30,(03003) 21 ANGELES,364,180,222,766
35042,2020-08-20,(03003) 21 ANGELES,316,151,159,626
35043,2020-07-03,(07001) PERDOMO,938,551,642,2131
35044,2020-04-13,(02104) Calle 146,405,286,212,903
35045,2020-07-05,(09119) Calle 57,208,116,194,518
35046,2020-04-30,(06107) Ciudad Universitaria,126,79,85,290
35047,2020-03-24,(10009) Museo Nacional,752,545,423,1720
35048,2020-03-14,(40001) Juan Pablo II,1109,568,748,2425
35049,2020-04-26,(40003) Mirador del Paraiso,365,203,289,857
35050,2020-04-21,(40002) Manitas,167,92,125,384
35051,2020-01-13,(10007) Las Nieves,1702,1109,1102,3913
35052,2020-10-10,(09107) Hortúa,414,290,429,1133
35053,2020-05-27,(07007) NQS - Calle 38A Sur,307,189,212,708
35054,2020-10-04,(02304) Heroes,196,175,296,667
35055,2020-05-07,(09122) Calle 72,773,534,472,1779
35056,2020-07-21,(12000) Puente Aranda,95,57,38,190
35057,2020-03-18,(03005) SUBA - AV. BOYACA,1330,806,739,2875
35058,2020-09-28,(07109) CAD,728,450,393,1571
35059,2020-08-22,(02102) Calle 161,146,88,134,368
35060,2020-09-11,(12004) Carrera 22,257,155,170,582
35061,2020-07-04,(02103) Mazurén,147,82,157,386
35062,2020-07-17,(04106) Carrera 47,321,161,152,634
35063,2020-08-17,(09003) Socorro,205,99,139,443
35064,2020-09-29,(09003) Socorro,618,318,406,1342
35065,2020-04-01,(10004) Policarpa,118,80,75,273
35066,2020-01-04,(09002) Consuelo,611,276,469,1356
35067,2020-09-10,(07103) AV. CHILE,829,497,528,1854
35068,2020-03-12,(02102) Calle 161,151,413,254,818
35069,2020-04-26,(02200) Alcalá,403,293,188,884
35070,2020-05-10,(06000) Portal Eldorado - alimentacion,876,386,436,1698
35071,2020-08-30,(07009) SENA,219,127,214,560
35072,2020-03-12,(12002) CDS - Carrera 32,215,38,65,318
35073,2020-07-21,(12002) CDS - Carrera 32,188,109,71,368
35074,2020-07-31,(12002) CDS - Carrera 32,158,107,70,335
35075,2020-08-04,(12002) CDS - Carrera 32,182,112,60,354
35076,2020-02-02,(40001) Juan Pablo II,503,226,482,1211
35077,2020-08-29,(09119) Calle 57,445,289,383,1117
35078,2020-01-15,(10005) Bicentenario - alimentacion,600,281,509,1390
35079,2020-08-28,(06103) CAN,338,199,198,735
35080,2020-03-15,(04000) Cabecera Calle 80 - intermunicipal,223,126,296,645
35081,2020-07-10,(06103) CAN,380,232,178,790
35082,2020-07-04,(04000) Cabecera Calle 80 - intermunicipal,187,106,212,505
35083,2020-09-30,(03010) PUENTE LARGO,390,250,307,947
35084,2020-07-25,(03001) LA CAMPIÑA,665,343,384,1392
35085,2020-09-20,(40002) Manitas,158,67,155,380
35086,2020-09-04,(09108) Hospital,40,41,110,191
35087,2020-02-28,(03014) SAN MARTIN,242,152,149,543
35088,2020-05-15,(06101) El Tiempo,270,172,136,578
35089,2020-04-26,(03012) SUBA - CALLE 95,55,41,39,135
35090,2020-10-11,(09114) Calle 26,75,60,165,300
35091,2020-04-20,(04100) Carrera 77,629,393,355,1377
35092,2020-05-24,(09101) Quiroga,122,59,101,282
35093,2020-04-08,(07006) General Santander,235,146,135,516
35094,2020-06-20,(03011) SUBA - CALLE 100,360,198,203,761
35095,2020-07-10,(03011) SUBA - CALLE 100,572,284,265,1121
35096,2020-03-23,(09110) Avenida Jimenez,116,87,112,315
35097,2020-10-10,(12002) CDS - Carrera 32,114,94,105,313
35098,2020-06-18,(14004) Museo del Oro,237,176,201,614
35099,2020-05-09,(07010) Bosa,346,182,247,775
35100,2020-07-08,(12007) Zona Industrial,383,235,150,768
35101,2020-09-28,(04000) Cabecera Calle 80 - intermunicipal,439,235,457,1131
35102,2020-03-31,(07008) NQS - Calle 30 Sur,136,73,86,295
35103,2020-04-18,(05102) Av. Américas - Av. Boyacá,87,43,40,170
35104,2020-05-14,(10004) Policarpa,168,89,114,371
35105,2020-08-30,(07001) PERDOMO,273,125,257,655
35106,2020-03-20,(14004) Museo del Oro,0,97,187,284
35107,2020-07-19,(10010) San Bernardo,188,95,146,429
35108,2020-04-14,(07104) Simon Bolivar,188,142,144,474
35109,2020-05-07,(03002) SUBA - TV- 91,496,292,309,1097
35110,2020-04-07,(09113) Calle 22,212,140,160,512
35111,2020-08-08,(07007) NQS - Calle 38A Sur,306,180,211,697
35112,2020-03-23,(04102) Avenida Boyaca,57,55,65,177
35113,2020-04-10,(10006) San Victorino,62,36,42,140
35114,2020-09-18,(04000) Cabecera Calle 80 - intermunicipal,433,225,386,1044
35115,2020-09-12,(12004) Carrera 22,205,133,124,462
35116,2020-05-06,(07506) DESPENSA,313,174,155,642
35117,2020-03-21,(07002) MADELENA,213,112,110,435
35118,2020-01-19,(12007) Zona Industrial,146,135,212,493
35119,2020-06-06,(10008) San Diego,142,101,110,353
35120,2020-06-23,(07101) CASTELLANA,235,150,129,514
35121,2020-04-08,(07108) Av. El Dorado,51,42,38,131
35122,2020-03-28,(07107) U. NACIONAL,109,95,86,290
35123,2020-03-21,(08001) Parque el Tunal,132,75,68,275
35124,2020-04-22,(09105) Río Fucha,74,37,46,157
35125,2020-03-29,(02103) Mazurén,20,18,20,58
35126,2020-07-23,(05103) Marsella,288,150,150,588
35127,2020-07-26,(06100) Av. Rojas,36,33,55,124
35128,2020-05-01,(07201) Guatoque -Veraguas,26,27,40,93
35129,2020-04-01,(06105) Quinta Paredes,67,42,59,168
35130,2020-04-26,(05103) Marsella,74,28,34,136
35131,2020-04-10,(04002) Carrera 90,94,57,36,187
35132,2019-12-31,(09107) Hortúa,31,9,32,72
35133,2020-02-09,(03014) SAN MARTIN,40,24,80,144
35134,2020-04-23,(10005) Bicentenario,56,30,47,133
35135,2020-03-17,(50006) Corral Carrera 77,27,19,28,74
35136,2020-06-20,(50002) Corral Calle 40 Sur,15,3,19,37
35137,2020-08-03,(04000) Cabecera Calle 80 - alimentacion,3040,1838,1956,6834
35138,2020-06-10,(07005) ALQUERIA,581,328,297,1206
35139,2020-07-07,(02502) Terminal,422,331,399,1152
35140,2020-02-20,(09118) Marly,7834,4940,3826,16600
35141,2020-03-06,(09118) Marly,7599,5039,4353,16991
35142,2020-03-28,(07504) TERREROS,1859,1003,987,3849
35143,2020-07-21,(07504) TERREROS,5664,3147,2615,11426
35144,2020-08-17,(07504) TERREROS,1632,864,1092,3588
35145,2020-05-25,(10000) Portal 20 de Julio - alimentacion,1486,623,766,2875
35146,2020-02-14,(09114) Calle 26,3100,2160,1880,7140
35147,2020-02-28,(09003) Socorro,1679,985,1029,3693
35148,2020-02-29,(09003) Socorro,1278,584,836,2698
35149,2020-02-29,(09121) Las Flores,1712,1231,1655,4598
35150,2020-02-25,(06107) Ciudad Universitaria,1629,982,885,3496
35151,2020-03-06,(06107) Ciudad Universitaria,1548,957,1069,3574
35152,2020-03-10,(06107) Ciudad Universitaria,628,160,220,1008
35153,2020-02-08,(05001) Patio Bonito,5059,2587,3062,10708
35154,2020-01-04,(07010) Bosa,850,483,782,2115
35155,2020-02-18,(07010) Bosa,2312,1337,1415,5064
35156,2020-02-28,(07010) Bosa,2294,1219,1430,4943
35157,2020-08-05,(07112) COMUNEROS,693,391,404,1488
35158,2020-02-05,(03000) Portal Suba,9759,5934,5272,20965
35159,2020-02-08,(08000) Portal Tunal - alimentacion,16506,8165,9562,34233
35160,2020-06-04,(09100) Calle 40 Sur,1562,948,907,3417
35161,2020-06-30,(09100) Calle 40 Sur,1878,1047,1199,4124
35162,2020-04-06,(06000) Portal Eldorado - alimentacion,2274,1120,1037,4431
35163,2020-01-22,(09115) Calle 34,3802,2539,2315,8656
35164,2020-02-20,(05100) Banderas P. Central - alimentacion,15499,9205,7785,32489
35165,2020-03-03,(10003) Ciudad Jardín,1041,609,697,2347
35166,2020-02-26,(10005) Bicentenario - alimentacion,732,372,549,1653
35167,2020-09-21,(10005) Bicentenario - alimentacion,146,74,160,380
35168,2020-06-09,(02000) Cabecera Autopista Norte,1234,827,750,2811
35169,2020-07-08,(09109) Tercer Milenio,375,212,253,840
35170,2020-05-06,(07505) LEON XIII,1481,925,783,3189
35171,2020-07-08,(07505) LEON XIII,2898,1539,1208,5645
35172,2020-07-15,(07505) LEON XIII,2496,1338,1066,4900
35173,2020-02-25,(06106) Recinto Ferial,1519,942,772,3233
35174,2020-08-01,(04100) Carrera 77,697,379,511,1587
35175,2020-06-26,(07102) NQS - CALLE 75,461,299,219,979
35176,2020-09-06,(09118) Marly,487,322,479,1288
35177,2020-01-06,(09103) Olaya,724,373,685,1782
35178,2020-01-22,(09103) Olaya,3721,2307,2346,8374
35179,2020-04-30,(09110) Avenida Jimenez,485,363,390,1238
35180,2020-03-05,(07110) PALOQUEMAO,2630,1563,1231,5424
35181,2020-01-27,(02001) Centro Comercial Santa Fe,4560,2932,2578,10070
35182,2020-05-20,(07000) Portal Sur - alimentacion,6243,3648,2939,12830
35183,2020-03-30,(09103) Olaya,471,253,221,945
35184,2020-08-22,(14001) La Sabana,132,98,93,323
35185,2020-09-26,(07000) Portal Sur - alimentacion,7491,3581,4972,16044
35186,2020-06-28,(08000) Portal Tunal - alimentacion,2084,975,1279,4338
35187,2020-09-10,(02000) Cabecera Autopista Norte,1343,791,1026,3160
35188,2020-02-13,(02104) Calle 146,9718,5939,5040,20697
35189,2020-02-26,(02104) Calle 146,9627,5762,5093,20482
35190,2020-01-18,(09113) Calle 22,840,620,831,2291
35191,2020-02-20,(02104) Calle 146,9248,5759,4470,19477
35192,2020-04-20,(50003) Corral Molinos,611,414,552,1577
35193,2020-06-17,(04000) Cabecera Calle 80,1059,697,817,2573
35194,2020-08-03,(07010) Bosa,592,287,351,1230
35195,2020-01-02,(05002) Tintal,4882,2696,3167,10745
35196,2020-03-27,(04002) Carrera 90,316,175,147,638
35197,2020-02-14,(07113) SANTA ISABEL,2130,1295,1419,4844
35198,2020-03-14,(06111) Universidades,1565,965,1551,4081
35199,2020-04-26,(03002) SUBA - TV- 91,155,81,83,319
35200,2020-02-18,(02302) Virrey,4025,2684,1834,8543
35201,2020-01-29,(06101) El Tiempo,2841,1608,1356,5805
35202,2020-04-13,(03000) Portal Suba,577,377,400,1354
35203,2020-02-26,(09101) Quiroga,1727,931,1187,3845
35204,2020-03-11,(09101) Quiroga,1418,963,1138,3519
35205,2020-02-25,(10002) Av. Primero de Mayo,8510,4473,4803,17786
35206,2020-08-22,(03000) Portal Suba - alimentacion,4380,2187,2709,9276
35207,2020-04-12,(03000) Portal Suba - alimentacion,1231,683,568,2482
35208,2020-08-18,(10000) Portal 20 de Julio,2029,1028,1105,4162
35209,2020-03-11,(40003) Mirador del Paraiso,4375,2432,2461,9268
35210,2020-01-23,(09109) Tercer Milenio,1293,760,875,2928
35211,2020-02-03,(05102) Av. Américas - Av. Boyacá,1901,1173,1010,4084
35212,2020-03-27,(06108) Concejo de Bogotá,86,55,63,204
35213,2020-06-25,(06108) Concejo de Bogotá,162,76,70,308
35214,2020-08-04,(10001) Country Sur,1197,539,712,2448
35215,2020-02-02,(03003) 21 ANGELES,357,147,355,859
35216,2020-02-08,(06002) Normandía,964,558,927,2449
35217,2020-08-15,(03000) Portal Suba - alimentacion,4723,2421,3138,10282
35218,2020-03-22,(09107) Hortúa,182,124,80,386
35219,2020-01-14,(05101) Mandalay - Cr.73,886,480,482,1848
35220,2020-08-07,(05002) Tintal,909,456,595,1960
35221,2020-04-19,(05000) Portal Américas,486,310,307,1103
35222,2020-05-28,(50003) Corral Molinos,1334,627,871,2832
35223,2020-01-09,(03011) SUBA - CALLE 100,1894,917,1129,3940
35224,2020-05-21,(02300) Calle 100,1066,682,494,2242
35225,2020-02-26,(03012) SUBA - CALLE 95,1359,975,1018,3352
35226,2020-01-08,(05100) Banderas P. Central,4858,2826,2716,10400
35227,2020-06-09,(08000) Portal Tunal,743,335,284,1362
35228,2020-03-07,(07104) Simon Bolivar,1477,951,1035,3463
35229,2020-04-19,(05005) Transversal 86,64,42,34,140
35230,2020-09-19,(02202) Calle 127,863,653,658,2174
35231,2020-04-04,(07009) SENA,215,98,109,422
35232,2020-01-23,(06109) Centro Memoria,1056,593,592,2241
35233,2020-02-24,(06109) Centro Memoria,1194,678,621,2493
35234,2020-02-26,(06109) Centro Memoria,1159,656,704,2519
35235,2020-07-17,(06000) Portal Eldorado - alimentacion,3624,1774,1774,7172
35236,2020-07-17,(04003) Avenida Ciudad de Cali,934,524,602,2060
35237,2020-02-12,(12007) Zona Industrial,1294,785,655,2734
35238,2020-08-10,(07201) Guatoque -Veraguas,200,101,131,432
35239,2020-09-21,(07201) Guatoque -Veraguas,165,93,121,379
35240,2020-06-13,(06000) Portal Eldorado - alimentacion,3036,1447,1611,6094
35241,2020-09-12,(02201) Prado,785,435,553,1773
35242,2020-01-21,(09121) Las Flores,2120,1383,1302,4805
35243,2020-02-15,(07113) SANTA ISABEL,1255,671,1123,3049
35244,2020-08-31,(07113) SANTA ISABEL,347,223,257,827
35245,2020-06-23,(03007) HUMEDAL CORDOBA,170,124,73,367
35246,2020-08-18,(03007) HUMEDAL CORDOBA,142,95,81,318
35247,2020-08-04,(10006) San Victorino,716,345,281,1342
35248,2020-10-09,(07000) Portal Sur,2356,1360,1818,5534
35249,2020-03-07,(02304) Heroes,1788,1540,1649,4977
35250,2020-09-22,(09100) Calle 40 Sur,1938,1103,1477,4518
35251,2020-01-16,(04107) Escuela Militar,556,349,407,1312
35252,2020-06-11,(04107) Escuela Militar,143,92,73,308
35253,2020-09-02,(04107) Escuela Militar,166,108,96,370
35254,2020-05-16,(08000) Portal Tunal,484,241,173,898
35255,2020-03-05,(02104) Calle 146,9328,5675,5086,20089
35256,2020-01-28,(09117) Calle 45,5700,3657,2862,12219
35257,2020-08-18,(04002) Carrera 90,664,342,389,1395
35258,2020-06-14,(06111) Universidades,55,27,121,203
35259,2020-03-06,(04001) Quirigua,2078,1215,1266,4559
35260,2020-03-12,(06105) Quinta Paredes,217,96,111,424
35261,2020-07-28,(06101) El Tiempo,304,177,173,654
35262,2020-09-12,(06101) El Tiempo,228,166,246,640
35263,2020-08-01,(09117) Calle 45,449,283,349,1081
35264,2020-04-07,(04100) Carrera 77,604,318,401,1323
35265,2020-07-10,(02204) Pepe Sierra,897,599,473,1969
35266,2020-05-19,(09001) Molinos,2023,1141,1261,4425
35267,2020-05-03,(03001) LA CAMPIÑA,191,102,105,398
35268,2020-06-14,(02000) Cabecera Autopista Norte,383,235,262,880
35269,2020-05-01,(07113) SANTA ISABEL,133,71,107,311
35270,2020-08-01,(04108) El Polo,240,139,146,525
35271,2020-04-27,(09120) Calle 63,114,310,145,569
35272,2020-07-19,(02302) Virrey,143,103,82,328
35273,2020-01-27,(12003) Ricaurte,1186,746,640,2572
35274,2020-02-06,(12003) Ricaurte,1241,834,685,2760
35275,2020-05-06,(12003) Ricaurte,238,170,85,493
35276,2020-09-09,(03012) SUBA - CALLE 95,357,213,255,825
35277,2020-06-05,(09104) Restrepo,1409,855,977,3241
35278,2020-08-28,(09104) Restrepo,1658,920,1216,3794
35279,2020-03-23,(03009) Av. Suba- Calle 116,171,108,95,374
35280,2020-05-10,(02105) Calle 142,165,114,101,380
35281,2020-08-19,(02105) Calle 142,705,411,439,1555
35282,2020-10-12,(10010) San Bernardo,243,133,289,665
35283,2020-01-07,(04000) Cabecera Calle 80 - intermunicipal,1274,884,1425,3583
35284,2020-06-22,(07103) AV. CHILE,267,189,180,636
35285,2020-09-01,(40002) Manitas,425,276,295,996
35286,2020-06-03,(06109) Centro Memoria,279,158,130,567
35287,2020-06-04,(05107) Américas - Cr.53,429,248,236,913
35288,2020-08-17,(09114) Calle 26,61,49,59,169
35289,2020-06-30,(09123) Calle 76,1149,750,648,2547
35290,2020-05-22,(06105) Quinta Paredes,128,84,60,272
35291,2020-04-24,(06002) Normandía,175,114,105,394
35292,2020-07-24,(02104) Calle 146,678,402,381,1461
35293,2020-08-08,(09004) Santa Lucía,1847,886,1032,3765
35294,2020-01-02,(08002) Biblioteca,526,272,378,1176
35295,2020-07-29,(09003) Socorro,559,300,283,1142
35296,2020-01-11,(10005) Bicentenario - alimentacion,368,175,415,958
35297,2020-06-21,(09115) Calle 34,177,112,164,453
35298,2020-06-24,(03006) NIZA - CALLE 127,511,291,240,1042
35299,2020-05-12,(02204) Pepe Sierra,555,425,271,1251
35300,2020-02-25,(12004) Carrera 22,714,454,422,1590
35301,2020-02-04,(12004) Carrera 22,722,409,508,1639
35302,2020-07-07,(07004) VENECIA,1080,685,662,2427
35303,2020-03-14,(06104) Gobernación,342,301,468,1111
35304,2020-02-18,(07006) General Santander - alimentacion,1534,903,1026,3463
35305,2020-05-12,(02302) Virrey,504,343,257,1104
35306,2020-05-20,(02302) Virrey,508,362,239,1109
35307,2020-06-05,(09114) Calle 26,288,202,198,688
35308,2020-05-11,(07201) Guatoque -Veraguas,138,87,100,325
35309,2020-05-03,(03000) Portal Suba,215,133,170,518
35310,2020-01-05,(02101) Toberín,1355,618,1465,3438
35311,2020-04-15,(07105) MOVISTAR ARENA,172,116,83,371
35312,2020-01-14,(09105) Río Fucha,633,338,492,1463
35313,2020-09-24,(02200) Alcalá,2210,1385,1338,4933
35314,2020-10-01,(09114) Calle 26,374,246,341,961
35315,2020-05-06,(03003) 21 ANGELES,207,97,85,389
35316,2020-09-13,(03003) 21 ANGELES,106,52,92,250
35317,2020-05-02,(10006) San Victorino,131,94,134,359
35318,2020-01-05,(02201) Prado,750,369,754,1873
35319,2020-08-03,(06107) Ciudad Universitaria,153,101,94,348
35320,2020-05-20,(04103) Las Ferias,289,164,162,615
35321,2020-02-22,(40002) Manitas,937,503,677,2117
35322,2020-06-04,(09122) Calle 72,1085,753,609,2447
35323,2020-09-12,(03007) HUMEDAL CORDOBA,117,69,79,265
35324,2020-06-11,(10002) Av. Primero de Mayo,2017,1076,1180,4273
35325,2020-06-11,(12000) Puente Aranda,87,50,37,174
35326,2020-09-25,(12000) Puente Aranda,88,52,72,212
35327,2020-10-12,(09121) Las Flores,189,151,242,582
35328,2020-06-11,(02102) Calle 161,238,146,126,510
35329,2020-08-28,(06001) Modelia,353,220,217,790
35330,2020-09-07,(06106) Recinto Ferial,267,179,150,596
35331,2020-04-19,(10009) Museo Nacional,66,41,56,163
35332,2020-05-16,(10009) Museo Nacional,218,148,159,525
35333,2020-04-30,(09107) Hortúa,441,269,263,973
35334,2020-04-29,(04106) Carrera 47,208,121,103,432
35335,2020-06-13,(04106) Carrera 47,256,134,167,557
35336,2020-04-26,(05001) Patio Bonito,325,201,213,739
35337,2020-06-22,(02200) Alcalá,656,508,406,1570
35338,2020-05-10,(06000) Portal Eldorado,218,130,123,471
35339,2020-05-03,(02201) Prado,157,119,108,384
35340,2020-06-22,(09120) Calle 63,353,232,282,867
35341,2020-04-18,(10010) San Bernardo,321,152,197,670
35342,2020-05-24,(03012) SUBA - CALLE 95,76,35,52,163
35343,2020-03-30,(12002) CDS - Carrera 32,141,126,66,333
35344,2020-08-26,(12002) CDS - Carrera 32,208,114,71,393
35345,2020-02-23,(04102) Avenida Boyaca,606,315,517,1438
35346,2020-04-14,(06100) Av. Rojas,117,74,72,263
35347,2020-09-21,(09123) Calle 76,844,652,640,2136
35348,2020-05-11,(02502) Terminal,291,193,232,716
35349,2020-01-06,(10006) San Victorino,206,174,292,672
35350,2020-10-11,(07000) Portal Sur,531,246,633,1410
35351,2020-03-15,(07105) MOVISTAR ARENA,154,113,198,465
35352,2020-03-22,(02304) Heroes,213,167,131,511
35353,2020-02-16,(05105) Pradera,537,375,474,1386
35354,2020-07-14,(02304) Heroes,625,444,351,1420
35355,2020-08-11,(06100) Av. Rojas,218,126,106,450
35356,2020-04-25,(09110) Avenida Jimenez,277,244,294,815
35357,2020-05-25,(09000) Cabecera Usme,446,253,304,1003
35358,2020-04-14,(09114) Calle 26,152,126,130,408
35359,2020-05-11,(06102) Salitre El Greco,166,94,96,356
35360,2020-04-08,(12001) Carrera 43,225,167,131,523
35361,2020-04-06,(06101) El Tiempo,220,172,122,514
35362,2020-04-04,(04101) Minuto de Dios,94,63,58,215
35363,2020-03-27,(10004) Policarpa,117,66,66,249
35364,2020-06-08,(12007) Zona Industrial,292,198,154,644
35365,2020-06-29,(10006) San Victorino,144,91,118,353
35366,2020-07-23,(09106) Nariño,302,164,203,669
35367,2020-10-04,(09106) Nariño,167,89,226,482
35368,2020-04-05,(06101) El Tiempo,75,66,52,193
35369,2020-02-07,(03014) SAN MARTIN,262,166,184,612
35370,2020-06-15,(07004) VENECIA,306,162,207,675
35371,2020-05-31,(05100) Banderas P. Central,150,66,124,340
35372,2020-09-28,(07105) MOVISTAR ARENA,260,168,201,629
35373,2020-07-18,(09106) Nariño,255,151,193,599
35374,2020-03-09,(09105) Río Fucha,188,141,120,449
35375,2020-04-11,(07008) NQS - Calle 30 Sur,81,50,32,163
35376,2020-03-08,(03004) GRATAMIRA,51,32,52,135
35377,2020-05-08,(06104) Gobernación,184,117,86,387
35378,2020-08-13,(03005) SUBA - AV. BOYACA,379,214,260,853
35379,2020-01-01,(09111) Calle 19,135,117,312,564
35380,2020-03-24,(12004) Carrera 22,85,69,117,271
35381,2020-06-21,(07006) General Santander,170,90,111,371
35382,2020-07-21,(06107) Ciudad Universitaria,158,95,115,368
35383,2020-05-17,(09106) Nariño,94,50,82,226
35384,2020-06-03,(10008) San Diego,257,156,159,572
35385,2020-05-11,(07200) Tygua-San José,173,72,110,355
35386,2020-08-23,(06002) Normandía,71,45,80,196
35387,2020-08-07,(04106) Carrera 47,131,70,70,271
35388,2020-04-20,(07200) Tygua-San José,93,63,69,225
35389,2020-08-02,(07006) General Santander - alimentacion,69,47,99,215
35390,2020-04-06,(06105) Quinta Paredes,64,56,42,162
35391,2020-06-14,(07105) MOVISTAR ARENA,57,35,60,152
35392,2020-01-02,(03014) SAN MARTIN,95,65,93,253
35393,2020-04-11,(09002) Consuelo,137,74,74,285
35394,2020-06-22,(04103) Las Ferias,127,75,64,266
35395,2020-06-15,(10005) Bicentenario,29,13,22,64
35396,2020-04-01,(50006) Corral Carrera 77,4,3,2,9
35397,2020-05-13,(04000) Cabecera Calle 80 - alimentacion,2914,1747,1705,6366
35398,2020-07-14,(07005) ALQUERIA,434,274,271,979
35399,2020-07-29,(07005) ALQUERIA,476,296,311,1083
35400,2020-09-01,(09002) Consuelo,528,244,316,1088
35401,2020-10-02,(09002) Consuelo,548,291,402,1241
35402,2020-07-06,(02502) Terminal,458,341,334,1133
35403,2020-09-19,(07504) TERREROS,5492,2542,3549,11583
35404,2020-07-28,(05000) Portal Américas - alimentacion,9099,5054,4557,18710
35405,2020-05-20,(09119) Calle 57,447,315,283,1045
35406,2020-08-14,(09119) Calle 57,541,360,344,1245
35407,2020-03-11,(03000) Portal Suba - alimentacion,27570,16010,15824,59404
35408,2020-02-19,(05000) Portal Américas,15655,8727,7942,32324
35409,2020-05-07,(05000) Portal Américas,1583,1186,1273,4042
35410,2020-02-26,(06104) Gobernación,1460,855,643,2958
35411,2020-01-24,(10000) Portal 20 de Julio - alimentacion,10908,5123,7004,23035
35412,2020-08-10,(04002) Carrera 90,614,339,354,1307
35413,2020-02-14,(07111) NQS - RICAURTE,3191,2018,1794,7003
35414,2020-01-25,(09100) Calle 40 Sur,4270,2061,2993,9324
35415,2020-08-06,(07503) SAN MATEO,10673,5819,5201,21693
35416,2020-04-03,(05000) Portal Américas - alimentacion,6029,2750,2587,11366
35417,2020-02-07,(06107) Ciudad Universitaria,1624,976,1045,3645
35418,2020-05-19,(06107) Ciudad Universitaria,171,104,100,375
35419,2020-07-29,(06107) Ciudad Universitaria,155,99,128,382
35420,2020-02-22,(09001) Molinos,5493,2747,4358,12598
35421,2020-07-28,(09001) Molinos,2318,1272,1581,5171
35422,2020-01-30,(05001) Patio Bonito,6748,3828,3658,14234
35423,2020-03-07,(07010) Bosa,1471,749,1194,3414
35424,2020-06-15,(07503) SAN MATEO,2933,1802,1769,6504
35425,2020-02-17,(05100) Banderas P. Central,8355,5021,3672,17048
35426,2020-02-15,(09000) Cabecera Usme,4005,2054,3452,9511
35427,2020-02-04,(07009) SENA,3717,2237,2055,8009
35428,2020-03-14,(07002) MADELENA,2391,1044,1635,5070
35429,2020-01-03,(02105) Calle 142,2488,1417,1761,5666
35430,2020-01-28,(10005) Bicentenario - alimentacion,675,291,500,1466
35431,2020-05-29,(09000) Cabecera Usme - alimentacion,7612,4279,4290,16181
35432,2020-04-17,(07001) PERDOMO,432,243,262,937
35433,2020-07-02,(07001) PERDOMO,971,530,674,2175
35434,2020-02-22,(04000) Cabecera Calle 80 - intermunicipal,1021,684,1303,3008
35435,2020-07-03,(04101) Minuto de Dios,346,203,252,801
35436,2020-02-29,(02101) Toberín,6014,2702,5118,13834
35437,2020-07-18,(02204) Pepe Sierra,563,383,276,1222
35438,2020-07-26,(02204) Pepe Sierra,187,166,114,467
35439,2020-02-26,(09115) Calle 34,4063,2907,2706,9676
35440,2020-01-16,(09110) Avenida Jimenez,3754,2752,2450,8956
35441,2020-02-05,(09110) Avenida Jimenez,5548,3558,2921,12027
35442,2020-05-11,(05002) Tintal,1445,810,783,3038
35443,2020-01-14,(07110) PALOQUEMAO,2169,1252,1091,4512
35444,2020-04-09,(03002) SUBA - TV- 91,154,93,72,319
35445,2020-08-20,(07102) NQS - CALLE 75,434,274,195,903
35446,2020-05-25,(03013) RIO NEGRO,85,48,53,186
35447,2020-05-29,(03013) RIO NEGRO,271,167,177,615
35448,2020-04-30,(09000) Cabecera Usme - alimentacion,5011,2663,2969,10643
35449,2020-07-11,(05100) Banderas P. Central - alimentacion,2527,1135,1502,5164
35450,2020-03-20,(09103) Olaya,468,288,216,972
35451,2020-05-19,(09103) Olaya,803,434,445,1682
35452,2020-01-15,(14001) La Sabana,321,235,339,895
35453,2020-05-18,(14001) La Sabana,144,94,83,321
35454,2020-08-20,(07111) NQS - RICAURTE,1112,658,458,2228
35455,2020-09-03,(02104) Calle 146,831,530,616,1977
35456,2020-10-08,(04102) Avenida Boyaca,479,270,343,1092
35457,2020-09-07,(08000) Portal Tunal - alimentacion,6370,3555,3929,13854
35458,2020-07-17,(07010) Bosa,664,304,357,1325
35459,2020-02-16,(09120) Calle 63,1282,801,1350,3433
35460,2020-07-06,(04002) Carrera 90,802,464,481,1747
35461,2020-08-10,(10001) Country Sur,1162,531,653,2346
35462,2020-09-16,(10001) Country Sur,1427,670,913,3010
35463,2020-05-05,(09111) Calle 19,433,269,394,1096
35464,2020-02-06,(10006) San Victorino,2685,1336,1326,5347
35465,2020-02-19,(03000) Portal Suba,10030,5879,5073,20982
35466,2020-02-29,(05002) Tintal,7125,3301,4638,15064
35467,2020-01-21,(02201) Prado,4219,2430,2007,8656
35468,2020-03-18,(02201) Prado,2695,1787,1415,5897
35469,2020-07-02,(03000) Portal Suba,1385,863,913,3161
35470,2020-01-23,(09101) Quiroga,1423,860,1214,3497
35471,2020-09-02,(02000) Cabecera Autopista Norte - alimentacion,5011,2704,3028,10743
35472,2020-01-29,(06100) Av. Rojas,2676,1445,1297,5418
35473,2020-02-08,(09119) Calle 57,1718,1041,1537,4296
35474,2020-01-22,(09108) Hospital,189,112,190,491
35475,2020-02-28,(08002) Biblioteca,1096,589,721,2406
35476,2020-06-20,(10000) Portal 20 de Julio,1866,922,1048,3836
35477,2020-03-02,(07108) Av. El Dorado,946,603,561,2110
35478,2020-09-13,(07503) SAN MATEO,3549,1756,2464,7769
35479,2020-02-01,(09116) Avenida 39,735,610,1049,2394
35480,2020-07-04,(09116) Avenida 39,211,166,183,560
35481,2020-02-20,(03000) Portal Suba,9404,5597,4797,19798
35482,2020-01-23,(02304) Heroes,4129,2874,2144,9147
35483,2020-04-08,(09123) Calle 76,453,362,294,1109
35484,2020-02-22,(05105) Pradera,1637,1035,956,3628
35485,2020-04-02,(05000) Portal Américas,1191,819,966,2976
35486,2020-06-17,(10000) Portal 20 de Julio,2314,1180,1074,4568
35487,2020-08-08,(02300) Calle 100,631,469,481,1581
35488,2020-02-13,(03012) SUBA - CALLE 95,1471,943,1016,3430
35489,2020-05-22,(03012) SUBA - CALLE 95,280,190,157,627
35490,2020-06-14,(10000) Portal 20 de Julio,669,335,412,1416
35491,2020-01-28,(07104) Simon Bolivar,2350,1449,1194,4993
35492,2020-05-29,(09001) Molinos,2082,1226,1578,4886
35493,2020-01-11,(02104) Calle 146,2514,1123,2208,5845
35494,2020-04-08,(02205) Calle 106,174,129,89,392
35495,2020-08-08,(02205) Calle 106,168,138,140,446
35496,2020-01-06,(12000) Puente Aranda,29,16,35,80
35497,2020-08-27,(04108) El Polo,476,308,228,1012
35498,2020-10-10,(06000) Portal Eldorado - alimentacion,3304,1519,2516,7339
35499,2020-10-10,(07106) EL CAMPIN,356,244,333,933
35500,2020-06-24,(07103) AV. CHILE,974,587,443,2004
35501,2020-08-18,(07010) Bosa,625,302,362,1289
35502,2020-06-15,(03007) HUMEDAL CORDOBA,63,49,25,137
35503,2020-07-22,(10006) San Victorino,414,226,285,925
35504,2020-03-27,(03011) SUBA - CALLE 100,301,183,137,621
35505,2020-04-21,(02000) Cabecera Autopista Norte - alimentacion,2732,1520,1305,5557
35506,2020-02-22,(07000) Portal Sur,4839,2376,3456,10671
35507,2020-04-28,(02000) Cabecera Autopista Norte - alimentacion,2888,1705,1430,6023
35508,2020-01-27,(02202) Calle 127,5762,3784,2865,12411
35509,2020-06-13,(09100) Calle 40 Sur,1369,771,904,3044
35510,2020-07-21,(07104) Simon Bolivar,577,359,223,1159
35511,2020-08-08,(10005) Bicentenario - alimentacion,131,65,140,336
35512,2020-02-26,(04107) Escuela Militar,658,444,469,1571
35513,2020-06-05,(04003) Avenida Ciudad de Cali,971,594,642,2207
35514,2020-02-13,(03001) LA CAMPIÑA,6894,4186,4350,15430
35515,2020-05-19,(10001) Country Sur,934,423,579,1936
35516,2020-09-17,(09110) Avenida Jimenez,1600,1137,1042,3779
35517,2020-02-16,(02202) Calle 127,1003,683,958,2644
35518,2020-04-02,(09103) Olaya,476,286,256,1018
35519,2020-04-28,(03001) LA CAMPIÑA,568,358,308,1234
35520,2020-10-02,(40001) Juan Pablo II,646,404,494,1544
35521,2020-02-16,(07008) NQS - Calle 30 Sur,467,191,448,1106
35522,2020-06-16,(12003) Ricaurte,382,270,195,847
35523,2020-08-29,(07009) SENA,521,284,389,1194
35524,2020-06-17,(06001) Modelia,420,259,211,890
35525,2020-01-16,(02502) Terminal,4161,2530,2819,9510
35526,2020-05-08,(06107) Ciudad Universitaria,131,78,88,297
35527,2020-06-26,(05107) Américas - Cr.53,433,284,282,999
35528,2020-05-12,(05100) Banderas P. Central - alimentacion,2026,1005,1025,4056
35529,2020-03-04,(07201) Guatoque -Veraguas,1046,517,600,2163
35530,2020-01-27,(07105) MOVISTAR ARENA,1298,745,662,2705
35531,2020-10-04,(05100) Banderas P. Central - alimentacion,1161,437,1022,2620
35532,2020-04-04,(07112) COMUNEROS,290,178,161,629
35533,2020-02-23,(06102) Salitre El Greco,277,154,235,666
35534,2020-02-12,(10004) Policarpa,944,446,570,1960
35535,2020-08-14,(06111) Universidades,327,184,320,831
35536,2020-10-11,(04000) Cabecera Calle 80 - intermunicipal,80,36,113,229
35537,2020-02-23,(07005) ALQUERIA,595,310,558,1463
35538,2020-04-16,(03006) NIZA - CALLE 127,251,177,112,540
35539,2020-04-24,(02101) Toberín,678,466,426,1570
35540,2020-09-30,(09107) Hortúa,663,398,561,1622
35541,2020-07-22,(05103) Marsella,394,201,217,812
35542,2020-06-24,(04105) Carrera 53,296,166,149,611
35543,2020-09-15,(09100) Calle 40 Sur,1822,1049,1267,4138
35544,2020-03-07,(07105) MOVISTAR ARENA,689,498,630,1817
35545,2020-04-19,(09004) Santa Lucía,415,220,279,914
35546,2020-07-15,(02200) Alcalá,1675,1118,801,3594
35547,2020-05-15,(05105) Pradera,442,280,202,924
35548,2020-06-23,(05105) Pradera,604,381,281,1266
35549,2020-09-10,(09115) Calle 34,643,408,479,1530
35550,2020-08-23,(03000) Portal Suba,285,185,295,765
35551,2020-07-03,(09114) Calle 26,326,211,225,762
35552,2020-05-11,(04003) Avenida Ciudad de Cali,714,444,506,1664
35553,2020-06-11,(06107) Ciudad Universitaria,175,112,108,395
35554,2020-08-08,(06107) Ciudad Universitaria,104,68,88,260
35555,2020-06-17,(05102) Av. Américas - Av. Boyacá,255,147,144,546
35556,2020-09-30,(40002) Manitas,442,274,352,1068
35557,2020-01-25,(12000) Puente Aranda,162,109,143,414
35558,2020-06-27,(06002) Normandía,242,132,192,566
35559,2020-05-15,(10004) Policarpa,195,95,146,436
35560,2020-07-29,(07110) PALOQUEMAO,586,349,244,1179
35561,2020-10-10,(10004) Policarpa,251,101,202,554
35562,2020-02-17,(07200) Tygua-San José,839,504,584,1927
35563,2020-04-25,(08001) Parque el Tunal,167,87,118,372
35564,2020-04-30,(06100) Av. Rojas,119,91,70,280
35565,2020-01-31,(07200) Tygua-San José,757,446,634,1837
35566,2020-07-23,(03010) PUENTE LARGO,328,184,155,667
35567,2020-03-31,(09115) Calle 34,339,261,220,820
35568,2020-09-14,(12002) CDS - Carrera 32,212,128,90,430
35569,2020-10-05,(06002) Normandía,369,250,313,932
35570,2020-02-25,(07003) SEVILLANA,2149,1247,1076,4472
35571,2020-05-02,(07108) Av. El Dorado,48,31,32,111
35572,2020-09-24,(06103) CAN,422,264,236,922
35573,2020-08-20,(03010) PUENTE LARGO,332,201,215,748
35574,2020-06-03,(03010) PUENTE LARGO,327,194,165,686
35575,2020-09-16,(07006) General Santander - alimentacion,405,228,326,959
35576,2020-02-19,(03014) SAN MARTIN,240,160,183,583
35577,2020-06-24,(09105) Río Fucha,130,59,104,293
35578,2020-05-01,(04103) Las Ferias,108,64,51,223
35579,2020-04-22,(07006) General Santander,281,172,136,589
35580,2020-03-31,(10007) Las Nieves,176,141,124,441
35581,2020-09-06,(03011) SUBA - CALLE 100,182,114,173,469
35582,2020-08-08,(12002) CDS - Carrera 32,92,65,50,207
35583,2020-08-19,(09121) Las Flores,652,389,455,1496
35584,2020-05-22,(07010) Bosa,581,298,371,1250
35585,2020-05-06,(07005) ALQUERIA,362,212,196,770
35586,2020-04-22,(02001) Centro Comercial Santa Fe,213,153,164,530
35587,2020-05-29,(12007) Zona Industrial,279,188,139,606
35588,2020-07-19,(02304) Heroes,164,117,122,403
35589,2020-05-03,(02303) Calle 85,135,90,88,313
35590,2020-05-03,(04003) Avenida Ciudad de Cali,182,110,145,437
35591,2020-07-27,(04001) Quirigua,391,248,213,852
35592,2020-06-30,(07006) General Santander,578,350,312,1240
35593,2020-04-01,(09002) Consuelo,236,117,151,504
35594,2020-05-27,(09105) Río Fucha,119,54,76,249
35595,2020-06-10,(09105) Río Fucha,119,54,82,255
35596,2020-05-04,(03004) GRATAMIRA,24,20,8,52
35597,2020-05-22,(02102) Calle 161,208,123,131,462
35598,2020-09-06,(04105) Carrera 53,84,64,98,246
35599,2020-06-10,(07007) NQS - Calle 38A Sur,367,189,230,786
35600,2020-01-04,(06106) Recinto Ferial,400,254,319,973
35601,2020-08-09,(12002) CDS - Carrera 32,29,32,17,78
35602,2020-02-25,(50006) Corral Carrera 77,35,30,46,111
35603,2020-03-12,(03014) SAN MARTIN,80,25,43,148
35604,2020-05-23,(40002) Manitas,280,140,179,599
35605,2020-07-11,(07101) CASTELLANA,139,88,129,356
35606,2020-05-27,(06107) Ciudad Universitaria,179,116,102,397
35607,2020-07-16,(03007) HUMEDAL CORDOBA,136,96,57,289
35608,2020-05-24,(07108) Av. El Dorado,28,17,13,58
35609,2020-10-04,(40002) Manitas,157,75,160,392
35610,2020-04-11,(06107) Ciudad Universitaria,51,43,50,144
35611,2020-05-14,(14005) Las Aguas,0,44,129,173
35612,2020-08-20,(14005) Las Aguas,159,102,176,437
35613,2020-08-11,(09105) Río Fucha,0,66,131,197
35614,2020-08-07,(09115) Calle 34,188,123,178,489
35615,2020-09-21,(50002) Corral Calle 40 Sur,19,8,19,46
35616,2020-05-03,(05102) Av. Américas - Av. Boyacá,46,20,22,88
35617,2020-03-23,(07104) Simon Bolivar,82,47,63,192
35618,2020-05-29,(07108) Av. El Dorado,131,88,60,279
35619,2020-03-23,(06104) Gobernación,56,39,34,129
35620,2020-03-22,(10009) Museo Nacional,91,58,73,222
35621,2019-12-31,(07106) EL CAMPIN,32,9,14,55
35622,2020-10-05,(50006) Corral Carrera 77,7,4,10,21
35623,2020-09-16,(12000) Puente Aranda,95,56,60,211
35624,2020-04-14,(12004) Carrera 22,56,47,45,148
35625,2020-04-08,(50002) Corral Calle 40 Sur,9,3,5,17
35626,2020-05-04,(03014) SAN MARTIN,17,9,18,44
35627,2020-05-27,(03014) SAN MARTIN,26,13,23,62
35628,2020-04-11,(03004) GRATAMIRA,16,10,12,38
35629,2020-05-10,(07005) ALQUERIA,95,47,56,198
35630,2020-01-16,(09002) Consuelo,1312,700,827,2839
35631,2020-07-01,(02502) Terminal,442,314,364,1120
35632,2020-09-19,(02502) Terminal,286,191,382,859
35633,2020-07-27,(09118) Marly,1385,891,658,2934
35634,2020-01-19,(03013) RIO NEGRO,266,142,328,736
35635,2020-04-13,(07504) TERREROS,2361,1502,1189,5052
35636,2020-01-16,(05000) Portal Américas - alimentacion,33236,17546,18571,69353
35637,2020-09-14,(09119) Calle 57,599,375,416,1390
35638,2020-10-07,(06000) Portal Eldorado - alimentacion,4398,2223,2946,9567
35639,2020-02-20,(09100) Calle 40 Sur,7254,4197,3842,15293
35640,2020-02-17,(03010) PUENTE LARGO,2116,1439,1253,4808
35641,2020-08-25,(06107) Ciudad Universitaria,161,100,96,357
35642,2020-01-16,(02000) Cabecera Autopista Norte - alimentacion,20129,10634,11990,42753
35643,2020-01-25,(02000) Cabecera Autopista Norte - alimentacion,13941,6510,8818,29269
35644,2020-02-24,(07010) Bosa,2268,1309,1479,5056
35645,2020-02-12,(05100) Banderas P. Central,8568,5053,3824,17445
35646,2020-06-18,(10001) Country Sur,1253,582,736,2571
35647,2020-09-05,(10001) Country Sur,1090,455,798,2343
35648,2020-06-29,(07503) SAN MATEO,3526,1940,1862,7328
35649,2020-02-12,(02102) Calle 161,2022,1249,1171,4442
35650,2020-02-24,(02102) Calle 161,1890,1159,1096,4145
35651,2020-01-06,(09115) Calle 34,342,263,541,1146
35652,2020-03-03,(07002) MADELENA,5033,2884,2588,10505
35653,2020-09-28,(07001) PERDOMO,1101,679,805,2585
35654,2020-01-17,(02000) Cabecera Autopista Norte,9091,5240,5555,19886
35655,2020-03-01,(09109) Tercer Milenio,339,207,395,941
35656,2020-04-20,(07505) LEON XIII,1253,750,607,2610
35657,2020-01-15,(06002) Normandía,1955,1156,1188,4299
35658,2020-04-25,(03005) SUBA - AV. BOYACA,180,104,125,409
35659,2020-01-09,(09101) Quiroga,1304,689,1025,3018
35660,2020-02-12,(07102) NQS - CALLE 75,1578,1005,955,3538
35661,2020-07-31,(07102) NQS - CALLE 75,290,182,172,644
35662,2020-01-03,(09103) Olaya,2148,1164,1566,4878
35663,2020-02-02,(09103) Olaya,1018,445,932,2395
35664,2020-04-21,(09110) Avenida Jimenez,350,311,390,1051
35665,2020-01-29,(06001) Modelia,2540,1523,1229,5292
35666,2020-02-11,(02103) Mazurén,3636,2265,1941,7842
35667,2020-04-17,(09104) Restrepo,721,522,613,1856
35668,2020-08-05,(05100) Banderas P. Central - alimentacion,2585,1355,1455,5395
35669,2020-06-28,(07002) MADELENA,234,109,167,510
35670,2020-06-09,(02200) Alcalá,1653,1176,941,3770
35671,2020-08-31,(07112) COMUNEROS,838,484,450,1772
35672,2020-10-05,(07112) COMUNEROS,928,536,677,2141
35673,2020-01-17,(09113) Calle 22,1055,775,980,2810
35674,2020-02-28,(03003) 21 ANGELES,1778,820,941,3539
35675,2020-03-07,(02201) Prado,3013,1665,2265,6943
35676,2020-08-10,(09118) Marly,1432,902,736,3070
35677,2020-03-03,(05107) Américas - Cr.53,2517,1466,1302,5285
35678,2020-03-09,(05107) Américas - Cr.53,738,291,324,1353
35679,2020-01-22,(05002) Tintal,10507,5942,5605,22054
35680,2020-02-20,(04104) Avenida 68,3617,1866,1741,7224
35681,2020-10-04,(02201) Prado,324,202,403,929
35682,2020-06-08,(04002) Carrera 90,676,389,376,1441
35683,2020-01-09,(10008) San Diego,1142,609,596,2347
35684,2020-01-17,(40003) Mirador del Paraiso,4442,2433,2502,9377
35685,2020-01-31,(40003) Mirador del Paraiso,4920,2730,2620,10270
35686,2020-02-28,(10000) Portal 20 de Julio,9163,3989,4082,17234
35687,2020-01-10,(04001) Quirigua,1374,782,944,3100
35688,2020-02-29,(09004) Santa Lucía,5391,2522,3560,11473
35689,2020-06-27,(10002) Av. Primero de Mayo,1689,825,1220,3734
35690,2020-02-03,(09107) Hortúa,2395,1512,1538,5445
35691,2020-03-03,(10005) Bicentenario - alimentacion,705,347,548,1600
35692,2020-02-17,(07106) EL CAMPIN,2162,1347,1128,4637
35693,2020-05-29,(03000) Portal Suba,1107,683,740,2530
35694,2020-07-27,(03000) Portal Suba,1173,720,757,2650
35695,2020-09-17,(03000) Portal Suba,1557,977,1107,3641
35696,2020-07-04,(09000) Cabecera Usme - alimentacion,7532,3892,4671,16095
35697,2020-02-09,(08001) Parque el Tunal,403,177,356,936
35698,2020-01-31,(06100) Av. Rojas,2534,1378,1359,5271
35699,2020-03-11,(06100) Av. Rojas,2574,1508,1213,5295
35700,2020-01-25,(08002) Biblioteca,572,274,426,1272
35701,2020-03-31,(09116) Avenida 39,154,124,115,393
35702,2020-07-16,(06000) Portal Eldorado - alimentacion,3422,1709,1723,6854
35703,2020-04-21,(08001) Parque el Tunal,246,152,132,530
35704,2020-09-18,(08001) Parque el Tunal,531,293,371,1195
35705,2020-01-03,(02302) Virrey,1719,1146,1144,4009
35706,2020-09-11,(02302) Virrey,669,470,379,1518
35707,2020-09-24,(07010) Bosa,0,396,867,1263
35708,2020-02-19,(09120) Calle 63,7502,4769,3899,16170
35709,2020-10-10,(02000) Cabecera Autopista Norte - alimentacion,4295,1905,3319,9519
35710,2020-02-24,(10007) Las Nieves,2180,1213,1189,4582
35711,2020-08-22,(09123) Calle 76,618,431,455,1504
35712,2020-06-25,(50002) Corral Calle 40 Sur,14,11,22,47
35713,2020-01-23,(07007) NQS - Calle 38A Sur,1956,1175,1181,4312
35714,2020-09-14,(08000) Portal Tunal,525,203,352,1080
35715,2020-06-28,(05005) Transversal 86,93,37,73,203
35716,2020-02-14,(09121) Las Flores,3239,2125,2147,7511
35717,2020-05-11,(08000) Portal Tunal,550,241,237,1028
35718,2020-05-13,(03009) Av. Suba- Calle 116,414,271,172,857
35719,2020-08-03,(03009) Av. Suba- Calle 116,393,262,201,856
35720,2020-09-10,(03009) Av. Suba- Calle 116,490,287,265,1042
35721,2020-05-18,(02205) Calle 106,310,200,139,649
35722,2020-07-29,(02205) Calle 106,331,215,165,711
35723,2020-09-21,(04108) El Polo,454,278,266,998
35724,2020-01-20,(07101) CASTELLANA,915,551,568,2034
35725,2020-06-26,(03007) HUMEDAL CORDOBA,188,102,65,355
35726,2020-02-04,(07108) Av. El Dorado,954,573,606,2133
35727,2020-01-20,(09117) Calle 45,4432,3004,2683,10119
35728,2020-05-13,(10000) Portal 20 de Julio,1812,933,878,3623
35729,2020-01-15,(04103) Las Ferias,1348,722,823,2893
35730,2020-01-28,(04103) Las Ferias,1504,845,864,3213
35731,2020-05-24,(10002) Av. Primero de Mayo,458,242,314,1014
35732,2020-01-03,(05107) Américas - Cr.53,1272,767,885,2924
35733,2020-04-25,(02304) Heroes,282,217,150,649
35734,2020-08-02,(09100) Calle 40 Sur,530,277,449,1256
35735,2020-05-22,(10005) Bicentenario - alimentacion,213,110,129,452
35736,2020-05-27,(10010) San Bernardo,556,271,362,1189
35737,2020-05-21,(07002) MADELENA,589,340,336,1265
35738,2020-04-28,(10005) Bicentenario - alimentacion,151,82,130,363
35739,2020-01-17,(09109) Tercer Milenio,1257,742,854,2853
35740,2020-09-23,(09109) Tercer Milenio,387,231,289,907
35741,2020-09-19,(07002) MADELENA,756,336,642,1734
35742,2020-01-03,(07109) CAD,1376,853,844,3073
35743,2020-02-08,(04105) Carrera 53,829,439,579,1847
35744,2020-07-16,(06101) El Tiempo,342,187,175,704
35745,2020-03-25,(40003) Mirador del Paraiso,636,374,383,1393
35746,2020-04-10,(02205) Calle 106,63,44,40,147
35747,2020-06-07,(05001) Patio Bonito,442,234,295,971
35748,2020-07-26,(05001) Patio Bonito,402,202,275,879
35749,2020-10-07,(07109) CAD,750,479,460,1689
35750,2020-06-17,(06106) Recinto Ferial,253,159,115,527
35751,2020-09-05,(02001) Centro Comercial Santa Fe,388,219,399,1006
35752,2020-01-13,(07008) NQS - Calle 30 Sur,1539,854,890,3283
35753,2020-04-14,(09120) Calle 63,572,425,369,1366
35754,2020-04-05,(09000) Cabecera Usme - alimentacion,1686,816,912,3414
35755,2020-07-01,(03010) PUENTE LARGO,351,239,228,818
35756,2020-07-03,(03010) PUENTE LARGO,394,245,214,853
35757,2020-01-31,(10007) Las Nieves,1781,1219,1267,4267
35758,2020-09-16,(06103) CAN,422,255,207,884
35759,2020-03-24,(02104) Calle 146,696,476,529,1701
35760,2020-04-06,(02105) Calle 142,381,299,235,915
35761,2020-03-13,(10010) San Bernardo,165,239,286,690
35762,2020-08-06,(02105) Calle 142,683,433,410,1526
35763,2020-08-05,(12007) Zona Industrial,225,127,138,490
35764,2020-02-24,(07201) Guatoque -Veraguas,1008,523,592,2123
35765,2020-03-24,(06102) Salitre El Greco,323,219,183,725
35766,2020-04-29,(06109) Centro Memoria,198,123,102,423
35767,2020-07-02,(02304) Heroes,932,638,520,2090
35768,2020-04-06,(02001) Centro Comercial Santa Fe,185,115,155,455
35769,2020-06-28,(07112) COMUNEROS,210,125,162,497
35770,2020-06-24,(02104) Calle 146,782,505,530,1817
35771,2020-02-15,(10009) Museo Nacional,1112,964,1438,3514
35772,2020-07-26,(09120) Calle 63,252,175,222,649
35773,2020-10-09,(05102) Av. Américas - Av. Boyacá,303,166,243,712
35774,2020-05-18,(40001) Juan Pablo II,452,289,279,1020
35775,2020-10-04,(10002) Av. Primero de Mayo,676,325,869,1870
35776,2020-10-05,(10003) Ciudad Jardín,260,126,230,616
35777,2020-01-23,(09120) Calle 63,4408,3131,3161,10700
35778,2020-02-05,(12004) Carrera 22,777,455,485,1717
35779,2020-03-12,(07201) Guatoque -Veraguas,194,137,136,467
35780,2020-06-18,(07200) Tygua-San José,231,123,167,521
35781,2020-06-20,(06109) Centro Memoria,201,122,116,439
35782,2020-03-21,(50002) Corral Calle 40 Sur,4,15,8,27
35783,2020-07-02,(07201) Guatoque -Veraguas,200,114,133,447
35784,2020-03-04,(07506) DESPENSA,1412,981,894,3287
35785,2020-05-30,(02200) Alcalá,1270,868,618,2756
35786,2020-07-13,(07107) U. NACIONAL,342,195,166,703
35787,2020-05-25,(07110) PALOQUEMAO,175,125,81,381
35788,2020-06-23,(14004) Museo del Oro,275,189,206,670
35789,2020-07-31,(14004) Museo del Oro,252,155,189,596
35790,2020-09-21,(07004) VENECIA,903,519,581,2003
35791,2020-08-19,(06107) Ciudad Universitaria,159,89,115,363
35792,2020-01-26,(40002) Manitas,356,125,332,813
35793,2020-03-08,(40002) Manitas,317,152,287,756
35794,2020-07-16,(04103) Las Ferias,313,168,142,623
35795,2020-05-31,(04104) Avenida 68,172,116,92,380
35796,2020-04-24,(06111) Universidades,0,95,202,297
35797,2020-07-16,(07103) AV. CHILE,878,552,406,1836
35798,2020-08-14,(03005) SUBA - AV. BOYACA,380,236,253,869
35799,2020-10-09,(09114) Calle 26,385,255,346,986
35800,2020-05-13,(08002) Biblioteca,242,136,119,497
35801,2020-09-30,(14005) Las Aguas,290,191,297,778
35802,2020-09-15,(12001) Carrera 43,444,250,281,975
35803,2020-04-07,(14005) Las Aguas,0,40,97,137
35804,2020-08-29,(02102) Calle 161,181,104,167,452
35805,2020-07-25,(06108) Concejo de Bogotá,81,42,48,171
35806,2020-08-15,(06002) Normandía,196,124,157,477
35807,2020-09-18,(06001) Modelia,419,261,266,946
35808,2020-10-04,(09100) Calle 40 Sur,658,308,695,1661
35809,2020-04-02,(10009) Museo Nacional,305,216,189,710
35810,2020-06-02,(07006) General Santander - alimentacion,329,211,225,765
35811,2020-06-06,(07113) SANTA ISABEL,269,161,198,628
35812,2020-08-26,(50003) Corral Molinos,1435,708,1025,3168
35813,2020-04-06,(09000) Cabecera Usme,839,443,621,1903
35814,2020-07-21,(03010) PUENTE LARGO,339,197,207,743
35815,2020-04-11,(14001) La Sabana,55,36,32,123
35816,2020-07-01,(07008) NQS - Calle 30 Sur,322,169,222,713
35817,2020-08-15,(04102) Avenida Boyaca,284,139,206,629
35818,2020-08-10,(12002) CDS - Carrera 32,192,112,69,373
35819,2020-07-26,(02502) Terminal,71,57,103,231
35820,2020-09-10,(07108) Av. El Dorado,156,83,101,340
35821,2020-04-04,(06002) Normandía,90,65,59,214
35822,2020-01-08,(07200) Tygua-San José,520,319,437,1276
35823,2020-09-21,(03010) PUENTE LARGO,342,208,212,762
35824,2020-04-16,(09003) Socorro,306,157,162,625
35825,2020-08-01,(03012) SUBA - CALLE 95,160,105,105,370
35826,2020-07-13,(12002) CDS - Carrera 32,111,92,128,331
35827,2020-04-08,(04103) Las Ferias,177,118,96,391
35828,2020-04-16,(04103) Las Ferias,216,129,91,436
35829,2020-03-15,(07006) General Santander - alimentacion,232,129,301,662
35830,2020-09-16,(06105) Quinta Paredes,159,105,93,357
35831,2020-06-29,(09113) Calle 22,230,138,204,572
35832,2020-08-04,(07006) General Santander - alimentacion,339,195,245,779
35833,2020-08-29,(07008) NQS - Calle 30 Sur,268,116,210,594
35834,2020-05-20,(05102) Av. Américas - Av. Boyacá,191,89,94,374
35835,2020-04-07,(10004) Policarpa,112,71,84,267
35836,2020-04-20,(09117) Calle 45,446,305,233,984
35837,2020-03-27,(06001) Modelia,267,180,173,620
35838,2020-10-02,(06105) Quinta Paredes,181,106,133,420
35839,2020-06-08,(04001) Quirigua,375,225,252,852
35840,2020-03-12,(10004) Policarpa,101,143,117,361
35841,2020-01-18,(12004) Carrera 22,428,282,319,1029
35842,2020-01-18,(12000) Puente Aranda,150,89,123,362
35843,2020-06-13,(06103) CAN,235,151,165,551
35844,2020-07-13,(06107) Ciudad Universitaria,149,88,97,334
35845,2020-05-23,(07108) Av. El Dorado,73,44,52,169
35846,2020-09-24,(03004) GRATAMIRA,0,18,40,58
35847,2020-05-19,(07506) DESPENSA,396,212,222,830
35848,2020-04-18,(09110) Avenida Jimenez,183,160,200,543
35849,2020-05-14,(12002) CDS - Carrera 32,193,126,62,381
35850,2020-03-29,(07104) Simon Bolivar,59,39,45,143
35851,2020-04-16,(07006) General Santander,242,166,138,546
35852,2020-05-06,(07006) General Santander,310,203,159,672
35853,2020-06-07,(10005) Bicentenario - alimentacion,42,19,53,114
35854,2020-05-16,(06103) CAN,216,159,100,475
35855,2020-07-13,(10003) Ciudad Jardín,136,69,115,320
35856,2020-08-16,(07010) Bosa,166,64,135,365
35857,2020-04-17,(07008) NQS - Calle 30 Sur,158,85,99,342
35858,2020-05-10,(02204) Pepe Sierra,171,150,97,418
35859,2020-10-12,(09106) Nariño,145,82,207,434
35860,2020-04-25,(04105) Carrera 53,121,75,65,261
35861,2020-04-16,(07101) CASTELLANA,81,60,72,213
35862,2020-06-22,(07109) CAD,193,124,120,437
35863,2020-07-28,(06108) Concejo de Bogotá,116,72,92,280
35864,2020-05-14,(07108) Av. El Dorado,112,67,69,248
35865,2020-05-09,(03014) SAN MARTIN,16,9,16,41
35866,2019-12-31,(06105) Quinta Paredes,3,1,10,14
35867,2020-04-19,(03011) SUBA - CALLE 100,113,58,57,228
35868,2020-09-02,(09105) Río Fucha,0,55,144,199
35869,2020-04-09,(09106) Nariño,72,53,55,180
35870,2020-08-16,(50002) Corral Calle 40 Sur,3,3,6,12
35871,2020-04-03,(04103) Las Ferias,162,123,94,379
35872,2020-08-23,(09105) Río Fucha,0,17,48,65
35873,2020-05-02,(50002) Corral Calle 40 Sur,8,5,8,21
35874,2020-04-09,(03014) SAN MARTIN,5,3,7,15
35875,2020-01-13,(09002) Consuelo,1187,648,729,2564
35876,2020-01-26,(09002) Consuelo,417,156,375,948
35877,2020-02-18,(09118) Marly,8537,5524,4098,18159
35878,2020-07-27,(05000) Portal Américas - alimentacion,9047,4932,4431,18410
35879,2020-01-07,(07111) NQS - RICAURTE,2059,1290,1263,4612
35880,2020-07-21,(07503) SAN MATEO,10553,6105,5069,21727
35881,2020-02-18,(06000) Portal Eldorado - alimentacion,19192,10458,9573,39223
35882,2020-05-06,(05000) Portal Américas,1579,1159,1245,3983
35883,2020-02-10,(09100) Calle 40 Sur,7628,4485,4387,16500
35884,2020-02-14,(09000) Cabecera Usme - alimentacion,26774,14685,15849,57308
35885,2020-10-06,(07503) SAN MATEO,14060,6978,7846,28884
35886,2020-01-18,(07010) Bosa,1487,753,1181,3421
35887,2020-02-05,(02000) Cabecera Autopista Norte - intermunicipal,5354,3569,3135,12058
35888,2020-02-19,(07000) Portal Sur - alimentacion,30102,17219,14308,61629
35889,2020-07-25,(10001) Country Sur,682,309,415,1406
35890,2020-01-22,(02000) Cabecera Autopista Norte,10093,6304,5646,22043
35891,2020-02-01,(07009) SENA,2205,1123,1525,4853
35892,2020-02-25,(07000) Portal Sur - alimentacion,29803,17544,14624,61971
35893,2020-01-23,(02204) Pepe Sierra,4820,3189,2352,10361
35894,2020-06-06,(09000) Cabecera Usme - alimentacion,6134,3365,3756,13255
35895,2020-04-16,(07001) PERDOMO,393,243,237,873
35896,2020-05-08,(07001) PERDOMO,594,344,341,1279
35897,2020-05-07,(40003) Mirador del Paraiso,1080,693,635,2408
35898,2020-01-22,(04000) Cabecera Calle 80 - intermunicipal,1867,1333,1921,5121
35899,2020-06-04,(04101) Minuto de Dios,286,173,203,662
35900,2020-04-29,(07505) LEON XIII,1317,898,694,2909
35901,2020-05-05,(07505) LEON XIII,1461,948,842,3251
35902,2020-01-26,(02204) Pepe Sierra,614,470,750,1834
35903,2020-01-13,(09123) Calle 76,4009,2696,2497,9202
35904,2020-02-20,(09123) Calle 76,5787,3770,2989,12546
35905,2020-02-20,(09004) Santa Lucía,7333,4134,3998,15465
35906,2020-08-16,(04100) Carrera 77,347,165,301,813
35907,2020-06-17,(07102) NQS - CALLE 75,466,278,216,960
35908,2020-09-02,(07102) NQS - CALLE 75,492,303,234,1029
35909,2020-09-17,(09000) Cabecera Usme - alimentacion,9414,4868,6128,20410
35910,2020-07-22,(06000) Portal Eldorado - alimentacion,3628,1768,1786,7182
35911,2020-08-16,(07000) Portal Sur - alimentacion,2379,1020,1474,4873
35912,2020-02-05,(07110) PALOQUEMAO,2257,1464,1431,5152
35913,2020-03-02,(06001) Modelia,2607,1523,1276,5406
35914,2020-02-10,(09116) Avenida 39,3365,2071,1645,7081
35915,2020-01-04,(09104) Restrepo,2037,1243,1982,5262
35916,2020-04-17,(05100) Banderas P. Central - alimentacion,1593,801,708,3102
35917,2020-07-31,(09103) Olaya,933,511,568,2012
35918,2020-03-17,(14001) La Sabana,289,222,252,763
35919,2020-08-26,(14001) La Sabana,163,107,92,362
35920,2020-06-02,(07002) MADELENA,683,397,421,1501
35921,2020-09-12,(08000) Portal Tunal - alimentacion,5424,2567,3418,11409
35922,2020-04-21,(02200) Alcalá,928,703,479,2110
35923,2020-02-12,(10007) Las Nieves,2146,1292,1246,4684
35924,2020-08-28,(50003) Corral Molinos,1562,800,1094,3456
35925,2020-01-14,(06106) Recinto Ferial,1218,673,710,2601
35926,2020-01-27,(09114) Calle 26,2552,1879,1779,6210
35927,2020-01-31,(07506) DESPENSA,1706,873,963,3542
35928,2020-07-28,(04100) Carrera 77,1147,697,754,2598
35929,2020-08-21,(10006) San Victorino,398,237,331,966
35930,2020-09-25,(10006) San Victorino,809,417,420,1646
35931,2020-07-06,(10000) Portal 20 de Julio - alimentacion,4322,2072,2669,9063
35932,2020-02-05,(10000) Portal 20 de Julio,9178,4197,4126,17501
35933,2020-01-08,(05002) Tintal,8257,4472,4550,17279
35934,2020-09-16,(10002) Av. Primero de Mayo,2366,1235,1617,5218
35935,2020-07-04,(10005) Bicentenario - alimentacion,172,88,190,450
35936,2020-05-20,(05002) Tintal,1759,943,928,3630
35937,2020-01-11,(09119) Calle 57,1067,791,1134,2992
35938,2020-01-08,(02302) Virrey,2897,1915,1439,6251
35939,2020-06-18,(02000) Cabecera Autopista Norte - intermunicipal,559,372,389,1320
35940,2020-07-05,(08001) Parque el Tunal,141,68,123,332
35941,2020-06-11,(08000) Portal Tunal - alimentacion,6039,3375,3135,12549
35942,2020-07-05,(07000) Portal Sur - alimentacion,2682,1269,1506,5457
35943,2020-05-22,(02303) Calle 85,570,403,271,1244
35944,2020-06-05,(09116) Avenida 39,298,201,197,696
35945,2020-01-06,(08002) Biblioteca,165,69,185,419
35946,2020-02-29,(07108) Av. El Dorado,400,288,475,1163
35947,2020-05-06,(09107) Hortúa,468,289,220,977
35948,2020-06-16,(09116) Avenida 39,354,220,220,794
35949,2020-01-23,(06103) CAN,2398,1422,1120,4940
35950,2020-02-21,(06103) CAN,2498,1493,1147,5138
35951,2020-01-31,(06108) Concejo de Bogotá,850,450,485,1785
35952,2020-06-25,(02000) Cabecera Autopista Norte,1374,861,855,3090
35953,2020-03-27,(03000) Portal Suba - alimentacion,3307,1757,1758,6822
35954,2020-01-10,(10009) Museo Nacional,2821,1639,1592,6052
35955,2020-10-10,(05101) Mandalay - Cr.73,104,55,99,258
35956,2020-04-15,(05002) Tintal,1284,659,571,2514
35957,2020-09-28,(05002) Tintal,2913,1722,1978,6613
35958,2020-05-28,(10000) Portal 20 de Julio,2078,1049,1012,4139
35959,2020-02-17,(03011) SUBA - CALLE 100,2796,1352,1446,5594
35960,2020-02-28,(03011) SUBA - CALLE 100,2507,1360,1518,5385
35961,2020-05-01,(02300) Calle 100,369,252,228,849
35962,2020-02-20,(03012) SUBA - CALLE 95,1425,920,922,3267
35963,2020-07-14,(09119) Calle 57,415,271,246,932
35964,2020-04-19,(02000) Cabecera Autopista Norte - alimentacion,1197,629,471,2297
35965,2020-02-04,(05105) Pradera,2599,1515,1291,5405
35966,2020-09-26,(07104) Simon Bolivar,437,307,350,1094
35967,2020-05-18,(09104) Restrepo,1133,740,864,2737
35968,2020-03-26,(05005) Transversal 86,176,90,88,354
35969,2020-09-28,(05005) Transversal 86,489,257,380,1126
35970,2020-10-06,(05005) Transversal 86,520,294,391,1205
35971,2020-09-03,(02202) Calle 127,1135,820,667,2622
35972,2020-09-29,(02205) Calle 106,426,286,282,994
35973,2020-02-08,(06111) Universidades,1951,1292,1807,5050
35974,2020-02-02,(02300) Calle 100,908,764,1325,2997
35975,2020-01-22,(12007) Zona Industrial,1192,770,628,2590
35976,2020-03-05,(12007) Zona Industrial,1206,711,642,2559
35977,2020-02-19,(07201) Guatoque -Veraguas,1073,493,622,2188
35978,2020-09-25,(02201) Prado,1061,684,746,2491
35979,2020-01-23,(07103) AV. CHILE,3606,2137,1784,7527
35980,2020-02-28,(07103) AV. CHILE,3548,2314,1946,7808
35981,2020-01-09,(03007) HUMEDAL CORDOBA,575,369,401,1345
35982,2020-04-27,(03007) HUMEDAL CORDOBA,21,38,9,68
35983,2020-09-02,(07000) Portal Sur,2094,1330,1387,4811
35984,2020-03-26,(02101) Toberín,598,436,439,1473
35985,2020-03-29,(02101) Toberín,129,94,111,334
35986,2020-02-25,(04103) Las Ferias,1600,942,802,3344
35987,2020-04-03,(05100) Banderas P. Central - alimentacion,1504,675,656,2835
35988,2020-04-05,(05100) Banderas P. Central - alimentacion,501,212,225,938
35989,2020-04-29,(07104) Simon Bolivar,316,207,155,678
35990,2020-07-31,(10005) Bicentenario - alimentacion,196,95,177,468
35991,2020-03-01,(03006) NIZA - CALLE 127,489,328,502,1319
35992,2020-10-10,(04003) Avenida Ciudad de Cali,890,427,973,2290
35993,2020-02-25,(09106) Nariño,2174,1336,1366,4876
35994,2020-06-20,(07000) Portal Sur,1475,873,960,3308
35995,2020-09-09,(03001) LA CAMPIÑA,1283,717,773,2773
35996,2020-03-19,(04105) Carrera 53,683,363,375,1421
35997,2020-07-16,(04105) Carrera 53,259,141,142,542
35998,2020-07-27,(09117) Calle 45,666,414,371,1451
35999,2020-03-07,(06100) Av. Rojas,869,558,890,2317
36000,2020-08-09,(05001) Patio Bonito,533,291,363,1187
36001,2020-05-30,(09002) Consuelo,378,168,205,751
36002,2020-05-26,(06106) Recinto Ferial,218,152,109,479
36003,2020-08-09,(02001) Centro Comercial Santa Fe,95,66,129,290
36004,2020-05-16,(07009) SENA,367,229,211,807
36005,2020-08-17,(09122) Calle 72,303,229,285,817
36006,2020-06-10,(12003) Ricaurte,330,234,153,717
36007,2020-04-21,(07106) EL CAMPIN,178,132,109,419
36008,2020-05-01,(02302) Virrey,195,154,105,454
36009,2020-02-22,(04003) Avenida Ciudad de Cali,3261,1541,2481,7283
36010,2020-01-02,(06108) Concejo de Bogotá,366,191,227,784
36011,2020-03-28,(10010) San Bernardo,199,152,170,521
36012,2020-06-05,(02103) Mazurén,186,111,145,442
36013,2020-09-16,(07103) AV. CHILE,1024,607,601,2232
36014,2020-06-23,(12007) Zona Industrial,381,240,175,796
36015,2020-07-15,(12007) Zona Industrial,328,222,141,691
36016,2020-05-17,(06108) Concejo de Bogotá,47,31,25,103
36017,2020-02-25,(07006) General Santander,2933,1729,1573,6235
36018,2020-07-04,(04100) Carrera 77,1069,547,709,2325
36019,2020-09-07,(10008) San Diego,274,179,229,682
36020,2020-08-02,(09120) Calle 63,343,214,269,826
36021,2020-09-02,(10009) Museo Nacional,555,312,366,1233
36022,2020-01-12,(09119) Calle 57,436,305,673,1414
36023,2020-09-05,(06111) Universidades,339,185,390,914
36024,2020-09-25,(09115) Calle 34,753,457,557,1767
36025,2020-09-05,(09115) Calle 34,413,291,453,1157
36026,2020-01-15,(07105) MOVISTAR ARENA,1246,702,712,2660
36027,2020-09-19,(03013) RIO NEGRO,217,125,221,563
36028,2020-09-23,(03013) RIO NEGRO,320,187,250,757
36029,2020-07-12,(07110) PALOQUEMAO,165,135,115,415
36030,2020-09-16,(07110) PALOQUEMAO,704,407,385,1496
36031,2020-03-21,(06105) Quinta Paredes,27,38,29,94
36032,2020-09-16,(02105) Calle 142,874,552,626,2052
36033,2020-08-28,(06100) Av. Rojas,228,148,156,532
36034,2020-08-17,(03012) SUBA - CALLE 95,75,52,69,196
36035,2020-08-02,(05107) Américas - Cr.53,60,53,86,199
36036,2020-02-09,(06001) Modelia,258,185,349,792
36037,2020-06-17,(04105) Carrera 53,280,168,155,603
36038,2020-05-19,(02303) Calle 85,553,403,284,1240
36039,2020-05-20,(06104) Gobernación,224,145,84,453
36040,2020-09-11,(06104) Gobernación,255,153,136,544
36041,2020-02-11,(07006) General Santander - alimentacion,1584,953,1028,3565
36042,2020-09-02,(07201) Guatoque -Veraguas,220,119,146,485
36043,2020-05-06,(07105) MOVISTAR ARENA,158,116,100,374
36044,2020-01-04,(09105) Río Fucha,225,137,227,589
36045,2020-07-09,(02200) Alcalá,1936,1302,985,4223
36046,2020-09-24,(09115) Calle 34,732,461,572,1765
36047,2020-05-21,(09100) Calle 40 Sur,1387,785,828,3000
36048,2020-05-09,(03003) 21 ANGELES,152,67,65,284
36049,2020-06-09,(07004) VENECIA,907,549,527,1983
36050,2020-04-01,(09121) Las Flores,405,288,260,953
36051,2020-08-14,(40001) Juan Pablo II,521,317,357,1195
36052,2020-04-19,(40002) Manitas,72,43,61,176
36053,2020-06-13,(06107) Ciudad Universitaria,145,85,105,335
36054,2020-07-01,(04103) Las Ferias,375,193,194,762
36055,2020-05-03,(08000) Portal Tunal,183,94,89,366
36056,2020-09-02,(03005) SUBA - AV. BOYACA,504,310,311,1125
36057,2020-09-20,(06111) Universidades,114,86,232,432
36058,2020-02-08,(40001) Juan Pablo II,1227,653,839,2719
36059,2020-02-01,(10004) Policarpa,582,248,555,1385
36060,2020-03-24,(12000) Puente Aranda,56,50,47,153
36061,2020-04-06,(06002) Normandía,171,112,97,380
36062,2020-06-05,(05102) Av. Américas - Av. Boyacá,182,93,150,425
36063,2020-05-30,(02102) Calle 161,158,94,112,364
36064,2020-06-23,(02102) Calle 161,255,177,159,591
36065,2020-07-12,(14001) La Sabana,67,48,58,173
36066,2020-08-03,(10009) Museo Nacional,458,261,283,1002
36067,2020-07-20,(03013) RIO NEGRO,79,58,47,184
36068,2020-05-11,(06100) Av. Rojas,160,92,101,353
36069,2020-03-29,(14001) La Sabana,28,31,21,80
36070,2020-01-06,(05100) Banderas P. Central,599,258,590,1447
36071,2020-05-09,(07004) VENECIA,479,283,301,1063
36072,2020-07-27,(12002) CDS - Carrera 32,166,87,59,312
36073,2020-07-25,(06103) CAN,192,112,112,416
36074,2020-01-06,(02205) Calle 106,169,166,258,593
36075,2020-09-08,(09108) Hospital,58,43,70,171
36076,2020-03-08,(03014) SAN MARTIN,42,32,58,132
36077,2020-08-29,(07002) MADELENA,606,289,496,1391
36078,2020-03-20,(06103) CAN,383,257,158,798
36079,2020-07-17,(07006) General Santander,505,316,266,1087
36080,2020-06-14,(03001) LA CAMPIÑA,256,129,159,544
36081,2020-05-17,(04106) Carrera 47,88,43,48,179
36082,2020-09-28,(07107) U. NACIONAL,403,257,296,956
36083,2020-06-16,(07008) NQS - Calle 30 Sur,282,154,158,594
36084,2020-05-29,(07006) General Santander - alimentacion,344,207,196,747
36085,2020-05-11,(09121) Las Flores,523,362,279,1164
36086,2020-01-06,(06108) Concejo de Bogotá,111,84,111,306
36087,2020-06-26,(07006) General Santander,568,355,296,1219
36088,2020-05-16,(03002) SUBA - TV- 91,401,210,261,872
36089,2020-09-04,(10003) Ciudad Jardín,241,115,165,521
36090,2020-09-23,(10003) Ciudad Jardín,259,122,209,590
36091,2020-07-22,(06001) Modelia,331,215,176,722
36092,2020-03-14,(07101) CASTELLANA,356,263,384,1003
36093,2020-04-22,(07103) AV. CHILE,544,372,215,1131
36094,2020-03-31,(04102) Avenida Boyaca,129,75,95,299
36095,2020-07-12,(04002) Carrera 90,247,119,181,547
36096,2020-02-02,(02102) Calle 161,282,150,369,801
36097,2020-08-23,(04000) Cabecera Calle 80,238,157,301,696
36098,2020-04-04,(03009) Av. Suba- Calle 116,224,153,118,495
36099,2019-12-31,(05002) Tintal,55,52,142,249
36100,2020-07-12,(07005) ALQUERIA,175,95,177,447
36101,2020-05-06,(03013) RIO NEGRO,182,119,119,420
36102,2020-07-18,(02103) Mazurén,106,69,96,271
36103,2020-05-19,(09003) Socorro,479,252,239,970
36104,2020-05-21,(10003) Ciudad Jardín,143,78,91,312
36105,2020-04-04,(02000) Cabecera Autopista Norte - intermunicipal,54,52,51,157
36106,2020-07-05,(02000) Cabecera Autopista Norte - intermunicipal,132,87,155,374
36107,2020-08-13,(05103) Marsella,420,212,196,828
36108,2020-06-16,(10003) Ciudad Jardín,206,112,131,449
36109,2020-04-30,(07200) Tygua-San José,119,63,77,259
36110,2020-04-14,(06106) Recinto Ferial,151,114,79,344
36111,2020-06-29,(07003) SEVILLANA,144,69,100,313
36112,2020-05-24,(05103) Marsella,67,40,44,151
36113,2020-05-10,(05102) Av. Américas - Av. Boyacá,47,22,26,95
36114,2020-04-23,(07010) Bosa,314,191,214,719
36115,2020-04-25,(07008) NQS - Calle 30 Sur,118,65,58,241
36116,2020-06-08,(09105) Río Fucha,120,50,90,260
36117,2020-05-31,(07113) SANTA ISABEL,104,63,87,254
36118,2020-10-09,(50006) Corral Carrera 77,5,4,12,21
36119,2020-03-23,(03014) SAN MARTIN,8,8,6,22
36120,2020-05-31,(10006) San Victorino,89,63,91,243
36121,2020-04-12,(12000) Puente Aranda,10,6,7,23
36122,2020-04-14,(12000) Puente Aranda,42,20,15,77
36123,2020-05-28,(14005) Las Aguas,0,48,184,232
36124,2019-12-31,(07101) CASTELLANA,2,1,10,13
36125,2020-04-26,(12000) Puente Aranda,9,3,7,19
36126,2020-09-11,(09002) Consuelo,505,255,324,1084
36127,2020-07-25,(02502) Terminal,226,155,202,583
36128,2020-08-24,(02502) Terminal,359,245,264,868
36129,2020-02-05,(07504) TERREROS,17690,10893,9554,38137
36130,2020-06-01,(07504) TERREROS,5194,3035,2615,10844
36131,2020-02-27,(05000) Portal Américas - alimentacion,37447,21862,20891,80200
36132,2020-01-24,(04106) Carrera 47,1402,738,837,2977
36133,2020-04-24,(05000) Portal Américas - alimentacion,6609,3409,2843,12861
36134,2020-03-02,(02200) Alcalá,14521,9217,6695,30433
36135,2020-01-07,(03010) PUENTE LARGO,1441,853,878,3172
36136,2020-01-24,(09003) Socorro,1580,841,974,3395
36137,2020-02-20,(02000) Cabecera Autopista Norte - alimentacion,23341,13616,12570,49527
36138,2020-03-17,(50003) Corral Molinos,2877,1507,2061,6445
36139,2020-02-23,(07503) SAN MATEO,9323,4176,5937,19436
36140,2020-03-23,(05000) Portal Américas - alimentacion,2921,1308,1215,5444
36141,2020-07-01,(05000) Portal Américas - alimentacion,10870,5997,5671,22538
36142,2020-07-31,(09001) Molinos,2277,1248,1537,5062
36143,2020-03-05,(04103) Las Ferias,1575,873,888,3336
36144,2020-03-14,(02000) Cabecera Autopista Norte - intermunicipal,1685,980,1606,4271
36145,2020-03-02,(07000) Portal Sur - alimentacion,28120,16243,14655,59018
36146,2020-03-09,(08000) Portal Tunal - alimentacion,932,5822,3555,10309
36147,2020-02-27,(14004) Museo del Oro,4339,2608,1955,8902
36148,2020-03-03,(05005) Transversal 86,2905,1611,1345,5861
36149,2020-10-12,(09004) Santa Lucía,1009,391,768,2168
36150,2020-01-13,(05100) Banderas P. Central,5927,3589,3295,12811
36151,2020-09-02,(05100) Banderas P. Central,965,570,636,2171
36152,2020-01-24,(07009) SENA,3294,1828,2072,7194
36153,2020-02-09,(07009) SENA,954,435,835,2224
36154,2020-09-05,(10003) Ciudad Jardín,179,86,176,441
36155,2020-02-26,(02105) Calle 142,7278,4171,4011,15460
36156,2020-02-25,(09000) Cabecera Usme - alimentacion,26209,15045,15870,57124
36157,2020-04-09,(40003) Mirador del Paraiso,317,188,241,746
36158,2020-02-22,(07505) LEON XIII,6011,2992,3053,12056
36159,2020-05-12,(07505) LEON XIII,1785,1114,866,3765
36160,2020-05-16,(07505) LEON XIII,1361,802,753,2916
36161,2020-06-01,(07505) LEON XIII,2446,1352,1098,4896
36162,2020-02-14,(05002) Tintal,11501,6425,5930,23856
36163,2020-01-23,(09123) Calle 76,5018,3394,2914,11326
36164,2020-01-07,(03005) SUBA - AV. BOYACA,1714,1084,1125,3923
36165,2020-03-08,(03013) RIO NEGRO,260,157,323,740
36166,2020-05-26,(03013) RIO NEGRO,288,175,203,666
36167,2020-03-14,(06000) Portal Eldorado - alimentacion,9466,4365,6092,19923
36168,2020-02-04,(02001) Centro Comercial Santa Fe,4874,3080,2701,10655
36169,2020-01-03,(07111) NQS - RICAURTE,1237,879,923,3039
36170,2020-03-02,(07107) U. NACIONAL,2765,1748,1400,5913
36171,2020-06-10,(02000) Cabecera Autopista Norte - alimentacion,4508,2538,2301,9347
36172,2020-08-10,(07112) COMUNEROS,757,412,433,1602
36173,2020-03-16,(09114) Calle 26,2129,1422,1169,4720
36174,2020-02-14,(10001) Country Sur,5256,2281,2794,10331
36175,2020-02-04,(10006) San Victorino,2554,1336,1293,5183
36176,2020-09-11,(40003) Mirador del Paraiso,1671,891,1121,3683
36177,2020-03-05,(10000) Portal 20 de Julio,9026,4010,4013,17049
36178,2020-02-29,(12001) Carrera 43,843,520,888,2251
36179,2020-05-13,(12001) Carrera 43,346,192,163,701
36180,2020-08-17,(12001) Carrera 43,76,49,61,186
36181,2020-08-29,(50003) Corral Molinos,1275,604,1087,2966
36182,2020-01-23,(07113) SANTA ISABEL,2023,1165,1338,4526
36183,2020-01-25,(09107) Hortúa,1205,702,1050,2957
36184,2020-07-10,(10005) Bicentenario - alimentacion,237,105,218,560
36185,2020-02-17,(02000) Cabecera Autopista Norte - intermunicipal,5247,3591,2991,11829
36186,2020-05-19,(09000) Cabecera Usme - alimentacion,6506,3755,3844,14105
36187,2020-08-26,(10000) Portal 20 de Julio,2088,1036,1059,4183
36188,2020-02-24,(02300) Calle 100,7095,4574,3879,15548
36189,2020-09-01,(07108) Av. El Dorado,162,98,86,346
36190,2020-06-09,(07010) Bosa,695,335,398,1428
36191,2020-05-01,(08000) Portal Tunal - alimentacion,1991,1041,976,4008
36192,2020-04-28,(02201) Prado,524,322,260,1106
36193,2020-01-20,(02304) Heroes,4007,2766,2109,8882
36194,2020-09-04,(09107) Hortúa,617,379,426,1422
36195,2020-08-28,(02204) Pepe Sierra,781,570,445,1796
36196,2020-07-23,(40003) Mirador del Paraiso,1209,753,812,2774
36197,2020-01-10,(05103) Marsella,2014,1027,1161,4202
36198,2020-02-14,(03012) SUBA - CALLE 95,1493,967,990,3450
36199,2020-08-02,(10000) Portal 20 de Julio,674,329,447,1450
36200,2020-03-08,(09103) Olaya,984,445,927,2356
36201,2020-02-11,(02104) Calle 146,9990,6432,5084,21506
36202,2020-09-18,(07104) Simon Bolivar,631,382,390,1403
36203,2020-07-18,(02202) Calle 127,792,525,412,1729
36204,2020-08-01,(05107) Américas - Cr.53,239,152,169,560
36205,2020-09-19,(03009) Av. Suba- Calle 116,369,285,282,936
36206,2020-01-08,(06111) Universidades,1758,1132,1509,4399
36207,2020-06-03,(06000) Portal Eldorado - alimentacion,3707,1875,1786,7368
36208,2020-07-14,(06000) Portal Eldorado - alimentacion,3451,1704,1551,6706
36209,2020-07-03,(04108) El Polo,527,325,296,1148
36210,2020-06-17,(10009) Museo Nacional,487,309,301,1097
36211,2020-01-29,(02202) Calle 127,5963,3891,2835,12689
36212,2020-01-14,(05001) Patio Bonito,5898,3290,3378,12566
36213,2020-02-09,(02304) Heroes,564,479,735,1778
36214,2020-01-10,(07103) AV. CHILE,2576,1602,1534,5712
36215,2020-05-16,(07113) SANTA ISABEL,243,137,153,533
36216,2020-01-28,(06000) Portal Eldorado,6364,3767,2679,12810
36217,2020-01-25,(02205) Calle 106,903,627,836,2366
36218,2020-02-22,(03007) HUMEDAL CORDOBA,463,268,352,1083
36219,2020-06-30,(03007) HUMEDAL CORDOBA,186,116,82,384
36220,2020-07-20,(03007) HUMEDAL CORDOBA,30,35,27,92
36221,2020-03-07,(03002) SUBA - TV- 91,2252,1136,1693,5081
36222,2020-08-12,(02101) Toberín,1229,826,831,2886
36223,2020-07-08,(07010) Bosa,767,368,474,1609
36224,2020-02-02,(09101) Quiroga,464,217,555,1236
36225,2020-03-21,(02304) Heroes,288,205,165,658
36226,2020-08-04,(07104) Simon Bolivar,328,238,241,807
36227,2020-06-17,(04107) Escuela Militar,143,89,92,324
36228,2020-05-27,(09000) Cabecera Usme,1464,946,951,3361
36229,2020-03-22,(07002) MADELENA,120,66,54,240
36230,2020-03-08,(03003) 21 ANGELES,344,119,342,805
36231,2020-01-14,(06105) Quinta Paredes,796,471,468,1735
36232,2020-08-13,(06101) El Tiempo,335,197,196,728
36233,2020-10-08,(40001) Juan Pablo II,606,350,483,1439
36234,2020-01-03,(04108) El Polo,834,551,612,1997
36235,2020-04-07,(02105) Calle 142,367,272,220,859
36236,2020-01-05,(07009) SENA,638,302,566,1506
36237,2020-02-08,(03010) PUENTE LARGO,896,562,799,2257
36238,2020-09-20,(03010) PUENTE LARGO,85,63,115,263
36239,2020-01-09,(05005) Transversal 86,1858,999,958,3815
36240,2020-05-22,(09002) Consuelo,436,229,232,897
36241,2020-06-26,(07007) NQS - Calle 38A Sur,455,262,288,1005
36242,2020-03-20,(10010) San Bernardo,330,227,198,755
36243,2020-06-29,(02104) Calle 146,271,191,193,655
36244,2020-08-20,(02103) Mazurén,181,109,151,441
36245,2020-05-04,(06109) Centro Memoria,195,106,104,405
36246,2020-03-12,(09106) Nariño,204,411,363,978
36247,2020-09-09,(02001) Centro Comercial Santa Fe,553,339,406,1298
36248,2020-02-29,(02102) Calle 161,790,371,789,1950
36249,2020-01-18,(10006) San Victorino,989,732,898,2619
36250,2020-06-16,(05107) Américas - Cr.53,438,259,260,957
36251,2020-09-13,(12007) Zona Industrial,66,59,67,192
36252,2020-08-31,(06111) Universidades,376,217,341,934
36253,2020-07-14,(12007) Zona Industrial,325,201,139,665
36254,2020-05-17,(40001) Juan Pablo II,129,79,103,311
36255,2020-09-05,(12001) Carrera 43,317,180,273,770
36256,2020-05-31,(10000) Portal 20 de Julio - alimentacion,1310,529,853,2692
36257,2020-08-20,(03013) RIO NEGRO,253,150,170,573
36258,2020-04-11,(07000) Portal Sur,467,277,316,1060
36259,2020-04-28,(07000) Portal Sur,1048,678,595,2321
36260,2020-08-16,(07001) PERDOMO,233,109,198,540
36261,2020-02-29,(12004) Carrera 22,438,321,379,1138
36262,2020-06-20,(09123) Calle 76,683,504,527,1714
36263,2020-08-06,(06109) Centro Memoria,248,133,128,509
36264,2020-05-02,(05103) Marsella,134,91,72,297
36265,2020-08-16,(04003) Avenida Ciudad de Cali,250,158,267,675
36266,2020-06-04,(10007) Las Nieves,546,316,262,1124
36267,2020-06-08,(07004) VENECIA,908,566,522,1996
36268,2020-06-16,(06107) Ciudad Universitaria,184,108,101,393
36269,2020-08-06,(07110) PALOQUEMAO,579,361,262,1202
36270,2020-04-30,(40001) Juan Pablo II,345,172,219,736
36271,2020-09-25,(03005) SUBA - AV. BOYACA,542,316,378,1236
36272,2020-05-06,(14005) Las Aguas,0,46,110,156
36273,2020-03-03,(12000) Puente Aranda,259,176,192,627
36274,2020-03-01,(04000) Cabecera Calle 80 - intermunicipal,317,171,442,930
36275,2020-04-21,(07109) CAD,434,304,169,907
36276,2020-08-24,(14005) Las Aguas,103,95,173,371
36277,2020-07-18,(02104) Calle 146,550,318,328,1196
36278,2020-10-10,(02001) Centro Comercial Santa Fe,412,242,434,1088
36279,2020-09-04,(06002) Normandía,359,192,232,783
36280,2020-10-07,(09111) Calle 19,787,510,614,1911
36281,2020-01-26,(12003) Ricaurte,138,131,202,471
36282,2020-03-27,(10009) Museo Nacional,316,231,220,767
36283,2020-06-21,(04106) Carrera 47,111,59,68,238
36284,2020-01-24,(09108) Hospital,184,112,178,474
36285,2020-08-16,(02202) Calle 127,275,231,258,764
36286,2020-03-08,(08000) Portal Tunal,509,361,358,1228
36287,2020-09-09,(07008) NQS - Calle 30 Sur,361,197,253,811
36288,2020-06-18,(07103) AV. CHILE,1004,574,403,1981
36289,2020-07-13,(10010) San Bernardo,477,270,309,1056
36290,2020-06-20,(02502) Terminal,271,175,254,700
36291,2020-04-04,(14001) La Sabana,59,40,48,147
36292,2020-05-30,(07005) ALQUERIA,397,237,209,843
36293,2020-04-07,(02103) Mazurén,94,60,73,227
36294,2020-07-30,(04102) Avenida Boyaca,356,228,246,830
36295,2020-07-09,(12002) CDS - Carrera 32,172,109,74,355
36296,2020-03-14,(04102) Avenida Boyaca,1280,690,988,2958
36297,2020-07-11,(04102) Avenida Boyaca,312,175,225,712
36298,2020-08-27,(04102) Avenida Boyaca,408,194,227,829
36299,2020-05-03,(06002) Normandía,65,44,50,159
36300,2020-06-25,(06002) Normandía,315,190,200,705
36301,2020-06-08,(04000) Cabecera Calle 80 - intermunicipal,283,160,249,692
36302,2020-05-24,(04100) Carrera 77,297,143,166,606
36303,2020-08-25,(09108) Hospital,70,31,54,155
36304,2020-03-28,(09100) Calle 40 Sur,559,321,346,1226
36305,2020-03-28,(09003) Socorro,183,96,96,375
36306,2020-04-11,(04103) Las Ferias,146,85,58,289
36307,2020-08-09,(03009) Av. Suba- Calle 116,120,75,82,277
36308,2020-05-27,(07200) Tygua-San José,222,109,137,468
36309,2020-06-22,(07112) COMUNEROS,246,147,154,547
36310,2020-06-04,(06105) Quinta Paredes,125,77,57,259
36311,2020-03-18,(09105) Río Fucha,386,203,247,836
36312,2020-07-15,(06102) Salitre El Greco,205,115,107,427
36313,2020-04-17,(05101) Mandalay - Cr.73,58,30,35,123
36314,2020-09-23,(05101) Mandalay - Cr.73,163,102,92,357
36315,2020-07-25,(12002) CDS - Carrera 32,104,71,36,211
36316,2020-09-27,(03000) Portal Suba,416,213,537,1166
36317,2020-04-06,(14004) Museo del Oro,0,50,97,147
36318,2020-08-27,(07107) U. NACIONAL,341,207,184,732
36319,2020-07-03,(07008) NQS - Calle 30 Sur,352,184,207,743
36320,2020-06-05,(04102) Avenida Boyaca,284,164,195,643
36321,2020-04-02,(12007) Zona Industrial,140,120,76,336
36322,2020-07-18,(10004) Policarpa,148,75,102,325
36323,2020-08-30,(05005) Transversal 86,113,52,116,281
36324,2020-06-14,(04002) Carrera 90,159,87,105,351
36325,2020-08-14,(06101) El Tiempo,314,200,173,687
36326,2020-08-16,(06101) El Tiempo,93,80,62,235
36327,2020-03-29,(12001) Carrera 43,45,35,24,104
36328,2020-06-15,(06101) El Tiempo,111,91,93,295
36329,2020-09-20,(04105) Carrera 53,105,54,112,271
36330,2020-07-25,(09121) Las Flores,432,265,331,1028
36331,2020-05-10,(09113) Calle 22,173,104,150,427
36332,2020-08-03,(06103) CAN,352,192,148,692
36333,2020-02-09,(10005) Bicentenario,76,67,129,272
36334,2020-05-06,(04000) Cabecera Calle 80 - intermunicipal,169,97,153,419
36335,2020-09-27,(02000) Cabecera Autopista Norte - intermunicipal,153,91,215,459
36336,2020-05-03,(07104) Simon Bolivar,97,67,65,229
36337,2020-04-20,(04107) Escuela Militar,62,47,42,151
36338,2020-04-02,(50002) Corral Calle 40 Sur,8,4,12,24
36339,2020-09-20,(06002) Normandía,98,61,134,293
36340,2020-07-10,(06100) Av. Rojas,249,151,169,569
36341,2020-07-27,(07101) CASTELLANA,189,100,89,378
36342,2019-12-31,(07107) U. NACIONAL,6,11,30,47
36343,2020-08-30,(07008) NQS - Calle 30 Sur,91,50,107,248
36344,2020-05-25,(04105) Carrera 53,88,52,57,197
36345,2020-03-29,(10009) Museo Nacional,49,31,48,128
36346,2020-04-15,(04001) Quirigua,197,108,135,440
36347,2020-07-13,(50006) Corral Carrera 77,5,1,5,11
36348,2020-04-15,(10005) Bicentenario,52,26,47,125
36349,2020-04-11,(10003) Ciudad Jardín,58,29,31,118
36350,2020-07-09,(50006) Corral Carrera 77,3,4,8,15
36351,2020-07-08,(03004) GRATAMIRA,35,17,18,70
36352,2020-07-29,(03004) GRATAMIRA,28,12,15,55
36353,2020-06-28,(10005) Bicentenario,23,11,22,56
36354,2020-05-13,(50006) Corral Carrera 77,7,5,4,16
36355,2020-05-19,(50006) Corral Carrera 77,8,4,5,17
36356,2020-04-10,(03004) GRATAMIRA,5,8,5,18
36357,2020-02-28,(50004) Corral Avenida Ciudad de Cali,0,0,1,1
36358,2020-06-26,(04000) Cabecera Calle 80 - alimentacion,4482,2496,2836,9814
36359,2020-09-28,(04000) Cabecera Calle 80 - alimentacion,4736,2728,3726,11190
36360,2020-04-28,(07504) TERREROS,2920,1831,1425,6176
36361,2020-04-29,(07504) TERREROS,2860,1799,1417,6076
36362,2020-05-19,(09119) Calle 57,449,297,284,1030
36363,2020-08-25,(09119) Calle 57,480,303,361,1144
36364,2020-09-03,(09119) Calle 57,597,372,431,1400
36365,2020-08-06,(07505) LEON XIII,2608,1295,1144,5047
36366,2020-03-03,(09122) Calle 72,8415,5474,4323,18212
36367,2020-02-04,(07503) SAN MATEO,41458,23607,17824,82889
36368,2020-01-17,(08001) Parque el Tunal,1540,805,966,3311
36369,2020-05-22,(05000) Portal Américas - alimentacion,9363,4847,4411,18621
36370,2020-07-10,(05000) Portal Américas - alimentacion,11343,6277,5801,23421
36371,2020-09-01,(07503) SAN MATEO,11660,6562,5769,23991
36372,2020-08-11,(04000) Cabecera Calle 80 - alimentacion,3358,1984,2283,7625
36373,2020-10-06,(04000) Cabecera Calle 80 - alimentacion,5034,2748,4105,11887
36374,2020-08-25,(07112) COMUNEROS,777,463,439,1679
36375,2020-02-03,(03000) Portal Suba,9372,5664,5085,20121
36376,2020-01-09,(05100) Banderas P. Central,4959,2835,2818,10612
36377,2020-03-22,(10001) Country Sur,231,92,132,455
36378,2020-02-24,(02204) Pepe Sierra,5213,3244,2407,10864
36379,2020-06-24,(05107) Américas - Cr.53,475,267,248,990
36380,2020-08-06,(09104) Restrepo,1471,826,1025,3322
36381,2020-08-10,(09104) Restrepo,1516,865,1019,3400
36382,2020-03-02,(07505) LEON XIII,8369,4665,3753,16787
36383,2020-04-30,(07505) LEON XIII,1379,845,719,2943
36384,2020-02-08,(03000) Portal Suba - alimentacion,16791,8526,11758,37075
36385,2020-08-08,(02000) Cabecera Autopista Norte - alimentacion,3326,1652,2046,7024
36386,2020-02-07,(09101) Quiroga,1656,991,1264,3911
36387,2020-10-01,(09101) Quiroga,617,296,515,1428
36388,2020-03-11,(03013) RIO NEGRO,1173,766,845,2784
36389,2020-04-21,(09118) Marly,1000,710,452,2162
36390,2020-09-04,(06000) Portal Eldorado - alimentacion,4161,2052,2534,8747
36391,2020-03-17,(02302) Virrey,2124,1499,1051,4674
36392,2020-05-12,(07000) Portal Sur - alimentacion,5846,3293,2529,11668
36393,2020-06-05,(50003) Corral Molinos,1399,751,1030,3180
36394,2020-06-11,(50003) Corral Molinos,1426,744,939,3109
36395,2020-05-07,(02103) Mazurén,106,91,98,295
36396,2020-04-10,(09103) Olaya,181,112,100,393
36397,2020-06-23,(09103) Olaya,1064,655,574,2293
36398,2020-02-04,(02000) Cabecera Autopista Norte - alimentacion,24107,14074,13682,51863
36399,2020-10-05,(07002) MADELENA,1042,611,794,2447
36400,2020-02-03,(07112) COMUNEROS,3777,2320,2289,8386
36401,2020-03-31,(07112) COMUNEROS,386,253,251,890
36402,2020-09-23,(02000) Cabecera Autopista Norte,1633,1096,1279,4008
36403,2020-01-23,(02104) Calle 146,8827,5399,4863,19089
36404,2020-02-12,(02104) Calle 146,9776,6331,5162,21269
36405,2020-01-25,(02000) Cabecera Autopista Norte,4564,2290,3661,10515
36406,2020-04-03,(04000) Cabecera Calle 80,501,332,361,1194
36407,2020-02-12,(05002) Tintal,11673,6921,6040,24634
36408,2020-02-06,(09114) Calle 26,3138,2200,1921,7259
36409,2020-06-20,(07506) DESPENSA,418,222,235,875
36410,2020-09-25,(07506) DESPENSA,466,299,381,1146
36411,2020-07-25,(04100) Carrera 77,838,414,510,1762
36412,2020-02-09,(09111) Calle 19,536,353,627,1516
36413,2020-02-23,(10006) San Victorino,276,270,435,981
36414,2020-03-14,(06002) Normandía,869,515,819,2203
36415,2020-02-07,(06111) Universidades,5794,3661,2791,12246
36416,2020-01-20,(10006) San Victorino,1973,1045,1179,4197
36417,2020-02-02,(10000) Portal 20 de Julio,2162,851,1756,4769
36418,2020-07-20,(10000) Portal 20 de Julio,602,298,384,1284
36419,2020-02-27,(07008) NQS - Calle 30 Sur,1987,1094,1081,4162
36420,2020-09-20,(40003) Mirador del Paraiso,691,342,625,1658
36421,2020-01-09,(09107) Hortúa,1661,1041,1129,3831
36422,2020-06-22,(07503) SAN MATEO,3234,1939,1755,6928
36423,2020-09-21,(08001) Parque el Tunal,410,183,258,851
36424,2020-02-07,(09116) Avenida 39,3049,2028,1814,6891
36425,2020-02-21,(09116) Avenida 39,2459,2085,1825,6369
36426,2020-08-18,(02101) Toberín,1201,827,854,2882
36427,2020-09-24,(02101) Toberín,1814,1157,1400,4371
36428,2020-01-01,(09113) Calle 22,213,97,329,639
36429,2020-04-15,(10000) Portal 20 de Julio - alimentacion,2719,1084,1484,5287
36430,2020-08-12,(07010) Bosa,612,297,393,1302
36431,2020-05-18,(07503) SAN MATEO,8468,5250,4163,17881
36432,2020-04-28,(10002) Av. Primero de Mayo,1387,677,719,2783
36433,2020-09-28,(09120) Calle 63,1254,856,981,3091
36434,2020-05-21,(02201) Prado,741,472,386,1599
36435,2020-02-17,(02202) Calle 127,6025,4057,2993,13075
36436,2020-03-14,(02000) Cabecera Autopista Norte,4350,2253,3491,10094
36437,2020-03-16,(06001) Modelia,1693,1007,813,3513
36438,2020-07-10,(09114) Calle 26,325,213,241,779
36439,2020-09-24,(09123) Calle 76,1136,740,757,2633
36440,2020-05-12,(05101) Mandalay - Cr.73,90,48,33,171
36441,2020-03-16,(10009) Museo Nacional,2994,1551,1278,5823
36442,2020-10-02,(02103) Mazurén,284,188,275,747
36443,2020-10-08,(05002) Tintal,2878,1743,2158,6779
36444,2020-05-04,(02300) Calle 100,906,645,508,2059
36445,2020-07-09,(03012) SUBA - CALLE 95,347,204,174,725
36446,2020-10-08,(03012) SUBA - CALLE 95,373,207,271,851
36447,2020-03-30,(09001) Molinos,1146,600,783,2529
36448,2020-01-02,(06000) Portal Eldorado,3361,2071,1798,7230
36449,2020-02-19,(05105) Pradera,2715,1640,1220,5575
36450,2020-03-23,(05005) Transversal 86,100,49,44,193
36451,2020-09-08,(02202) Calle 127,1140,802,673,2615
36452,2020-04-05,(07009) SENA,96,52,61,209
36453,2020-08-15,(07007) NQS - Calle 38A Sur,335,205,224,764
36454,2020-07-10,(02205) Calle 106,395,236,209,840
36455,2020-01-09,(03006) NIZA - CALLE 127,1570,937,1170,3677
36456,2020-01-22,(03006) NIZA - CALLE 127,2259,1450,1450,5159
36457,2020-09-13,(05000) Portal Américas - alimentacion,3868,1599,2614,8081
36458,2020-03-09,(07000) Portal Sur,199,2238,1546,3983
36459,2020-03-10,(07101) CASTELLANA,422,71,184,677
36460,2020-02-13,(07101) CASTELLANA,918,600,616,2134
36461,2020-07-23,(03000) Portal Suba - alimentacion,5389,3116,2853,11358
36462,2020-07-09,(03007) HUMEDAL CORDOBA,174,111,96,381
36463,2020-09-10,(04104) Avenida 68,589,289,412,1290
36464,2020-08-22,(08002) Biblioteca,235,121,145,501
36465,2020-09-10,(08002) Biblioteca,324,176,211,711
36466,2020-09-24,(04100) Carrera 77,1430,791,1087,3308
36467,2020-03-04,(03010) PUENTE LARGO,2059,1399,1276,4734
36468,2020-09-16,(05101) Mandalay - Cr.73,140,91,96,327
36469,2020-07-30,(07000) Portal Sur,1732,1133,1123,3988
36470,2020-05-27,(02101) Toberín,1286,815,765,2866
36471,2020-04-07,(09100) Calle 40 Sur,810,470,501,1781
36472,2020-02-27,(07004) VENECIA,4762,2755,2403,9920
36473,2020-07-09,(09121) Las Flores,757,446,454,1657
36474,2020-05-16,(02000) Cabecera Autopista Norte,669,416,408,1493
36475,2020-04-15,(09000) Cabecera Usme,856,523,586,1965
36476,2020-08-29,(04003) Avenida Ciudad de Cali,798,406,683,1887
36477,2020-04-02,(05103) Marsella,171,98,101,370
36478,2020-07-09,(05103) Marsella,460,244,250,954
36479,2020-09-09,(09109) Tercer Milenio,392,232,267,891
36480,2020-09-11,(05001) Patio Bonito,2078,986,1182,4246
36481,2020-09-18,(06101) El Tiempo,403,258,273,934
36482,2020-09-29,(06101) El Tiempo,376,243,262,881
36483,2020-07-16,(04104) Avenida 68,585,289,277,1151
36484,2020-07-09,(02202) Calle 127,1167,836,563,2566
36485,2020-03-16,(06104) Gobernación,1012,592,418,2022
36486,2020-05-30,(10001) Country Sur,755,326,506,1587
36487,2020-05-13,(03001) LA CAMPIÑA,743,444,371,1558
36488,2020-06-08,(03001) LA CAMPIÑA,1061,581,562,2204
36489,2020-01-05,(07004) VENECIA,710,358,670,1738
36490,2020-03-24,(07113) SANTA ISABEL,294,201,267,762
36491,2020-09-14,(09120) Calle 63,1098,716,790,2604
36492,2020-01-18,(07007) NQS - Calle 38A Sur,1246,660,843,2749
36493,2020-09-19,(12003) Ricaurte,285,218,241,744
36494,2020-10-04,(03010) PUENTE LARGO,88,62,136,286
36495,2020-06-13,(10010) San Bernardo,487,209,362,1058
36496,2020-06-30,(10010) San Bernardo,686,350,445,1481
36497,2020-08-24,(07200) Tygua-San José,206,126,129,461
36498,2020-08-16,(02105) Calle 142,165,121,143,429
36499,2020-04-19,(05102) Av. Américas - Av. Boyacá,51,29,17,97
36500,2020-03-13,(07010) Bosa,58,409,435,902
36501,2020-09-04,(05107) Américas - Cr.53,480,286,328,1094
36502,2020-09-12,(07103) AV. CHILE,583,375,470,1428
36503,2020-07-24,(10005) Bicentenario,92,46,59,197
36504,2020-02-24,(40002) Manitas,1344,787,732,2863
36505,2020-07-18,(04002) Carrera 90,503,244,308,1055
36506,2020-07-04,(02001) Centro Comercial Santa Fe,355,210,305,870
36507,2020-05-08,(02104) Calle 146,522,350,309,1181
36508,2020-01-16,(07102) NQS - CALLE 75,1166,868,969,3003
36509,2020-10-09,(10010) San Bernardo,612,326,603,1541
36510,2020-07-10,(05105) Pradera,647,374,289,1310
36511,2020-07-28,(06111) Universidades,330,185,258,773
36512,2020-04-24,(09004) Santa Lucía,1269,677,740,2686
36513,2020-09-11,(02202) Calle 127,1130,741,694,2565
36514,2020-03-19,(03004) GRATAMIRA,92,42,70,204
36515,2020-01-03,(07005) ALQUERIA,1175,678,831,2684
36516,2020-04-10,(02204) Pepe Sierra,201,163,90,454
36517,2020-02-22,(05102) Av. Américas - Av. Boyacá,854,440,637,1931
36518,2020-10-03,(07006) General Santander,499,254,460,1213
36519,2020-08-05,(07002) MADELENA,678,392,460,1530
36520,2020-05-18,(03006) NIZA - CALLE 127,316,216,180,712
36521,2020-04-28,(02200) Alcalá,1005,739,532,2276
36522,2020-10-02,(07001) PERDOMO,1206,682,973,2861
36523,2020-03-14,(10003) Ciudad Jardín,504,262,490,1256
36524,2020-03-06,(09111) Calle 19,2266,1378,1610,5254
36525,2020-06-30,(09111) Calle 19,799,461,533,1793
36526,2020-03-14,(10009) Museo Nacional,1005,778,1215,2998
36527,2020-07-12,(02502) Terminal,77,75,140,292
36528,2020-02-06,(12002) CDS - Carrera 32,600,407,345,1352
36529,2020-04-28,(09118) Marly,1077,743,466,2286
36530,2020-04-19,(09123) Calle 76,184,163,124,471
36531,2020-06-05,(07105) MOVISTAR ARENA,233,143,151,527
36532,2020-04-09,(02200) Alcalá,373,290,188,851
36533,2020-01-18,(10007) Las Nieves,999,823,971,2793
36534,2020-05-11,(03003) 21 ANGELES,240,112,119,471
36535,2020-03-25,(07113) SANTA ISABEL,174,121,121,416
36536,2020-04-15,(07004) VENECIA,506,323,283,1112
36537,2020-05-10,(40001) Juan Pablo II,102,55,73,230
36538,2020-08-10,(03011) SUBA - CALLE 100,412,206,214,832
36539,2020-09-06,(05005) Transversal 86,140,58,135,333
36540,2020-06-15,(09110) Avenida Jimenez,231,179,266,676
36541,2020-04-22,(08002) Biblioteca,157,92,108,357
36542,2020-07-24,(09121) Las Flores,570,343,358,1271
36543,2020-05-31,(05102) Av. Américas - Av. Boyacá,49,30,26,105
36544,2020-08-25,(02102) Calle 161,221,123,148,492
36545,2020-09-08,(07107) U. NACIONAL,418,253,236,907
36546,2020-09-07,(06001) Modelia,403,249,219,871
36547,2020-06-02,(03013) RIO NEGRO,261,169,178,608
36548,2020-04-06,(10009) Museo Nacional,303,223,182,708
36549,2020-08-10,(02201) Prado,646,521,492,1659
36550,2020-08-27,(04103) Las Ferias,371,208,153,732
36551,2020-04-04,(02300) Calle 100,517,452,313,1282
36552,2020-08-16,(04002) Carrera 90,171,78,142,391
36553,2020-04-15,(40003) Mirador del Paraiso,799,459,552,1810
36554,2020-03-10,(02102) Calle 161,170,476,318,964
36555,2020-03-23,(14001) La Sabana,43,27,31,101
36556,2020-07-24,(09113) Calle 22,304,180,253,737
36557,2020-01-09,(07102) NQS - CALLE 75,1099,682,725,2506
36558,2020-05-16,(04000) Cabecera Calle 80 - intermunicipal,120,54,124,298
36559,2020-09-27,(14004) Museo del Oro,43,40,98,181
36560,2020-09-25,(04001) Quirigua,479,279,393,1151
36561,2020-06-09,(04102) Avenida Boyaca,322,188,201,711
36562,2020-04-21,(02502) Terminal,169,131,153,453
36563,2020-07-26,(07006) General Santander,124,63,92,279
36564,2020-06-12,(09108) Hospital,78,45,53,176
36565,2020-01-24,(03004) GRATAMIRA,303,156,154,613
36566,2020-05-01,(03003) 21 ANGELES,101,45,45,191
36567,2020-06-22,(07111) NQS - RICAURTE,237,189,169,595
36568,2020-04-07,(09000) Cabecera Usme,768,422,558,1748
36569,2020-10-01,(07200) Tygua-San José,282,145,213,640
36570,2020-05-06,(03002) SUBA - TV- 91,474,290,232,996
36571,2020-04-21,(03006) NIZA - CALLE 127,225,149,123,497
36572,2020-09-06,(05101) Mandalay - Cr.73,22,26,35,83
36573,2020-04-19,(07009) SENA,94,62,66,222
36574,2020-08-09,(10006) San Victorino,161,102,135,398
36575,2020-05-03,(09000) Cabecera Usme,318,191,237,746
36576,2020-06-15,(04101) Minuto de Dios,74,50,74,198
36577,2020-08-05,(10004) Policarpa,231,95,154,480
36578,2020-05-23,(06102) Salitre El Greco,140,82,73,295
36579,2020-08-27,(06102) Salitre El Greco,205,124,126,455
36580,2020-03-01,(10008) San Diego,196,135,287,618
36581,2020-09-06,(06002) Normandía,83,68,113,264
36582,2020-08-09,(03000) Portal Suba,205,145,248,598
36583,2020-02-26,(03004) GRATAMIRA,344,167,152,663
36584,2020-03-03,(03004) GRATAMIRA,311,160,135,606
36585,2020-07-06,(03004) GRATAMIRA,39,17,23,79
36586,2020-08-09,(07004) VENECIA,228,131,169,528
36587,2020-01-01,(06104) Gobernación,59,67,87,213
36588,2020-08-10,(09106) Nariño,388,213,290,891
36589,2020-03-19,(10003) Ciudad Jardín,442,255,292,989
36590,2020-06-14,(07009) SENA,194,94,140,428
36591,2020-06-07,(07007) NQS - Calle 38A Sur,145,70,97,312
36592,2020-04-05,(05100) Banderas P. Central,85,52,59,196
36593,2020-10-12,(09113) Calle 22,201,104,222,527
36594,2020-03-29,(06108) Concejo de Bogotá,36,35,34,105
36595,2020-04-15,(07008) NQS - Calle 30 Sur,150,80,78,308
36596,2020-04-20,(07008) NQS - Calle 30 Sur,150,82,74,306
36597,2020-04-19,(07005) ALQUERIA,94,49,52,195
36598,2020-09-20,(06103) CAN,120,78,114,312
36599,2020-06-15,(02304) Heroes,245,177,167,589
36600,2020-03-08,(07108) Av. El Dorado,140,95,208,443
36601,2020-06-14,(10008) San Diego,65,48,52,165
36602,2020-06-22,(10004) Policarpa,94,44,71,209
36603,2020-03-01,(04107) Escuela Militar,115,91,182,388
36604,2020-04-20,(07101) CASTELLANA,101,79,72,252
36605,2020-04-22,(06106) Recinto Ferial,169,110,70,349
36606,2020-03-23,(10003) Ciudad Jardín,36,22,29,87
36607,2020-07-20,(10007) Las Nieves,63,50,71,184
36608,2020-03-30,(14005) Las Aguas,0,31,67,98
36609,2020-04-04,(10006) San Victorino,109,78,97,284
36610,2020-04-16,(06106) Recinto Ferial,156,107,79,342
36611,2020-05-12,(03014) SAN MARTIN,21,7,35,63
36612,2020-07-25,(07113) SANTA ISABEL,210,115,166,491
36613,2020-09-08,(12000) Puente Aranda,90,51,44,185
36614,2019-12-31,(06108) Concejo de Bogotá,5,5,8,18
36615,2020-04-19,(10005) Bicentenario,14,7,12,33
36616,2020-05-30,(04000) Cabecera Calle 80 - alimentacion,2505,1326,1563,5394
36617,2020-08-05,(09002) Consuelo,482,250,265,997
36618,2020-03-18,(02502) Terminal,1816,1171,1163,4150
36619,2020-08-25,(09118) Marly,1336,823,748,2907
36620,2020-09-02,(07504) TERREROS,6580,3620,3307,13507
36621,2020-01-09,(05000) Portal Américas - alimentacion,28285,15280,15937,59502
36622,2020-03-18,(05000) Portal Américas,8940,4628,4452,18020
36623,2020-06-02,(10000) Portal 20 de Julio - alimentacion,3897,1802,2191,7890
36624,2020-09-16,(10000) Portal 20 de Julio - alimentacion,4548,2109,2960,9617
36625,2020-06-11,(07503) SAN MATEO,10129,6232,5168,21529
36626,2020-05-05,(05000) Portal Américas - alimentacion,7511,3827,3541,14879
36627,2020-10-02,(07503) SAN MATEO,14493,7178,8188,29859
36628,2020-03-22,(04000) Cabecera Calle 80 - alimentacion,567,335,336,1238
36629,2020-01-22,(06107) Ciudad Universitaria,1458,825,832,3115
36630,2020-02-06,(14004) Museo del Oro,4130,2684,2178,8992
36631,2020-03-10,(14004) Museo del Oro,2245,130,466,2841
36632,2020-01-12,(07503) SAN MATEO,8921,3835,5768,18524
36633,2020-02-14,(07103) AV. CHILE,3637,2329,1951,7917
36634,2020-02-20,(07103) AV. CHILE,3644,2258,1799,7701
36635,2020-07-14,(10001) Country Sur,796,395,480,1671
36636,2020-06-02,(09100) Calle 40 Sur,1534,919,920,3373
36637,2020-05-18,(09115) Calle 34,545,368,341,1254
36638,2020-01-24,(02000) Cabecera Autopista Norte,10241,5819,5930,21990
36639,2020-02-10,(02000) Cabecera Autopista Norte,11787,7424,5983,25194
36640,2020-01-27,(02105) Calle 142,6888,4288,3576,14752
36641,2020-02-05,(02502) Terminal,5531,3607,2955,12093
36642,2020-03-13,(05100) Banderas P. Central,211,1398,1142,2751
36643,2020-02-04,(02205) Calle 106,2827,1734,1430,5991
36644,2020-02-28,(10006) San Victorino,2386,1311,1308,5005
36645,2020-03-27,(02000) Cabecera Autopista Norte - alimentacion,2570,1311,1189,5070
36646,2020-07-04,(02000) Cabecera Autopista Norte - alimentacion,4188,2124,2525,8837
36647,2020-01-22,(12003) Ricaurte,1162,740,590,2492
36648,2020-09-15,(07102) NQS - CALLE 75,478,318,249,1045
36649,2020-03-05,(09103) Olaya,4159,2495,2587,9241
36650,2020-03-16,(09110) Avenida Jimenez,3603,2512,2071,8186
36651,2020-02-03,(07110) PALOQUEMAO,2531,1476,1154,5161
36652,2020-01-28,(03001) LA CAMPIÑA,6466,3902,4009,14377
36653,2020-02-14,(50003) Corral Molinos,3227,2348,3626,9201
36654,2020-06-19,(05100) Banderas P. Central - alimentacion,2951,1602,1793,6346
36655,2020-09-16,(05100) Banderas P. Central - alimentacion,3578,1938,2190,7706
36656,2020-08-15,(09103) Olaya,859,401,518,1778
36657,2020-01-17,(14001) La Sabana,301,268,320,889
36658,2020-01-08,(07106) EL CAMPIN,1354,902,852,3108
36659,2020-06-23,(02000) Cabecera Autopista Norte,1400,900,871,3171
36660,2020-01-17,(02201) Prado,4939,2937,2865,10741
36661,2020-05-03,(05000) Portal Américas,488,323,339,1150
36662,2020-09-28,(05000) Portal Américas,3888,2118,2729,8735
36663,2020-08-02,(02000) Cabecera Autopista Norte - alimentacion,1504,738,977,3219
36664,2020-05-20,(03002) SUBA - TV- 91,609,348,342,1299
36665,2020-02-01,(09114) Calle 26,645,587,1119,2351
36666,2019-12-31,(07506) DESPENSA,11,17,15,43
36667,2020-08-30,(07506) DESPENSA,110,86,135,331
36668,2020-08-08,(10001) Country Sur,848,372,596,1816
36669,2020-09-03,(10001) Country Sur,1352,620,940,2912
36670,2020-09-09,(09111) Calle 19,789,497,480,1766
36671,2020-10-04,(10006) San Victorino,212,153,210,575
36672,2020-01-24,(03000) Portal Suba,8417,4645,5072,18134
36673,2020-02-25,(06000) Portal Eldorado,6909,4080,2877,13866
36674,2020-05-24,(40003) Mirador del Paraiso,502,272,324,1098
36675,2020-05-21,(09107) Hortúa,519,329,283,1131
36676,2020-09-04,(02000) Cabecera Autopista Norte - intermunicipal,600,394,489,1483
36677,2020-04-24,(03000) Portal Suba - alimentacion,3467,1947,1812,7226
36678,2020-07-12,(02000) Cabecera Autopista Norte - alimentacion,1946,932,1297,4175
36679,2020-02-01,(02300) Calle 100,2781,2026,2741,7548
36680,2020-09-09,(07108) Av. El Dorado,153,106,108,367
36681,2020-01-19,(02502) Terminal,297,281,760,1338
36682,2020-01-04,(09107) Hortúa,797,469,683,1949
36683,2020-08-21,(07007) NQS - Calle 38A Sur,348,207,255,810
36684,2020-02-22,(05002) Tintal,6943,3307,4451,14701
36685,2020-03-10,(02202) Calle 127,1832,719,662,3213
36686,2020-09-11,(02201) Prado,878,581,605,2064
36687,2020-08-10,(06102) Salitre El Greco,240,129,126,495
36688,2020-08-28,(06102) Salitre El Greco,214,148,145,507
36689,2020-07-09,(09107) Hortúa,659,376,346,1381
36690,2020-09-29,(09123) Calle 76,1181,779,812,2772
36691,2020-02-13,(05101) Mandalay - Cr.73,1257,680,584,2521
36692,2020-02-21,(05105) Pradera,2610,1545,1184,5339
36693,2020-10-05,(05002) Tintal,2896,1743,2118,6757
36694,2020-06-01,(10000) Portal 20 de Julio,2095,1047,956,4098
36695,2020-02-29,(03012) SUBA - CALLE 95,749,545,833,2127
36696,2020-07-17,(50002) Corral Calle 40 Sur,15,10,23,48
36697,2020-05-08,(02000) Cabecera Autopista Norte - alimentacion,3490,1911,1740,7141
36698,2020-03-16,(07104) Simon Bolivar,1610,995,826,3431
36699,2020-03-14,(03012) SUBA - CALLE 95,692,478,635,1805
36700,2020-09-18,(05001) Patio Bonito,2401,1222,1457,5080
36701,2020-06-18,(09001) Molinos,2563,1385,1711,5659
36702,2020-02-08,(10008) San Diego,690,497,672,1859
36703,2020-02-04,(06109) Centro Memoria,1178,673,636,2487
36704,2020-03-31,(08000) Portal Tunal,344,208,167,719
36705,2020-08-16,(05000) Portal Américas - alimentacion,2880,1273,1822,5975
36706,2020-05-20,(02205) Calle 106,303,168,150,621
36707,2020-04-17,(10002) Av. Primero de Mayo,1175,643,752,2570
36708,2020-03-10,(02001) Centro Comercial Santa Fe,356,1356,882,2594
36709,2020-06-06,(04108) El Polo,320,186,186,692
36710,2020-06-26,(04108) El Polo,524,314,286,1124
36711,2020-05-25,(07106) EL CAMPIN,109,79,67,255
36712,2020-02-18,(07103) AV. CHILE,3797,2391,1858,8046
36713,2020-06-05,(07103) AV. CHILE,912,546,424,1882
36714,2020-05-31,(03007) HUMEDAL CORDOBA,40,29,11,80
36715,2020-07-01,(04104) Avenida 68,673,338,375,1386
36716,2020-08-04,(04104) Avenida 68,477,245,295,1017
36717,2020-07-31,(02101) Toberín,1148,741,761,2650
36718,2020-04-25,(10000) Portal 20 de Julio,990,512,525,2027
36719,2020-01-18,(04103) Las Ferias,741,395,619,1755
36720,2020-06-02,(10010) San Bernardo,581,317,359,1257
36721,2020-10-03,(07102) NQS - CALLE 75,318,241,347,906
36722,2020-06-23,(07104) Simon Bolivar,626,387,312,1325
36723,2020-01-03,(04107) Escuela Militar,218,131,221,570
36724,2020-05-22,(04107) Escuela Militar,116,78,66,260
36725,2020-07-01,(04107) Escuela Militar,140,96,99,335
36726,2020-01-09,(40003) Mirador del Paraiso,3785,2055,2204,8044
36727,2020-03-15,(04002) Carrera 90,583,252,516,1351
36728,2020-09-20,(07002) MADELENA,280,121,296,697
36729,2020-10-03,(09114) Calle 26,190,153,279,622
36730,2020-01-07,(06100) Av. Rojas,1343,776,836,2955
36731,2020-01-06,(04001) Quirigua,316,154,333,803
36732,2020-02-19,(07003) SEVILLANA,2180,1244,1131,4555
36733,2020-07-18,(04001) Quirigua,284,158,174,616
36734,2020-05-08,(10001) Country Sur,761,316,447,1524
36735,2020-02-09,(02205) Calle 106,188,204,410,802
36736,2020-07-26,(02200) Alcalá,486,332,316,1134
36737,2020-05-06,(03001) LA CAMPIÑA,644,366,307,1317
36738,2020-04-09,(02000) Cabecera Autopista Norte,223,147,119,489
36739,2020-09-22,(02105) Calle 142,918,603,702,2223
36740,2020-07-28,(06103) CAN,332,185,162,679
36741,2020-06-16,(02105) Calle 142,756,517,461,1734
36742,2020-04-16,(09109) Tercer Milenio,147,90,109,346
36743,2020-02-01,(06108) Concejo de Bogotá,302,217,387,906
36744,2020-08-03,(07007) NQS - Calle 38A Sur,287,209,212,708
36745,2020-10-05,(05107) Américas - Cr.53,505,291,348,1144
36746,2020-08-07,(04000) Cabecera Calle 80 - intermunicipal,61,26,62,149
36747,2020-06-25,(02103) Mazurén,224,137,188,549
36748,2020-05-30,(07103) AV. CHILE,587,379,318,1284
36749,2020-03-11,(07201) Guatoque -Veraguas,1010,471,610,2091
36750,2020-02-10,(07105) MOVISTAR ARENA,1422,868,683,2973
36751,2020-07-23,(04002) Carrera 90,621,322,313,1256
36752,2020-08-06,(07003) SEVILLANA,379,209,240,828
36753,2020-01-05,(50003) Corral Molinos,891,355,922,2168
36754,2020-09-11,(09118) Marly,1418,906,918,3242
36755,2020-03-06,(08002) Biblioteca,996,596,647,2239
36756,2020-06-16,(03011) SUBA - CALLE 100,505,221,235,961
36757,2020-08-16,(08002) Biblioteca,101,57,59,217
36758,2020-08-08,(12007) Zona Industrial,192,126,122,440
36759,2020-05-28,(09004) Santa Lucía,2265,1107,1160,4532
36760,2020-08-25,(07110) PALOQUEMAO,644,372,252,1268
36761,2020-09-15,(07110) PALOQUEMAO,708,396,333,1437
36762,2020-08-06,(06000) Portal Eldorado,826,532,469,1827
36763,2020-03-14,(09111) Calle 19,1281,874,1165,3320
36764,2020-05-28,(09122) Calle 72,1031,711,559,2301
36765,2020-06-21,(09122) Calle 72,375,231,309,915
36766,2020-07-02,(06104) Gobernación,269,168,116,553
36767,2020-09-25,(06109) Centro Memoria,289,179,214,682
36768,2020-05-15,(02303) Calle 85,528,370,292,1190
36769,2020-02-29,(07105) MOVISTAR ARENA,712,478,622,1812
36770,2020-03-20,(03000) Portal Suba,645,415,404,1464
36771,2020-07-09,(07105) MOVISTAR ARENA,257,157,143,557
36772,2020-07-23,(09121) Las Flores,594,343,297,1234
36773,2020-02-13,(07506) DESPENSA,1586,894,910,3390
36774,2020-07-23,(02200) Alcalá,1544,1003,823,3370
36775,2020-03-24,(07107) U. NACIONAL,314,231,243,788
36776,2020-09-25,(09114) Calle 26,395,230,336,961
36777,2020-06-15,(09118) Marly,526,345,303,1174
36778,2020-05-22,(07001) PERDOMO,746,439,450,1635
36779,2020-06-17,(14004) Museo del Oro,214,171,207,592
36780,2020-02-08,(06107) Ciudad Universitaria,614,415,726,1755
36781,2020-09-08,(04103) Las Ferias,355,209,219,783
36782,2020-10-10,(10007) Las Nieves,499,350,482,1331
36783,2020-05-09,(08000) Portal Tunal,414,189,163,766
36784,2020-09-02,(05005) Transversal 86,431,235,253,919
36785,2020-04-15,(40001) Juan Pablo II,245,146,150,541
36786,2020-10-11,(07106) EL CAMPIN,136,87,149,372
36787,2020-05-11,(04105) Carrera 53,211,126,117,454
36788,2020-08-19,(40002) Manitas,383,235,275,893
36789,2020-04-09,(03011) SUBA - CALLE 100,124,86,56,266
36790,2020-08-31,(09122) Calle 72,1214,794,825,2833
36791,2020-08-21,(03007) HUMEDAL CORDOBA,152,111,84,347
36792,2020-08-04,(02102) Calle 161,209,132,141,482
36793,2020-07-15,(12004) Carrera 22,142,78,97,317
36794,2020-09-27,(10005) Bicentenario - alimentacion,40,39,95,174
36795,2020-05-24,(04106) Carrera 47,80,44,60,184
36796,2020-09-14,(04106) Carrera 47,347,173,199,719
36797,2020-05-29,(07109) CAD,583,367,281,1231
36798,2020-09-20,(09117) Calle 45,250,149,311,710
36799,2020-03-30,(02001) Centro Comercial Santa Fe,171,126,164,461
36800,2020-04-13,(02001) Centro Comercial Santa Fe,181,128,118,427
36801,2020-01-05,(12002) CDS - Carrera 32,36,40,68,144
36802,2020-04-06,(12002) CDS - Carrera 32,148,115,54,317
36803,2020-04-17,(12002) CDS - Carrera 32,178,129,46,353
36804,2020-06-18,(12002) CDS - Carrera 32,213,124,101,438
36805,2020-08-18,(12002) CDS - Carrera 32,197,112,78,387
36806,2020-07-25,(40001) Juan Pablo II,336,181,218,735
36807,2020-03-17,(04102) Avenida Boyaca,1425,787,762,2974
36808,2020-08-14,(06002) Normandía,258,158,179,595
36809,2020-09-24,(06002) Normandía,360,227,242,829
36810,2020-04-07,(04101) Minuto de Dios,144,109,118,371
36811,2020-04-25,(50003) Corral Molinos,659,329,463,1451
36812,2020-08-10,(09108) Hospital,69,33,45,147
36813,2020-05-13,(06101) El Tiempo,264,176,108,548
36814,2020-05-08,(09117) Calle 45,534,334,280,1148
36815,2020-04-05,(04103) Las Ferias,62,54,48,164
36816,2020-04-14,(04103) Las Ferias,200,125,105,430
36817,2020-05-09,(03002) SUBA - TV- 91,358,198,205,761
36818,2020-09-09,(09121) Las Flores,754,457,494,1705
36819,2020-03-23,(09000) Cabecera Usme,347,187,225,759
36820,2020-06-29,(04106) Carrera 47,121,65,78,264
36821,2020-03-22,(09122) Calle 72,244,167,135,546
36822,2020-08-25,(06104) Gobernación,250,128,99,477
36823,2020-07-31,(09113) Calle 22,404,227,293,924
36824,2020-05-19,(10004) Policarpa,204,94,144,442
36825,2020-05-11,(12007) Zona Industrial,258,160,109,527
36826,2020-05-04,(07006) General Santander,301,193,162,656
36827,2020-07-17,(10004) Policarpa,185,96,140,421
36828,2020-04-29,(05105) Pradera,457,297,165,919
36829,2020-04-19,(09115) Calle 34,114,86,83,283
36830,2020-03-06,(03004) GRATAMIRA,294,142,159,595
36831,2020-09-13,(09115) Calle 34,152,123,227,502
36832,2020-09-21,(04000) Cabecera Calle 80 - intermunicipal,326,165,317,808
36833,2020-01-23,(03014) SAN MARTIN,252,156,154,562
36834,2020-06-07,(02103) Mazurén,38,21,46,105
36835,2020-08-27,(06100) Av. Rojas,223,135,150,508
36836,2020-09-06,(03004) GRATAMIRA,0,7,16,23
36837,2020-04-27,(09111) Calle 19,79,119,84,282
36838,2020-05-30,(03009) Av. Suba- Calle 116,306,212,163,681
36839,2020-08-18,(40002) Manitas,360,233,276,869
36840,2020-08-30,(07200) Tygua-San José,76,50,80,206
36841,2020-06-16,(10005) Bicentenario,112,49,86,247
36842,2020-05-25,(04101) Minuto de Dios,81,55,67,203
36843,2020-08-16,(06100) Av. Rojas,33,32,52,117
36844,2020-04-01,(07101) CASTELLANA,51,62,77,190
36845,2020-08-07,(04101) Minuto de Dios,111,64,107,282
36846,2020-07-28,(06105) Quinta Paredes,121,75,74,270
36847,2020-07-16,(07200) Tygua-San José,151,79,98,328
36848,2020-07-12,(03005) SUBA - AV. BOYACA,110,75,122,307
36849,2020-04-20,(04001) Quirigua,215,127,104,446
36850,2020-03-22,(09101) Quiroga,74,36,42,152
36851,2020-04-27,(12007) Zona Industrial,13,124,41,178
36852,2020-07-25,(09105) Río Fucha,54,25,46,125
36853,2020-03-29,(05101) Mandalay - Cr.73,13,7,5,25
36854,2020-04-13,(06106) Recinto Ferial,146,91,62,299
36855,2020-07-26,(07107) U. NACIONAL,96,60,52,208
36856,2020-05-01,(03004) GRATAMIRA,14,6,11,31
36857,2020-08-07,(09105) Río Fucha,0,30,67,97
36858,2020-03-20,(50002) Corral Calle 40 Sur,12,6,14,32
36859,2020-03-27,(50002) Corral Calle 40 Sur,7,8,11,26
36860,2020-04-11,(50006) Corral Carrera 77,5,1,1,7
36861,2020-06-09,(50006) Corral Carrera 77,6,2,3,11
36862,2020-05-20,(07005) ALQUERIA,463,265,199,927
36863,2020-02-26,(02502) Terminal,5411,3402,3022,11835
36864,2020-07-28,(02502) Terminal,376,258,309,943
36865,2020-09-14,(02502) Terminal,475,346,425,1246
36866,2020-06-05,(05000) Portal Américas - alimentacion,10065,5235,4808,20108
36867,2020-06-08,(07505) LEON XIII,2578,1350,1154,5082
36868,2020-01-24,(07503) SAN MATEO,39273,21073,17604,77950
36869,2020-05-08,(05000) Portal Américas,1584,1193,1301,4078
36870,2020-06-25,(05000) Portal Américas,2682,1908,2079,6669
36871,2020-03-03,(07003) SEVILLANA,2112,1152,1187,4451
36872,2020-04-01,(50003) Corral Molinos,791,332,545,1668
36873,2020-09-26,(09001) Molinos,2485,1076,2058,5619
36874,2020-09-01,(05000) Portal Américas - alimentacion,10977,5944,6206,23127
36875,2020-03-19,(09001) Molinos,4476,2537,3499,10512
36876,2020-07-05,(05001) Patio Bonito,0,259,716,975
36877,2020-01-12,(02000) Cabecera Autopista Norte - alimentacion,5739,2315,4542,12596
36878,2020-01-15,(08000) Portal Tunal - alimentacion,21157,10909,10605,42671
36879,2020-02-06,(07103) AV. CHILE,3590,2372,1959,7921
36880,2020-06-30,(05100) Banderas P. Central,801,450,547,1798
36881,2020-07-24,(05100) Banderas P. Central,515,290,318,1123
36882,2020-05-31,(10001) Country Sur,273,112,205,590
36883,2020-08-06,(09100) Calle 40 Sur,1655,961,1050,3666
36884,2020-01-04,(09115) Calle 34,696,563,880,2139
36885,2020-05-15,(09115) Calle 34,530,382,307,1219
36886,2020-02-18,(02000) Cabecera Autopista Norte,11978,7354,6250,25582
36887,2020-02-15,(07002) MADELENA,2915,1265,2050,6230
36888,2020-02-13,(10003) Ciudad Jardín,1128,580,694,2402
36889,2020-02-09,(07000) Portal Sur - alimentacion,7687,3191,5103,15981
36890,2020-02-07,(02204) Pepe Sierra,5088,3229,2551,10868
36891,2020-08-14,(10000) Portal 20 de Julio - alimentacion,4073,1817,2408,8298
36892,2020-02-27,(07001) PERDOMO,4633,2747,2603,9983
36893,2020-06-19,(07001) PERDOMO,1010,558,596,2164
36894,2020-09-12,(09000) Cabecera Usme - alimentacion,7440,3613,5204,16257
36895,2020-02-14,(09104) Restrepo,5573,3297,4050,12920
36896,2020-01-04,(04101) Minuto de Dios,595,313,568,1476
36897,2020-05-08,(04101) Minuto de Dios,205,128,152,485
36898,2020-08-06,(04101) Minuto de Dios,255,140,233,628
36899,2020-03-05,(04100) Carrera 77,6795,3892,3916,14603
36900,2020-01-19,(07112) COMUNEROS,840,449,867,2156
36901,2020-01-29,(07110) PALOQUEMAO,2488,1432,1157,5077
36902,2020-01-05,(05000) Portal Américas,2136,933,2088,5157
36903,2020-06-03,(07102) NQS - CALLE 75,362,253,157,772
36904,2020-06-27,(07102) NQS - CALLE 75,308,212,229,749
36905,2020-09-16,(07102) NQS - CALLE 75,488,315,296,1099
36906,2020-10-05,(07102) NQS - CALLE 75,502,318,317,1137
36907,2020-01-21,(07110) PALOQUEMAO,1833,1053,748,3634
36908,2020-08-05,(07111) NQS - RICAURTE,980,622,413,2015
36909,2020-07-08,(07002) MADELENA,882,528,509,1919
36910,2020-09-29,(07002) MADELENA,1040,584,779,2403
36911,2020-02-28,(09113) Calle 22,1584,913,1097,3594
36912,2020-09-03,(04000) Cabecera Calle 80,1131,698,1017,2846
36913,2020-10-08,(07010) Bosa,0,403,951,1354
36914,2020-03-10,(02000) Cabecera Autopista Norte - alimentacion,2268,5673,4020,11961
36915,2020-01-20,(04106) Carrera 47,1367,738,840,2945
36916,2020-06-18,(04002) Carrera 90,711,377,396,1484
36917,2020-07-11,(04100) Carrera 77,985,550,784,2319
36918,2020-09-17,(10006) San Victorino,807,388,407,1602
36919,2020-07-09,(40003) Mirador del Paraiso,1794,1160,1049,4003
36920,2020-02-21,(04104) Avenida 68,3468,1863,1805,7136
36921,2020-06-04,(09107) Hortúa,612,353,334,1299
36922,2020-02-15,(02304) Heroes,1845,1511,1667,5023
36923,2020-07-18,(03000) Portal Suba,796,443,538,1777
36924,2020-09-05,(09101) Quiroga,413,192,422,1027
36925,2020-04-27,(08000) Portal Tunal - alimentacion,2660,343,361,3364
36926,2020-03-08,(09108) Hospital,61,55,100,216
36927,2020-01-07,(10000) Portal 20 de Julio,6269,2791,3248,12308
36928,2020-08-30,(04108) El Polo,97,63,100,260
36929,2020-08-31,(02303) Calle 85,731,469,386,1586
36930,2020-03-07,(02300) Calle 100,2828,2155,2930,7913
36931,2020-01-12,(09004) Santa Lucía,1966,724,1571,4261
36932,2020-09-05,(09003) Socorro,539,229,368,1136
36933,2020-06-08,(09116) Avenida 39,301,215,193,709
36934,2020-05-06,(06108) Concejo de Bogotá,100,61,51,212
36935,2020-07-09,(06108) Concejo de Bogotá,157,83,84,324
36936,2020-05-02,(10002) Av. Primero de Mayo,912,469,582,1963
36937,2020-04-27,(14004) Museo del Oro,0,22,32,54
36938,2020-06-20,(02201) Prado,740,439,502,1681
36939,2020-07-25,(02201) Prado,548,359,321,1228
36940,2020-05-03,(03000) Portal Suba - alimentacion,1348,759,769,2876
36941,2020-03-06,(07007) NQS - Calle 38A Sur,2192,1200,1327,4719
36942,2020-03-19,(06102) Salitre El Greco,731,386,340,1457
36943,2020-08-03,(03000) Portal Suba - alimentacion,4741,2759,2779,10279
36944,2020-03-17,(04003) Avenida Ciudad de Cali,3212,1753,1871,6836
36945,2020-05-04,(09107) Hortúa,454,286,204,944
36946,2020-05-25,(09107) Hortúa,231,135,133,499
36947,2020-07-11,(40003) Mirador del Paraiso,1677,984,1064,3725
36948,2020-05-16,(04002) Carrera 90,380,206,227,813
36949,2020-01-01,(02300) Calle 100,412,320,680,1412
36950,2020-05-24,(02300) Calle 100,279,221,165,665
36951,2020-06-17,(03012) SUBA - CALLE 95,359,203,191,753
36952,2020-05-21,(10000) Portal 20 de Julio,1917,950,888,3755
36953,2020-01-17,(09001) Molinos,6917,3806,5554,16277
36954,2020-06-11,(08000) Portal Tunal,708,318,270,1296
36955,2020-07-31,(05105) Pradera,458,300,272,1030
36956,2020-03-01,(07009) SENA,913,400,883,2196
36957,2020-06-15,(06109) Centro Memoria,70,52,71,193
36958,2020-10-11,(03000) Portal Suba - alimentacion,2535,906,2235,5676
36959,2020-01-11,(12000) Puente Aranda,118,84,100,302
36960,2020-02-13,(03006) NIZA - CALLE 127,2468,1535,1492,5495
36961,2020-03-03,(04003) Avenida Ciudad de Cali,5497,3342,3635,12474
36962,2020-07-22,(04003) Avenida Ciudad de Cali,846,497,654,1997
36963,2020-02-29,(12007) Zona Industrial,718,482,526,1726
36964,2020-03-10,(09000) Cabecera Usme,234,1644,1457,3335
36965,2020-01-17,(07101) CASTELLANA,831,545,551,1927
36966,2020-08-22,(04100) Carrera 77,874,457,613,1944
36967,2020-07-06,(03007) HUMEDAL CORDOBA,166,112,95,373
36968,2020-07-13,(03007) HUMEDAL CORDOBA,127,95,59,281
36969,2020-08-14,(08002) Biblioteca,291,167,191,649
36970,2020-08-12,(07000) Portal Sur,1799,1117,1134,4050
36971,2020-09-27,(14005) Las Aguas,87,46,180,313
36972,2020-04-01,(07110) PALOQUEMAO,335,244,173,752
36973,2020-07-22,(10005) Bicentenario - alimentacion,185,98,155,438
36974,2020-06-05,(04107) Escuela Militar,118,86,80,284
36975,2020-08-11,(04107) Escuela Militar,120,61,86,267
36976,2020-09-29,(04107) Escuela Militar,174,101,136,411
36977,2020-01-23,(07004) VENECIA,4403,2477,2384,9264
36978,2020-01-03,(09001) Molinos,4605,2345,3769,10719
36979,2020-09-12,(09109) Tercer Milenio,288,178,243,709
36980,2020-01-15,(09117) Calle 45,3201,2366,2392,7959
36981,2020-09-21,(05001) Patio Bonito,1858,598,970,3426
36982,2020-08-11,(06101) El Tiempo,328,186,180,694
36983,2020-10-02,(09117) Calle 45,795,495,708,1998
36984,2020-03-20,(05002) Tintal,1222,725,539,2486
36985,2020-05-01,(02205) Calle 106,69,63,42,174
36986,2020-01-12,(07004) VENECIA,932,455,824,2211
36987,2020-08-19,(09002) Consuelo,436,239,259,934
36988,2020-01-03,(07008) NQS - Calle 30 Sur,870,457,616,1943
36989,2020-08-17,(06100) Av. Rojas,37,26,48,111
36990,2020-08-26,(02302) Virrey,593,401,308,1302
36991,2020-06-22,(12003) Ricaurte,62,59,48,169
36992,2020-03-13,(04103) Las Ferias,237,191,188,616
36993,2020-05-26,(09104) Restrepo,1278,807,964,3049
36994,2020-03-14,(10010) San Bernardo,843,517,960,2320
36995,2020-06-23,(10010) San Bernardo,618,362,399,1379
36996,2020-09-13,(05100) Banderas P. Central,234,91,251,576
36997,2020-04-09,(03009) Av. Suba- Calle 116,153,117,78,348
36998,2020-04-04,(02105) Calle 142,279,202,143,624
36999,2020-05-08,(09116) Avenida 39,226,168,141,535
37000,2020-01-05,(03006) NIZA - CALLE 127,402,257,370,1029
37001,2020-09-07,(05107) Américas - Cr.53,445,274,332,1051
37002,2020-06-29,(10010) San Bernardo,268,136,190,594
37003,2020-01-07,(03001) LA CAMPIÑA,4488,2429,2682,9599
37004,2020-10-09,(12007) Zona Industrial,387,241,253,881
37005,2020-01-15,(07201) Guatoque -Veraguas,825,450,587,1862
37006,2020-09-05,(10005) Bicentenario,81,46,98,225
37007,2020-04-19,(06108) Concejo de Bogotá,63,40,29,132
37008,2020-08-10,(02001) Centro Comercial Santa Fe,405,255,284,944
37009,2020-08-20,(07003) SEVILLANA,396,214,246,856
37010,2020-01-02,(07006) General Santander,1180,723,838,2741
37011,2020-06-04,(05100) Banderas P. Central,488,312,367,1167
37012,2020-08-11,(10008) San Diego,306,157,164,627
37013,2020-02-04,(08002) Biblioteca,1069,605,668,2342
37014,2020-02-11,(08002) Biblioteca,1009,626,710,2345
37015,2020-08-20,(10009) Museo Nacional,438,265,252,955
37016,2020-07-29,(05105) Pradera,456,301,254,1011
37017,2020-06-21,(09113) Calle 22,256,131,196,583
37018,2020-07-25,(12007) Zona Industrial,159,101,108,368
37019,2020-05-18,(09004) Santa Lucía,2042,1051,1030,4123
37020,2020-05-01,(02204) Pepe Sierra,222,169,117,508
37021,2020-05-14,(02104) Calle 146,552,382,349,1283
37022,2020-05-25,(07001) PERDOMO,253,130,154,537
37023,2020-03-14,(05102) Av. Américas - Av. Boyacá,687,387,534,1608
37024,2020-03-29,(07006) General Santander,90,46,47,183
37025,2020-07-16,(06104) Gobernación,217,127,113,457
37026,2020-07-24,(06104) Gobernación,218,129,82,429
37027,2020-01-01,(09123) Calle 76,236,195,419,850
37028,2020-01-19,(07108) Av. El Dorado,135,83,220,438
37029,2020-02-22,(50002) Corral Calle 40 Sur,66,34,86,186
37030,2020-05-14,(07201) Guatoque -Veraguas,149,98,92,339
37031,2020-07-29,(07105) MOVISTAR ARENA,243,130,120,493
37032,2020-09-07,(14004) Museo del Oro,375,235,282,892
37033,2020-06-10,(10006) San Victorino,537,278,307,1122
37034,2020-03-12,(40002) Manitas,56,263,209,528
37035,2020-05-12,(12004) Carrera 22,142,86,88,316
37036,2020-09-26,(03013) RIO NEGRO,212,145,209,566
37037,2020-06-02,(04106) Carrera 47,291,168,170,629
37038,2020-05-10,(09002) Consuelo,100,60,48,208
37039,2020-05-07,(07008) NQS - Calle 30 Sur,174,104,83,361
37040,2020-07-29,(07200) Tygua-San José,213,122,147,482
37041,2020-10-06,(10007) Las Nieves,752,447,545,1744
37042,2020-03-31,(07003) SEVILLANA,232,150,120,502
37043,2020-05-11,(07003) SEVILLANA,364,179,172,715
37044,2020-01-13,(09106) Nariño,1627,946,1215,3788
37045,2020-04-21,(02103) Mazurén,103,71,84,258
37046,2020-07-31,(03006) NIZA - CALLE 127,372,214,208,794
37047,2020-06-21,(03003) 21 ANGELES,97,35,75,207
37048,2020-09-20,(10000) Portal 20 de Julio - alimentacion,1589,672,1400,3661
37049,2020-01-01,(05102) Av. Américas - Av. Boyacá,72,54,107,233
37050,2020-06-19,(05107) Américas - Cr.53,444,249,269,962
37051,2020-07-26,(05107) Américas - Cr.53,59,60,73,192
37052,2020-03-09,(07006) General Santander - alimentacion,72,367,242,681
37053,2020-06-07,(03009) Av. Suba- Calle 116,132,85,94,311
37054,2020-01-04,(03004) GRATAMIRA,68,32,57,157
37055,2020-09-15,(07200) Tygua-San José,234,147,186,567
37056,2020-07-21,(04104) Avenida 68,604,309,315,1228
37057,2020-05-02,(04100) Carrera 77,504,245,308,1057
37058,2020-03-11,(09105) Río Fucha,736,432,482,1650
37059,2020-10-08,(07006) General Santander - alimentacion,410,231,338,979
37060,2020-05-28,(14004) Museo del Oro,0,96,219,315
37061,2020-09-06,(07506) DESPENSA,118,66,135,319
37062,2020-09-05,(07006) General Santander - alimentacion,279,157,287,723
37063,2020-06-04,(05102) Av. Américas - Av. Boyacá,170,103,126,399
37064,2020-03-30,(06001) Modelia,262,193,168,623
37065,2020-09-21,(10004) Policarpa,174,77,127,378
37066,2020-04-25,(14001) La Sabana,67,56,54,177
37067,2020-08-15,(06000) Portal Eldorado,620,422,531,1573
37068,2020-09-26,(40002) Manitas,373,211,330,914
37069,2020-04-15,(10006) San Victorino,197,134,127,458
37070,2020-04-22,(09003) Socorro,312,152,172,636
37071,2020-03-21,(07010) Bosa,175,104,160,439
37072,2020-08-30,(05105) Pradera,161,135,162,458
37073,2020-10-06,(07108) Av. El Dorado,186,109,141,436
37074,2020-02-26,(03014) SAN MARTIN,249,163,155,567
37075,2020-05-17,(06102) Salitre El Greco,67,39,35,141
37076,2020-04-10,(09101) Quiroga,68,39,38,145
37077,2020-03-28,(06108) Concejo de Bogotá,60,45,45,150
37078,2020-01-10,(03014) SAN MARTIN,177,113,156,446
37079,2020-03-13,(03014) SAN MARTIN,66,21,37,124
37080,2020-07-01,(09105) Río Fucha,125,66,100,291
37081,2020-04-27,(40002) Manitas,148,20,25,193
37082,2020-04-26,(04105) Carrera 53,52,34,41,127
37083,2020-04-11,(06111) Universidades,0,41,112,153
37084,2020-03-23,(05101) Mandalay - Cr.73,17,12,8,37
37085,2020-06-21,(02204) Pepe Sierra,240,180,165,585
37086,2020-04-26,(04108) El Polo,46,34,42,122
37087,2020-05-10,(06105) Quinta Paredes,20,23,13,56
37088,2020-06-21,(03005) SUBA - AV. BOYACA,111,76,96,283
37089,2020-07-28,(06100) Av. Rojas,183,123,124,430
37090,2020-10-08,(03014) SAN MARTIN,0,22,59,81
37091,2020-05-31,(06106) Recinto Ferial,66,34,48,148
37092,2020-06-04,(03007) HUMEDAL CORDOBA,124,90,43,257
37093,2020-04-07,(05101) Mandalay - Cr.73,45,26,22,93
37094,2020-08-10,(50006) Corral Carrera 77,3,2,3,8
37095,2020-05-17,(07107) U. NACIONAL,84,52,46,182
37096,2020-09-05,(12000) Puente Aranda,63,35,47,145
37097,2020-09-17,(03014) SAN MARTIN,0,17,27,44
37098,2020-04-02,(03007) HUMEDAL CORDOBA,62,42,35,139
37099,2020-04-10,(14004) Museo del Oro,0,6,11,17
37100,2020-09-23,(03004) GRATAMIRA,0,21,36,57
37101,2020-07-26,(50006) Corral Carrera 77,1,0,1,2
37102,2020-02-25,(04000) Cabecera Calle 80 - alimentacion,24591,15027,14603,54221
37103,2020-09-19,(09118) Marly,1140,766,898,2804
37104,2020-01-29,(02101) Toberín,14801,9273,7720,31794
37105,2020-02-12,(02101) Toberín,15860,9908,7897,33665
37106,2020-09-14,(05000) Portal Américas,3351,2028,2339,7718
37107,2020-01-05,(06104) Gobernación,75,66,151,292
37108,2020-02-03,(04002) Carrera 90,3699,2270,2060,8029
37109,2020-09-19,(09001) Molinos,2454,1125,2008,5587
37110,2020-01-11,(07503) SAN MATEO,23517,11162,11904,46583
37111,2020-01-30,(09004) Santa Lucía,7240,4014,4047,15301
37112,2020-03-03,(10001) Country Sur,5129,2406,2762,10297
37113,2020-07-17,(10001) Country Sur,851,409,563,1823
37114,2020-02-13,(09000) Cabecera Usme,6177,3728,3988,13893
37115,2020-09-10,(09000) Cabecera Usme,1754,994,1179,3927
37116,2020-03-07,(09115) Calle 34,1488,1126,1634,4248
37117,2020-03-10,(07000) Portal Sur - alimentacion,1013,8095,4977,14085
37118,2020-01-15,(40003) Mirador del Paraiso,4349,2351,2467,9167
37119,2020-04-15,(07505) LEON XIII,1172,726,516,2414
37120,2020-01-10,(02204) Pepe Sierra,3550,2306,1858,7714
37121,2020-06-10,(09000) Cabecera Usme,1664,1070,1090,3824
37122,2020-01-17,(09110) Avenida Jimenez,3948,2772,2591,9311
37123,2020-02-11,(09117) Calle 45,6880,4373,3025,14278
37124,2020-02-26,(12003) Ricaurte,1212,852,733,2797
37125,2020-02-14,(03009) Av. Suba- Calle 116,2576,1620,1524,5720
37126,2020-05-20,(09101) Quiroga,392,225,262,879
37127,2020-09-03,(07102) NQS - CALLE 75,482,313,259,1054
37128,2020-04-14,(03013) RIO NEGRO,137,102,118,357
37129,2020-02-03,(02304) Heroes,4693,3146,2336,10175
37130,2020-02-08,(09103) Olaya,2664,1275,1880,5819
37131,2020-04-14,(50003) Corral Molinos,825,389,559,1773
37132,2020-02-17,(03007) HUMEDAL CORDOBA,1006,678,493,2177
37133,2020-02-10,(02103) Mazurén,3614,2308,1843,7765
37134,2020-07-24,(05100) Banderas P. Central - alimentacion,2218,1156,1106,4480
37135,2020-09-05,(05100) Banderas P. Central - alimentacion,2676,1209,1788,5673
37136,2020-05-28,(07002) MADELENA,674,378,346,1398
37137,2020-10-10,(02000) Cabecera Autopista Norte,1191,661,1139,2991
37138,2020-01-24,(04102) Avenida Boyaca,2754,1540,1631,5925
37139,2020-04-13,(04105) Carrera 53,174,102,88,364
37140,2020-06-21,(05000) Portal Américas,681,453,635,1769
37141,2020-02-26,(04000) Cabecera Calle 80,7703,4431,5075,17209
37142,2020-08-14,(04000) Cabecera Calle 80,928,561,770,2259
37143,2020-07-04,(07112) COMUNEROS,672,415,439,1526
37144,2020-10-03,(04002) Carrera 90,671,295,542,1508
37145,2020-05-08,(04100) Carrera 77,873,471,548,1892
37146,2020-03-16,(03000) Portal Suba,6243,3720,3419,13382
37147,2020-02-21,(40003) Mirador del Paraiso,4745,2621,2657,10023
37148,2020-08-27,(02101) Toberín,1359,853,971,3183
37149,2020-03-11,(04001) Quirigua,1982,1253,1133,4368
37150,2020-10-05,(12001) Carrera 43,511,305,319,1135
37151,2020-03-05,(06111) Universidades,5724,3598,2761,12083
37152,2020-08-14,(09000) Cabecera Usme - alimentacion,8063,4309,4815,17187
37153,2020-09-09,(06105) Quinta Paredes,151,102,117,370
37154,2020-07-31,(09101) Quiroga,458,248,327,1033
37155,2020-01-01,(08001) Parque el Tunal,157,69,188,414
37156,2020-03-08,(05002) Tintal,1974,898,1893,4765
37157,2020-03-18,(06100) Av. Rojas,928,513,479,1920
37158,2020-10-12,(07000) Portal Sur - alimentacion,3104,1380,2270,6754
37159,2020-01-09,(09116) Avenida 39,1663,1114,1099,3876
37160,2020-07-22,(10000) Portal 20 de Julio,1695,913,933,3541
37161,2020-08-08,(07112) COMUNEROS,550,304,344,1198
37162,2020-08-24,(07112) COMUNEROS,702,398,415,1515
37163,2020-07-08,(09004) Santa Lucía,2725,1444,1458,5627
37164,2020-02-13,(07008) NQS - Calle 30 Sur,2024,1031,1101,4156
37165,2020-05-07,(08001) Parque el Tunal,293,155,173,621
37166,2020-07-02,(09116) Avenida 39,364,225,258,847
37167,2020-07-09,(07010) Bosa,738,345,417,1500
37168,2020-03-23,(07503) SAN MATEO,2928,1453,1459,5840
37169,2020-02-20,(02202) Calle 127,5839,3804,2772,12415
37170,2020-03-29,(09107) Hortúa,168,125,77,370
37171,2020-07-31,(05101) Mandalay - Cr.73,108,50,55,213
37172,2020-02-26,(03011) SUBA - CALLE 100,2722,1422,1493,5637
37173,2020-10-12,(02300) Calle 100,240,230,404,874
37174,2020-05-26,(09119) Calle 57,495,349,333,1177
37175,2020-08-19,(50002) Corral Calle 40 Sur,24,7,26,57
37176,2020-08-28,(50002) Corral Calle 40 Sur,27,15,29,71
37177,2020-09-20,(50002) Corral Calle 40 Sur,9,3,4,16
37178,2020-10-11,(02101) Toberín,370,211,575,1156
37179,2020-02-10,(05105) Pradera,2630,1613,1198,5441
37180,2020-01-01,(09104) Restrepo,467,290,764,1521
37181,2020-05-23,(09104) Restrepo,974,606,676,2256
37182,2020-10-02,(02302) Virrey,779,573,511,1863
37183,2020-06-27,(05005) Transversal 86,327,132,210,669
37184,2020-06-27,(02202) Calle 127,914,682,529,2125
37185,2020-01-27,(08000) Portal Tunal,2066,1184,1001,4251
37186,2020-05-15,(08000) Portal Tunal,615,261,220,1096
37187,2020-05-26,(08000) Portal Tunal,658,290,240,1188
37188,2020-07-21,(08000) Portal Tunal,576,239,201,1016
37189,2020-03-07,(03009) Av. Suba- Calle 116,1099,842,1117,3058
37190,2020-03-25,(02205) Calle 106,198,170,117,485
37191,2020-06-30,(02205) Calle 106,407,254,273,934
37192,2020-07-09,(03000) Portal Suba - alimentacion,6498,3798,3724,14020
37193,2020-07-18,(03007) HUMEDAL CORDOBA,99,53,50,202
37194,2020-02-13,(07108) Av. El Dorado,839,591,667,2097
37195,2020-03-03,(05101) Mandalay - Cr.73,1224,641,527,2392
37196,2020-02-23,(02101) Toberín,1702,781,2113,4596
37197,2020-03-21,(03011) SUBA - CALLE 100,214,135,95,444
37198,2020-07-30,(02000) Cabecera Autopista Norte - alimentacion,4439,2424,2422,9285
37199,2020-07-14,(02000) Cabecera Autopista Norte - alimentacion,4261,2315,2279,8855
37200,2020-03-24,(02304) Heroes,673,545,482,1700
37201,2020-09-19,(07104) Simon Bolivar,457,303,365,1125
37202,2020-07-28,(10005) Bicentenario - alimentacion,195,117,171,483
37203,2020-10-02,(07109) CAD,740,466,475,1681
37204,2020-06-14,(05103) Marsella,93,45,77,215
37205,2020-07-04,(05103) Marsella,354,179,242,775
37206,2020-09-26,(09100) Calle 40 Sur,1534,802,1324,3660
37207,2020-01-03,(12001) Carrera 43,709,467,604,1780
37208,2020-08-19,(05001) Patio Bonito,1733,923,1002,3658
37209,2020-09-05,(02104) Calle 146,655,346,604,1605
37210,2020-06-18,(02202) Calle 127,1190,796,564,2550
37211,2020-04-30,(03011) SUBA - CALLE 100,312,173,132,617
37212,2020-09-08,(07109) CAD,677,433,367,1477
37213,2020-04-26,(09002) Consuelo,115,51,73,239
37214,2020-09-25,(02105) Calle 142,1011,622,772,2405
37215,2020-08-01,(06100) Av. Rojas,98,65,92,255
37216,2020-04-21,(06000) Portal Eldorado,851,559,351,1761
37217,2020-04-30,(06000) Portal Eldorado,889,556,402,1847
37218,2020-07-23,(02302) Virrey,510,327,272,1109
37219,2020-09-22,(02302) Virrey,776,549,421,1746
37220,2020-08-20,(07009) SENA,562,329,311,1202
37221,2020-02-08,(12003) Ricaurte,749,579,537,1865
37222,2020-08-21,(12003) Ricaurte,390,266,185,841
37223,2020-10-02,(12003) Ricaurte,437,275,264,976
37224,2020-03-02,(04103) Las Ferias,1472,908,865,3245
37225,2020-05-06,(07106) EL CAMPIN,219,145,124,488
37226,2020-06-09,(07106) EL CAMPIN,344,213,208,765
37227,2020-08-22,(10010) San Bernardo,443,208,357,1008
37228,2020-04-14,(03009) Av. Suba- Calle 116,338,247,171,756
37229,2020-04-08,(06107) Ciudad Universitaria,96,66,74,236
37230,2020-05-14,(09002) Consuelo,379,201,205,785
37231,2020-06-28,(03002) SUBA - TV- 91,224,110,189,523
37232,2020-04-13,(05107) Américas - Cr.53,307,212,160,679
37233,2020-04-18,(05107) Américas - Cr.53,235,153,128,516
37234,2020-07-03,(07103) AV. CHILE,975,585,522,2082
37235,2020-09-25,(10005) Bicentenario,107,79,117,303
37236,2020-08-21,(40002) Manitas,365,252,262,879
37237,2020-10-08,(05103) Marsella,577,299,393,1269
37238,2020-03-18,(09106) Nariño,1008,586,663,2257
37239,2020-09-08,(02304) Heroes,900,590,552,2042
37240,2020-05-25,(06108) Concejo de Bogotá,62,43,37,142
37241,2020-01-15,(03005) SUBA - AV. BOYACA,2369,1409,1413,5191
37242,2020-06-11,(09123) Calle 76,989,691,495,2175
37243,2020-02-18,(07104) Simon Bolivar,2455,1535,1196,5186
37244,2020-08-05,(07004) VENECIA,926,527,492,1945
37245,2020-05-19,(09110) Avenida Jimenez,843,622,579,2044
37246,2020-08-04,(10008) San Diego,293,165,175,633
37247,2020-02-09,(03012) SUBA - CALLE 95,323,182,357,862
37248,2020-01-28,(07105) MOVISTAR ARENA,1279,783,785,2847
37249,2020-03-21,(05102) Av. Américas - Av. Boyacá,86,59,35,180
37250,2020-02-03,(07006) General Santander,2870,1663,1571,6104
37251,2020-05-28,(03006) NIZA - CALLE 127,373,223,186,782
37252,2020-02-16,(04107) Escuela Militar,126,79,176,381
37253,2020-01-02,(12004) Carrera 22,214,152,207,573
37254,2020-03-14,(12002) CDS - Carrera 32,298,231,259,788
37255,2020-06-19,(06104) Gobernación,261,169,123,553
37256,2020-05-16,(06102) Salitre El Greco,125,73,61,259
37257,2020-09-29,(50003) Corral Molinos,1601,807,1374,3782
37258,2020-09-17,(07201) Guatoque -Veraguas,219,123,154,496
37259,2020-05-24,(02303) Calle 85,143,122,88,353
37260,2020-06-28,(06109) Centro Memoria,72,55,60,187
37261,2020-03-17,(07008) NQS - Calle 30 Sur,1078,551,537,2166
37262,2020-04-23,(07113) SANTA ISABEL,202,147,113,462
37263,2020-09-05,(09119) Calle 57,500,316,385,1201
37264,2020-08-25,(05005) Transversal 86,332,181,219,732
37265,2020-09-29,(14005) Las Aguas,252,159,283,694
37266,2020-05-08,(03007) HUMEDAL CORDOBA,89,61,44,194
37267,2020-05-11,(03006) NIZA - CALLE 127,290,207,161,658
37268,2020-05-04,(03005) SUBA - AV. BOYACA,227,170,160,557
37269,2020-06-10,(09120) Calle 63,1064,732,640,2436
37270,2020-03-08,(04000) Cabecera Calle 80 - intermunicipal,312,166,424,902
37271,2020-08-03,(02102) Calle 161,195,137,122,454
37272,2020-01-02,(09111) Calle 19,974,619,872,2465
37273,2020-07-31,(02103) Mazurén,152,83,127,362
37274,2020-10-08,(10007) Las Nieves,743,456,515,1714
37275,2020-05-19,(10009) Museo Nacional,440,284,239,963
37276,2020-01-12,(06108) Concejo de Bogotá,93,78,178,349
37277,2020-01-22,(07006) General Santander - alimentacion,1420,845,896,3161
37278,2020-09-21,(02204) Pepe Sierra,712,522,439,1673
37279,2020-06-11,(09113) Calle 22,391,266,331,988
37280,2020-05-04,(02001) Centro Comercial Santa Fe,266,184,176,626
37281,2020-04-22,(12002) CDS - Carrera 32,215,153,68,436
37282,2020-05-21,(12002) CDS - Carrera 32,198,140,58,396
37283,2020-06-25,(07003) SEVILLANA,477,284,242,1003
37284,2020-05-04,(06002) Normandía,193,106,92,391
37285,2020-04-30,(07506) DESPENSA,297,150,182,629
37286,2020-07-13,(07006) General Santander,465,316,242,1023
37287,2020-09-29,(04102) Avenida Boyaca,458,254,326,1038
37288,2020-03-16,(09108) Hospital,165,107,139,411
37289,2020-05-15,(09108) Hospital,67,47,52,166
37290,2020-08-28,(09108) Hospital,54,44,79,177
37291,2020-02-16,(06107) Ciudad Universitaria,254,155,373,782
37292,2020-09-08,(09111) Calle 19,679,458,494,1631
37293,2020-07-18,(09000) Cabecera Usme,915,568,814,2297
37294,2020-04-29,(09003) Socorro,353,184,202,739
37295,2020-08-03,(06105) Quinta Paredes,131,86,67,284
37296,2020-05-11,(10008) San Diego,200,126,158,484
37297,2020-05-02,(04002) Carrera 90,290,151,157,598
37298,2020-05-28,(05107) Américas - Cr.53,366,226,240,832
37299,2020-05-31,(02303) Calle 85,168,123,111,402
37300,2020-08-26,(14004) Museo del Oro,219,149,185,553
37301,2020-04-14,(07005) ALQUERIA,282,183,127,592
37302,2020-07-31,(05102) Av. Américas - Av. Boyacá,195,105,127,427
37303,2020-07-13,(06102) Salitre El Greco,206,116,88,410
37304,2020-08-02,(03000) Portal Suba,221,160,228,609
37305,2020-10-12,(06101) El Tiempo,99,84,153,336
37306,2020-03-29,(02303) Calle 85,153,117,71,341
37307,2020-06-22,(06000) Portal Eldorado,253,182,173,608
37308,2020-07-03,(03011) SUBA - CALLE 100,565,236,255,1056
37309,2020-04-21,(05100) Banderas P. Central,347,207,223,777
37310,2020-03-27,(06111) Universidades,0,74,206,280
37311,2020-07-19,(07010) Bosa,164,88,117,369
37312,2020-05-29,(03002) SUBA - TV- 91,666,429,355,1450
37313,2020-08-04,(07007) NQS - Calle 38A Sur,278,198,228,704
37314,2020-08-30,(06001) Modelia,73,53,98,224
37315,2020-06-13,(14001) La Sabana,143,107,101,351
37316,2020-08-02,(02103) Mazurén,26,17,40,83
37317,2020-05-29,(05101) Mandalay - Cr.73,110,57,58,225
37318,2020-08-05,(06104) Gobernación,228,144,105,477
37319,2020-04-27,(03002) SUBA - TV- 91,278,79,58,415
37320,2020-04-03,(04104) Avenida 68,284,174,198,656
37321,2020-08-27,(05103) Marsella,415,215,212,842
37322,2020-06-09,(10004) Policarpa,225,100,148,473
37323,2020-07-20,(09111) Calle 19,136,95,163,394
37324,2020-07-12,(06103) CAN,127,79,75,281
37325,2020-03-24,(04001) Quirigua,304,197,219,720
37326,2020-09-27,(07105) MOVISTAR ARENA,61,34,120,215
37327,2020-07-12,(06105) Quinta Paredes,42,25,26,93
37328,2020-07-20,(03014) SAN MARTIN,0,8,16,24
37329,2020-05-20,(14005) Las Aguas,0,55,146,201
37330,2020-05-31,(07108) Av. El Dorado,27,26,33,86
37331,2020-04-26,(50002) Corral Calle 40 Sur,7,2,5,14
37332,2020-05-17,(50002) Corral Calle 40 Sur,6,1,5,12
37333,2020-10-13,(09001) Molinos,1,0,0,1
37334,2020-04-19,(03014) SAN MARTIN,5,6,6,17
37335,2020-05-29,(07005) ALQUERIA,514,285,258,1057
37336,2020-08-21,(02502) Terminal,362,256,337,955
37337,2020-09-26,(09118) Marly,1131,775,970,2876
37338,2020-01-25,(07504) TERREROS,11590,5774,7248,24612
37339,2020-10-10,(07504) TERREROS,5538,2453,3783,11774
37340,2020-02-03,(05000) Portal Américas - alimentacion,36173,21453,21750,79376
37341,2020-08-20,(05000) Portal Américas - alimentacion,9383,5388,5608,20379
37342,2020-09-16,(05000) Portal Américas - alimentacion,12239,6771,7407,26417
37343,2020-02-18,(09119) Calle 57,4059,2421,2153,8633
37344,2020-03-03,(04106) Carrera 47,1520,848,925,3293
37345,2020-01-18,(03000) Portal Suba - alimentacion,15049,7225,10480,32754
37346,2020-10-01,(03000) Portal Suba - alimentacion,7528,4003,5212,16743
37347,2020-03-05,(03002) SUBA - TV- 91,4561,2648,2469,9678
37348,2020-01-03,(07503) SAN MATEO,23643,12431,11615,47689
37349,2020-09-24,(07503) SAN MATEO,13368,6830,6664,26862
37350,2020-01-18,(04101) Minuto de Dios,1181,665,1106,2952
37351,2020-05-12,(05000) Portal Américas - alimentacion,8518,4409,3855,16782
37352,2020-02-13,(07010) Bosa,2308,1247,1446,5001
37353,2020-02-09,(04100) Carrera 77,1483,635,1498,3616
37354,2020-08-26,(07503) SAN MATEO,10702,6045,4968,21715
37355,2020-01-04,(09000) Cabecera Usme - alimentacion,11297,5364,7967,24628
37356,2020-04-17,(10000) Portal 20 de Julio - alimentacion,2480,1161,1754,5395
37357,2020-08-26,(09000) Cabecera Usme,1689,1019,1184,3892
37358,2020-07-07,(06000) Portal Eldorado - alimentacion,4195,2245,2302,8742
37359,2020-06-17,(09115) Calle 34,701,435,416,1552
37360,2020-01-02,(05100) Banderas P. Central - alimentacion,6163,3247,3843,13253
37361,2020-06-11,(09000) Cabecera Usme - alimentacion,8161,4540,4391,17092
37362,2020-03-01,(07001) PERDOMO,961,400,875,2236
37363,2020-02-11,(09120) Calle 63,7582,4809,3787,16178
37364,2020-01-30,(05107) Américas - Cr.53,2493,1432,1404,5329
37365,2020-01-27,(04000) Cabecera Calle 80 - intermunicipal,2063,1453,1965,5481
37366,2020-07-13,(09104) Restrepo,1094,659,730,2483
37367,2020-06-19,(04101) Minuto de Dios,356,206,262,824
37368,2020-04-21,(07505) LEON XIII,1168,750,594,2512
37369,2020-03-02,(05001) Patio Bonito,6980,3975,3630,14585
37370,2020-01-14,(09123) Calle 76,4196,2787,2502,9485
37371,2020-08-25,(09123) Calle 76,891,623,528,2042
37372,2020-07-23,(02000) Cabecera Autopista Norte - alimentacion,4100,2195,2128,8423
37373,2020-01-02,(03005) SUBA - AV. BOYACA,1007,633,745,2385
37374,2020-01-25,(03005) SUBA - AV. BOYACA,1352,743,1037,3132
37375,2020-02-25,(07102) NQS - CALLE 75,1523,1024,961,3508
37376,2020-02-01,(02304) Heroes,1720,1403,1643,4766
37377,2020-03-12,(09116) Avenida 39,1222,152,324,1698
37378,2020-03-17,(07106) EL CAMPIN,1220,874,663,2757
37379,2020-05-19,(02103) Mazurén,138,93,128,359
37380,2020-02-06,(02303) Calle 85,3779,2709,2032,8520
37381,2020-07-03,(05100) Banderas P. Central - alimentacion,3113,1750,1881,6744
37382,2020-09-07,(09103) Olaya,1042,565,625,2232
37383,2020-09-08,(09103) Olaya,1077,574,676,2327
37384,2020-04-14,(14001) La Sabana,84,71,50,205
37385,2020-05-28,(14001) La Sabana,92,102,116,310
37386,2020-06-23,(14001) La Sabana,182,129,105,416
37387,2020-02-05,(07112) COMUNEROS,3992,2428,2305,8725
37388,2020-05-18,(02000) Cabecera Autopista Norte,995,689,652,2336
37389,2020-01-05,(09113) Calle 22,437,246,424,1107
37390,2020-01-28,(02201) Prado,5641,3535,2943,12119
37391,2020-02-09,(02000) Cabecera Autopista Norte - intermunicipal,682,460,730,1872
37392,2020-01-22,(06105) Quinta Paredes,894,563,486,1943
37393,2020-01-20,(07007) NQS - Calle 38A Sur,1920,1128,1192,4240
37394,2020-02-07,(04000) Cabecera Calle 80,7766,4270,5089,17125
37395,2020-05-19,(04000) Cabecera Calle 80,820,531,598,1949
37396,2020-07-14,(04000) Cabecera Calle 80,941,573,718,2232
37397,2020-02-25,(05002) Tintal,11282,6864,5942,24088
37398,2020-03-19,(05002) Tintal,5890,3085,3119,12094
37399,2020-05-16,(10001) Country Sur,643,303,414,1360
37400,2020-02-26,(40003) Mirador del Paraiso,4767,2519,2760,10046
37401,2020-06-05,(40003) Mirador del Paraiso,1661,1068,981,3710
37402,2020-02-06,(12001) Carrera 43,1752,1054,1057,3863
37403,2020-09-26,(09000) Cabecera Usme - alimentacion,7850,3572,5684,17106
37404,2020-03-13,(07112) COMUNEROS,528,506,514,1548
37405,2020-08-28,(02303) Calle 85,732,479,439,1650
37406,2020-01-29,(07000) Portal Sur,7757,4647,4265,16669
37407,2020-01-17,(02001) Centro Comercial Santa Fe,4126,2342,2525,8993
37408,2020-02-20,(06102) Salitre El Greco,1548,860,644,3052
37409,2020-03-31,(07503) SAN MATEO,5504,2998,2717,11219
37410,2020-06-25,(08001) Parque el Tunal,473,280,270,1023
37411,2020-10-11,(08001) Parque el Tunal,147,75,159,381
37412,2020-04-18,(06108) Concejo de Bogotá,66,45,45,156
37413,2020-08-30,(06108) Concejo de Bogotá,40,24,33,97
37414,2020-07-25,(07001) PERDOMO,494,260,344,1098
37415,2020-03-20,(09000) Cabecera Usme - alimentacion,3631,1886,1827,7344
37416,2020-03-20,(06000) Portal Eldorado - alimentacion,2455,1085,837,4377
37417,2020-09-04,(02201) Prado,980,661,630,2271
37418,2020-02-28,(02304) Heroes,4447,3300,2372,10119
37419,2020-03-06,(06106) Recinto Ferial,1490,829,885,3204
37420,2020-09-07,(09118) Marly,1515,972,912,3399
37421,2020-04-01,(03000) Portal Suba - alimentacion,3202,1681,1724,6607
37422,2020-02-24,(10009) Museo Nacional,4654,2359,1924,8937
37423,2020-05-31,(02000) Cabecera Autopista Norte - alimentacion,1627,808,940,3375
37424,2020-09-01,(03011) SUBA - CALLE 100,564,256,283,1103
37425,2020-05-11,(02300) Calle 100,993,664,465,2122
37426,2020-01-31,(03012) SUBA - CALLE 95,1327,858,1051,3236
37427,2020-03-26,(09001) Molinos,1093,581,770,2444
37428,2020-06-20,(05101) Mandalay - Cr.73,107,45,63,215
37429,2020-03-06,(14005) Las Aguas,3106,1989,2064,7159
37430,2020-06-11,(05005) Transversal 86,313,172,182,667
37431,2020-03-17,(08000) Portal Tunal,1491,808,731,3030
37432,2020-02-03,(09121) Las Flores,3307,2010,2057,7374
37433,2020-01-25,(04104) Avenida 68,1662,916,1362,3940
37434,2020-09-04,(03009) Av. Suba- Calle 116,535,352,263,1150
37435,2020-03-14,(12000) Puente Aranda,137,105,130,372
37436,2020-02-01,(04101) Minuto de Dios,1328,756,1210,3294
37437,2020-08-13,(04101) Minuto de Dios,281,156,225,662
37438,2020-02-14,(09101) Quiroga,1751,1039,1172,3962
37439,2020-03-19,(04108) El Polo,1037,676,630,2343
37440,2020-06-19,(07101) CASTELLANA,219,130,141,490
37441,2020-02-16,(06102) Salitre El Greco,255,169,254,678
37442,2020-04-08,(06102) Salitre El Greco,148,92,76,316
37443,2020-02-16,(07010) Bosa,437,261,549,1247
37444,2020-01-19,(07113) SANTA ISABEL,452,224,561,1237
37445,2020-05-09,(05001) Patio Bonito,878,483,465,1826
37446,2020-06-18,(06111) Universidades,244,168,321,733
37447,2020-09-06,(06111) Universidades,123,77,186,386
37448,2020-01-11,(04102) Avenida Boyaca,1185,606,852,2643
37449,2020-03-24,(09004) Santa Lucía,1850,841,1136,3827
37450,2020-01-02,(07108) Av. El Dorado,290,217,320,827
37451,2020-01-22,(09117) Calle 45,4709,3240,2635,10584
37452,2020-05-19,(10010) San Bernardo,555,310,320,1185
37453,2020-02-08,(04102) Avenida Boyaca,1579,858,1177,3614
37454,2020-04-18,(10005) Bicentenario - alimentacion,108,56,95,259
37455,2020-09-07,(10005) Bicentenario - alimentacion,198,96,217,511
37456,2020-05-15,(10010) San Bernardo,570,289,344,1203
37457,2020-06-06,(07000) Portal Sur,1335,739,824,2898
37458,2020-09-13,(02000) Cabecera Autopista Norte - intermunicipal,140,87,185,412
37459,2020-04-23,(05103) Marsella,210,105,109,424
37460,2020-04-30,(09118) Marly,1135,738,514,2387
37461,2020-09-02,(04103) Las Ferias,316,197,267,780
37462,2020-10-08,(06101) El Tiempo,393,248,294,935
37463,2020-03-26,(05002) Tintal,1013,620,633,2266
37464,2020-03-20,(09001) Molinos,1048,638,568,2254
37465,2020-08-07,(08000) Portal Tunal - alimentacion,2840,1376,1535,5751
37466,2020-05-20,(03001) LA CAMPIÑA,854,489,462,1805
37467,2020-07-19,(03000) Portal Suba,283,145,198,626
37468,2020-03-01,(06106) Recinto Ferial,294,167,320,781
37469,2020-10-06,(06106) Recinto Ferial,291,191,206,688
37470,2020-06-14,(02001) Centro Comercial Santa Fe,124,72,128,324
37471,2020-03-18,(07008) NQS - Calle 30 Sur,929,442,561,1932
37472,2020-09-15,(12003) Ricaurte,411,280,201,892
37473,2020-02-21,(04103) Las Ferias,1494,821,803,3118
37474,2020-01-11,(03010) PUENTE LARGO,774,511,646,1931
37475,2020-07-29,(10010) San Bernardo,586,320,402,1308
37476,2020-02-29,(03006) NIZA - CALLE 127,1247,822,965,3034
37477,2020-07-31,(07009) SENA,493,306,342,1141
37478,2020-06-03,(06103) CAN,340,220,163,723
37479,2020-05-04,(07005) ALQUERIA,339,201,178,718
37480,2020-09-13,(03006) NIZA - CALLE 127,175,114,128,417
37481,2020-05-24,(07504) TERREROS,1088,636,632,2356
37482,2020-01-09,(10005) Bicentenario,512,286,294,1092
37483,2020-07-01,(07007) NQS - Calle 38A Sur,416,237,286,939
37484,2020-09-10,(10005) Bicentenario,92,60,75,227
37485,2020-02-13,(40002) Manitas,1341,786,814,2941
37486,2020-04-13,(06108) Concejo de Bogotá,102,72,53,227
37487,2020-06-22,(03001) LA CAMPIÑA,289,159,215,663
37488,2020-06-23,(02001) Centro Comercial Santa Fe,559,352,352,1263
37489,2020-01-28,(02102) Calle 161,1794,1145,1148,4087
37490,2020-09-17,(04100) Carrera 77,1314,819,1017,3150
37491,2020-06-04,(07003) SEVILLANA,405,215,188,808
37492,2020-06-07,(02104) Calle 146,201,142,119,462
37493,2020-07-28,(09004) Santa Lucía,2385,1273,1217,4875
37494,2020-09-25,(02200) Alcalá,2205,1372,1460,5037
37495,2020-07-20,(08002) Biblioteca,97,47,49,193
37496,2020-06-07,(09120) Calle 63,301,206,279,786
37497,2020-09-20,(10010) San Bernardo,224,111,271,606
37498,2020-06-19,(09117) Calle 45,742,455,463,1660
37499,2020-03-30,(10005) Bicentenario - alimentacion,154,72,108,334
37500,2020-07-08,(06111) Universidades,330,200,347,877
37501,2020-09-20,(07004) VENECIA,315,192,324,831
37502,2020-04-02,(09115) Calle 34,329,232,200,761
37503,2020-05-21,(02104) Calle 146,562,382,368,1312
37504,2020-01-18,(07006) General Santander,1466,727,1089,3282
37505,2020-01-04,(12004) Carrera 22,217,142,196,555
37506,2020-02-15,(12004) Carrera 22,477,363,405,1245
37507,2020-03-07,(12002) CDS - Carrera 32,281,216,239,736
37508,2020-09-21,(06109) Centro Memoria,168,147,166,481
37509,2020-02-19,(07006) General Santander - alimentacion,1571,897,994,3462
37510,2020-02-02,(07105) MOVISTAR ARENA,220,158,313,691
37511,2020-03-31,(09121) Las Flores,360,287,222,869
37512,2020-03-05,(07506) DESPENSA,1483,904,924,3311
37513,2020-09-16,(07107) U. NACIONAL,410,232,279,921
37514,2020-05-19,(04003) Avenida Ciudad de Cali,839,548,513,1900
37515,2020-07-07,(07001) PERDOMO,981,559,597,2137
37516,2020-06-25,(07004) VENECIA,1056,624,600,2280
37517,2020-08-09,(06000) Portal Eldorado,137,131,184,452
37518,2020-05-04,(05102) Av. Américas - Av. Boyacá,139,78,71,288
37519,2020-03-26,(06111) Universidades,1,77,199,277
37520,2020-07-31,(09122) Calle 72,942,625,662,2229
37521,2020-02-03,(50002) Corral Calle 40 Sur,131,92,150,373
37522,2020-06-01,(07109) CAD,607,406,293,1306
37523,2020-08-13,(06001) Modelia,335,203,183,721
37524,2020-07-14,(04001) Quirigua,342,209,227,778
37525,2020-01-19,(08000) Portal Tunal,510,361,395,1266
37526,2020-06-19,(07200) Tygua-San José,233,127,151,511
37527,2020-09-16,(06001) Modelia,384,246,239,869
37528,2020-10-03,(02000) Cabecera Autopista Norte - intermunicipal,463,249,462,1174
37529,2020-03-15,(10010) San Bernardo,325,222,397,944
37530,2020-08-07,(03010) PUENTE LARGO,85,60,57,202
37531,2020-07-12,(04108) El Polo,98,69,95,262
37532,2020-07-25,(06106) Recinto Ferial,174,99,88,361
37533,2020-04-03,(04102) Avenida Boyaca,140,80,102,322
37534,2020-10-01,(12002) CDS - Carrera 32,198,151,90,439
37535,2020-07-04,(07006) General Santander,466,283,283,1032
37536,2020-04-09,(40001) Juan Pablo II,96,54,65,215
37537,2020-04-11,(06002) Normandía,86,55,47,188
37538,2020-04-23,(06002) Normandía,185,114,106,405
37539,2020-05-10,(04000) Cabecera Calle 80 - intermunicipal,24,16,33,73
37540,2020-04-29,(09108) Hospital,53,34,38,125
37541,2020-08-08,(04103) Las Ferias,217,116,138,471
37542,2020-01-06,(04107) Escuela Militar,83,65,128,276
37543,2020-05-12,(07103) AV. CHILE,727,449,306,1482
37544,2020-01-02,(07003) SEVILLANA,903,503,594,2000
37545,2020-03-29,(10002) Av. Primero de Mayo,354,187,219,760
37546,2020-09-06,(07006) General Santander - alimentacion,94,48,124,266
37547,2020-05-16,(09116) Avenida 39,173,111,142,426
37548,2020-10-12,(08001) Parque el Tunal,137,73,164,374
37549,2020-05-12,(07008) NQS - Calle 30 Sur,171,104,104,379
37550,2020-07-21,(09108) Hospital,61,33,42,136
37551,2020-10-10,(09108) Hospital,49,24,67,140
37552,2020-07-22,(06102) Salitre El Greco,223,122,109,454
37553,2020-05-13,(07003) SEVILLANA,334,178,174,686
37554,2020-05-24,(02304) Heroes,161,149,105,415
37555,2020-04-07,(04104) Avenida 68,288,179,170,637
37556,2020-06-03,(12007) Zona Industrial,322,206,150,678
37557,2020-04-18,(08001) Parque el Tunal,161,92,101,354
37558,2020-04-26,(06103) CAN,125,93,70,288
37559,2020-10-11,(07010) Bosa,0,95,328,423
37560,2020-05-04,(07506) DESPENSA,315,164,157,636
37561,2020-06-14,(06102) Salitre El Greco,76,48,48,172
37562,2020-08-20,(06105) Quinta Paredes,114,74,66,254
37563,2020-05-01,(02201) Prado,258,151,131,540
37564,2020-03-23,(14004) Museo del Oro,0,18,36,54
37565,2020-06-14,(03004) GRATAMIRA,13,3,9,25
37566,2020-02-19,(50006) Corral Carrera 77,32,21,48,101
37567,2020-05-31,(12004) Carrera 22,46,25,38,109
37568,2020-07-31,(05103) Marsella,330,193,176,699
37569,2020-06-14,(06103) CAN,141,90,62,293
37570,2019-12-31,(07004) VENECIA,58,40,58,156
37571,2020-05-12,(03007) HUMEDAL CORDOBA,98,62,54,214
37572,2020-09-20,(04103) Las Ferias,127,78,106,311
37573,2020-05-11,(50002) Corral Calle 40 Sur,15,8,11,34
37574,2020-04-14,(06111) Universidades,0,87,235,322
37575,2020-06-11,(10003) Ciudad Jardín,193,94,111,398
37576,2020-06-13,(06106) Recinto Ferial,201,114,117,432
37577,2020-08-12,(06107) Ciudad Universitaria,176,100,114,390
37578,2020-04-30,(03014) SAN MARTIN,19,10,24,53
37579,2020-05-25,(14004) Museo del Oro,0,15,36,51
37580,2020-10-12,(12002) CDS - Carrera 32,51,50,33,134
37581,2020-05-23,(04105) Carrera 53,185,101,112,398
37582,2020-06-29,(06106) Recinto Ferial,71,48,48,167
37583,2020-05-24,(09108) Hospital,28,18,23,69
37584,2020-04-11,(09105) Río Fucha,43,26,32,101
37585,2020-04-19,(04104) Avenida 68,126,83,63,272
37586,2020-03-25,(09108) Hospital,31,20,27,78
37587,2020-09-06,(12004) Carrera 22,61,53,69,183
37588,2020-05-17,(07113) SANTA ISABEL,77,57,66,200
37589,2019-12-31,(07008) NQS - Calle 30 Sur,26,9,29,64
37590,2020-10-13,(07000) Portal Sur - alimentacion,0,1,1,2
37591,2020-01-06,(50002) Corral Calle 40 Sur,19,11,21,51
37592,2020-03-22,(12003) Ricaurte,33,25,24,82
37593,2020-08-29,(03004) GRATAMIRA,0,17,28,45
37594,2020-02-12,(04000) Cabecera Calle 80 - alimentacion,24628,15328,15422,55378
37595,2020-01-15,(07005) ALQUERIA,2184,1240,1207,4631
37596,2020-07-04,(02502) Terminal,275,201,294,770
37597,2020-05-07,(07504) TERREROS,3310,2030,1619,6959
37598,2020-06-23,(10000) Portal 20 de Julio - alimentacion,4418,2057,2548,9023
37599,2020-01-15,(07111) NQS - RICAURTE,2784,1809,1646,6239
37600,2020-03-08,(05000) Portal Américas - alimentacion,8925,3661,6801,19387
37601,2020-01-09,(09122) Calle 72,4574,3021,2952,10547
37602,2020-02-07,(09122) Calle 72,7872,5179,4301,17352
37603,2020-02-28,(09100) Calle 40 Sur,7648,4146,4266,16060
37604,2020-01-24,(07003) SEVILLANA,1948,1036,1154,4138
37605,2020-07-03,(09000) Cabecera Usme - alimentacion,9320,5116,5854,20290
37606,2020-10-10,(09001) Molinos,2417,1039,2034,5490
37607,2020-08-12,(05000) Portal Américas - alimentacion,10518,5539,5483,21540
37608,2020-01-03,(06107) Ciudad Universitaria,362,245,445,1052
37609,2020-10-07,(09001) Molinos,3046,1490,2389,6925
37610,2020-07-06,(05001) Patio Bonito,0,951,2144,3095
37611,2020-07-13,(05001) Patio Bonito,1451,833,881,3165
37612,2020-01-22,(07112) COMUNEROS,3501,2146,2225,7872
37613,2020-09-09,(04103) Las Ferias,384,217,220,821
37614,2020-09-25,(09100) Calle 40 Sur,1944,1117,1565,4626
37615,2020-01-03,(09113) Calle 22,823,476,740,2039
37616,2020-09-10,(10005) Bicentenario - alimentacion,200,94,200,494
37617,2020-03-15,(09109) Tercer Milenio,249,140,272,661
37618,2020-04-26,(09109) Tercer Milenio,52,46,46,144
37619,2020-01-15,(09104) Restrepo,4590,2737,3600,10927
37620,2020-07-11,(02204) Pepe Sierra,633,442,332,1407
37621,2020-09-18,(02204) Pepe Sierra,857,590,545,1992
37622,2020-02-07,(09117) Calle 45,6105,4036,3232,13373
37623,2020-02-16,(07110) PALOQUEMAO,358,317,462,1137
37624,2020-08-06,(09004) Santa Lucía,2350,1185,1367,4902
37625,2020-01-01,(03005) SUBA - AV. BOYACA,163,79,233,475
37626,2020-05-18,(09101) Quiroga,320,203,317,840
37627,2020-02-21,(07102) NQS - CALLE 75,1481,1001,935,3417
37628,2020-02-22,(07102) NQS - CALLE 75,828,622,750,2200
37629,2020-04-02,(09000) Cabecera Usme - alimentacion,4449,2011,2496,8956
37630,2020-05-14,(09000) Cabecera Usme - alimentacion,6452,3566,3512,13530
37631,2020-03-18,(09110) Avenida Jimenez,2921,2183,1747,6851
37632,2020-03-16,(07110) PALOQUEMAO,1908,1173,857,3938
37633,2020-02-13,(50003) Corral Molinos,3395,2276,3547,9218
37634,2020-05-28,(09103) Olaya,832,432,447,1711
37635,2020-07-25,(07002) MADELENA,396,222,279,897
37636,2020-04-11,(07111) NQS - RICAURTE,180,130,109,419
37637,2020-07-27,(02000) Cabecera Autopista Norte - alimentacion,4317,2452,2437,9206
37638,2020-02-15,(04105) Carrera 53,796,462,635,1893
37639,2020-06-04,(09001) Molinos,2288,1312,1471,5071
37640,2020-06-09,(09001) Molinos,2302,1332,1523,5157
37641,2020-03-06,(05002) Tintal,10980,6009,6024,23013
37642,2020-03-02,(02000) Cabecera Autopista Norte - intermunicipal,5023,3467,2949,11439
37643,2020-07-07,(09001) Molinos,2750,1528,1889,6167
37644,2020-02-13,(06000) Portal Eldorado,6847,4089,2996,13932
37645,2020-01-01,(09000) Cabecera Usme - alimentacion,2352,1100,2915,6367
37646,2020-02-18,(06111) Universidades,6236,3770,2517,12523
37647,2020-02-03,(02105) Calle 142,7235,4462,3863,15560
37648,2020-03-10,(02105) Calle 142,634,1778,1058,3470
37649,2020-03-25,(02000) Cabecera Autopista Norte - intermunicipal,133,100,90,323
37650,2020-09-14,(06101) El Tiempo,364,233,241,838
37651,2020-06-26,(03000) Portal Suba,1372,834,952,3158
37652,2020-01-02,(08001) Parque el Tunal,829,435,585,1849
37653,2020-09-05,(10002) Av. Primero de Mayo,1703,856,1464,4023
37654,2020-07-14,(07112) COMUNEROS,735,439,386,1560
37655,2020-01-27,(07004) VENECIA,4547,2752,2370,9669
37656,2020-01-15,(06103) CAN,2127,1213,1047,4387
37657,2020-05-22,(10002) Av. Primero de Mayo,1793,972,1029,3794
37658,2020-04-22,(10002) Av. Primero de Mayo,1229,700,737,2666
37659,2020-03-01,(08001) Parque el Tunal,371,164,344,879
37660,2020-10-07,(14004) Museo del Oro,441,295,386,1122
37661,2020-03-10,(02304) Heroes,2762,155,521,3438
37662,2020-01-25,(06001) Modelia,868,583,863,2314
37663,2020-06-19,(05100) Banderas P. Central,760,434,517,1711
37664,2020-10-05,(09123) Calle 76,1207,798,863,2868
37665,2020-01-08,(05101) Mandalay - Cr.73,697,380,374,1451
37666,2020-06-02,(05002) Tintal,1579,937,955,3471
37667,2020-02-12,(05105) Pradera,2728,1639,1278,5645
37668,2020-05-18,(10000) Portal 20 de Julio,1950,973,973,3896
37669,2020-01-16,(03011) SUBA - CALLE 100,2245,1154,1341,4740
37670,2020-01-31,(05101) Mandalay - Cr.73,1171,628,571,2370
37671,2020-01-29,(14005) Las Aguas,3110,1894,1765,6769
37672,2020-01-15,(07104) Simon Bolivar,1973,1234,1204,4411
37673,2020-04-15,(05105) Pradera,279,270,157,706
37674,2020-02-14,(09106) Nariño,2195,1225,1414,4834
37675,2020-06-02,(08000) Portal Tunal,711,297,261,1269
37676,2020-02-29,(03009) Av. Suba- Calle 116,1082,781,1074,2937
37677,2020-09-07,(03009) Av. Suba- Calle 116,539,340,268,1147
37678,2020-09-17,(03009) Av. Suba- Calle 116,573,319,326,1218
37679,2020-07-02,(02205) Calle 106,368,237,229,834
37680,2020-10-10,(02205) Calle 106,235,176,300,711
37681,2020-01-18,(04002) Carrera 90,1812,816,1351,3979
37682,2020-04-01,(10002) Av. Primero de Mayo,1087,601,665,2353
37683,2020-02-02,(12000) Puente Aranda,37,36,63,136
37684,2020-02-01,(04000) Cabecera Calle 80,3707,1808,3544,9059
37685,2020-08-15,(04000) Cabecera Calle 80,794,443,735,1972
37686,2020-07-08,(04108) El Polo,519,324,262,1105
37687,2020-02-11,(10009) Museo Nacional,4741,2515,2026,9282
37688,2020-07-28,(07106) EL CAMPIN,379,250,194,823
37689,2020-09-26,(06106) Recinto Ferial,223,152,168,543
37690,2020-02-24,(06000) Portal Eldorado,6838,4020,2776,13634
37691,2020-07-08,(14004) Museo del Oro,324,204,249,777
37692,2020-03-26,(03007) HUMEDAL CORDOBA,78,44,37,159
37693,2020-04-22,(03007) HUMEDAL CORDOBA,79,49,47,175
37694,2020-04-13,(10006) San Victorino,210,160,149,519
37695,2020-08-26,(05101) Mandalay - Cr.73,122,82,64,268
37696,2020-04-27,(02101) Toberín,363,191,135,689
37697,2020-05-17,(02101) Toberín,164,133,166,463
37698,2020-01-22,(05103) Marsella,2656,1514,1425,5595
37699,2020-01-11,(04101) Minuto de Dios,1017,571,933,2521
37700,2020-02-07,(04102) Avenida Boyaca,3147,1761,1829,6737
37701,2020-09-17,(07104) Simon Bolivar,684,380,362,1426
37702,2020-02-28,(07109) CAD,2695,1725,1589,6009
37703,2020-08-25,(06000) Portal Eldorado,899,588,456,1943
37704,2020-03-17,(02104) Calle 146,3685,2285,2102,8072
37705,2020-09-16,(09118) Marly,1545,961,990,3496
37706,2020-08-27,(02202) Calle 127,1024,748,597,2369
37707,2020-01-26,(04001) Quirigua,389,193,452,1034
37708,2020-04-11,(03011) SUBA - CALLE 100,182,116,93,391
37709,2020-05-12,(10001) Country Sur,849,378,526,1753
37710,2020-06-18,(05001) Patio Bonito,1844,1077,1120,4041
37711,2020-03-30,(03001) LA CAMPIÑA,491,272,264,1027
37712,2020-06-07,(09002) Consuelo,126,54,114,294
37713,2020-05-30,(09118) Marly,1048,664,544,2256
37714,2020-06-15,(06100) Av. Rojas,46,33,58,137
37715,2020-05-19,(12003) Ricaurte,295,234,139,668
37716,2020-07-10,(12003) Ricaurte,417,275,215,907
37717,2020-01-02,(10008) San Diego,710,410,461,1581
37718,2020-03-17,(03009) Av. Suba- Calle 116,1482,899,739,3120
37719,2020-09-18,(06103) CAN,435,258,255,948
37720,2020-02-16,(03012) SUBA - CALLE 95,325,189,360,874
37721,2020-08-12,(09116) Avenida 39,349,190,211,750
37722,2020-04-24,(09000) Cabecera Usme,926,580,666,2172
37723,2020-10-10,(10010) San Bernardo,474,208,501,1183
37724,2020-03-27,(09123) Calle 76,454,328,289,1071
37725,2020-03-30,(09123) Calle 76,483,380,287,1150
37726,2020-01-14,(07201) Guatoque -Veraguas,848,457,569,1874
37727,2020-07-01,(40002) Manitas,430,261,325,1016
37728,2020-01-14,(07006) General Santander - alimentacion,1260,718,922,2900
37729,2020-06-19,(02001) Centro Comercial Santa Fe,516,305,365,1186
37730,2020-10-06,(09114) Calle 26,388,251,353,992
37731,2020-06-25,(02300) Calle 100,1363,865,708,2936
37732,2020-02-02,(09123) Calle 76,576,461,886,1923
37733,2020-09-15,(09118) Marly,1484,954,888,3326
37734,2020-05-07,(06000) Portal Eldorado - alimentacion,2861,1358,1365,5584
37735,2020-04-20,(09120) Calle 63,574,423,331,1328
37736,2020-05-01,(09120) Calle 63,346,223,207,776
37737,2020-07-01,(10009) Museo Nacional,500,289,348,1137
37738,2020-03-04,(10004) Policarpa,921,467,578,1966
37739,2020-10-09,(05105) Pradera,677,411,486,1574
37740,2020-06-17,(06111) Universidades,223,170,295,688
37741,2020-06-23,(09115) Calle 34,745,453,423,1621
37742,2020-02-22,(14004) Museo del Oro,863,764,1199,2826
37743,2020-04-18,(07110) PALOQUEMAO,318,235,141,694
37744,2020-05-12,(07006) General Santander,359,226,177,762
37745,2020-03-24,(09106) Nariño,285,194,266,745
37746,2020-04-18,(12004) Carrera 22,37,35,35,107
37747,2020-03-26,(06107) Ciudad Universitaria,103,73,71,247
37748,2020-05-12,(09122) Calle 72,871,603,556,2030
37749,2020-07-04,(07004) VENECIA,844,465,558,1867
37750,2020-08-18,(02202) Calle 127,949,735,602,2286
37751,2020-04-18,(06109) Centro Memoria,127,89,63,279
37752,2020-07-15,(07001) PERDOMO,693,417,410,1520
37753,2020-08-27,(07001) PERDOMO,923,546,588,2057
37754,2020-01-01,(09120) Calle 63,293,292,632,1217
37755,2020-02-21,(10007) Las Nieves,1876,1276,1272,4424
37756,2020-07-29,(07201) Guatoque -Veraguas,185,83,110,378
37757,2020-07-07,(06108) Concejo de Bogotá,169,85,99,353
37758,2020-04-12,(04002) Carrera 90,115,58,47,220
37759,2020-09-08,(07105) MOVISTAR ARENA,253,152,176,581
37760,2020-02-28,(07506) DESPENSA,1440,903,905,3248
37761,2020-09-26,(09114) Calle 26,200,134,294,628
37762,2020-03-03,(07506) DESPENSA,1400,957,936,3293
37763,2020-09-20,(04100) Carrera 77,453,208,511,1172
37764,2020-07-08,(07001) PERDOMO,919,551,591,2061
37765,2020-05-29,(10006) San Victorino,439,255,303,997
37766,2020-06-24,(10006) San Victorino,737,333,366,1436
37767,2020-05-07,(10007) Las Nieves,319,216,228,763
37768,2020-06-25,(10007) Las Nieves,728,399,384,1511
37769,2020-10-08,(07007) NQS - Calle 38A Sur,471,296,432,1199
37770,2020-04-05,(07103) AV. CHILE,123,98,90,311
37771,2020-10-09,(04102) Avenida Boyaca,476,264,379,1119
37772,2020-08-23,(09003) Socorro,192,73,124,389
37773,2020-06-21,(05102) Av. Américas - Av. Boyacá,72,38,31,141
37774,2020-08-24,(07107) U. NACIONAL,320,182,155,657
37775,2020-04-12,(10009) Museo Nacional,56,38,48,142
37776,2020-04-22,(05100) Banderas P. Central,333,214,219,766
37777,2020-04-25,(09003) Socorro,257,127,126,510
37778,2020-01-16,(09108) Hospital,214,116,228,558
37779,2020-03-20,(09002) Consuelo,183,118,87,388
37780,2020-04-23,(07200) Tygua-San José,124,71,78,273
37781,2020-06-11,(07200) Tygua-San José,215,121,142,478
37782,2020-02-19,(09105) Río Fucha,886,496,490,1872
37783,2020-09-12,(02000) Cabecera Autopista Norte - intermunicipal,410,209,395,1014
37784,2020-08-03,(04002) Carrera 90,605,341,310,1256
37785,2020-04-07,(03012) SUBA - CALLE 95,164,132,124,420
37786,2020-05-31,(14001) La Sabana,49,25,38,112
37787,2020-05-25,(06000) Portal Eldorado,287,182,133,602
37788,2020-05-09,(02001) Centro Comercial Santa Fe,195,108,138,441
37789,2020-03-18,(12002) CDS - Carrera 32,420,282,193,895
37790,2020-06-10,(04000) Cabecera Calle 80 - intermunicipal,305,170,256,731
37791,2020-07-27,(07108) Av. El Dorado,127,89,67,283
37792,2020-07-20,(06002) Normandía,92,53,64,209
37793,2020-09-12,(14004) Museo del Oro,159,141,236,536
37794,2020-09-07,(07110) PALOQUEMAO,647,389,308,1344
37795,2020-07-10,(09108) Hospital,87,54,73,214
37796,2020-09-19,(09108) Hospital,65,27,68,160
37797,2020-04-27,(03009) Av. Suba- Calle 116,58,147,64,269
37798,2020-06-05,(07004) VENECIA,895,554,465,1914
37799,2020-04-03,(07008) NQS - Calle 30 Sur,151,84,90,325
37800,2020-05-15,(06106) Recinto Ferial,211,128,92,431
37801,2020-08-01,(03003) 21 ANGELES,185,73,107,365
37802,2020-09-20,(02303) Calle 85,181,148,194,523
37803,2020-08-16,(07006) General Santander - alimentacion,70,53,102,225
37804,2020-10-06,(03005) SUBA - AV. BOYACA,563,335,416,1314
37805,2020-05-31,(07006) General Santander - alimentacion,67,58,89,214
37806,2019-12-31,(06102) Salitre El Greco,22,9,20,51
37807,2020-04-20,(07107) U. NACIONAL,235,166,103,504
37808,2020-08-01,(07006) General Santander - alimentacion,231,122,192,545
37809,2020-03-26,(07506) DESPENSA,233,100,127,460
37810,2020-06-29,(03000) Portal Suba,359,206,310,875
37811,2020-03-22,(04001) Quirigua,66,46,31,143
37812,2020-05-24,(03013) RIO NEGRO,64,41,50,155
37813,2020-04-08,(06111) Universidades,0,77,208,285
37814,2020-07-31,(06103) CAN,334,196,165,695
37815,2020-09-30,(10003) Ciudad Jardín,267,123,225,615
37816,2020-06-22,(07506) DESPENSA,175,68,111,354
37817,2020-04-04,(05100) Banderas P. Central,198,93,148,439
37818,2020-05-13,(07101) CASTELLANA,134,83,98,315
37819,2019-12-31,(09117) Calle 45,25,14,63,102
37820,2020-08-23,(02103) Mazurén,25,26,37,88
37821,2020-04-09,(02000) Cabecera Autopista Norte - intermunicipal,37,32,37,106
37822,2020-04-26,(09110) Avenida Jimenez,94,90,128,312
37823,2020-04-09,(03003) 21 ANGELES,62,27,39,128
37824,2020-04-12,(03003) 21 ANGELES,42,23,24,89
37825,2020-03-21,(04002) Carrera 90,189,100,91,380
37826,2020-04-10,(08002) Biblioteca,64,42,23,129
37827,2020-05-09,(08002) Biblioteca,163,85,88,336
37828,2020-05-03,(05107) Américas - Cr.53,65,57,48,170
37829,2020-06-14,(02000) Cabecera Autopista Norte - intermunicipal,90,47,93,230
37830,2020-01-26,(06105) Quinta Paredes,119,79,165,363
37831,2020-03-01,(07108) Av. El Dorado,141,101,217,459
37832,2020-06-29,(07006) General Santander - alimentacion,104,67,126,297
37833,2020-10-04,(06002) Normandía,103,59,163,325
37834,2020-07-13,(04001) Quirigua,353,204,208,765
37835,2020-06-29,(07105) MOVISTAR ARENA,73,49,56,178
37836,2020-09-20,(07201) Guatoque -Veraguas,38,23,95,156
37837,2020-05-30,(04103) Las Ferias,254,139,121,514
37838,2020-08-26,(06103) CAN,333,204,172,709
37839,2020-05-10,(04101) Minuto de Dios,55,32,49,136
37840,2020-08-30,(10003) Ciudad Jardín,87,37,59,183
37841,2020-08-30,(03007) HUMEDAL CORDOBA,33,31,25,89
37842,2020-01-04,(03014) SAN MARTIN,61,38,68,167
37843,2020-04-05,(07106) EL CAMPIN,50,50,34,134
37844,2020-06-04,(50006) Corral Carrera 77,5,1,8,14
37845,2020-04-10,(50002) Corral Calle 40 Sur,1,2,4,7
37846,2020-01-24,(04000) Cabecera Calle 80 - alimentacion,21894,11866,13863,47623
37847,2020-01-18,(09002) Consuelo,885,385,669,1939
37848,2020-07-07,(09002) Consuelo,499,287,285,1071
37849,2020-02-04,(05000) Portal Américas - alimentacion,28879,21723,26340,76942
37850,2020-01-28,(06000) Portal Eldorado - alimentacion,17447,9455,8998,35900
37851,2020-02-27,(06000) Portal Eldorado - alimentacion,18753,10142,9563,38458
37852,2020-01-10,(09100) Calle 40 Sur,5618,2900,3405,11923
37853,2020-04-03,(04002) Carrera 90,326,177,188,691
37854,2020-06-23,(05000) Portal Américas - alimentacion,11574,6393,5557,23524
37855,2020-09-08,(06107) Ciudad Universitaria,211,108,127,446
37856,2020-02-13,(08000) Portal Tunal - alimentacion,25524,13980,12044,51548
37857,2020-01-08,(09118) Marly,3759,2608,2638,9005
37858,2020-01-15,(07010) Bosa,1996,1186,1357,4539
37859,2020-01-30,(07112) COMUNEROS,3803,2230,2155,8188
37860,2020-01-09,(07000) Portal Sur - alimentacion,21943,11933,11566,45442
37861,2020-03-04,(07000) Portal Sur - alimentacion,28466,16487,14667,59620
37862,2020-02-18,(10001) Country Sur,5413,2441,2724,10578
37863,2020-04-14,(06000) Portal Eldorado - alimentacion,2321,1122,968,4411
37864,2020-01-02,(09115) Calle 34,1813,1207,1280,4300
37865,2020-03-05,(09115) Calle 34,4415,2757,2446,9618
37866,2020-02-29,(07002) MADELENA,2737,1152,1997,5886
37867,2020-01-30,(02204) Pepe Sierra,4879,3239,2353,10471
37868,2020-09-20,(09000) Cabecera Usme - alimentacion,2852,1322,2365,6539
37869,2020-08-03,(09104) Restrepo,1395,806,1018,3219
37870,2020-02-26,(06106) Recinto Ferial,1509,874,821,3204
37871,2020-03-13,(03013) RIO NEGRO,320,111,169,600
37872,2020-09-24,(09000) Cabecera Usme - alimentacion,9736,4785,6031,20552
37873,2020-08-20,(05100) Banderas P. Central - alimentacion,2754,1473,1508,5735
37874,2020-05-21,(14001) La Sabana,137,99,79,315
37875,2020-07-10,(14001) La Sabana,163,109,103,375
37876,2020-09-25,(14001) La Sabana,183,95,138,416
37877,2020-07-31,(07111) NQS - RICAURTE,995,598,400,1993
37878,2020-09-23,(07111) NQS - RICAURTE,1306,825,618,2749
37879,2020-02-03,(02000) Cabecera Autopista Norte - alimentacion,23121,13713,13754,50588
37880,2020-04-16,(07112) COMUNEROS,417,268,213,898
37881,2020-08-25,(02000) Cabecera Autopista Norte,1225,749,750,2724
37882,2020-01-22,(02201) Prado,5460,3421,2894,11775
37883,2020-02-17,(10007) Las Nieves,2173,1268,1230,4671
37884,2020-05-16,(05000) Portal Américas,1351,878,1067,3296
37885,2020-01-08,(04000) Cabecera Calle 80,5154,3012,3635,11801
37886,2020-01-07,(04106) Carrera 47,916,528,675,2119
37887,2020-09-23,(03000) Portal Suba,1676,1074,1181,3931
37888,2020-07-09,(06000) Portal Eldorado,1012,668,527,2207
37889,2020-01-14,(40003) Mirador del Paraiso,4061,2397,2597,9055
37890,2020-01-21,(04001) Quirigua,1462,719,728,2909
37891,2020-06-08,(02000) Cabecera Autopista Norte - alimentacion,4465,2638,2514,9617
37892,2020-01-09,(02302) Virrey,2997,1888,1455,6340
37893,2020-07-16,(08001) Parque el Tunal,344,197,200,741
37894,2020-02-07,(04108) El Polo,1934,1197,1190,4321
37895,2020-02-06,(09004) Santa Lucía,7795,4320,4230,16345
37896,2020-03-17,(09107) Hortúa,1589,948,907,3444
37897,2020-06-16,(09003) Socorro,587,324,289,1200
37898,2020-04-22,(07503) SAN MATEO,5535,3565,2438,11538
37899,2020-05-01,(07503) SAN MATEO,2739,1798,1324,5861
37900,2020-06-21,(10001) Country Sur,356,162,274,792
37901,2020-10-10,(10002) Av. Primero de Mayo,1831,840,1641,4312
37902,2020-10-03,(14004) Museo del Oro,173,173,337,683
37903,2020-02-18,(02202) Calle 127,6161,4040,2956,13157
37904,2020-02-16,(04003) Avenida Ciudad de Cali,1086,502,1176,2764
37905,2020-06-25,(09107) Hortúa,618,390,333,1341
37906,2020-09-03,(09107) Hortúa,631,377,407,1415
37907,2020-09-11,(05002) Tintal,2699,1499,1667,5865
37908,2020-03-14,(50003) Corral Molinos,2431,1290,2389,6110
37909,2020-01-14,(02300) Calle 100,6288,3872,3481,13641
37910,2020-07-21,(50002) Corral Calle 40 Sur,16,7,21,44
37911,2020-06-14,(05005) Transversal 86,81,47,60,188
37912,2020-08-15,(02202) Calle 127,758,587,558,1903
37913,2020-01-23,(04105) Carrera 53,1338,719,729,2786
37914,2020-03-19,(07007) NQS - Calle 38A Sur,985,570,527,2082
37915,2020-02-19,(09121) Las Flores,3635,2151,2050,7836
37916,2020-09-09,(02205) Calle 106,404,270,280,954
37917,2020-02-17,(09113) Calle 22,1591,933,1113,3637
37918,2020-05-18,(02300) Calle 100,1059,704,527,2290
37919,2020-01-07,(10009) Museo Nacional,2743,1496,1398,5637
37920,2020-02-28,(02202) Calle 127,5784,3734,2993,12511
37921,2020-03-10,(07201) Guatoque -Veraguas,213,170,152,535
37922,2020-08-11,(06000) Portal Eldorado - alimentacion,3564,1787,1855,7206
37923,2020-08-22,(03007) HUMEDAL CORDOBA,105,74,67,246
37924,2020-05-28,(04104) Avenida 68,542,297,266,1105
37925,2020-10-05,(08002) Biblioteca,320,195,211,726
37926,2020-02-22,(09117) Calle 45,2790,1726,2328,6844
37927,2020-05-25,(40003) Mirador del Paraiso,649,376,424,1449
37928,2020-03-18,(05103) Marsella,1264,690,606,2560
37929,2020-08-22,(09109) Tercer Milenio,261,162,223,646
37930,2020-06-07,(02202) Calle 127,346,270,199,815
37931,2020-05-02,(10001) Country Sur,473,196,275,944
37932,2020-04-16,(04108) El Polo,233,151,120,504
37933,2020-04-23,(02302) Virrey,328,245,156,729
37934,2020-09-25,(07009) SENA,767,414,605,1786
37935,2020-06-25,(09104) Restrepo,1626,1004,1155,3785
37936,2020-03-07,(07001) PERDOMO,2568,1125,2020,5713
37937,2020-06-20,(06107) Ciudad Universitaria,137,86,97,320
37938,2020-04-22,(09002) Consuelo,274,152,140,566
37939,2020-01-29,(10005) Bicentenario,804,425,358,1587
37940,2020-07-17,(03002) SUBA - TV- 91,716,400,426,1542
37941,2020-08-15,(05107) Américas - Cr.53,306,183,229,718
37942,2020-10-10,(07111) NQS - RICAURTE,866,578,666,2110
37943,2020-09-30,(02304) Heroes,1016,719,698,2433
37944,2020-04-11,(06108) Concejo de Bogotá,78,57,39,174
37945,2020-09-24,(04105) Carrera 53,327,184,218,729
37946,2020-06-24,(02300) Calle 100,1312,856,685,2853
37947,2020-10-01,(07003) SEVILLANA,530,296,394,1220
37948,2020-02-15,(14001) La Sabana,319,272,333,924
37949,2020-02-15,(08002) Biblioteca,600,328,511,1439
37950,2020-07-21,(09003) Socorro,448,232,281,961
37951,2020-05-15,(40001) Juan Pablo II,466,270,281,1017
37952,2020-04-08,(02204) Pepe Sierra,414,317,229,960
37953,2020-03-24,(05102) Av. Américas - Av. Boyacá,224,128,152,504
37954,2020-04-04,(07000) Portal Sur,619,347,395,1361
37955,2020-02-16,(10005) Bicentenario - alimentacion,134,89,232,455
37956,2020-03-13,(07105) MOVISTAR ARENA,398,77,160,635
37957,2020-06-13,(09120) Calle 63,852,579,604,2035
37958,2020-01-01,(04003) Avenida Ciudad de Cali,305,189,557,1051
37959,2020-04-23,(03002) SUBA - TV- 91,441,271,212,924
37960,2020-08-29,(07111) NQS - RICAURTE,899,572,470,1941
37961,2020-03-07,(07201) Guatoque -Veraguas,508,286,554,1348
37962,2020-05-24,(07201) Guatoque -Veraguas,18,18,57,93
37963,2020-07-21,(07201) Guatoque -Veraguas,144,69,103,316
37964,2020-04-15,(04003) Avenida Ciudad de Cali,542,311,346,1199
37965,2020-05-26,(07105) MOVISTAR ARENA,245,146,121,512
37966,2020-07-15,(07105) MOVISTAR ARENA,241,116,120,477
37967,2020-09-25,(07105) MOVISTAR ARENA,247,153,189,589
37968,2020-08-01,(09114) Calle 26,139,103,127,369
37969,2020-06-20,(03003) 21 ANGELES,272,107,152,531
37970,2020-07-06,(14004) Museo del Oro,337,187,232,756
37971,2020-05-31,(02104) Calle 146,222,157,141,520
37972,2020-04-10,(08000) Portal Tunal,119,67,63,249
37973,2020-07-11,(04000) Cabecera Calle 80,870,520,749,2139
37974,2020-08-24,(05005) Transversal 86,317,183,204,704
37975,2020-10-12,(02304) Heroes,220,189,246,655
37976,2020-02-12,(12000) Puente Aranda,322,171,181,674
37977,2020-08-13,(12000) Puente Aranda,91,50,46,187
37978,2020-08-22,(09004) Santa Lucía,1965,916,1103,3984
37979,2020-03-28,(07001) PERDOMO,265,166,169,600
37980,2020-04-23,(07103) AV. CHILE,538,381,271,1190
37981,2020-04-25,(07103) AV. CHILE,372,253,193,818
37982,2020-10-02,(02102) Calle 161,301,179,282,762
37983,2020-05-21,(12004) Carrera 22,189,98,98,385
37984,2020-04-26,(02302) Virrey,166,118,70,354
37985,2020-08-13,(09111) Calle 19,735,406,408,1549
37986,2020-08-10,(02502) Terminal,388,283,324,995
37987,2020-03-15,(10005) Bicentenario - alimentacion,105,74,193,372
37988,2020-05-30,(09119) Calle 57,384,246,262,892
37989,2020-05-09,(04106) Carrera 47,176,79,117,372
37990,2020-08-01,(10004) Policarpa,180,76,145,401
37991,2020-03-30,(02200) Alcalá,827,599,446,1872
37992,2020-05-12,(06111) Universidades,0,106,292,398
37993,2020-05-07,(09002) Consuelo,305,172,199,676
37994,2020-02-14,(07008) NQS - Calle 30 Sur,2011,1057,1143,4211
37995,2020-08-05,(03010) PUENTE LARGO,247,182,161,590
37996,2020-06-04,(07103) AV. CHILE,881,544,398,1823
37997,2020-03-24,(09117) Calle 45,743,514,470,1727
37998,2020-09-26,(04002) Carrera 90,615,281,509,1405
37999,2020-07-26,(04102) Avenida Boyaca,124,70,80,274
38000,2020-09-02,(12002) CDS - Carrera 32,210,142,99,451
38001,2020-07-19,(07005) ALQUERIA,136,65,116,317
38002,2020-08-09,(09113) Calle 22,189,113,178,480
38003,2020-05-28,(07003) SEVILLANA,401,206,189,796
38004,2020-03-24,(40001) Juan Pablo II,401,213,297,911
38005,2020-10-04,(07108) Av. El Dorado,44,30,49,123
38006,2020-08-18,(06002) Normandía,282,159,176,617
38007,2020-05-14,(04102) Avenida Boyaca,216,142,161,519
38008,2020-05-21,(06101) El Tiempo,285,165,156,606
38009,2020-04-11,(03012) SUBA - CALLE 95,98,73,69,240
38010,2020-10-12,(06103) CAN,165,106,132,403
38011,2020-09-10,(07010) Bosa,0,263,790,1053
38012,2020-07-18,(12002) CDS - Carrera 32,120,78,53,251
38013,2019-12-31,(02300) Calle 100,45,25,63,133
38014,2020-01-26,(05107) Américas - Cr.53,432,271,446,1149
38015,2020-08-17,(07006) General Santander - alimentacion,94,69,85,248
38016,2020-06-27,(09105) Río Fucha,103,42,87,232
38017,2020-08-10,(05103) Marsella,408,220,223,851
38018,2020-06-15,(04000) Cabecera Calle 80,267,191,253,711
38019,2020-04-28,(07107) U. NACIONAL,221,144,121,486
38020,2020-04-19,(12001) Carrera 43,59,31,41,131
38021,2020-07-16,(10004) Policarpa,199,80,99,378
38022,2020-07-26,(09109) Tercer Milenio,78,47,87,212
38023,2020-05-09,(09111) Calle 19,353,229,297,879
38024,2020-04-05,(08000) Portal Tunal,137,99,85,321
38025,2020-05-28,(06103) CAN,330,219,148,697
38026,2020-03-23,(09122) Calle 72,291,185,174,650
38027,2020-04-27,(03005) SUBA - AV. BOYACA,85,67,49,201
38028,2020-03-20,(09107) Hortúa,494,329,224,1047
38029,2020-04-23,(07004) VENECIA,522,334,281,1137
38030,2020-08-11,(10003) Ciudad Jardín,208,95,151,454
38031,2020-04-22,(07008) NQS - Calle 30 Sur,146,81,70,297
38032,2020-08-23,(04000) Cabecera Calle 80 - intermunicipal,66,25,57,148
38033,2020-09-15,(07003) SEVILLANA,490,291,302,1083
38034,2020-03-29,(07107) U. NACIONAL,72,59,40,171
38035,2020-05-16,(03011) SUBA - CALLE 100,238,136,133,507
38036,2020-06-11,(14005) Las Aguas,0,73,232,305
38037,2020-04-04,(04003) Avenida Ciudad de Cali,333,212,264,809
38038,2020-07-25,(07101) CASTELLANA,95,61,71,227
38039,2020-03-20,(07105) MOVISTAR ARENA,178,110,81,369
38040,2020-04-17,(07101) CASTELLANA,79,64,77,220
38041,2020-04-19,(07201) Guatoque -Veraguas,10,13,19,42
38042,2020-04-14,(07201) Guatoque -Veraguas,78,59,68,205
38043,2020-09-13,(06102) Salitre El Greco,90,40,83,213
38044,2020-07-19,(07006) General Santander - alimentacion,78,38,83,199
38045,2020-03-25,(10003) Ciudad Jardín,88,52,57,197
38046,2020-04-03,(05102) Av. Américas - Av. Boyacá,139,74,72,285
38047,2020-04-12,(09105) Río Fucha,28,14,20,62
38048,2020-04-12,(06104) Gobernación,40,40,18,98
38049,2020-03-22,(07101) CASTELLANA,18,20,30,68
38050,2020-07-12,(07101) CASTELLANA,34,26,49,109
38051,2020-06-28,(10005) Bicentenario - alimentacion,67,33,62,162
38052,2020-10-07,(12000) Puente Aranda,94,60,64,218
38053,2020-06-14,(10005) Bicentenario,22,10,19,51
38054,2019-12-31,(02001) Centro Comercial Santa Fe,24,15,32,71
38055,2020-06-08,(50006) Corral Carrera 77,4,0,9,13
38056,2020-05-25,(12003) Ricaurte,56,55,48,159
38057,2020-01-26,(03014) SAN MARTIN,33,19,68,120
38058,2020-10-07,(03004) GRATAMIRA,0,27,60,87
38059,2020-10-13,(05100) Banderas P. Central - alimentacion,0,2,1,3
38060,2020-06-26,(09002) Consuelo,515,269,259,1043
38061,2020-07-07,(09118) Marly,1521,980,859,3360
38062,2020-02-22,(07504) TERREROS,11868,5926,7408,25202
38063,2020-02-17,(08000) Portal Tunal - alimentacion,24766,14018,12041,50825
38064,2020-10-10,(03000) Portal Suba - alimentacion,5493,2454,4415,12362
38065,2020-01-03,(05000) Portal Américas - alimentacion,20965,10545,12490,44000
38066,2020-06-09,(07505) LEON XIII,2522,1429,1033,4984
38067,2020-01-18,(06104) Gobernación,284,266,417,967
38068,2020-01-28,(09121) Las Flores,3139,1971,1852,6962
38069,2020-03-17,(07503) SAN MATEO,27024,15178,11228,53430
38070,2020-04-16,(05000) Portal Américas - alimentacion,6142,3159,2781,12082
38071,2020-04-05,(04000) Cabecera Calle 80 - alimentacion,543,340,287,1170
38072,2020-07-15,(05001) Patio Bonito,1489,848,870,3207
38073,2020-02-28,(02201) Prado,5912,3536,3115,12563
38074,2020-08-03,(07000) Portal Sur - alimentacion,6732,3807,3419,13958
38075,2020-03-09,(07112) COMUNEROS,752,723,634,2109
38076,2020-01-24,(05005) Transversal 86,2530,1352,1261,5143
38077,2020-01-05,(08000) Portal Tunal - alimentacion,4674,1989,3364,10027
38078,2020-01-22,(09004) Santa Lucía,6878,3809,4163,14850
38079,2020-10-04,(09000) Cabecera Usme,545,261,754,1560
38080,2020-03-04,(07009) SENA,3700,2202,2070,7972
38081,2020-06-16,(08000) Portal Tunal - alimentacion,6332,3583,3416,13331
38082,2020-02-20,(02205) Calle 106,2707,1722,1256,5685
38083,2020-01-25,(07113) SANTA ISABEL,1186,638,1028,2852
38084,2020-02-12,(07113) SANTA ISABEL,2201,1298,1369,4868
38085,2020-10-12,(09000) Cabecera Usme,573,263,660,1496
38086,2020-07-10,(09104) Restrepo,1676,1031,1211,3918
38087,2020-08-04,(04101) Minuto de Dios,248,133,208,589
38088,2020-02-20,(04100) Carrera 77,6847,4000,3753,14600
38089,2020-02-10,(05103) Marsella,3268,1980,1517,6765
38090,2020-03-05,(06002) Normandía,2611,1521,1392,5524
38091,2020-02-22,(09110) Avenida Jimenez,3401,2384,2254,8039
38092,2020-01-24,(07112) COMUNEROS,3621,2054,2243,7918
38093,2020-09-08,(12003) Ricaurte,432,265,209,906
38094,2020-03-13,(03002) SUBA - TV- 91,212,826,720,1758
38095,2020-06-27,(05000) Portal Américas,2075,1297,1670,5042
38096,2020-03-10,(07102) NQS - CALLE 75,764,114,325,1203
38097,2020-02-07,(09103) Olaya,4456,2437,2578,9471
38098,2020-03-18,(07110) PALOQUEMAO,1492,1035,698,3225
38099,2020-08-18,(50003) Corral Molinos,1471,749,1030,3250
38100,2020-04-19,(09104) Restrepo,268,218,242,728
38101,2020-08-11,(02103) Mazurén,158,98,178,434
38102,2020-09-09,(05100) Banderas P. Central - alimentacion,3502,1891,2167,7560
38103,2020-08-16,(09103) Olaya,328,150,240,718
38104,2020-06-24,(07002) MADELENA,847,511,476,1834
38105,2020-10-09,(02000) Cabecera Autopista Norte,1732,992,1475,4199
38106,2020-02-03,(07107) U. NACIONAL,2322,1571,1566,5459
38107,2020-03-09,(02201) Prado,1072,1196,793,3061
38108,2020-01-29,(09117) Calle 45,5646,3706,2938,12290
38109,2020-10-02,(04105) Carrera 53,343,169,261,773
38110,2020-07-29,(05000) Portal Américas,2000,1477,1667,5144
38111,2020-08-29,(04000) Cabecera Calle 80,837,456,781,2074
38112,2020-09-09,(09110) Avenida Jimenez,1639,1114,910,3663
38113,2020-01-15,(10001) Country Sur,4492,1877,2386,8755
38114,2020-09-10,(10001) Country Sur,1321,542,724,2587
38115,2020-04-18,(04100) Carrera 77,444,278,266,988
38116,2020-06-06,(04100) Carrera 77,858,480,570,1908
38117,2020-02-09,(09000) Cabecera Usme - alimentacion,6187,2763,5218,14168
38118,2020-10-08,(10006) San Victorino,718,452,514,1684
38119,2020-03-22,(06000) Portal Eldorado,285,236,192,713
38120,2020-09-27,(40003) Mirador del Paraiso,694,347,631,1672
38121,2020-05-07,(02000) Cabecera Autopista Norte - alimentacion,3350,1870,1782,7002
38122,2020-01-16,(09107) Hortúa,2030,1206,1410,4646
38123,2020-05-20,(05100) Banderas P. Central - alimentacion,2199,1123,1047,4369
38124,2020-08-05,(09000) Cabecera Usme - alimentacion,7851,4135,4383,16369
38125,2020-04-18,(03000) Portal Suba - alimentacion,2256,1343,1234,4833
38126,2020-03-17,(09119) Calle 57,2090,1347,1227,4664
38127,2020-03-11,(10002) Av. Primero de Mayo,8020,4108,4543,16671
38128,2020-02-03,(10010) San Bernardo,1843,1094,1437,4374
38129,2020-05-11,(03000) Portal Suba - alimentacion,4431,2618,2259,9308
38130,2020-08-14,(02000) Cabecera Autopista Norte - alimentacion,4372,2382,2450,9204
38131,2020-01-07,(07000) Portal Sur,5503,3308,3462,12273
38132,2020-09-21,(09004) Santa Lucía,2274,960,1255,4489
38133,2020-02-24,(09003) Socorro,1733,1042,1012,3787
38134,2020-05-21,(09116) Avenida 39,273,189,188,650
38135,2020-10-03,(07505) LEON XIII,2643,1140,1724,5507
38136,2020-09-23,(06108) Concejo de Bogotá,157,80,116,353
38137,2020-01-10,(07001) PERDOMO,3614,1937,2142,7693
38138,2020-03-12,(02202) Calle 127,1590,582,592,2764
38139,2020-06-01,(02201) Prado,859,560,473,1892
38140,2020-04-19,(09107) Hortúa,183,112,90,385
38141,2020-07-28,(05101) Mandalay - Cr.73,107,71,51,229
38142,2020-08-28,(05101) Mandalay - Cr.73,152,85,81,318
38143,2020-10-09,(05101) Mandalay - Cr.73,185,99,147,431
38144,2020-01-12,(05103) Marsella,411,165,340,916
38145,2020-06-22,(05103) Marsella,120,65,75,260
38146,2020-08-21,(09119) Calle 57,498,313,346,1157
38147,2020-06-23,(50002) Corral Calle 40 Sur,22,9,22,53
38148,2020-09-30,(04104) Avenida 68,739,377,501,1617
38149,2020-01-28,(14005) Las Aguas,3104,1922,1700,6726
38150,2020-02-24,(08000) Portal Tunal,2225,1298,1055,4578
38151,2020-04-27,(09104) Restrepo,425,225,161,811
38152,2020-04-23,(05105) Pradera,425,279,155,859
38153,2020-01-15,(09121) Las Flores,2860,1766,1713,6339
38154,2020-06-03,(08000) Portal Tunal,681,307,240,1228
38155,2020-03-05,(03009) Av. Suba- Calle 116,2632,1567,1438,5637
38156,2020-07-23,(09101) Quiroga,346,194,280,820
38157,2020-02-28,(07201) Guatoque -Veraguas,1057,480,684,2221
38158,2020-08-31,(07201) Guatoque -Veraguas,185,99,144,428
38159,2020-02-04,(07101) CASTELLANA,978,574,599,2151
38160,2020-02-13,(07001) PERDOMO,4810,2659,2521,9990
38161,2020-05-28,(07103) AV. CHILE,834,547,346,1727
38162,2020-03-19,(07113) SANTA ISABEL,944,564,608,2116
38163,2020-06-26,(07113) SANTA ISABEL,406,253,284,943
38164,2020-02-15,(03006) NIZA - CALLE 127,1257,767,962,2986
38165,2020-01-19,(03007) HUMEDAL CORDOBA,147,82,134,363
38166,2020-08-06,(03007) HUMEDAL CORDOBA,102,77,72,251
38167,2020-09-13,(03007) HUMEDAL CORDOBA,32,31,38,101
38168,2020-05-21,(10006) San Victorino,402,220,260,882
38169,2020-09-08,(10006) San Victorino,571,337,321,1229
38170,2020-03-24,(03011) SUBA - CALLE 100,506,302,248,1056
38171,2020-06-22,(02101) Toberín,343,232,334,909
38172,2020-09-08,(05103) Marsella,473,252,281,1006
38173,2020-02-23,(09115) Calle 34,517,396,684,1597
38174,2020-04-21,(10000) Portal 20 de Julio,1271,663,684,2618
38175,2020-02-20,(06105) Quinta Paredes,1053,621,452,2126
38176,2020-01-23,(14005) Las Aguas,2507,1569,1604,5680
38177,2020-02-16,(02304) Heroes,592,451,698,1741
38178,2020-02-04,(07104) Simon Bolivar,2444,1493,1254,5191
38179,2020-06-10,(07104) Simon Bolivar,591,370,259,1220
38180,2020-08-31,(07104) Simon Bolivar,592,358,297,1247
38181,2020-01-06,(02000) Cabecera Autopista Norte - intermunicipal,438,306,507,1251
38182,2020-05-14,(02304) Heroes,645,459,317,1421
38183,2020-06-19,(05103) Marsella,441,237,235,913
38184,2020-08-31,(09109) Tercer Milenio,347,204,223,774
38185,2020-07-01,(05001) Patio Bonito,0,862,2046,2908
38186,2020-08-25,(05001) Patio Bonito,1720,964,954,3638
38187,2020-04-20,(09000) Cabecera Usme - alimentacion,3509,2221,2483,8213
38188,2020-09-28,(02104) Calle 146,1025,653,779,2457
38189,2020-01-10,(06100) Av. Rojas,1420,858,907,3185
38190,2020-03-15,(07505) LEON XIII,1778,734,1053,3565
38191,2020-05-03,(02000) Cabecera Autopista Norte,240,156,153,549
38192,2020-09-19,(09120) Calle 63,1053,699,854,2606
38193,2020-04-28,(06000) Portal Eldorado,882,538,353,1773
38194,2020-04-17,(02302) Virrey,322,227,203,752
38195,2020-04-28,(12003) Ricaurte,186,136,109,431
38196,2020-05-28,(12003) Ricaurte,309,237,136,682
38197,2020-10-05,(04103) Las Ferias,387,226,253,866
38198,2020-01-01,(09117) Calle 45,278,204,509,991
38199,2020-03-21,(02302) Virrey,269,180,132,581
38200,2020-01-18,(05107) Américas - Cr.53,1225,729,1040,2994
38201,2020-01-12,(10000) Portal 20 de Julio - alimentacion,3257,1239,2780,7276
38202,2020-10-08,(02105) Calle 142,957,568,829,2354
38203,2020-06-10,(05002) Tintal,1916,1086,1128,4130
38204,2020-01-21,(09109) Tercer Milenio,1011,577,585,2173
38205,2020-04-28,(09109) Tercer Milenio,186,117,133,436
38206,2020-04-06,(05102) Av. Américas - Av. Boyacá,127,72,89,288
38207,2020-06-30,(06107) Ciudad Universitaria,182,107,131,420
38208,2020-04-24,(10010) San Bernardo,414,231,258,903
38209,2020-01-31,(04000) Cabecera Calle 80 - intermunicipal,2163,1450,1955,5568
38210,2020-07-13,(09123) Calle 76,813,575,454,1842
38211,2020-06-21,(09000) Cabecera Usme - alimentacion,2407,1267,1536,5210
38212,2020-06-02,(07103) AV. CHILE,854,523,382,1759
38213,2020-09-15,(07004) VENECIA,1115,624,668,2407
38214,2020-01-26,(09120) Calle 63,927,699,1175,2801
38215,2020-07-05,(02102) Calle 161,60,37,71,168
38216,2020-08-10,(09004) Santa Lucía,2411,1239,1313,4963
38217,2020-09-14,(10008) San Diego,264,164,180,608
38218,2020-07-04,(07000) Portal Sur,1530,877,1073,3480
38219,2020-01-26,(02303) Calle 85,444,379,601,1424
38220,2020-01-01,(03001) LA CAMPIÑA,340,153,551,1044
38221,2020-09-12,(12007) Zona Industrial,280,184,179,643
38222,2020-05-29,(06111) Universidades,0,123,389,512
38223,2020-05-26,(40001) Juan Pablo II,503,314,288,1105
38224,2020-09-16,(02202) Calle 127,1192,846,730,2768
38225,2020-05-11,(04002) Carrera 90,508,293,262,1063
38226,2020-08-17,(07006) General Santander,166,78,127,371
38227,2020-05-16,(12004) Carrera 22,101,71,72,244
38228,2020-03-09,(07105) MOVISTAR ARENA,568,115,164,847
38229,2020-08-24,(09122) Calle 72,861,691,659,2211
38230,2020-09-19,(09122) Calle 72,934,646,971,2551
38231,2020-04-03,(06109) Centro Memoria,156,106,94,356
38232,2020-03-27,(06101) El Tiempo,227,176,123,526
38233,2020-07-14,(07105) MOVISTAR ARENA,257,145,110,512
38234,2020-07-16,(07105) MOVISTAR ARENA,265,131,137,533
38235,2020-09-03,(03003) 21 ANGELES,360,178,208,746
38236,2020-06-02,(10007) Las Nieves,524,340,306,1170
38237,2020-06-30,(10007) Las Nieves,693,363,441,1497
38238,2020-09-25,(10004) Policarpa,306,134,211,651
38239,2020-08-09,(09119) Calle 57,162,111,161,434
38240,2020-09-30,(08000) Portal Tunal,829,378,382,1589
38241,2020-06-04,(10002) Av. Primero de Mayo,1918,1031,1103,4052
38242,2020-02-04,(12000) Puente Aranda,330,159,181,670
38243,2020-08-08,(09000) Cabecera Usme,1155,637,1011,2803
38244,2020-09-09,(06001) Modelia,393,248,242,883
38245,2020-05-31,(09002) Consuelo,122,61,98,281
38246,2020-06-28,(09003) Socorro,226,96,131,453
38247,2020-01-01,(07005) ALQUERIA,166,112,250,528
38248,2020-07-12,(08001) Parque el Tunal,162,68,124,354
38249,2020-03-23,(09002) Consuelo,103,55,55,213
38250,2020-09-12,(07008) NQS - Calle 30 Sur,296,136,225,657
38251,2020-04-08,(07200) Tygua-San José,74,37,69,180
38252,2020-05-08,(03013) RIO NEGRO,189,126,118,433
38253,2020-08-16,(09000) Cabecera Usme,424,217,456,1097
38254,2020-04-17,(10010) San Bernardo,424,260,307,991
38255,2020-03-20,(07003) SEVILLANA,244,148,121,513
38256,2020-05-08,(06106) Recinto Ferial,192,123,77,392
38257,2020-07-26,(04101) Minuto de Dios,75,45,77,197
38258,2020-07-10,(07006) General Santander,596,366,326,1288
38259,2020-07-14,(04000) Cabecera Calle 80 - intermunicipal,286,167,264,717
38260,2020-08-07,(03003) 21 ANGELES,122,51,61,234
38261,2020-10-02,(03010) PUENTE LARGO,401,252,337,990
38262,2020-08-13,(09108) Hospital,85,42,64,191
38263,2020-06-13,(03009) Av. Suba- Calle 116,334,225,201,760
38264,2020-03-29,(04103) Las Ferias,66,45,36,147
38265,2020-03-10,(07200) Tygua-San José,160,152,156,468
38266,2020-08-18,(07005) ALQUERIA,475,290,289,1054
38267,2020-04-28,(07004) VENECIA,558,339,282,1179
38268,2020-05-08,(07010) Bosa,466,268,308,1042
38269,2020-01-19,(07010) Bosa,486,258,541,1285
38270,2020-08-23,(07506) DESPENSA,111,59,91,261
38271,2020-03-21,(06107) Ciudad Universitaria,54,50,45,149
38272,2020-03-09,(05102) Av. Américas - Av. Boyacá,177,440,231,848
38273,2020-09-26,(10004) Policarpa,262,107,216,585
38274,2019-12-31,(02101) Toberín,83,48,88,219
38275,2020-06-20,(06001) Modelia,282,169,192,643
38276,2020-10-04,(05107) Américas - Cr.53,113,83,218,414
38277,2020-05-03,(10002) Av. Primero de Mayo,440,221,290,951
38278,2020-09-12,(03011) SUBA - CALLE 100,375,241,292,908
38279,2020-05-01,(03011) SUBA - CALLE 100,145,90,71,306
38280,2020-05-09,(07109) CAD,302,213,146,661
38281,2020-07-27,(03004) GRATAMIRA,32,15,13,60
38282,2020-10-02,(07007) NQS - Calle 38A Sur,486,295,373,1154
38283,2020-01-01,(04108) El Polo,86,58,213,357
38284,2020-08-23,(40001) Juan Pablo II,164,70,130,364
38285,2020-04-07,(06103) CAN,300,219,164,683
38286,2020-05-06,(07007) NQS - Calle 38A Sur,206,122,138,466
38287,2020-04-16,(06111) Universidades,0,95,225,320
38288,2020-03-25,(07201) Guatoque -Veraguas,43,45,65,153
38289,2020-02-02,(08002) Biblioteca,250,101,230,581
38290,2020-07-26,(02000) Cabecera Autopista Norte - intermunicipal,81,67,78,226
38291,2020-07-01,(04001) Quirigua,420,260,261,941
38292,2020-06-30,(10003) Ciudad Jardín,234,118,137,489
38293,2020-03-22,(05103) Marsella,65,40,38,143
38294,2020-06-19,(02102) Calle 161,269,173,184,626
38295,2020-07-19,(06102) Salitre El Greco,76,47,47,170
38296,2020-07-31,(03005) SUBA - AV. BOYACA,296,189,221,706
38297,2020-08-23,(12002) CDS - Carrera 32,36,40,22,98
38298,2020-04-28,(04001) Quirigua,219,142,135,496
38299,2020-07-03,(50002) Corral Calle 40 Sur,20,11,34,65
38300,2020-09-11,(50002) Corral Calle 40 Sur,21,18,26,65
38301,2020-04-06,(09113) Calle 22,196,134,192,522
38302,2020-07-02,(12000) Puente Aranda,96,53,43,192
38303,2020-05-03,(04103) Las Ferias,88,47,44,179
38304,2020-07-05,(06105) Quinta Paredes,37,25,28,90
38305,2020-08-02,(02102) Calle 161,50,42,52,144
38306,2020-04-27,(07113) SANTA ISABEL,118,50,32,200
38307,2020-06-10,(50002) Corral Calle 40 Sur,17,7,17,41
38308,2020-05-17,(02102) Calle 161,35,31,36,102
38309,2020-06-08,(50004) Corral Avenida Ciudad de Cali,1,1,0,2
38310,2020-09-29,(04000) Cabecera Calle 80 - alimentacion,4852,2689,3816,11357
38311,2020-10-10,(04000) Cabecera Calle 80 - alimentacion,3551,1639,3350,8540
38312,2020-09-22,(07005) ALQUERIA,570,334,432,1336
38313,2020-06-18,(09002) Consuelo,509,262,274,1045
38314,2020-09-02,(02502) Terminal,443,309,365,1117
38315,2020-06-08,(07504) TERREROS,5394,3042,2605,11041
38316,2020-06-16,(07504) TERREROS,5840,3310,2790,11940
38317,2020-02-19,(03002) SUBA - TV- 91,4817,2802,2493,10112
38318,2020-02-18,(09122) Calle 72,8888,5716,4171,18775
38319,2020-02-14,(14005) Las Aguas,3202,2054,2075,7331
38320,2020-02-24,(07003) SEVILLANA,2126,1188,1099,4413
38321,2020-01-19,(04000) Cabecera Calle 80 - alimentacion,4665,1954,4786,11405
38322,2020-02-12,(09001) Molinos,7424,4901,5942,18267
38323,2020-08-05,(09001) Molinos,2354,1229,1575,5158
38324,2020-02-10,(09118) Marly,8224,5289,4134,17647
38325,2020-02-22,(07010) Bosa,1545,816,1136,3497
38326,2020-09-14,(07000) Portal Sur - alimentacion,8607,4603,4716,17926
38327,2020-07-21,(05100) Banderas P. Central,666,372,404,1442
38328,2020-01-11,(09000) Cabecera Usme,3171,1604,2634,7409
38329,2020-06-29,(09115) Calle 34,180,133,163,476
38330,2020-09-20,(09113) Calle 22,229,114,275,618
38331,2020-02-04,(02000) Cabecera Autopista Norte,11789,7198,6313,25300
38332,2020-02-06,(06102) Salitre El Greco,1548,889,781,3218
38333,2020-03-11,(06102) Salitre El Greco,1396,814,680,2890
38334,2020-06-04,(09000) Cabecera Usme - alimentacion,7782,4356,4333,16471
38335,2020-09-08,(09000) Cabecera Usme - alimentacion,9011,4675,5344,19030
38336,2020-01-10,(09104) Restrepo,3964,2364,3358,9686
38337,2020-07-17,(04101) Minuto de Dios,282,153,185,620
38338,2020-03-14,(07505) LEON XIII,5272,2593,2764,10629
38339,2020-07-13,(07505) LEON XIII,2470,1360,1043,4873
38340,2020-03-01,(07504) TERREROS,4599,1847,3530,9976
38341,2020-02-14,(09117) Calle 45,6399,4188,3330,13917
38342,2020-02-21,(09117) Calle 45,5516,4136,3170,12822
38343,2020-02-28,(09117) Calle 45,6215,4223,3301,13739
38344,2020-01-15,(05001) Patio Bonito,5924,3376,3370,12670
38345,2020-02-14,(09123) Calle 76,5484,3818,3244,12546
38346,2020-01-13,(12003) Ricaurte,1030,675,558,2263
38347,2020-02-22,(12003) Ricaurte,751,572,605,1928
38348,2020-01-03,(09000) Cabecera Usme,3292,1837,2650,7779
38349,2020-06-13,(05000) Portal Américas,1681,1146,1510,4337
38350,2020-09-27,(07102) NQS - CALLE 75,78,76,158,312
38351,2020-03-17,(03001) LA CAMPIÑA,3706,2031,1996,7733
38352,2020-02-24,(06001) Modelia,2665,1585,1189,5439
38353,2020-02-04,(07106) EL CAMPIN,2145,1309,1124,4578
38354,2020-06-24,(07000) Portal Sur - alimentacion,8265,4774,3928,16967
38355,2020-05-17,(09103) Olaya,253,132,164,549
38356,2020-08-21,(09103) Olaya,984,528,556,2068
38357,2020-09-16,(09103) Olaya,1117,631,710,2458
38358,2020-07-22,(14001) La Sabana,106,83,68,257
38359,2020-03-05,(07106) EL CAMPIN,2096,1309,1202,4607
38360,2020-02-01,(02200) Alcalá,6161,3291,4408,13860
38361,2020-05-29,(02000) Cabecera Autopista Norte,1181,712,686,2579
38362,2020-09-26,(02000) Cabecera Autopista Norte,1251,692,1085,3028
38363,2020-05-02,(09113) Calle 22,246,145,203,594
38364,2020-02-20,(03003) 21 ANGELES,1708,897,833,3438
38365,2020-02-10,(10007) Las Nieves,2238,1295,1167,4700
38366,2020-09-17,(50003) Corral Molinos,1647,845,1277,3769
38367,2020-07-27,(04000) Cabecera Calle 80,990,648,729,2367
38368,2020-01-16,(07506) DESPENSA,1484,791,916,3191
38369,2020-01-07,(10001) Country Sur,3513,1519,2138,7170
38370,2020-07-29,(10001) Country Sur,1167,558,632,2357
38371,2020-04-16,(09002) Consuelo,283,130,148,561
38372,2020-02-12,(04002) Carrera 90,3931,2357,1980,8268
38373,2020-06-10,(04002) Carrera 90,685,376,382,1443
38374,2020-03-12,(06000) Portal Eldorado,2246,538,715,3499
38375,2020-03-06,(10008) San Diego,1390,830,829,3049
38376,2020-03-06,(10000) Portal 20 de Julio,8987,3890,4033,16910
38377,2020-01-24,(12001) Carrera 43,1576,905,1022,3503
38378,2020-10-08,(12001) Carrera 43,505,306,341,1152
38379,2020-01-08,(10002) Av. Primero de Mayo,6058,2945,3838,12841
38380,2020-06-16,(10002) Av. Primero de Mayo,2131,1166,1257,4554
38381,2020-03-04,(02001) Centro Comercial Santa Fe,4802,3053,2673,10528
38382,2020-04-08,(07503) SAN MATEO,5067,2894,2383,10344
38383,2020-01-11,(02000) Cabecera Autopista Norte - intermunicipal,1509,851,1320,3680
38384,2020-02-20,(07106) EL CAMPIN,2160,1313,1114,4587
38385,2020-03-02,(03000) Portal Suba,9603,5659,4945,20207
38386,2020-03-18,(09101) Quiroga,947,562,719,2228
38387,2020-01-16,(04001) Quirigua,1648,954,1064,3666
38388,2020-08-27,(02303) Calle 85,706,451,385,1542
38389,2020-08-31,(07004) VENECIA,988,589,577,2154
38390,2020-06-11,(09118) Marly,1407,921,683,3011
38391,2020-04-17,(08001) Parque el Tunal,236,129,148,513
38392,2020-04-20,(08001) Parque el Tunal,254,153,144,551
38393,2020-08-11,(08001) Parque el Tunal,452,254,249,955
38394,2020-08-18,(09116) Avenida 39,327,162,215,704
38395,2020-05-03,(07505) LEON XIII,480,295,203,978
38396,2020-05-26,(06108) Concejo de Bogotá,135,67,66,268
38397,2020-03-21,(07503) SAN MATEO,3589,2007,1658,7254
38398,2020-06-10,(09116) Avenida 39,331,218,222,771
38399,2020-06-10,(03003) 21 ANGELES,316,162,142,620
38400,2020-01-19,(02101) Toberín,1667,855,2203,4725
38401,2020-09-05,(06001) Modelia,260,166,234,660
38402,2020-06-24,(10000) Portal 20 de Julio,2374,1168,1111,4653
38403,2020-02-28,(04003) Avenida Ciudad de Cali,5659,3078,3631,12368
38404,2020-04-01,(09123) Calle 76,444,351,275,1070
38405,2020-02-07,(05101) Mandalay - Cr.73,1244,622,601,2467
38406,2020-05-16,(40003) Mirador del Paraiso,1213,704,677,2594
38407,2020-02-20,(05103) Marsella,3165,1766,1344,6275
38408,2020-08-23,(05103) Marsella,92,41,97,230
38409,2020-02-02,(10006) San Victorino,279,311,512,1102
38410,2020-01-25,(03011) SUBA - CALLE 100,1049,637,1012,2698
38411,2020-08-29,(03012) SUBA - CALLE 95,230,146,179,555
38412,2020-06-19,(09119) Calle 57,631,409,450,1490
38413,2020-01-07,(06000) Portal Eldorado,4627,2774,2303,9704
38414,2020-07-25,(09123) Calle 76,543,378,362,1283
38415,2020-03-21,(05005) Transversal 86,142,70,67,279
38416,2020-08-03,(05005) Transversal 86,266,183,207,656
38417,2020-02-05,(02202) Calle 127,6065,3989,3052,13106
38418,2020-06-02,(02202) Calle 127,1054,719,500,2273
38419,2020-07-09,(05105) Pradera,616,345,264,1225
38420,2020-05-01,(06109) Centro Memoria,90,58,59,207
38421,2020-01-05,(10007) Las Nieves,172,184,301,657
38422,2020-03-06,(03009) Av. Suba- Calle 116,2536,1561,1490,5587
38423,2020-03-31,(02205) Calle 106,194,147,115,456
38424,2020-05-21,(02205) Calle 106,270,166,148,584
38425,2020-02-22,(12000) Puente Aranda,190,136,156,482
38426,2020-07-29,(04003) Avenida Ciudad de Cali,916,533,626,2075
38427,2020-02-10,(07000) Portal Sur,7971,4968,4194,17133
38428,2020-02-19,(12007) Zona Industrial,1357,787,611,2755
38429,2020-06-12,(05001) Patio Bonito,1564,864,966,3394
38430,2020-10-06,(02304) Heroes,1019,699,717,2435
38431,2020-02-03,(07113) SANTA ISABEL,2115,1238,1446,4799
38432,2020-06-05,(03007) HUMEDAL CORDOBA,150,93,58,301
38433,2020-03-18,(03011) SUBA - CALLE 100,1359,683,660,2702
38434,2020-04-09,(02000) Cabecera Autopista Norte - alimentacion,1306,666,431,2403
38435,2020-01-11,(40003) Mirador del Paraiso,3377,1705,2040,7122
38436,2020-05-12,(07110) PALOQUEMAO,562,329,205,1096
38437,2020-07-01,(07104) Simon Bolivar,645,372,305,1322
38438,2020-05-02,(10005) Bicentenario - alimentacion,120,53,75,248
38439,2020-05-24,(02000) Cabecera Autopista Norte - intermunicipal,60,43,70,173
38440,2020-04-23,(04002) Carrera 90,389,225,200,814
38441,2020-02-20,(09106) Nariño,2013,1239,1234,4486
38442,2020-05-29,(05103) Marsella,338,160,213,711
38443,2020-10-06,(09117) Calle 45,758,467,671,1896
38444,2020-06-09,(02104) Calle 146,696,483,499,1678
38445,2020-02-09,(06000) Portal Eldorado,723,532,1105,2360
38446,2020-10-12,(02200) Alcalá,628,459,607,1694
38447,2020-03-25,(09002) Consuelo,232,112,113,457
38448,2020-05-07,(07009) SENA,440,251,261,952
38449,2020-03-15,(09120) Calle 63,992,677,1043,2712
38450,2020-04-07,(02302) Virrey,295,239,172,706
38451,2020-04-14,(02302) Virrey,338,291,209,838
38452,2020-08-08,(07200) Tygua-San José,181,112,129,422
38453,2020-04-29,(09001) Molinos,1469,866,953,3288
38454,2020-06-03,(02105) Calle 142,705,418,413,1536
38455,2020-08-29,(02105) Calle 142,575,344,438,1357
38456,2020-07-07,(10008) San Diego,309,169,215,693
38457,2020-03-24,(09109) Tercer Milenio,257,188,212,657
38458,2020-03-26,(05102) Av. Américas - Av. Boyacá,129,71,78,278
38459,2020-06-25,(06000) Portal Eldorado - alimentacion,4041,2205,2064,8310
38460,2020-07-31,(03002) SUBA - TV- 91,552,338,383,1273
38461,2020-07-12,(02104) Calle 146,304,179,245,728
38462,2020-09-15,(02103) Mazurén,228,156,195,579
38463,2020-06-19,(12007) Zona Industrial,367,242,171,780
38464,2020-09-17,(12007) Zona Industrial,420,256,199,875
38465,2020-10-07,(12007) Zona Industrial,411,273,227,911
38466,2020-09-01,(03010) PUENTE LARGO,370,218,226,814
38467,2020-02-28,(10005) Bicentenario,723,432,439,1594
38468,2020-03-30,(10005) Bicentenario,40,28,41,109
38469,2020-09-01,(09106) Nariño,439,252,338,1029
38470,2020-08-13,(02001) Centro Comercial Santa Fe,431,267,349,1047
38471,2020-09-16,(07003) SEVILLANA,504,282,356,1142
38472,2020-09-09,(07006) General Santander,624,334,370,1328
38473,2020-01-03,(02103) Mazurén,1037,608,787,2432
38474,2020-07-15,(09120) Calle 63,823,544,548,1915
38475,2020-09-22,(09120) Calle 63,1274,840,951,3065
38476,2020-03-17,(04107) Escuela Militar,379,255,254,888
38477,2020-08-20,(10008) San Diego,219,128,186,533
38478,2020-06-20,(09003) Socorro,518,248,292,1058
38479,2020-06-18,(07111) NQS - RICAURTE,1189,720,428,2337
38480,2020-02-02,(09109) Tercer Milenio,341,193,383,917
38481,2020-05-29,(02304) Heroes,689,520,396,1605
38482,2020-07-23,(09122) Calle 72,941,628,618,2187
38483,2020-08-06,(09122) Calle 72,1029,692,707,2428
38484,2020-03-27,(06104) Gobernación,141,126,72,339
38485,2020-06-26,(06102) Salitre El Greco,247,148,135,530
38486,2020-10-03,(09100) Calle 40 Sur,1526,806,1454,3786
38487,2020-02-01,(07108) Av. El Dorado,393,299,437,1129
38488,2020-01-28,(09105) Río Fucha,759,437,461,1657
38489,2020-04-08,(02200) Alcalá,884,600,467,1951
38490,2020-03-18,(09120) Calle 63,2987,1995,1802,6784
38491,2020-06-13,(09123) Calle 76,638,472,464,1574
38492,2020-07-01,(09113) Calle 22,440,250,394,1084
38493,2020-08-21,(03003) 21 ANGELES,307,158,163,628
38494,2020-07-09,(09119) Calle 57,604,385,406,1395
38495,2020-07-20,(06107) Ciudad Universitaria,53,36,39,128
38496,2020-03-01,(03005) SUBA - AV. BOYACA,413,255,554,1222
38497,2020-08-25,(07106) EL CAMPIN,356,233,204,793
38498,2020-05-09,(04105) Carrera 53,160,84,80,324
38499,2020-04-26,(07007) NQS - Calle 38A Sur,77,46,52,175
38500,2020-05-06,(07109) CAD,443,290,202,935
38501,2020-08-08,(03006) NIZA - CALLE 127,247,175,160,582
38502,2020-05-08,(03005) SUBA - AV. BOYACA,278,168,188,634
38503,2020-07-12,(10002) Av. Primero de Mayo,714,350,611,1675
38504,2020-06-19,(12004) Carrera 22,265,152,129,546
38505,2020-07-08,(12004) Carrera 22,280,159,150,589
38506,2020-08-14,(12004) Carrera 22,268,151,139,558
38507,2020-09-02,(03013) RIO NEGRO,297,184,223,704
38508,2020-04-09,(10009) Museo Nacional,72,42,55,169
38509,2020-07-16,(10009) Museo Nacional,355,239,246,840
38510,2020-04-22,(07112) COMUNEROS,442,283,211,936
38511,2020-05-01,(03013) RIO NEGRO,71,53,47,171
38512,2020-03-22,(02300) Calle 100,248,230,191,669
38513,2020-02-20,(40001) Juan Pablo II,1586,948,865,3399
38514,2020-08-12,(07008) NQS - Calle 30 Sur,281,163,174,618
38515,2020-07-29,(04002) Carrera 90,669,410,355,1434
38516,2020-04-17,(03012) SUBA - CALLE 95,187,127,104,418
38517,2020-03-21,(14001) La Sabana,47,38,37,122
38518,2020-02-29,(12002) CDS - Carrera 32,283,220,274,777
38519,2020-01-19,(40001) Juan Pablo II,440,199,362,1001
38520,2020-08-29,(04105) Carrera 53,196,119,158,473
38521,2020-09-15,(06103) CAN,393,238,198,829
38522,2020-05-31,(09004) Santa Lucía,669,330,436,1435
38523,2020-09-10,(03010) PUENTE LARGO,375,182,246,803
38524,2020-04-09,(07000) Portal Sur,332,177,197,706
38525,2020-01-01,(06002) Normandía,89,73,157,319
38526,2020-06-03,(06001) Modelia,395,257,164,816
38527,2020-03-10,(09108) Hospital,37,50,58,145
38528,2020-07-17,(07009) SENA,611,360,365,1336
38529,2020-05-18,(02000) Cabecera Autopista Norte - intermunicipal,395,298,274,967
38530,2020-03-31,(07200) Tygua-San José,55,35,78,168
38531,2020-04-28,(02502) Terminal,213,134,155,502
38532,2020-09-05,(07506) DESPENSA,337,193,260,790
38533,2020-04-13,(07104) Simon Bolivar,198,163,102,463
38534,2020-07-28,(40002) Manitas,381,240,208,829
38535,2020-08-29,(02304) Heroes,585,422,435,1442
38536,2020-08-21,(12007) Zona Industrial,330,193,145,668
38537,2020-08-19,(10004) Policarpa,234,112,160,506
38538,2020-05-01,(05105) Pradera,162,112,68,342
38539,2020-09-15,(40002) Manitas,404,252,337,993
38540,2020-09-06,(12001) Carrera 43,70,57,93,220
38541,2020-07-05,(10006) San Victorino,177,112,137,426
38542,2020-08-20,(06101) El Tiempo,335,184,166,685
38543,2020-05-21,(03004) GRATAMIRA,23,17,14,54
38544,2020-08-25,(03004) GRATAMIRA,0,11,33,44
38545,2020-07-05,(06002) Normandía,71,61,78,210
38546,2020-04-09,(07112) COMUNEROS,141,85,64,290
38547,2020-06-21,(50003) Corral Molinos,512,237,406,1155
38548,2020-07-22,(07113) SANTA ISABEL,346,210,215,771
38549,2020-05-20,(07008) NQS - Calle 30 Sur,189,122,105,416
38550,2020-08-17,(04107) Escuela Militar,45,31,33,109
38551,2020-01-28,(03014) SAN MARTIN,277,173,158,608
38552,2020-01-01,(03004) GRATAMIRA,21,12,29,62
38553,2020-10-12,(07201) Guatoque -Veraguas,47,38,108,193
38554,2020-03-30,(09110) Avenida Jimenez,261,204,258,723
38555,2020-06-14,(07006) General Santander,155,75,95,325
38556,2020-06-25,(09105) Río Fucha,130,66,106,302
38557,2020-08-10,(05101) Mandalay - Cr.73,119,72,61,252
38558,2020-04-09,(06001) Modelia,93,68,55,216
38559,2020-09-13,(14001) La Sabana,51,32,70,153
38560,2020-07-20,(07200) Tygua-San José,52,31,45,128
38561,2020-07-16,(05101) Mandalay - Cr.73,103,61,54,218
38562,2020-01-08,(12000) Puente Aranda,173,111,114,398
38563,2020-06-06,(07101) CASTELLANA,97,67,82,246
38564,2020-10-01,(12000) Puente Aranda,102,57,82,241
38565,2020-05-23,(12004) Carrera 22,134,86,82,302
38566,2020-04-29,(05101) Mandalay - Cr.73,69,42,43,154
38567,2020-09-07,(12000) Puente Aranda,99,46,36,181
38568,2020-09-10,(12000) Puente Aranda,83,43,47,173
38569,2020-10-12,(06104) Gobernación,49,58,79,186
38570,2020-05-14,(03014) SAN MARTIN,27,9,30,66
38571,2020-08-06,(50006) Corral Carrera 77,1,1,10,12
38572,2020-05-24,(14004) Museo del Oro,0,20,34,54
38573,2020-08-15,(03004) GRATAMIRA,0,19,36,55
38574,2020-06-23,(04000) Cabecera Calle 80 - alimentacion,4361,2550,2758,9669
38575,2020-09-07,(02502) Terminal,481,348,415,1244
38576,2020-03-02,(09118) Marly,7870,5193,4145,17208
38577,2020-03-17,(07504) TERREROS,12328,7206,6256,25790
38578,2020-04-06,(07504) TERREROS,2380,1400,1336,5116
38579,2020-04-11,(07504) TERREROS,1423,865,715,3003
38580,2020-07-23,(07504) TERREROS,5266,2957,2347,10570
38581,2020-05-08,(09119) Calle 57,361,242,229,832
38582,2020-02-20,(09122) Calle 72,8348,5326,4004,17678
38583,2020-02-24,(14005) Las Aguas,3500,2052,1855,7407
38584,2020-02-03,(05000) Portal Américas,14462,8600,8081,31143
38585,2020-06-12,(05000) Portal Américas,2387,1647,1784,5818
38586,2020-01-28,(09003) Socorro,1569,908,963,3440
38587,2020-07-22,(09003) Socorro,436,219,268,923
38588,2020-01-31,(10000) Portal 20 de Julio - alimentacion,10782,5268,7467,23517
38589,2020-06-11,(04101) Minuto de Dios,299,174,236,709
38590,2020-02-27,(09001) Molinos,7736,4607,5722,18065
38591,2020-02-10,(02000) Cabecera Autopista Norte - alimentacion,24085,14419,13478,51982
38592,2020-01-10,(07010) Bosa,1837,1016,1288,4141
38593,2020-01-20,(07010) Bosa,2073,1247,1416,4736
38594,2020-01-16,(07002) MADELENA,4195,2192,2366,8753
38595,2020-07-14,(05100) Banderas P. Central,659,369,413,1441
38596,2020-09-11,(05100) Banderas P. Central,962,547,656,2165
38597,2020-07-07,(10001) Country Sur,1382,626,774,2782
38598,2020-05-15,(07503) SAN MATEO,8224,4946,3772,16942
38599,2020-01-26,(06000) Portal Eldorado - alimentacion,4300,1769,3205,9274
38600,2020-02-22,(05100) Banderas P. Central - alimentacion,8749,4220,6136,19105
38601,2020-03-25,(05000) Portal Américas - alimentacion,6333,2919,2802,12054
38602,2020-05-30,(08000) Portal Tunal - alimentacion,4642,2450,2427,9519
38603,2020-02-29,(07001) PERDOMO,2670,1198,2091,5959
38604,2020-01-20,(09120) Calle 63,4142,2974,3090,10206
38605,2020-02-05,(04000) Cabecera Calle 80 - intermunicipal,2344,1705,2157,6206
38606,2020-03-03,(09104) Restrepo,5298,3274,4076,12648
38607,2020-09-28,(09104) Restrepo,1685,973,1495,4153
38608,2020-02-08,(07505) LEON XIII,6072,2930,3312,12314
38609,2020-05-02,(07505) LEON XIII,941,597,473,2011
38610,2020-07-21,(03000) Portal Suba - alimentacion,5619,3237,3186,12042
38611,2020-07-22,(05002) Tintal,2208,1249,1376,4833
38612,2020-07-10,(09101) Quiroga,547,326,402,1275
38613,2020-09-12,(09101) Quiroga,472,207,424,1103
38614,2020-06-30,(07102) NQS - CALLE 75,460,284,258,1002
38615,2020-04-13,(02103) Mazurén,100,55,74,229
38616,2020-07-11,(14001) La Sabana,157,107,121,385
38617,2020-08-11,(14001) La Sabana,168,103,88,359
38618,2020-03-04,(04102) Avenida Boyaca,3057,1815,1655,6527
38619,2020-09-15,(09113) Calle 22,417,251,355,1023
38620,2020-07-31,(09004) Santa Lucía,2269,1189,1149,4607
38621,2020-01-20,(07109) CAD,2713,1584,1405,5702
38622,2020-10-07,(05000) Portal Américas,4041,2158,2850,9049
38623,2020-09-06,(10006) San Victorino,244,144,175,563
38624,2020-01-05,(05002) Tintal,1716,700,1526,3942
38625,2020-01-26,(12001) Carrera 43,180,123,285,588
38626,2020-06-06,(12001) Carrera 43,287,139,172,598
38627,2020-06-18,(12001) Carrera 43,456,255,239,950
38628,2020-03-26,(07000) Portal Sur - alimentacion,3886,1990,1543,7419
38629,2020-07-20,(07505) LEON XIII,788,411,355,1554
38630,2020-01-13,(02105) Calle 142,5477,3254,3292,12023
38631,2020-01-28,(02302) Virrey,3819,2485,1783,8087
38632,2020-07-10,(09000) Cabecera Usme - alimentacion,9305,5055,5342,19702
38633,2020-03-14,(09101) Quiroga,834,507,835,2176
38634,2020-02-29,(06000) Portal Eldorado - alimentacion,10685,4995,7451,23131
38635,2020-01-25,(06111) Universidades,1674,1045,1681,4400
38636,2020-08-12,(10000) Portal 20 de Julio,2126,1078,1114,4318
38637,2020-10-08,(07004) VENECIA,1176,713,858,2747
38638,2020-03-05,(09004) Santa Lucía,7471,4186,4198,15855
38639,2020-05-16,(09004) Santa Lucía,1588,764,820,3172
38640,2020-07-25,(09004) Santa Lucía,1558,710,823,3091
38641,2020-08-30,(09004) Santa Lucía,924,374,705,2003
38642,2020-03-04,(07108) Av. El Dorado,991,610,607,2208
38643,2020-05-26,(08001) Parque el Tunal,425,238,213,876
38644,2020-05-27,(09116) Avenida 39,293,187,161,641
38645,2020-10-08,(09116) Avenida 39,437,271,387,1095
38646,2020-06-11,(02101) Toberín,1415,889,840,3144
38647,2020-08-22,(10001) Country Sur,794,337,559,1690
38648,2020-05-27,(09120) Calle 63,926,658,584,2168
38649,2020-03-06,(07001) PERDOMO,4541,2557,2807,9905
38650,2020-02-06,(05105) Pradera,2509,1589,1268,5366
38651,2020-02-26,(10009) Museo Nacional,4632,2461,1987,9080
38652,2020-01-07,(02300) Calle 100,5172,3178,2944,11294
38653,2020-05-19,(02300) Calle 100,1086,692,536,2314
38654,2020-08-05,(02300) Calle 100,1053,697,577,2327
38655,2020-09-02,(02300) Calle 100,1274,839,768,2881
38656,2020-04-13,(02000) Cabecera Autopista Norte - alimentacion,2693,1466,1223,5382
38657,2020-01-14,(10010) San Bernardo,1423,888,1223,3534
38658,2020-01-25,(05101) Mandalay - Cr.73,436,189,323,948
38659,2020-05-20,(08000) Portal Tunal,645,272,238,1155
38660,2020-06-15,(09001) Molinos,837,421,631,1889
38661,2020-08-29,(02202) Calle 127,838,576,607,2021
38662,2020-09-05,(02202) Calle 127,865,635,637,2137
38663,2020-07-02,(10008) San Diego,298,169,211,678
38664,2020-03-01,(09121) Las Flores,556,371,683,1610
38665,2020-05-30,(02205) Calle 106,177,130,122,429
38666,2020-01-16,(03006) NIZA - CALLE 127,1915,1238,1342,4495
38667,2020-09-30,(04108) El Polo,564,354,350,1268
38668,2020-02-13,(07201) Guatoque -Veraguas,1000,563,590,2153
38669,2020-03-27,(06000) Portal Eldorado,738,522,390,1650
38670,2020-04-19,(03007) HUMEDAL CORDOBA,42,28,16,86
38671,2020-07-28,(07000) Portal Sur,1730,1096,1000,3826
38672,2020-03-30,(02101) Toberín,575,433,410,1418
38673,2020-05-25,(02101) Toberín,256,169,228,653
38674,2020-03-11,(02300) Calle 100,6532,4416,3762,14710
38675,2020-05-18,(02000) Cabecera Autopista Norte - alimentacion,4077,2351,2103,8531
38676,2020-07-05,(05100) Banderas P. Central - alimentacion,911,405,621,1937
38677,2020-01-09,(02204) Pepe Sierra,3497,2325,1853,7675
38678,2020-04-22,(09100) Calle 40 Sur,956,611,590,2157
38679,2020-07-17,(04107) Escuela Militar,141,80,90,311
38680,2020-08-24,(04107) Escuela Militar,139,71,75,285
38681,2020-01-17,(07004) VENECIA,4153,2274,2452,8879
38682,2020-07-02,(09118) Marly,1444,926,845,3215
38683,2020-08-26,(04002) Carrera 90,644,344,369,1357
38684,2020-10-05,(05001) Patio Bonito,2299,1167,1415,4881
38685,2020-03-16,(03003) 21 ANGELES,1178,534,579,2291
38686,2020-09-16,(02104) Calle 146,967,565,679,2211
38687,2020-04-22,(03002) SUBA - TV- 91,437,263,242,942
38688,2020-04-05,(02202) Calle 127,334,239,175,748
38689,2020-01-20,(07103) AV. CHILE,3464,2086,1854,7404
38690,2020-04-17,(04108) El Polo,240,164,136,540
38691,2020-04-24,(04108) El Polo,233,166,156,555
38692,2020-02-23,(02001) Centro Comercial Santa Fe,557,342,827,1726
38693,2020-06-22,(02001) Centro Comercial Santa Fe,152,100,138,390
38694,2020-01-19,(06100) Av. Rojas,178,143,290,611
38695,2020-07-28,(06000) Portal Eldorado,831,532,448,1811
38696,2020-09-15,(03013) RIO NEGRO,302,178,214,694
38697,2020-05-22,(09104) Restrepo,1201,757,856,2814
38698,2020-04-16,(02302) Virrey,304,263,228,795
38699,2020-04-22,(03009) Av. Suba- Calle 116,344,230,175,749
38700,2020-02-08,(07003) SEVILLANA,1214,613,897,2724
38701,2020-01-12,(04100) Carrera 77,1286,563,1358,3207
38702,2020-07-11,(02105) Calle 142,611,380,411,1402
38703,2020-07-26,(02105) Calle 142,161,106,139,406
38704,2020-09-06,(02105) Calle 142,212,150,245,607
38705,2020-07-14,(09109) Tercer Milenio,188,124,148,460
38706,2020-09-12,(09116) Avenida 39,219,152,244,615
38707,2020-09-24,(10005) Bicentenario,118,70,91,279
38708,2020-06-19,(40002) Manitas,413,277,305,995
38709,2020-02-22,(06101) El Tiempo,1020,683,972,2675
38710,2020-01-23,(07006) General Santander - alimentacion,1434,823,919,3176
38711,2020-06-18,(02001) Centro Comercial Santa Fe,519,330,346,1195
38712,2020-03-09,(07001) PERDOMO,147,1452,949,2548
38713,2020-02-17,(06105) Quinta Paredes,1068,646,524,2238
38714,2020-08-30,(07112) COMUNEROS,253,144,184,581
38715,2020-06-29,(09004) Santa Lucía,998,467,567,2032
38716,2020-05-23,(04000) Cabecera Calle 80,625,359,431,1415
38717,2020-05-30,(05105) Pradera,405,288,194,887
38718,2020-06-18,(06100) Av. Rojas,241,130,152,523
38719,2020-07-16,(07111) NQS - RICAURTE,806,536,383,1725
38720,2020-08-28,(09115) Calle 34,622,382,450,1454
38721,2020-01-03,(05102) Av. Américas - Av. Boyacá,611,370,472,1453
38722,2020-09-25,(03013) RIO NEGRO,333,198,248,779
38723,2020-05-06,(07110) PALOQUEMAO,564,311,210,1085
38724,2020-08-18,(07110) PALOQUEMAO,632,385,259,1276
38725,2020-07-27,(07006) General Santander,477,301,271,1049
38726,2020-07-05,(09122) Calle 72,348,224,375,947
38727,2020-01-26,(06001) Modelia,242,165,338,745
38728,2020-07-25,(06104) Gobernación,104,62,68,234
38729,2020-05-12,(09120) Calle 63,833,595,500,1928
38730,2020-04-03,(10001) Country Sur,517,238,399,1154
38731,2020-04-26,(07105) MOVISTAR ARENA,31,26,32,89
38732,2020-01-08,(07506) DESPENSA,1261,709,754,2724
38733,2020-09-30,(07000) Portal Sur,2313,1367,1604,5284
38734,2020-07-25,(07107) U. NACIONAL,226,140,110,476
38735,2020-06-18,(09114) Calle 26,312,201,179,692
38736,2020-04-22,(02303) Calle 85,372,258,199,829
38737,2020-05-21,(02303) Calle 85,513,369,273,1155
38738,2020-09-01,(10007) Las Nieves,674,403,363,1440
38739,2020-09-10,(10007) Las Nieves,641,355,392,1388
38740,2020-04-06,(07113) SANTA ISABEL,204,127,128,459
38741,2020-06-27,(07004) VENECIA,816,412,553,1781
38742,2020-09-13,(02204) Pepe Sierra,197,182,225,604
38743,2020-06-18,(06107) Ciudad Universitaria,175,115,112,402
38744,2020-07-09,(07110) PALOQUEMAO,662,391,272,1325
38745,2020-07-25,(05102) Av. Américas - Av. Boyacá,122,80,93,295
38746,2020-08-12,(03009) Av. Suba- Calle 116,416,276,198,890
38747,2020-05-22,(09110) Avenida Jimenez,882,669,562,2113
38748,2020-07-18,(09110) Avenida Jimenez,371,353,478,1202
38749,2020-06-29,(40002) Manitas,167,93,97,357
38750,2020-09-11,(40002) Manitas,417,266,306,989
38751,2020-03-09,(10005) Bicentenario - alimentacion,74,106,123,303
38752,2020-08-09,(02304) Heroes,178,151,139,468
38753,2020-03-29,(12000) Puente Aranda,12,13,9,34
38754,2020-07-13,(09004) Santa Lucía,1534,868,805,3207
38755,2020-06-08,(07506) DESPENSA,495,284,229,1008
38756,2020-09-11,(07506) DESPENSA,305,249,320,874
38757,2020-01-06,(04102) Avenida Boyaca,505,265,388,1158
38758,2020-05-03,(12004) Carrera 22,21,19,26,66
38759,2020-05-26,(10004) Policarpa,193,112,153,458
38760,2020-04-20,(02103) Mazurén,112,70,79,261
38761,2020-04-18,(09109) Tercer Milenio,92,70,73,235
38762,2020-09-23,(06002) Normandía,378,233,244,855
38763,2020-09-13,(09120) Calle 63,398,264,447,1109
38764,2020-09-09,(09114) Calle 26,340,224,277,841
38765,2020-06-21,(07004) VENECIA,291,150,202,643
38766,2020-08-27,(07005) ALQUERIA,529,310,339,1178
38767,2020-01-25,(07008) NQS - Calle 30 Sur,1081,486,750,2317
38768,2020-07-17,(12003) Ricaurte,246,193,163,602
38769,2020-09-01,(04102) Avenida Boyaca,326,194,241,761
38770,2020-09-19,(04102) Avenida Boyaca,383,206,324,913
38771,2020-09-06,(09100) Calle 40 Sur,640,307,615,1562
38772,2020-04-11,(09107) Hortúa,243,160,126,529
38773,2020-10-06,(04000) Cabecera Calle 80 - intermunicipal,453,230,487,1170
38774,2020-02-18,(09108) Hospital,294,161,234,689
38775,2020-09-26,(07006) General Santander - alimentacion,291,165,288,744
38776,2020-04-08,(03003) 21 ANGELES,140,58,94,292
38777,2020-05-26,(03012) SUBA - CALLE 95,290,193,187,670
38778,2020-01-24,(09105) Río Fucha,693,411,493,1597
38779,2020-05-09,(02502) Terminal,134,113,121,368
38780,2020-10-03,(03004) GRATAMIRA,0,16,60,76
38781,2020-06-29,(09000) Cabecera Usme,567,284,437,1288
38782,2020-04-19,(05001) Patio Bonito,327,187,185,699
38783,2020-10-11,(05105) Pradera,183,151,197,531
38784,2020-07-09,(07108) Av. El Dorado,174,109,103,386
38785,2020-09-08,(07003) SEVILLANA,475,256,285,1016
38786,2020-10-11,(07003) SEVILLANA,140,60,160,360
38787,2020-02-16,(04000) Cabecera Calle 80 - intermunicipal,283,194,470,947
38788,2020-01-19,(04106) Carrera 47,365,167,317,849
38789,2020-09-10,(09106) Nariño,436,229,352,1017
38790,2020-05-17,(04101) Minuto de Dios,64,37,58,159
38791,2020-01-01,(05107) Américas - Cr.53,177,129,275,581
38792,2020-04-12,(02303) Calle 85,132,105,65,302
38793,2020-07-18,(10007) Las Nieves,236,156,228,620
38794,2020-08-02,(10007) Las Nieves,105,79,97,281
38795,2020-03-28,(07506) DESPENSA,169,80,102,351
38796,2020-04-22,(06103) CAN,294,208,126,628
38797,2020-04-28,(10003) Ciudad Jardín,118,68,67,253
38798,2020-08-29,(10003) Ciudad Jardín,177,69,137,383
38799,2020-03-22,(09117) Calle 45,217,153,82,452
38800,2020-06-13,(03005) SUBA - AV. BOYACA,357,193,224,774
38801,2020-04-13,(02000) Cabecera Autopista Norte - intermunicipal,163,117,105,385
38802,2020-04-20,(07506) DESPENSA,241,133,143,517
38803,2020-05-01,(04105) Carrera 53,94,50,47,191
38804,2020-04-17,(07007) NQS - Calle 38A Sur,175,103,107,385
38805,2020-06-15,(06001) Modelia,111,75,77,263
38806,2020-04-06,(03013) RIO NEGRO,140,96,98,334
38807,2020-07-02,(10003) Ciudad Jardín,236,112,144,492
38808,2020-06-14,(09101) Quiroga,174,72,126,372
38809,2020-05-07,(04000) Cabecera Calle 80 - intermunicipal,172,88,151,411
38810,2020-05-10,(12004) Carrera 22,27,18,29,74
38811,2020-10-10,(07101) CASTELLANA,134,87,167,388
38812,2020-10-04,(03012) SUBA - CALLE 95,90,60,135,285
38813,2020-07-03,(04105) Carrera 53,307,164,171,642
38814,2020-07-02,(09105) Río Fucha,138,64,98,300
38815,2020-03-31,(05103) Marsella,165,87,89,341
38816,2020-08-23,(04102) Avenida Boyaca,141,82,87,310
38817,2020-08-04,(07106) EL CAMPIN,357,218,195,770
38818,2020-06-24,(07101) CASTELLANA,221,130,133,484
38819,2020-07-16,(05102) Av. Américas - Av. Boyacá,182,109,120,411
38820,2020-07-28,(04101) Minuto de Dios,308,166,211,685
38821,2020-05-10,(03002) SUBA - TV- 91,164,95,99,358
38822,2020-04-07,(04102) Avenida Boyaca,125,89,96,310
38823,2020-07-23,(06108) Concejo de Bogotá,126,48,59,233
38824,2020-03-21,(12003) Ricaurte,39,35,27,101
38825,2020-09-02,(03007) HUMEDAL CORDOBA,169,113,90,372
38826,2020-08-06,(06107) Ciudad Universitaria,149,93,111,353
38827,2020-08-15,(12000) Puente Aranda,61,42,39,142
38828,2020-04-18,(06105) Quinta Paredes,55,40,14,109
38829,2020-06-07,(04104) Avenida 68,169,92,113,374
38830,2020-08-23,(02502) Terminal,60,52,126,238
38831,2020-10-12,(05101) Mandalay - Cr.73,41,16,36,93
38832,2020-05-16,(10005) Bicentenario,64,42,59,165
38833,2020-05-11,(03014) SAN MARTIN,21,13,23,57
38834,2020-03-30,(03007) HUMEDAL CORDOBA,58,41,36,135
38835,2020-01-08,(04000) Cabecera Calle 80 - alimentacion,15713,8876,11091,35680
38836,2020-01-17,(04000) Cabecera Calle 80 - alimentacion,20219,10838,13394,44451
38837,2020-02-04,(04000) Cabecera Calle 80 - alimentacion,24527,14830,14841,54198
38838,2020-08-27,(02502) Terminal,384,281,302,967
38839,2020-05-26,(07504) TERREROS,4833,2869,2454,10156
38840,2020-09-28,(07504) TERREROS,6892,3629,3787,14308
38841,2020-02-06,(04106) Carrera 47,1535,893,968,3396
38842,2020-03-18,(05000) Portal Américas - alimentacion,23502,12655,12290,48447
38843,2020-05-19,(05000) Portal Américas - alimentacion,9070,4737,4156,17963
38844,2020-03-25,(07503) SAN MATEO,6345,3441,2991,12777
38845,2020-01-13,(02200) Alcalá,10985,6939,5541,23465
38846,2020-02-25,(50003) Corral Molinos,2825,2422,3909,9156
38847,2020-02-11,(06107) Ciudad Universitaria,1765,1073,935,3773
38848,2020-09-30,(06107) Ciudad Universitaria,199,129,164,492
38849,2020-01-08,(08000) Portal Tunal - alimentacion,17846,9305,9542,36693
38850,2020-05-04,(08000) Portal Tunal - alimentacion,4086,2139,2102,8327
38851,2020-03-02,(10000) Portal 20 de Julio - alimentacion,9855,5655,8168,23678
38852,2020-02-08,(06000) Portal Eldorado - alimentacion,10918,5038,7268,23224
38853,2020-09-02,(09100) Calle 40 Sur,1902,1115,1271,4288
38854,2020-06-27,(09115) Calle 34,455,301,380,1136
38855,2020-09-11,(10005) Bicentenario - alimentacion,199,97,188,484
38856,2020-06-13,(07001) PERDOMO,661,322,466,1449
38857,2020-02-10,(09000) Cabecera Usme - alimentacion,26188,15130,16047,57365
38858,2020-09-26,(40003) Mirador del Paraiso,1612,831,1263,3706
38859,2020-05-13,(07505) LEON XIII,1888,1186,867,3941
38860,2020-09-05,(07505) LEON XIII,2430,1115,1306,4851
38861,2020-05-29,(02000) Cabecera Autopista Norte - alimentacion,4325,2451,2197,8973
38862,2020-06-11,(02000) Cabecera Autopista Norte - alimentacion,4615,2577,2393,9585
38863,2020-09-27,(07000) Portal Sur - alimentacion,3091,1217,2199,6507
38864,2020-05-11,(07102) NQS - CALLE 75,294,199,176,669
38865,2020-01-13,(03013) RIO NEGRO,1017,611,732,2360
38866,2020-05-21,(09118) Marly,1253,847,666,2766
38867,2020-02-21,(03001) LA CAMPIÑA,6476,3460,4143,14079
38868,2020-01-10,(07106) EL CAMPIN,1478,967,960,3405
38869,2020-09-08,(07000) Portal Sur - alimentacion,8377,4726,4779,17882
38870,2020-10-02,(05100) Banderas P. Central - alimentacion,3805,1915,2762,8482
38871,2020-05-06,(09103) Olaya,566,353,346,1265
38872,2020-07-11,(07111) NQS - RICAURTE,956,639,477,2072
38873,2020-01-22,(07002) MADELENA,4556,2641,2515,9712
38874,2020-03-13,(07002) MADELENA,165,996,748,1909
38875,2020-07-06,(04105) Carrera 53,299,156,155,610
38876,2020-10-08,(08000) Portal Tunal - alimentacion,6846,3683,5016,15545
38877,2020-02-12,(04000) Cabecera Calle 80,7793,4968,5207,17968
38878,2020-06-19,(04000) Cabecera Calle 80,1060,676,822,2558
38879,2020-01-05,(09123) Calle 76,410,348,627,1385
38880,2020-02-03,(09114) Calle 26,3141,2063,1686,6890
38881,2020-02-05,(10001) Country Sur,5356,2352,2825,10533
38882,2020-06-17,(04100) Carrera 77,1248,712,732,2692
38883,2020-08-17,(10006) San Victorino,65,68,104,237
38884,2020-01-04,(03000) Portal Suba,2081,1055,1796,4932
38885,2020-03-04,(06000) Portal Eldorado,6663,3895,2799,13357
38886,2020-01-18,(05002) Tintal,5906,2966,4087,12959
38887,2020-03-13,(05002) Tintal,190,2272,1829,4291
38888,2020-01-06,(07505) LEON XIII,1699,777,1145,3621
38889,2020-02-07,(09107) Hortúa,2485,1461,1565,5511
38890,2020-03-10,(10006) San Victorino,1491,155,320,1966
38891,2020-04-02,(06105) Quinta Paredes,57,43,42,142
38892,2020-02-03,(07106) EL CAMPIN,2096,1323,1160,4579
38893,2020-02-20,(02000) Cabecera Autopista Norte - intermunicipal,4726,3248,2690,10664
38894,2020-04-22,(03000) Portal Suba - alimentacion,3321,2014,1665,7000
38895,2020-03-16,(06100) Av. Rojas,1414,779,712,2905
38896,2020-03-04,(09119) Calle 57,3880,2360,2260,8500
38897,2020-01-15,(08002) Biblioteca,841,485,594,1920
38898,2020-02-11,(07000) Portal Sur,8156,5006,4230,17392
38899,2020-08-18,(10002) Av. Primero de Mayo,1975,1009,1253,4237
38900,2020-08-28,(08001) Parque el Tunal,465,255,321,1041
38901,2020-02-16,(07505) LEON XIII,2189,955,1451,4595
38902,2020-07-23,(10001) Country Sur,856,387,544,1787
38903,2020-06-16,(03003) 21 ANGELES,333,167,188,688
38904,2020-04-30,(10002) Av. Primero de Mayo,1367,728,825,2920
38905,2020-05-12,(02201) Prado,663,442,377,1482
38906,2020-04-13,(03000) Portal Suba - alimentacion,3225,1890,1736,6851
38907,2020-10-03,(06102) Salitre El Greco,198,139,206,543
38908,2020-06-12,(09107) Hortúa,630,354,367,1351
38909,2020-02-25,(05105) Pradera,2696,1632,1221,5549
38910,2020-09-05,(02300) Calle 100,729,581,728,2038
38911,2020-05-07,(03012) SUBA - CALLE 95,230,135,121,486
38912,2020-05-21,(03012) SUBA - CALLE 95,275,178,170,623
38913,2020-02-09,(50002) Corral Calle 40 Sur,23,13,37,73
38914,2020-01-29,(07006) General Santander,2814,1633,1511,5958
38915,2020-02-18,(05105) Pradera,2710,1681,1247,5638
38916,2020-10-10,(09104) Restrepo,1256,726,1392,3374
38917,2020-02-23,(03012) SUBA - CALLE 95,342,200,356,898
38918,2020-05-08,(05105) Pradera,447,310,167,924
38919,2020-03-17,(02303) Calle 85,2136,1492,1160,4788
38920,2020-09-01,(05107) Américas - Cr.53,407,256,290,953
38921,2020-02-18,(09106) Nariño,2203,1338,1418,4959
38922,2020-07-04,(09101) Quiroga,434,214,389,1037
38923,2020-01-27,(04108) El Polo,1852,1141,1139,4132
38924,2020-07-13,(04108) El Polo,443,271,203,917
38925,2020-09-17,(04108) El Polo,563,323,308,1194
38926,2020-09-18,(06000) Portal Eldorado,937,669,703,2309
38927,2020-06-13,(03007) HUMEDAL CORDOBA,129,81,64,274
38928,2020-08-11,(03007) HUMEDAL CORDOBA,118,73,47,238
38929,2020-08-27,(07000) Portal Sur,1920,1268,1244,4432
38930,2020-01-13,(04103) Las Ferias,1249,729,789,2767
38931,2020-01-24,(04103) Las Ferias,1499,819,827,3145
38932,2020-05-29,(10010) San Bernardo,555,305,370,1230
38933,2020-04-20,(07104) Simon Bolivar,227,157,125,509
38934,2020-05-23,(07104) Simon Bolivar,426,263,188,877
38935,2020-03-07,(06000) Portal Eldorado,2567,1866,2447,6880
38936,2020-02-20,(07109) CAD,2835,1716,1296,5847
38937,2020-03-06,(07109) CAD,2559,1680,1604,5843
38938,2020-07-03,(09106) Nariño,444,272,325,1041
38939,2020-07-07,(09109) Tercer Milenio,379,219,264,862
38940,2020-05-04,(05001) Patio Bonito,1157,618,679,2454
38941,2020-02-02,(05001) Patio Bonito,1706,788,1635,4129
38942,2020-02-13,(07109) CAD,2043,1732,1749,5524
38943,2020-02-13,(04001) Quirigua,2201,1325,1260,4786
38944,2020-02-29,(04104) Avenida 68,1753,1020,1519,4292
38945,2020-04-09,(05002) Tintal,377,243,218,838
38946,2020-09-13,(02205) Calle 106,59,53,94,206
38947,2020-02-16,(06000) Portal Eldorado,773,597,1061,2431
38948,2020-03-17,(07103) AV. CHILE,2295,1525,1245,5065
38949,2020-10-07,(07003) SEVILLANA,535,303,359,1197
38950,2020-05-08,(07009) SENA,414,236,238,888
38951,2020-08-29,(06100) Av. Rojas,140,94,139,373
38952,2020-03-30,(09122) Calle 72,547,415,327,1289
38953,2020-07-23,(12003) Ricaurte,220,149,105,474
38954,2020-06-01,(02302) Virrey,602,368,307,1277
38955,2020-04-21,(03009) Av. Suba- Calle 116,334,228,155,717
38956,2020-01-12,(07107) U. NACIONAL,222,196,364,782
38957,2020-01-08,(06103) CAN,1595,938,894,3427
38958,2020-06-21,(06001) Modelia,85,61,84,230
38959,2020-08-17,(07007) NQS - Calle 38A Sur,133,84,86,303
38960,2020-03-30,(05107) Américas - Cr.53,286,241,180,707
38961,2020-09-07,(12007) Zona Industrial,368,213,192,773
38962,2020-09-18,(10005) Bicentenario,129,81,93,303
38963,2020-02-23,(05002) Tintal,1892,961,1776,4629
38964,2020-08-18,(09106) Nariño,336,197,283,816
38965,2020-04-03,(02104) Calle 146,387,291,261,939
38966,2020-07-10,(08002) Biblioteca,355,207,211,773
38967,2020-03-21,(09101) Quiroga,115,70,73,258
38968,2020-07-02,(07000) Portal Sur,1918,1210,1179,4307
38969,2020-05-13,(09120) Calle 63,835,578,481,1894
38970,2020-04-29,(09113) Calle 22,281,160,255,696
38971,2020-03-01,(09115) Calle 34,520,387,803,1710
38972,2020-08-14,(02202) Calle 127,918,736,639,2293
38973,2020-03-26,(10000) Portal 20 de Julio,1121,539,481,2141
38974,2020-03-31,(06101) El Tiempo,219,154,123,496
38975,2020-08-05,(07201) Guatoque -Veraguas,177,98,119,394
38976,2020-08-09,(04000) Cabecera Calle 80 - alimentacion,890,494,740,2124
38977,2020-07-10,(07107) U. NACIONAL,356,209,185,750
38978,2020-07-29,(07107) U. NACIONAL,327,170,177,674
38979,2020-08-28,(40001) Juan Pablo II,574,352,354,1280
38980,2020-09-06,(09119) Calle 57,220,149,237,606
38981,2020-07-05,(06107) Ciudad Universitaria,46,35,53,134
38982,2020-07-22,(06107) Ciudad Universitaria,153,86,126,365
38983,2020-05-15,(04103) Las Ferias,275,155,146,576
38984,2020-08-09,(03005) SUBA - AV. BOYACA,91,59,103,253
38985,2020-03-30,(03002) SUBA - TV- 91,415,245,247,907
38986,2020-08-19,(03005) SUBA - AV. BOYACA,412,254,227,893
38987,2020-06-09,(09122) Calle 72,1134,767,654,2555
38988,2020-05-27,(08002) Biblioteca,281,153,142,576
38989,2020-02-23,(07006) General Santander - alimentacion,269,182,304,755
38990,2020-09-21,(02102) Calle 161,232,135,152,519
38991,2020-06-11,(12004) Carrera 22,209,120,121,450
38992,2020-09-21,(12004) Carrera 22,119,126,147,392
38993,2020-07-23,(09111) Calle 19,427,270,346,1043
38994,2020-09-23,(06001) Modelia,430,290,289,1009
38995,2020-05-15,(07102) NQS - CALLE 75,316,215,166,697
38996,2020-01-28,(07006) General Santander - alimentacion,1460,850,984,3294
38997,2020-02-03,(07200) Tygua-San José,833,483,579,1895
38998,2020-08-15,(40001) Juan Pablo II,462,228,311,1001
38999,2020-04-20,(07005) ALQUERIA,287,167,153,607
39000,2020-01-15,(07200) Tygua-San José,677,390,580,1647
39001,2020-07-13,(09108) Hospital,51,37,38,126
39002,2020-09-27,(09108) Hospital,36,17,53,106
39003,2020-07-11,(04101) Minuto de Dios,274,160,243,677
39004,2020-04-11,(07006) General Santander - alimentacion,100,69,79,248
39005,2020-04-21,(05105) Pradera,417,279,148,844
39006,2020-06-21,(05105) Pradera,170,137,115,422
39007,2020-08-18,(07107) U. NACIONAL,304,170,159,633
39008,2020-09-20,(07111) NQS - RICAURTE,204,196,272,672
39009,2020-05-21,(07006) General Santander,383,233,186,802
39010,2020-05-23,(03009) Av. Suba- Calle 116,284,180,150,614
39011,2020-04-27,(07004) VENECIA,353,88,75,516
39012,2020-07-25,(05107) Américas - Cr.53,239,147,162,548
39013,2020-06-27,(05102) Av. Américas - Av. Boyacá,183,98,113,394
39014,2020-05-02,(07006) General Santander - alimentacion,149,101,98,348
39015,2020-07-27,(07008) NQS - Calle 30 Sur,198,132,129,459
39016,2020-03-31,(07107) U. NACIONAL,172,144,117,433
39017,2020-10-11,(06105) Quinta Paredes,40,29,53,122
39018,2020-03-28,(02303) Calle 85,240,181,156,577
39019,2020-08-09,(02303) Calle 85,162,116,120,398
39020,2020-04-14,(04001) Quirigua,194,124,114,432
39021,2020-06-01,(12007) Zona Industrial,320,236,142,698
39022,2020-09-30,(07105) MOVISTAR ARENA,276,165,180,621
39023,2020-05-02,(06111) Universidades,0,70,176,246
39024,2020-10-11,(03001) LA CAMPIÑA,351,176,397,924
39025,2020-09-10,(06103) CAN,338,201,227,766
39026,2020-10-11,(02204) Pepe Sierra,209,169,249,627
39027,2020-04-14,(09106) Nariño,196,121,141,458
39028,2020-03-30,(05100) Banderas P. Central,337,206,222,765
39029,2020-03-20,(07010) Bosa,283,167,196,646
39030,2020-06-14,(07106) EL CAMPIN,109,75,86,270
39031,2020-05-20,(10003) Ciudad Jardín,170,95,123,388
39032,2020-02-02,(07201) Guatoque -Veraguas,105,98,269,472
39033,2020-06-07,(02000) Cabecera Autopista Norte - intermunicipal,73,75,92,240
39034,2020-08-02,(02303) Calle 85,175,127,130,432
39035,2020-04-01,(07008) NQS - Calle 30 Sur,135,76,81,292
39036,2020-05-06,(06100) Av. Rojas,145,84,79,308
39037,2020-07-26,(08001) Parque el Tunal,100,57,87,244
39038,2020-01-06,(05107) Américas - Cr.53,430,250,366,1046
39039,2020-09-28,(06106) Recinto Ferial,296,191,190,677
39040,2020-04-05,(07006) General Santander - alimentacion,61,41,46,148
39041,2020-03-30,(06107) Ciudad Universitaria,92,69,65,226
39042,2020-08-22,(06106) Recinto Ferial,184,113,103,400
39043,2020-06-15,(07006) General Santander - alimentacion,89,64,115,268
39044,2020-08-30,(12003) Ricaurte,59,54,61,174
39045,2020-06-23,(05102) Av. Américas - Av. Boyacá,258,163,138,559
39046,2020-03-29,(12002) CDS - Carrera 32,20,27,18,65
39047,2020-04-28,(07101) CASTELLANA,95,72,66,233
39048,2020-03-22,(02102) Calle 161,30,18,31,79
39049,2020-07-20,(04107) Escuela Militar,37,29,29,95
39050,2020-03-23,(07003) SEVILLANA,79,51,41,171
39051,2020-03-30,(07113) SANTA ISABEL,164,117,118,399
39052,2020-09-06,(09109) Tercer Milenio,114,74,121,309
39053,2020-04-27,(07106) EL CAMPIN,49,79,48,176
39054,2020-07-05,(04000) Cabecera Calle 80 - intermunicipal,52,33,57,142
39055,2020-04-05,(03007) HUMEDAL CORDOBA,41,31,23,95
39056,2020-05-03,(03014) SAN MARTIN,5,8,11,24
39057,2020-04-27,(05101) Mandalay - Cr.73,44,7,4,55
39058,2020-01-03,(50006) Corral Carrera 77,16,8,28,52
39059,2020-03-22,(06105) Quinta Paredes,26,23,19,68
39060,2020-05-10,(06104) Gobernación,42,31,20,93
39061,2020-09-06,(12003) Ricaurte,52,49,72,173
39062,2020-07-22,(03014) SAN MARTIN,0,21,36,57
39063,2020-05-24,(50006) Corral Carrera 77,1,0,1,2
39064,2020-04-09,(04107) Escuela Militar,25,14,17,56
39065,2020-07-01,(03014) SAN MARTIN,31,9,27,67
39066,2020-05-10,(14004) Museo del Oro,0,16,31,47
39067,2020-09-11,(07005) ALQUERIA,534,293,366,1193
39068,2020-09-19,(09002) Consuelo,468,201,366,1035
39069,2020-10-09,(09002) Consuelo,525,284,392,1201
39070,2020-02-15,(07504) TERREROS,12229,6040,7636,25905
39071,2020-08-08,(07504) TERREROS,3883,1958,2151,7992
39072,2020-09-23,(05000) Portal Américas - alimentacion,12769,6796,7494,27059
39073,2020-01-06,(09119) Calle 57,329,289,569,1187
39074,2020-03-06,(05000) Portal Américas - alimentacion,35355,20809,22400,78564
39075,2020-02-28,(02200) Alcalá,14845,8493,6849,30187
39076,2020-01-22,(14005) Las Aguas,2477,1518,1595,5590
39077,2020-06-16,(05000) Portal Américas,2473,1814,1992,6279
39078,2020-03-03,(09003) Socorro,1640,993,1013,3646
39079,2020-02-18,(09121) Las Flores,3571,2198,2099,7868
39080,2020-03-01,(04000) Cabecera Calle 80 - alimentacion,4730,2070,5098,11898
39081,2020-09-09,(09001) Molinos,2804,1411,1977,6192
39082,2020-07-28,(05001) Patio Bonito,1509,868,906,3283
39083,2020-01-29,(09118) Marly,6380,4236,3681,14297
39084,2020-03-06,(07010) Bosa,2193,1186,1481,4860
39085,2020-03-11,(07000) Portal Sur - alimentacion,27130,15401,13933,56464
39086,2020-01-22,(14004) Museo del Oro,3171,1995,1792,6958
39087,2020-02-08,(05005) Transversal 86,1381,584,997,2962
39088,2020-10-05,(09104) Restrepo,1639,1022,1679,4340
39089,2020-08-20,(09000) Cabecera Usme,1622,1013,1203,3838
39090,2020-02-15,(06000) Portal Eldorado - alimentacion,10970,5183,7219,23372
39091,2020-01-02,(09113) Calle 22,725,446,646,1817
39092,2020-03-05,(04000) Cabecera Calle 80,7490,4446,4948,16884
39093,2020-01-08,(06102) Salitre El Greco,1081,621,584,2286
39094,2020-01-03,(02000) Cabecera Autopista Norte,4111,2400,3019,9530
39095,2020-06-10,(02000) Cabecera Autopista Norte,1236,811,677,2724
39096,2020-02-25,(09104) Restrepo,5420,3312,3892,12624
39097,2020-09-19,(07505) LEON XIII,2524,1189,1456,5169
39098,2020-02-15,(02204) Pepe Sierra,2148,1460,1692,5300
39099,2020-03-07,(02204) Pepe Sierra,2126,1443,1783,5352
39100,2020-02-13,(09115) Calle 34,4549,2941,2611,10101
39101,2020-01-30,(04104) Avenida 68,3627,1890,1758,7275
39102,2020-03-11,(04104) Avenida 68,3467,1861,1723,7051
39103,2020-02-22,(07110) PALOQUEMAO,1348,921,943,3212
39104,2020-09-06,(02000) Cabecera Autopista Norte - alimentacion,2082,893,1700,4675
39105,2020-02-20,(03009) Av. Suba- Calle 116,2548,1674,1287,5509
39106,2020-09-12,(04100) Carrera 77,1004,524,778,2306
39107,2020-05-22,(03013) RIO NEGRO,255,154,150,559
39108,2020-01-04,(09103) Olaya,1430,717,1057,3204
39109,2020-01-12,(09103) Olaya,848,380,826,2054
39110,2020-08-31,(06000) Portal Eldorado - alimentacion,3782,1916,2152,7850
39111,2020-09-13,(07000) Portal Sur - alimentacion,3001,1222,1993,6216
39112,2020-01-30,(09103) Olaya,4101,2372,2307,8780
39113,2020-08-24,(09103) Olaya,900,476,493,1869
39114,2020-08-08,(07111) NQS - RICAURTE,745,491,353,1589
39115,2020-08-25,(09113) Calle 22,381,231,282,894
39116,2020-01-31,(04105) Carrera 53,1406,789,775,2970
39117,2020-01-15,(07007) NQS - Calle 38A Sur,1749,1057,1107,3913
39118,2020-09-01,(08000) Portal Tunal - alimentacion,6262,3449,3867,13578
39119,2020-07-14,(05000) Portal Américas,2417,1613,1532,5562
39120,2020-02-02,(02000) Cabecera Autopista Norte - alimentacion,6579,2636,5214,14429
39121,2020-06-13,(07112) COMUNEROS,634,366,369,1369
39122,2020-02-13,(05107) Américas - Cr.53,2712,1532,1386,5630
39123,2020-07-07,(07112) COMUNEROS,866,516,474,1856
39124,2020-01-18,(09114) Calle 26,627,551,939,2117
39125,2020-10-08,(10001) Country Sur,1460,646,1048,3154
39126,2020-02-29,(03000) Portal Suba,4657,2139,3679,10475
39127,2020-05-12,(06000) Portal Eldorado,979,611,433,2023
39128,2020-06-12,(12001) Carrera 43,408,262,204,874
39129,2020-02-16,(04104) Avenida 68,661,338,642,1641
39130,2020-03-12,(07113) SANTA ISABEL,239,414,377,1030
39131,2020-02-06,(06105) Quinta Paredes,1060,667,501,2228
39132,2020-07-16,(03000) Portal Suba,1124,711,700,2535
39133,2020-09-05,(02000) Cabecera Autopista Norte - alimentacion,4345,1988,2925,9258
39134,2020-03-03,(06100) Av. Rojas,2851,1538,1263,5652
39135,2020-07-18,(10000) Portal 20 de Julio,1254,646,829,2729
39136,2020-09-09,(10000) Portal 20 de Julio,2334,1205,1382,4921
39137,2020-04-20,(09116) Avenida 39,191,133,127,451
39138,2020-04-19,(08002) Biblioteca,61,35,32,128
39139,2020-07-07,(02201) Prado,964,633,593,2190
39140,2020-05-28,(04002) Carrera 90,642,350,325,1317
39141,2020-03-02,(09105) Río Fucha,768,456,471,1695
39142,2020-03-14,(09107) Hortúa,1087,717,1025,2829
39143,2020-10-11,(07504) TERREROS,2089,786,1598,4473
39144,2020-01-07,(07007) NQS - Calle 38A Sur,1404,850,964,3218
39145,2020-10-10,(07010) Bosa,0,270,843,1113
39146,2020-01-18,(07001) PERDOMO,2421,1088,1894,5403
39147,2020-07-07,(03003) 21 ANGELES,367,196,237,800
39148,2020-10-01,(02201) Prado,1023,630,756,2409
39149,2020-09-07,(02201) Prado,919,634,597,2150
39150,2020-01-24,(10009) Museo Nacional,3584,2057,1863,7504
39151,2020-04-13,(09107) Hortúa,438,286,213,937
39152,2020-07-15,(09107) Hortúa,499,291,281,1071
39153,2020-05-03,(09123) Calle 76,167,129,104,400
39154,2020-05-02,(40003) Mirador del Paraiso,803,451,505,1759
39155,2020-06-14,(02300) Calle 100,294,222,197,713
39156,2020-05-28,(03012) SUBA - CALLE 95,295,185,168,648
39157,2020-01-12,(06000) Portal Eldorado,652,532,914,2098
39158,2020-02-21,(07104) Simon Bolivar,2347,1438,1276,5061
39159,2020-07-26,(09104) Restrepo,365,195,318,878
39160,2020-03-09,(02302) Virrey,2266,153,509,2928
39161,2020-09-24,(05005) Transversal 86,469,261,358,1088
39162,2020-08-27,(05001) Patio Bonito,1925,1039,1066,4030
39163,2020-10-04,(05001) Patio Bonito,769,344,622,1735
39164,2020-08-08,(02202) Calle 127,747,528,403,1678
39165,2020-03-26,(07009) SENA,276,166,154,596
39166,2020-05-19,(05000) Portal Américas,1941,1351,1562,4854
39167,2020-01-03,(09121) Las Flores,1623,1008,1127,3758
39168,2020-01-28,(03006) NIZA - CALLE 127,2383,1475,1475,5333
39169,2020-10-08,(09101) Quiroga,592,315,509,1416
39170,2020-01-31,(12007) Zona Industrial,1200,745,668,2613
39171,2020-03-12,(12007) Zona Industrial,525,56,129,710
39172,2020-01-19,(06102) Salitre El Greco,300,175,272,747
39173,2020-02-09,(06111) Universidades,534,315,830,1679
39174,2020-07-08,(04104) Avenida 68,661,336,347,1344
39175,2020-03-08,(09116) Avenida 39,212,193,439,844
39176,2020-03-10,(03011) SUBA - CALLE 100,1476,287,471,2234
39177,2020-02-25,(03010) PUENTE LARGO,2205,1427,1207,4839
39178,2020-02-01,(03006) NIZA - CALLE 127,1269,741,1086,3096
39179,2020-03-27,(07000) Portal Sur,811,487,555,1853
39180,2020-06-30,(02000) Cabecera Autopista Norte - alimentacion,5005,2802,2942,10749
39181,2020-04-15,(02304) Heroes,417,333,254,1004
39182,2020-06-18,(07110) PALOQUEMAO,700,418,268,1386
39183,2020-06-26,(07104) Simon Bolivar,625,395,297,1317
39184,2020-01-31,(04107) Escuela Militar,614,400,453,1467
39185,2020-05-16,(04108) El Polo,230,156,162,548
39186,2020-06-12,(10001) Country Sur,1173,527,705,2405
39187,2020-01-20,(09109) Tercer Milenio,1214,782,836,2832
39188,2020-03-01,(09100) Calle 40 Sur,1650,750,1581,3981
39189,2020-02-05,(03003) 21 ANGELES,1813,916,1002,3731
39190,2020-09-19,(03001) LA CAMPIÑA,1003,456,741,2200
39191,2020-09-13,(09101) Quiroga,201,93,201,495
39192,2020-04-18,(03011) SUBA - CALLE 100,215,122,111,448
39193,2020-04-13,(04001) Quirigua,180,115,98,393
39194,2020-10-12,(05002) Tintal,778,372,819,1969
39195,2020-05-30,(02000) Cabecera Autopista Norte,828,492,551,1871
39196,2020-04-23,(07109) CAD,447,303,187,937
39197,2020-04-01,(03001) LA CAMPIÑA,462,279,282,1023
39198,2020-05-08,(04108) El Polo,320,219,164,703
39199,2020-09-04,(06106) Recinto Ferial,272,155,139,566
39200,2020-03-28,(09120) Calle 63,381,295,246,922
39201,2020-07-16,(09120) Calle 63,822,551,517,1890
39202,2020-06-24,(09120) Calle 63,1189,819,732,2740
39203,2020-07-20,(12003) Ricaurte,46,42,42,130
39204,2020-08-09,(03010) PUENTE LARGO,67,43,57,167
39205,2020-02-03,(07001) PERDOMO,4557,2863,2669,10089
39206,2020-07-17,(07106) EL CAMPIN,385,236,170,791
39207,2020-03-28,(02105) Calle 142,306,217,161,684
39208,2020-07-17,(05002) Tintal,2256,1216,1290,4762
39209,2020-03-24,(05107) Américas - Cr.53,387,334,277,998
39210,2020-04-28,(05107) Américas - Cr.53,315,235,163,713
39211,2020-05-07,(05107) Américas - Cr.53,318,215,202,735
39212,2020-08-18,(05107) Américas - Cr.53,371,217,269,857
39213,2020-03-08,(10010) San Bernardo,370,237,588,1195
39214,2020-04-23,(10010) San Bernardo,434,255,248,937
39215,2020-10-11,(10010) San Bernardo,240,111,304,655
39216,2020-06-09,(02105) Calle 142,711,447,435,1593
39217,2020-06-26,(07103) AV. CHILE,1009,627,478,2114
39218,2020-10-02,(07103) AV. CHILE,990,615,730,2335
39219,2020-10-06,(12007) Zona Industrial,391,255,229,875
39220,2020-10-07,(10005) Bicentenario,132,83,120,335
39221,2020-01-23,(40002) Manitas,1244,676,751,2671
39222,2020-01-18,(08001) Parque el Tunal,1010,484,719,2213
39223,2020-06-26,(02001) Centro Comercial Santa Fe,540,336,366,1242
39224,2020-10-11,(07112) COMUNEROS,265,146,309,720
39225,2020-03-06,(40001) Juan Pablo II,1646,945,985,3576
39226,2020-03-02,(08002) Biblioteca,1037,600,642,2279
39227,2020-05-28,(03002) SUBA - TV- 91,671,386,368,1425
39228,2020-08-04,(03013) RIO NEGRO,219,136,156,511
39229,2020-09-16,(09120) Calle 63,1286,847,889,3022
39230,2020-08-26,(08000) Portal Tunal,783,292,299,1374
39231,2020-08-29,(08000) Portal Tunal,619,264,292,1175
39232,2020-03-11,(10004) Policarpa,921,426,585,1932
39233,2020-08-25,(09003) Socorro,554,295,325,1174
39234,2020-08-06,(05105) Pradera,444,305,259,1008
39235,2020-03-25,(07003) SEVILLANA,239,137,126,502
39236,2020-03-27,(06107) Ciudad Universitaria,89,64,78,231
39237,2020-06-02,(40001) Juan Pablo II,531,339,349,1219
39238,2020-03-09,(07111) NQS - RICAURTE,1498,211,483,2192
39239,2020-09-01,(09115) Calle 34,685,409,411,1505
39240,2020-05-26,(03002) SUBA - TV- 91,675,405,395,1475
39241,2020-02-06,(03004) GRATAMIRA,340,167,164,671
39242,2020-05-25,(07005) ALQUERIA,154,97,96,347
39243,2020-06-02,(07006) General Santander,471,292,281,1044
39244,2020-03-10,(03012) SUBA - CALLE 95,690,158,265,1113
39245,2020-07-09,(09122) Calle 72,1269,866,766,2901
39246,2020-03-28,(06104) Gobernación,72,59,50,181
39247,2020-05-11,(09120) Calle 63,788,549,491,1828
39248,2020-05-22,(10007) Las Nieves,502,309,273,1084
39249,2020-06-07,(09123) Calle 76,191,144,162,497
39250,2020-04-13,(10000) Portal 20 de Julio,1146,638,580,2364
39251,2020-01-22,(50002) Corral Calle 40 Sur,123,69,120,312
39252,2020-06-12,(09121) Las Flores,695,466,444,1605
39253,2020-06-13,(05105) Pradera,422,262,244,928
39254,2020-07-24,(07107) U. NACIONAL,312,169,163,644
39255,2020-07-20,(09123) Calle 76,181,147,172,500
39256,2020-08-27,(03003) 21 ANGELES,325,179,168,672
39257,2020-09-06,(03003) 21 ANGELES,98,55,100,253
39258,2020-10-01,(10007) Las Nieves,735,449,540,1724
39259,2020-05-18,(10006) San Victorino,403,239,247,889
39260,2020-09-13,(05002) Tintal,768,362,732,1862
39261,2020-07-24,(04104) Avenida 68,568,268,296,1132
39262,2020-09-29,(40002) Manitas,446,249,357,1052
39263,2020-10-06,(40002) Manitas,442,254,351,1047
39264,2020-03-15,(10007) Las Nieves,162,180,309,651
39265,2020-05-20,(10007) Las Nieves,481,287,284,1052
39266,2020-06-12,(07007) NQS - Calle 38A Sur,371,201,233,805
39267,2020-04-30,(12000) Puente Aranda,48,32,29,109
39268,2020-08-04,(12000) Puente Aranda,87,58,44,189
39269,2020-01-06,(07109) CAD,433,269,395,1097
39270,2020-04-04,(07109) CAD,251,175,125,551
39271,2020-05-09,(08001) Parque el Tunal,245,123,132,500
39272,2020-09-26,(09121) Las Flores,485,373,535,1393
39273,2020-04-26,(02102) Calle 161,39,28,26,93
39274,2020-06-13,(07111) NQS - RICAURTE,862,575,397,1834
39275,2020-06-09,(03013) RIO NEGRO,264,169,182,615
39276,2020-08-26,(04001) Quirigua,371,210,259,840
39277,2020-09-01,(09122) Calle 72,1212,836,801,2849
39278,2020-05-28,(04106) Carrera 47,292,168,162,622
39279,2020-06-20,(02302) Virrey,439,323,289,1051
39280,2020-06-29,(07103) AV. CHILE,248,177,196,621
39281,2020-08-28,(06106) Recinto Ferial,219,148,141,508
39282,2020-07-12,(03000) Portal Suba,376,207,376,959
39283,2020-04-26,(02001) Centro Comercial Santa Fe,59,52,60,171
39284,2020-03-02,(12002) CDS - Carrera 32,617,377,349,1343
39285,2020-06-16,(04000) Cabecera Calle 80 - intermunicipal,339,188,305,832
39286,2020-05-19,(07109) CAD,575,350,200,1125
39287,2020-04-02,(04003) Avenida Ciudad de Cali,497,306,355,1158
39288,2020-07-11,(03009) Av. Suba- Calle 116,345,238,211,794
39289,2020-06-30,(07010) Bosa,782,372,465,1619
39290,2020-05-06,(10008) San Diego,164,122,102,388
39291,2020-03-15,(07107) U. NACIONAL,213,186,318,717
39292,2020-04-12,(04103) Las Ferias,78,52,45,175
39293,2020-05-25,(04103) Las Ferias,104,66,67,237
39294,2020-06-09,(07101) CASTELLANA,186,125,101,412
39295,2020-06-23,(07006) General Santander - alimentacion,396,221,237,854
39296,2020-05-10,(09117) Calle 45,211,134,116,461
39297,2020-08-27,(07006) General Santander - alimentacion,380,188,238,806
39298,2020-08-08,(40002) Manitas,302,158,217,677
39299,2020-02-23,(05101) Mandalay - Cr.73,108,48,120,276
39300,2020-07-12,(07107) U. NACIONAL,103,56,66,225
39301,2020-05-09,(12007) Zona Industrial,179,121,77,377
39302,2020-05-20,(07107) U. NACIONAL,286,162,127,575
39303,2020-06-15,(09117) Calle 45,274,164,231,669
39304,2020-06-07,(06102) Salitre El Greco,61,40,41,142
39305,2020-04-05,(02303) Calle 85,141,87,74,302
39306,2020-07-15,(10004) Policarpa,186,90,111,387
39307,2020-06-15,(04003) Avenida Ciudad de Cali,314,170,268,752
39308,2020-08-02,(03001) LA CAMPIÑA,194,126,132,452
39309,2020-07-24,(06001) Modelia,286,190,163,639
39310,2020-06-09,(03005) SUBA - AV. BOYACA,414,250,268,932
39311,2020-08-02,(06001) Modelia,80,58,60,198
39312,2019-12-31,(02202) Calle 127,53,17,42,112
39313,2020-05-10,(04108) El Polo,62,41,59,162
39314,2020-03-21,(50003) Corral Molinos,416,199,298,913
39315,2020-07-26,(07106) EL CAMPIN,117,88,75,280
39316,2020-04-25,(07201) Guatoque -Veraguas,69,54,72,195
39317,2020-05-05,(06103) CAN,314,203,125,642
39318,2020-04-24,(09116) Avenida 39,181,134,130,445
39319,2020-07-12,(04000) Cabecera Calle 80 - intermunicipal,76,33,75,184
39320,2020-07-20,(40001) Juan Pablo II,119,83,97,299
39321,2020-05-05,(08002) Biblioteca,193,113,125,431
39322,2020-05-24,(05107) Américas - Cr.53,67,45,58,170
39323,2020-07-19,(12004) Carrera 22,21,15,34,70
39324,2020-07-09,(04105) Carrera 53,305,145,157,607
39325,2020-06-27,(06103) CAN,243,166,156,565
39326,2020-07-14,(07007) NQS - Calle 38A Sur,350,228,201,779
39327,2020-04-09,(08001) Parque el Tunal,79,45,53,177
39328,2020-04-06,(09105) Río Fucha,50,41,49,140
39329,2020-05-29,(05102) Av. Américas - Av. Boyacá,177,103,111,391
39330,2020-02-02,(50002) Corral Calle 40 Sur,23,11,33,67
39331,2020-09-03,(50002) Corral Calle 40 Sur,27,12,32,71
39332,2019-12-31,(02502) Terminal,12,14,32,58
39333,2020-04-11,(12002) CDS - Carrera 32,62,44,25,131
39334,2020-09-17,(12000) Puente Aranda,109,64,79,252
39335,2020-10-06,(12000) Puente Aranda,92,48,60,200
39336,2020-09-02,(03014) SAN MARTIN,0,12,35,47
39337,2020-05-03,(14004) Museo del Oro,0,19,25,44
39338,2020-09-29,(03014) SAN MARTIN,0,20,49,69
39339,2020-04-05,(07200) Tygua-San José,23,24,35,82
39340,2019-12-31,(06103) CAN,23,8,11,42
39341,2020-02-08,(04000) Cabecera Calle 80 - alimentacion,13452,6160,10721,30333
39342,2020-09-14,(09002) Consuelo,529,289,350,1168
39343,2020-07-31,(07504) TERREROS,5564,2983,2637,11184
39344,2020-02-26,(14005) Las Aguas,3109,2168,1995,7272
39345,2020-06-11,(05000) Portal Américas,2340,1614,1722,5676
39346,2020-01-08,(09114) Calle 26,2045,1365,1300,4710
39347,2020-02-14,(09003) Socorro,1707,996,1024,3727
39348,2020-03-15,(09003) Socorro,418,185,322,925
39349,2020-01-08,(08001) Parque el Tunal,1222,699,753,2674
39350,2020-02-22,(09000) Cabecera Usme - alimentacion,18241,9018,12186,39445
39351,2020-01-31,(04002) Carrera 90,3638,1979,2054,7671
39352,2020-01-19,(04100) Carrera 77,1402,593,1374,3369
39353,2020-09-07,(07503) SAN MATEO,12145,6723,6278,25146
39354,2020-08-08,(10000) Portal 20 de Julio - alimentacion,3067,1282,2001,6350
39355,2020-02-24,(04000) Cabecera Calle 80,7538,4712,4918,17168
39356,2020-06-01,(07001) PERDOMO,819,471,450,1740
39357,2020-02-03,(02000) Cabecera Autopista Norte,11283,7086,6207,24576
39358,2020-01-18,(06000) Portal Eldorado - alimentacion,9669,4406,6289,20364
39359,2020-06-20,(09104) Restrepo,1240,733,1003,2976
39360,2020-02-05,(07505) LEON XIII,8664,4956,3897,17517
39361,2020-06-23,(07505) LEON XIII,2847,1546,1228,5621
39362,2020-01-31,(10006) San Victorino,2172,1225,1299,4696
39363,2020-01-30,(06002) Normandía,2575,1507,1362,5444
39364,2020-01-18,(09110) Avenida Jimenez,2949,2103,2019,7071
39365,2020-02-13,(05002) Tintal,11343,6613,5855,23811
39366,2020-02-04,(09117) Calle 45,6567,4122,3048,13737
39367,2020-03-12,(05001) Patio Bonito,235,1648,1127,3010
39368,2020-01-28,(09123) Calle 76,5238,3535,2844,11617
39369,2020-01-10,(09101) Quiroga,1334,704,1048,3086
39370,2020-06-10,(09101) Quiroga,550,256,314,1120
39371,2020-02-14,(06106) Recinto Ferial,1584,886,908,3378
39372,2020-05-08,(07102) NQS - CALLE 75,257,203,140,600
39373,2020-03-03,(03013) RIO NEGRO,1279,787,891,2957
39374,2020-02-07,(02304) Heroes,4453,3258,2402,10113
39375,2020-02-20,(02103) Mazurén,3395,1996,1700,7091
39376,2020-04-25,(09104) Restrepo,612,399,506,1517
39377,2020-09-01,(09103) Olaya,994,539,611,2144
39378,2020-03-11,(07002) MADELENA,4808,2673,2513,9994
39379,2020-03-03,(07112) COMUNEROS,3845,2276,2416,8537
39380,2020-01-24,(10007) Las Nieves,1777,1147,1158,4082
39381,2020-01-18,(02000) Cabecera Autopista Norte - intermunicipal,1762,972,1655,4389
39382,2020-01-17,(04105) Carrera 53,1229,659,761,2649
39383,2020-08-06,(09110) Avenida Jimenez,1352,972,808,3132
39384,2020-03-11,(06106) Recinto Ferial,1423,838,795,3056
39385,2020-01-10,(09120) Calle 63,3207,2410,2708,8325
39386,2020-02-15,(09114) Calle 26,766,643,1134,2543
39387,2020-03-13,(09001) Molinos,314,1560,1551,3425
39388,2020-09-26,(10006) San Victorino,578,344,380,1302
39389,2020-06-10,(12001) Carrera 43,411,229,201,841
39390,2020-07-13,(12001) Carrera 43,387,242,181,810
39391,2020-09-22,(10002) Av. Primero de Mayo,2297,1237,1692,5226
39392,2020-01-05,(04104) Avenida 68,445,255,487,1187
39393,2020-02-09,(40003) Mirador del Paraiso,1867,867,1315,4049
39394,2020-01-18,(02201) Prado,2612,1383,2017,6012
39395,2020-03-08,(06105) Quinta Paredes,123,75,177,375
39396,2020-03-18,(03000) Portal Suba,4246,2522,2409,9177
39397,2020-03-25,(03000) Portal Suba,611,427,461,1499
39398,2020-04-16,(02000) Cabecera Autopista Norte - intermunicipal,143,104,111,358
39399,2020-07-29,(02000) Cabecera Autopista Norte - intermunicipal,514,343,345,1202
39400,2020-02-05,(09101) Quiroga,1690,1030,1269,3989
39401,2020-03-09,(09101) Quiroga,101,475,348,924
39402,2020-04-17,(03000) Portal Suba - alimentacion,3314,1967,1884,7165
39403,2020-03-04,(10010) San Bernardo,1748,1046,1341,4135
39404,2020-07-29,(03000) Portal Suba - alimentacion,5949,3415,3418,12782
39405,2020-02-21,(10010) San Bernardo,1806,1048,1299,4153
39406,2020-02-03,(03007) HUMEDAL CORDOBA,1012,660,529,2201
39407,2020-08-24,(10000) Portal 20 de Julio,1960,933,905,3798
39408,2020-08-03,(07112) COMUNEROS,709,376,398,1483
39409,2020-04-18,(07000) Portal Sur - alimentacion,3353,1752,1329,6434
39410,2020-03-18,(02303) Calle 85,1801,1325,979,4105
39411,2020-08-03,(02303) Calle 85,641,461,359,1461
39412,2020-05-19,(08002) Biblioteca,259,128,122,509
39413,2020-07-02,(09004) Santa Lucía,2791,1441,1555,5787
39414,2020-02-23,(04100) Carrera 77,1362,613,1380,3355
39415,2020-06-21,(07504) TERREROS,1610,828,927,3365
39416,2020-01-25,(09113) Calle 22,973,620,882,2475
39417,2020-06-10,(06108) Concejo de Bogotá,148,80,65,293
39418,2020-04-13,(04000) Cabecera Calle 80,533,373,363,1269
39419,2020-07-17,(04000) Cabecera Calle 80,955,592,774,2321
39420,2020-02-13,(03000) Portal Suba,9989,5644,5212,20845
39421,2020-02-27,(02304) Heroes,4720,3324,2270,10314
39422,2020-08-10,(03000) Portal Suba - alimentacion,4906,3018,3028,10952
39423,2020-04-08,(09107) Hortúa,387,269,230,886
39424,2020-08-24,(05002) Tintal,2154,1230,1199,4583
39425,2020-03-04,(10009) Museo Nacional,4486,2371,2000,8857
39426,2020-01-04,(10006) San Victorino,564,447,592,1603
39427,2020-09-05,(03012) SUBA - CALLE 95,240,155,212,607
39428,2020-05-22,(10000) Portal 20 de Julio,2006,977,930,3913
39429,2020-08-23,(50002) Corral Calle 40 Sur,4,1,5,10
39430,2020-05-10,(02000) Cabecera Autopista Norte - alimentacion,1328,685,616,2629
39431,2020-06-05,(02000) Cabecera Autopista Norte - alimentacion,4599,2514,2428,9541
39432,2020-06-03,(02202) Calle 127,1058,695,528,2281
39433,2020-08-23,(10008) San Diego,67,46,70,183
39434,2020-09-02,(10008) San Diego,325,165,202,692
39435,2020-06-23,(04104) Avenida 68,689,328,333,1350
39436,2020-08-18,(02205) Calle 106,293,260,261,814
39437,2020-06-23,(03000) Portal Suba - alimentacion,6393,3801,3636,13830
39438,2020-10-09,(04108) El Polo,542,330,401,1273
39439,2020-09-30,(05001) Patio Bonito,2294,1226,1388,4908
39440,2020-02-17,(07001) PERDOMO,4872,2930,2534,10336
39441,2020-02-26,(07001) PERDOMO,4679,2741,2607,10027
39442,2020-07-16,(02201) Prado,757,506,410,1673
39443,2020-09-05,(07010) Bosa,558,249,459,1266
39444,2020-08-08,(07113) SANTA ISABEL,245,128,220,593
39445,2020-01-22,(04102) Avenida Boyaca,2714,1639,1500,5853
39446,2020-05-15,(10006) San Victorino,372,231,252,855
39447,2020-09-22,(04104) Avenida 68,734,363,440,1537
39448,2020-09-24,(04104) Avenida 68,746,360,434,1540
39449,2020-02-05,(03005) SUBA - AV. BOYACA,2894,1690,1585,6169
39450,2020-06-18,(07000) Portal Sur,1916,1197,1079,4192
39451,2020-02-28,(06105) Quinta Paredes,1047,585,531,2163
39452,2020-09-09,(02204) Pepe Sierra,853,608,491,1952
39453,2020-06-14,(09100) Calle 40 Sur,514,277,369,1160
39454,2020-05-14,(07104) Simon Bolivar,458,269,222,949
39455,2020-06-12,(07104) Simon Bolivar,637,379,272,1288
39456,2020-06-08,(04107) Escuela Militar,145,84,83,312
39457,2020-10-03,(04107) Escuela Militar,109,75,116,300
39458,2020-06-29,(02000) Cabecera Autopista Norte - intermunicipal,127,99,138,364
39459,2020-09-28,(04003) Avenida Ciudad de Cali,1161,683,939,2783
39460,2020-01-09,(07101) CASTELLANA,683,427,480,1590
39461,2020-09-10,(09109) Tercer Milenio,334,222,209,765
39462,2020-01-04,(40003) Mirador del Paraiso,2719,1309,1711,5739
39463,2020-02-22,(02202) Calle 127,2861,1860,2070,6791
39464,2020-07-06,(02202) Calle 127,1187,825,663,2675
39465,2020-10-10,(06000) Portal Eldorado,571,491,750,1812
39466,2020-07-08,(06106) Recinto Ferial,243,146,119,508
39467,2020-08-31,(02302) Virrey,686,456,392,1534
39468,2020-06-09,(12003) Ricaurte,332,218,168,718
39469,2020-09-25,(03010) PUENTE LARGO,399,243,264,906
39470,2020-04-20,(02302) Virrey,362,279,210,851
39471,2020-02-23,(02104) Calle 146,1075,511,1141,2727
39472,2020-05-03,(02105) Calle 142,146,110,94,350
39473,2020-09-13,(02105) Calle 142,205,139,274,618
39474,2020-01-01,(03013) RIO NEGRO,96,49,164,309
39475,2020-01-12,(03006) NIZA - CALLE 127,470,287,457,1214
39476,2020-06-17,(07007) NQS - Calle 38A Sur,409,238,288,935
39477,2020-10-11,(10002) Av. Primero de Mayo,700,323,823,1846
39478,2020-04-15,(10010) San Bernardo,400,260,272,932
39479,2020-09-19,(10010) San Bernardo,465,226,445,1136
39480,2020-04-14,(09123) Calle 76,506,412,309,1227
39481,2020-06-19,(02103) Mazurén,223,127,178,528
39482,2020-10-07,(07103) AV. CHILE,1002,632,715,2349
39483,2020-07-27,(10005) Bicentenario,96,51,61,208
39484,2020-09-01,(10005) Bicentenario,89,65,72,226
39485,2020-03-17,(40002) Manitas,961,485,590,2036
39486,2020-08-22,(40002) Manitas,319,179,227,725
39487,2020-07-21,(02304) Heroes,668,463,371,1502
39488,2020-09-18,(04105) Carrera 53,333,185,207,725
39489,2020-05-23,(10008) San Diego,155,108,123,386
39490,2020-08-26,(09120) Calle 63,997,649,661,2307
39491,2020-08-16,(03011) SUBA - CALLE 100,127,73,89,289
39492,2020-10-06,(07113) SANTA ISABEL,432,247,438,1117
39493,2020-05-27,(40001) Juan Pablo II,490,301,274,1065
39494,2020-08-02,(09115) Calle 34,147,108,165,420
39495,2020-06-03,(07005) ALQUERIA,503,304,251,1058
39496,2020-04-23,(02204) Pepe Sierra,398,342,220,960
39497,2020-08-17,(40003) Mirador del Paraiso,601,353,474,1428
39498,2020-08-18,(03013) RIO NEGRO,271,170,179,620
39499,2020-02-08,(07105) MOVISTAR ARENA,717,470,581,1768
39500,2020-02-10,(12004) Carrera 22,699,444,496,1639
39501,2020-09-11,(09103) Olaya,1078,569,661,2308
39502,2020-03-11,(07006) General Santander,2695,1504,1512,5711
39503,2020-05-11,(06109) Centro Memoria,232,128,109,469
39504,2020-01-06,(05103) Marsella,290,149,281,720
39505,2020-08-16,(07111) NQS - RICAURTE,191,147,167,505
39506,2020-04-25,(09123) Calle 76,381,305,246,932
39507,2020-08-29,(06104) Gobernación,130,81,112,323
39508,2020-09-25,(06104) Gobernación,292,193,171,656
39509,2020-02-28,(07006) General Santander - alimentacion,1520,834,1023,3377
39510,2020-08-27,(07105) MOVISTAR ARENA,246,124,139,509
39511,2020-01-04,(07506) DESPENSA,634,314,473,1421
39512,2020-01-10,(07506) DESPENSA,1268,744,748,2760
39513,2020-08-30,(09123) Calle 76,241,197,277,715
39514,2020-01-21,(10007) Las Nieves,584,850,971,2405
39515,2020-07-20,(50003) Corral Molinos,461,239,352,1052
39516,2020-09-07,(05102) Av. Américas - Av. Boyacá,228,142,177,547
39517,2020-09-22,(05102) Av. Américas - Av. Boyacá,294,161,244,699
39518,2020-09-12,(40002) Manitas,0,164,469,633
39519,2020-03-17,(05005) Transversal 86,1566,829,732,3127
39520,2020-07-08,(08002) Biblioteca,297,180,215,692
39521,2020-07-27,(03010) PUENTE LARGO,310,194,171,675
39522,2020-06-23,(09122) Calle 72,1217,844,768,2829
39523,2020-05-17,(12000) Puente Aranda,6,10,11,27
39524,2020-01-07,(07109) CAD,1974,1168,1119,4261
39525,2020-07-06,(07109) CAD,654,398,320,1372
39526,2020-03-20,(04100) Carrera 77,546,329,285,1160
39527,2020-07-11,(08001) Parque el Tunal,412,217,253,882
39528,2020-05-22,(07506) DESPENSA,425,211,210,846
39529,2020-09-30,(12004) Carrera 22,315,201,181,697
39530,2020-05-15,(07005) ALQUERIA,415,264,191,870
39531,2020-07-25,(07005) ALQUERIA,344,194,202,740
39532,2020-03-20,(07006) General Santander,285,156,148,589
39533,2020-04-26,(04106) Carrera 47,82,44,38,164
39534,2020-05-24,(02201) Prado,224,142,121,487
39535,2020-08-23,(50003) Corral Molinos,459,233,417,1109
39536,2020-09-22,(40001) Juan Pablo II,626,367,445,1438
39537,2020-09-27,(09117) Calle 45,254,168,309,731
39538,2020-09-02,(05101) Mandalay - Cr.73,157,90,98,345
39539,2020-07-15,(07004) VENECIA,849,518,480,1847
39540,2020-03-31,(02103) Mazurén,78,49,65,192
39541,2020-07-02,(12002) CDS - Carrera 32,196,107,104,407
39542,2020-08-11,(07006) General Santander,492,303,297,1092
39543,2020-05-13,(09003) Socorro,485,254,253,992
39544,2020-06-16,(04102) Avenida Boyaca,360,222,206,788
39545,2020-01-15,(07006) General Santander - alimentacion,1256,745,885,2886
39546,2020-06-22,(07108) Av. El Dorado,44,29,43,116
39547,2020-03-13,(06002) Normandía,264,323,328,915
39548,2020-05-05,(04101) Minuto de Dios,215,142,165,522
39549,2020-10-06,(07001) PERDOMO,1144,670,926,2740
39550,2020-08-09,(04001) Quirigua,91,55,83,229
39551,2020-09-04,(04000) Cabecera Calle 80 - intermunicipal,390,193,395,978
39552,2020-06-30,(09108) Hospital,70,48,55,173
39553,2020-07-02,(09108) Hospital,92,55,69,216
39554,2020-07-16,(09108) Hospital,62,35,48,145
39555,2020-09-28,(07006) General Santander - alimentacion,390,233,317,940
39556,2020-06-17,(07006) General Santander - alimentacion,385,212,220,817
39557,2020-09-04,(09105) Río Fucha,0,84,169,253
39558,2020-08-16,(02502) Terminal,71,53,103,227
39559,2020-09-03,(06101) El Tiempo,378,213,203,794
39560,2020-06-02,(05107) Américas - Cr.53,429,232,218,879
39561,2020-05-10,(09100) Calle 40 Sur,366,195,260,821
39562,2020-04-16,(07107) U. NACIONAL,208,159,120,487
39563,2020-04-20,(06102) Salitre El Greco,129,86,56,271
39564,2020-07-19,(02303) Calle 85,140,97,86,323
39565,2020-05-31,(04000) Cabecera Calle 80,208,132,197,537
39566,2020-03-29,(05001) Patio Bonito,264,170,178,612
39567,2020-06-25,(06103) CAN,406,245,182,833
39568,2020-04-09,(03013) RIO NEGRO,52,24,35,111
39569,2020-03-23,(07004) VENECIA,215,128,109,452
39570,2020-09-14,(07201) Guatoque -Veraguas,199,108,149,456
39571,2020-03-26,(04106) Carrera 47,143,93,73,309
39572,2020-04-21,(04103) Las Ferias,191,121,92,404
39573,2020-05-03,(08002) Biblioteca,68,40,38,146
39574,2020-05-02,(06104) Gobernación,86,57,53,196
39575,2020-09-03,(03005) SUBA - AV. BOYACA,516,282,338,1136
39576,2020-01-12,(50006) Corral Carrera 77,9,6,13,28
39577,2020-05-25,(09115) Calle 34,156,126,108,390
39578,2020-06-29,(06103) CAN,184,115,82,381
39579,2020-05-25,(07006) General Santander,138,76,73,287
39580,2020-05-03,(06001) Modelia,62,45,60,167
39581,2020-05-17,(12007) Zona Industrial,29,34,34,97
39582,2020-04-09,(04105) Carrera 53,46,43,28,117
39583,2020-04-09,(07105) MOVISTAR ARENA,52,36,25,113
39584,2020-03-29,(07010) Bosa,101,61,75,237
39585,2020-06-29,(06002) Normandía,90,65,78,233
39586,2020-08-17,(07101) CASTELLANA,36,23,42,101
39587,2020-05-16,(03007) HUMEDAL CORDOBA,80,51,36,167
39588,2020-07-26,(06103) CAN,114,62,67,243
39589,2020-06-07,(05102) Av. Américas - Av. Boyacá,54,33,34,121
39590,2020-09-26,(09105) Río Fucha,0,64,152,216
39591,2020-04-10,(03005) SUBA - AV. BOYACA,71,40,40,151
39592,2020-08-07,(14005) Las Aguas,60,47,97,204
39593,2020-08-03,(03014) SAN MARTIN,0,10,22,32
39594,2019-12-31,(06001) Modelia,24,10,25,59
39595,2020-06-01,(04000) Cabecera Calle 80 - alimentacion,3595,2075,2170,7840
39596,2020-09-01,(09118) Marly,1469,917,804,3190
39597,2020-06-19,(07504) TERREROS,6135,3377,3063,12575
39598,2020-02-26,(05000) Portal Américas - alimentacion,37242,20989,21659,79890
39599,2020-02-04,(03002) SUBA - TV- 91,4648,2822,2445,9915
39600,2020-01-23,(02101) Toberín,14185,8672,7405,30262
39601,2020-06-17,(05000) Portal Américas,2579,1867,2042,6488
39602,2020-02-07,(09100) Calle 40 Sur,7679,4091,4284,16054
39603,2020-10-10,(05000) Portal Américas - alimentacion,9411,4515,7098,21024
39604,2020-01-27,(06107) Ciudad Universitaria,1521,908,838,3267
39605,2020-07-25,(07503) SAN MATEO,7466,4113,3391,14970
39606,2020-03-21,(05000) Portal Américas,885,598,689,2172
39607,2020-07-13,(07000) Portal Sur - alimentacion,7069,4052,3252,14373
39608,2020-02-28,(10000) Portal 20 de Julio - alimentacion,10882,5717,7730,24329
39609,2020-08-30,(10000) Portal 20 de Julio - alimentacion,1438,599,1212,3249
39610,2020-08-16,(10001) Country Sur,295,138,252,685
39611,2020-05-15,(06000) Portal Eldorado - alimentacion,3249,1577,1484,6310
39612,2020-08-22,(09113) Calle 22,375,210,292,877
39613,2020-03-16,(02000) Cabecera Autopista Norte,6621,4025,3619,14265
39614,2020-02-08,(07002) MADELENA,2782,1184,1999,5965
39615,2020-05-01,(40003) Mirador del Paraiso,534,334,376,1244
39616,2020-07-04,(40003) Mirador del Paraiso,1608,960,1091,3659
39617,2020-01-24,(04000) Cabecera Calle 80 - intermunicipal,1957,1353,1846,5156
39618,2020-04-17,(07505) LEON XIII,1155,742,615,2512
39619,2020-08-08,(07505) LEON XIII,1809,904,915,3628
39620,2020-09-20,(02204) Pepe Sierra,197,174,208,579
39621,2020-08-01,(09000) Cabecera Usme,1186,643,984,2813
39622,2020-02-19,(09115) Calle 34,4697,2912,2594,10203
39623,2020-01-17,(10006) San Victorino,1650,1037,1151,3838
39624,2020-01-08,(09110) Avenida Jimenez,3110,2131,2050,7291
39625,2020-06-16,(03013) RIO NEGRO,266,182,198,646
39626,2020-07-02,(09000) Cabecera Usme - alimentacion,9044,4927,5442,19413
39627,2020-02-11,(09103) Olaya,4428,2663,2422,9513
39628,2020-01-11,(04100) Carrera 77,3038,1427,2298,6763
39629,2020-01-11,(02205) Calle 106,748,521,697,1966
39630,2020-09-07,(05100) Banderas P. Central - alimentacion,3256,1774,1923,6953
39631,2020-08-28,(07112) COMUNEROS,846,480,469,1795
39632,2020-09-25,(02104) Calle 146,1096,629,829,2554
39633,2020-04-18,(09113) Calle 22,192,117,157,466
39634,2020-03-10,(03003) 21 ANGELES,65,444,359,868
39635,2020-02-07,(09114) Calle 26,2987,2037,1867,6891
39636,2020-01-24,(50003) Corral Molinos,3227,2085,3444,8756
39637,2020-01-05,(04000) Cabecera Calle 80,1014,476,1093,2583
39638,2020-07-23,(07010) Bosa,566,294,325,1185
39639,2020-03-09,(07009) SENA,655,722,560,1937
39640,2020-02-17,(09114) Calle 26,3533,2189,1765,7487
39641,2020-05-26,(09114) Calle 26,264,200,210,674
39642,2020-04-07,(09001) Molinos,1178,662,852,2692
39643,2020-01-29,(04003) Avenida Ciudad de Cali,5346,3108,3338,11792
39644,2020-07-07,(10006) San Victorino,803,374,340,1517
39645,2020-02-05,(10008) San Diego,1574,858,819,3251
39646,2020-02-01,(05002) Tintal,7091,3193,4504,14788
39647,2020-05-29,(09107) Hortúa,579,373,344,1296
39648,2020-07-25,(09000) Cabecera Usme - alimentacion,5047,2656,2963,10666
39649,2020-07-18,(06105) Quinta Paredes,84,60,58,202
39650,2020-01-26,(09100) Calle 40 Sur,1635,667,1466,3768
39651,2020-01-28,(06111) Universidades,5521,3370,2441,11332
39652,2020-05-23,(09108) Hospital,51,28,39,118
39653,2020-01-14,(10000) Portal 20 de Julio,7640,3414,3793,14847
39654,2020-03-24,(10000) Portal 20 de Julio,1882,918,1083,3883
39655,2020-02-10,(02303) Calle 85,3889,2557,1884,8330
39656,2020-03-09,(02001) Centro Comercial Santa Fe,334,1332,837,2503
39657,2020-03-06,(07004) VENECIA,4476,2458,2525,9459
39658,2020-01-06,(02502) Terminal,265,219,515,999
39659,2020-02-04,(07008) NQS - Calle 30 Sur,1961,1049,1097,4107
39660,2020-06-11,(08001) Parque el Tunal,443,259,245,947
39661,2020-09-10,(08001) Parque el Tunal,476,248,272,996
39662,2020-03-16,(09123) Calle 76,3929,2658,2091,8678
39663,2020-01-30,(06103) CAN,2508,1501,1160,5169
39664,2020-02-11,(06103) CAN,2824,1611,1119,5554
39665,2020-09-03,(06108) Concejo de Bogotá,133,79,83,295
39666,2020-03-02,(02300) Calle 100,6902,4499,3796,15197
39667,2020-02-05,(09116) Avenida 39,3252,2030,1677,6959
39668,2020-10-06,(14004) Museo del Oro,454,286,375,1115
39669,2020-01-01,(05000) Portal Américas - alimentacion,3554,1516,3524,8594
39670,2020-01-25,(06102) Salitre El Greco,684,419,537,1640
39671,2020-01-15,(10009) Museo Nacional,3397,1879,1743,7019
39672,2020-03-08,(09123) Calle 76,556,506,835,1897
39673,2020-08-04,(09123) Calle 76,908,610,561,2079
39674,2020-08-11,(09123) Calle 76,975,669,555,2199
39675,2020-09-03,(05101) Mandalay - Cr.73,151,82,100,333
39676,2020-01-18,(05105) Pradera,1350,925,871,3146
39677,2020-02-14,(03007) HUMEDAL CORDOBA,1065,636,554,2255
39678,2020-02-14,(04102) Avenida Boyaca,3162,1866,1752,6780
39679,2020-01-14,(03011) SUBA - CALLE 100,2286,1152,1223,4661
39680,2020-08-19,(02300) Calle 100,1048,700,600,2348
39681,2020-09-06,(02300) Calle 100,235,244,322,801
39682,2020-06-18,(03012) SUBA - CALLE 95,337,217,165,719
39683,2020-09-05,(10000) Portal 20 de Julio,1961,930,1409,4300
39684,2020-08-14,(50002) Corral Calle 40 Sur,21,19,38,78
39685,2020-03-16,(05107) Américas - Cr.53,1825,1021,922,3768
39686,2020-08-27,(07104) Simon Bolivar,605,355,298,1258
39687,2020-08-23,(09104) Restrepo,439,250,392,1081
39688,2020-03-14,(08000) Portal Tunal,1199,735,870,2804
39689,2020-04-25,(02205) Calle 106,128,80,56,264
39690,2020-06-21,(03000) Portal Suba - alimentacion,1900,983,1292,4175
39691,2020-06-28,(09101) Quiroga,205,84,158,447
39692,2020-06-26,(09101) Quiroga,645,300,420,1365
39693,2020-05-27,(04108) El Polo,458,287,225,970
39694,2020-02-15,(06102) Salitre El Greco,672,446,561,1679
39695,2020-06-20,(07106) EL CAMPIN,304,208,200,712
39696,2020-03-08,(07113) SANTA ISABEL,454,252,565,1271
39697,2020-01-18,(02001) Centro Comercial Santa Fe,1877,857,1648,4382
39698,2020-09-21,(10006) San Victorino,159,243,340,742
39699,2020-01-20,(07108) Av. El Dorado,815,522,577,1914
39700,2020-03-18,(02204) Pepe Sierra,2348,1662,1152,5162
39701,2020-07-03,(07000) Portal Sur,1942,1237,1255,4434
39702,2020-09-18,(07000) Portal Sur,2314,1383,1686,5383
39703,2020-09-16,(10010) San Bernardo,653,316,486,1455
39704,2020-09-29,(02200) Alcalá,2158,1400,1445,5003
39705,2020-01-04,(04102) Avenida Boyaca,820,471,650,1941
39706,2020-03-14,(07110) PALOQUEMAO,1226,852,895,2973
39707,2020-05-16,(07110) PALOQUEMAO,399,246,179,824
39708,2020-06-19,(09100) Calle 40 Sur,1877,1098,1189,4164
39709,2020-06-19,(07104) Simon Bolivar,610,394,298,1302
39710,2020-02-17,(04107) Escuela Militar,692,426,443,1561
39711,2020-04-16,(10010) San Bernardo,418,249,286,953
39712,2020-09-22,(04003) Avenida Ciudad de Cali,1136,638,935,2709
39713,2020-05-18,(05103) Marsella,283,144,162,589
39714,2020-05-26,(04003) Avenida Ciudad de Cali,883,561,568,2012
39715,2020-03-11,(09109) Tercer Milenio,1303,811,812,2926
39716,2020-05-23,(09109) Tercer Milenio,223,148,155,526
39717,2020-08-29,(09109) Tercer Milenio,270,180,240,690
39718,2020-10-03,(09109) Tercer Milenio,328,187,326,841
39719,2020-07-11,(02104) Calle 146,623,381,434,1438
39720,2020-01-16,(03003) 21 ANGELES,1480,661,866,3007
39721,2020-07-11,(09121) Las Flores,534,353,406,1293
39722,2020-02-16,(02104) Calle 146,1209,593,1323,3125
39723,2020-05-14,(07113) SANTA ISABEL,297,194,208,699
39724,2020-05-29,(07009) SENA,576,346,354,1276
39725,2020-05-08,(05100) Banderas P. Central - alimentacion,2084,972,943,3999
39726,2020-06-08,(06000) Portal Eldorado,947,651,435,2033
39727,2020-10-04,(02302) Virrey,150,141,247,538
39728,2020-08-14,(07009) SENA,616,356,395,1367
39729,2020-09-11,(03012) SUBA - CALLE 95,367,207,223,797
39730,2020-09-27,(07200) Tygua-San José,83,53,88,224
39731,2020-09-03,(02105) Calle 142,849,517,554,1920
39732,2020-03-29,(09109) Tercer Milenio,59,33,37,129
39733,2020-06-21,(03013) RIO NEGRO,93,53,69,215
39734,2020-08-05,(07103) AV. CHILE,662,449,402,1513
39735,2020-08-11,(09002) Consuelo,454,266,295,1015
39736,2020-02-11,(10005) Bicentenario,827,442,382,1651
39737,2020-03-25,(05107) Américas - Cr.53,305,251,188,744
39738,2020-03-20,(09123) Calle 76,460,329,236,1025
39739,2020-09-02,(02101) Toberín,1475,992,1025,3492
39740,2020-01-12,(02001) Centro Comercial Santa Fe,546,311,782,1639
39741,2020-09-26,(04105) Carrera 53,240,125,225,590
39742,2020-04-23,(09123) Calle 76,516,410,301,1227
39743,2020-01-07,(07006) General Santander,1824,1124,1148,4096
39744,2020-02-17,(40001) Juan Pablo II,1655,993,1024,3672
39745,2020-07-23,(04000) Cabecera Calle 80,896,577,606,2079
39746,2020-07-28,(09120) Calle 63,1058,724,605,2387
39747,2020-05-07,(02200) Alcalá,1171,805,617,2593
39748,2020-09-10,(03011) SUBA - CALLE 100,544,220,265,1029
39749,2020-05-14,(05107) Américas - Cr.53,329,220,198,747
39750,2020-03-06,(07003) SEVILLANA,2054,1120,1188,4362
39751,2020-06-20,(06111) Universidades,188,129,270,587
39752,2020-09-11,(06111) Universidades,419,236,381,1036
39753,2020-01-15,(06100) Av. Rojas,1979,1098,1051,4128
39754,2020-06-11,(09004) Santa Lucía,2403,1263,1216,4882
39755,2020-06-23,(40001) Juan Pablo II,600,368,358,1326
39756,2020-06-25,(07111) NQS - RICAURTE,1212,707,462,2381
39757,2020-05-13,(02204) Pepe Sierra,582,419,304,1305
39758,2020-06-17,(07110) PALOQUEMAO,662,395,286,1343
39759,2020-09-11,(10003) Ciudad Jardín,227,103,154,484
39760,2020-08-06,(07201) Guatoque -Veraguas,189,102,113,404
39761,2020-01-26,(07008) NQS - Calle 30 Sur,416,171,356,943
39762,2020-03-25,(02001) Centro Comercial Santa Fe,216,151,164,531
39763,2020-01-17,(09111) Calle 19,1725,1222,1386,4333
39764,2020-06-17,(07000) Portal Sur,1888,1243,1120,4251
39765,2020-04-08,(06109) Centro Memoria,143,105,100,348
39766,2020-04-21,(06109) Centro Memoria,186,122,94,402
39767,2020-06-05,(04105) Carrera 53,245,133,133,511
39768,2020-09-11,(04105) Carrera 53,287,155,195,637
39769,2020-04-11,(09103) Olaya,265,151,169,585
39770,2020-08-21,(06104) Gobernación,250,149,116,515
39771,2020-03-06,(07006) General Santander - alimentacion,1477,862,995,3334
39772,2020-01-19,(04101) Minuto de Dios,428,218,564,1210
39773,2020-05-17,(03000) Portal Suba,219,132,210,561
39774,2020-06-13,(09121) Las Flores,474,371,372,1217
39775,2020-04-13,(02303) Calle 85,339,244,200,783
39776,2020-04-08,(05001) Patio Bonito,820,445,544,1809
39777,2020-05-29,(07110) PALOQUEMAO,627,364,254,1245
39778,2020-06-14,(07001) PERDOMO,248,110,164,522
39779,2020-06-27,(06107) Ciudad Universitaria,127,96,129,352
39780,2020-05-22,(04104) Avenida 68,531,298,268,1097
39781,2020-03-29,(03002) SUBA - TV- 91,156,85,91,332
39782,2020-01-19,(07103) AV. CHILE,513,399,718,1630
39783,2020-05-04,(07109) CAD,445,299,221,965
39784,2020-09-21,(14005) Las Aguas,82,109,235,426
39785,2019-12-31,(06002) Normandía,14,7,23,44
39786,2020-07-07,(05102) Av. Américas - Av. Boyacá,227,152,195,574
39787,2020-10-10,(07506) DESPENSA,317,201,338,856
39788,2020-07-31,(09111) Calle 19,693,398,455,1546
39789,2020-04-11,(07505) LEON XIII,712,468,296,1476
39790,2020-04-14,(07009) SENA,314,186,171,671
39791,2020-05-16,(06002) Normandía,157,88,112,357
39792,2020-01-01,(08000) Portal Tunal,233,192,229,654
39793,2020-08-11,(09114) Calle 26,299,165,186,650
39794,2020-03-27,(14001) La Sabana,60,45,61,166
39795,2020-05-19,(02101) Toberín,1132,769,650,2551
39796,2020-04-02,(40001) Juan Pablo II,244,135,127,506
39797,2020-06-03,(04102) Avenida Boyaca,282,174,203,659
39798,2020-02-24,(09108) Hospital,258,152,215,625
39799,2020-07-16,(07009) SENA,590,357,314,1261
39800,2020-01-02,(03004) GRATAMIRA,95,64,76,235
39801,2020-02-08,(03004) GRATAMIRA,170,79,116,365
39802,2020-05-06,(09111) Calle 19,377,227,286,890
39803,2020-06-20,(03009) Av. Suba- Calle 116,349,233,211,793
39804,2019-12-31,(05000) Portal Américas,68,75,161,304
39805,2020-08-10,(40002) Manitas,367,214,252,833
39806,2020-05-01,(09122) Calle 72,355,224,236,815
39807,2020-03-29,(09116) Avenida 39,70,63,60,193
39808,2020-09-09,(07107) U. NACIONAL,390,235,213,838
39809,2020-06-26,(05102) Av. Américas - Av. Boyacá,258,139,159,556
39810,2020-09-12,(09108) Hospital,66,34,67,167
39811,2020-04-30,(07006) General Santander - alimentacion,219,124,128,471
39812,2020-08-19,(07008) NQS - Calle 30 Sur,282,165,187,634
39813,2020-07-29,(06001) Modelia,323,201,162,686
39814,2020-04-07,(12003) Ricaurte,94,75,78,247
39815,2020-04-06,(04003) Avenida Ciudad de Cali,473,313,349,1135
39816,2020-05-23,(09111) Calle 19,525,329,356,1210
39817,2020-03-26,(04001) Quirigua,157,109,103,369
39818,2020-03-28,(09117) Calle 45,325,225,140,690
39819,2020-05-08,(07006) General Santander,335,199,183,717
39820,2020-05-09,(07006) General Santander,248,128,159,535
39821,2020-06-28,(05105) Pradera,194,153,107,454
39822,2020-05-20,(09105) Río Fucha,117,56,81,254
39823,2020-06-03,(12004) Carrera 22,205,102,101,408
39824,2020-02-17,(03014) SAN MARTIN,259,162,169,590
39825,2020-04-12,(07201) Guatoque -Veraguas,17,10,18,45
39826,2020-10-11,(06103) CAN,131,91,134,356
39827,2020-07-12,(03004) GRATAMIRA,14,5,12,31
39828,2020-04-13,(06107) Ciudad Universitaria,104,72,91,267
39829,2020-10-11,(07108) Av. El Dorado,46,30,77,153
39830,2020-04-09,(09111) Calle 19,85,54,104,243
39831,2020-04-18,(09111) Calle 19,169,121,146,436
39832,2020-08-07,(40002) Manitas,192,108,131,431
39833,2020-05-24,(12003) Ricaurte,36,37,54,127
39834,2020-05-06,(05101) Mandalay - Cr.73,66,43,31,140
39835,2020-06-14,(07109) CAD,162,115,117,394
39836,2020-09-27,(06105) Quinta Paredes,36,33,47,116
39837,2020-07-24,(07007) NQS - Calle 38A Sur,249,158,209,616
39838,2019-12-31,(09101) Quiroga,25,25,37,87
39839,2020-04-04,(06105) Quinta Paredes,44,35,32,111
39840,2020-06-28,(03005) SUBA - AV. BOYACA,116,76,99,291
39841,2020-05-24,(03006) NIZA - CALLE 127,139,76,82,297
39842,2020-05-25,(07108) Av. El Dorado,40,33,32,105
39843,2020-08-16,(07101) CASTELLANA,27,20,38,85
39844,2020-03-23,(06106) Recinto Ferial,51,33,22,106
39845,2020-04-25,(04000) Cabecera Calle 80 - intermunicipal,82,52,71,205
39846,2020-07-19,(07104) Simon Bolivar,108,65,87,260
39847,2020-04-10,(07106) EL CAMPIN,52,39,21,112
39848,2020-10-09,(03014) SAN MARTIN,0,17,61,78
39849,2020-03-29,(06104) Gobernación,47,42,20,109
39850,2020-10-11,(50002) Corral Calle 40 Sur,7,3,7,17
39851,2020-08-27,(04000) Cabecera Calle 80 - alimentacion,3975,2271,2663,8909
39852,2020-03-17,(09002) Consuelo,1036,569,598,2203
39853,2020-10-05,(09002) Consuelo,526,287,401,1214
39854,2020-09-28,(09118) Marly,1546,1014,1040,3600
39855,2020-05-28,(07504) TERREROS,4714,2767,2260,9741
39856,2020-01-24,(05000) Portal Américas - alimentacion,33407,19389,20287,73083
39857,2020-01-21,(09119) Calle 57,2228,1414,1261,4903
39858,2020-09-16,(09119) Calle 57,640,385,448,1473
39859,2020-02-21,(03002) SUBA - TV- 91,4609,2405,2360,9374
39860,2020-02-07,(02101) Toberín,15348,8999,8036,32383
39861,2020-02-10,(02101) Toberín,15403,9916,7664,32983
39862,2020-08-13,(07503) SAN MATEO,11151,6000,5077,22228
39863,2020-03-04,(02200) Alcalá,14737,9253,6837,30827
39864,2020-01-21,(06000) Portal Eldorado - alimentacion,12306,5521,5887,23714
39865,2020-05-22,(06104) Gobernación,219,141,78,438
39866,2020-01-06,(10000) Portal 20 de Julio - alimentacion,3087,1191,2452,6730
39867,2020-01-15,(06107) Ciudad Universitaria,834,552,704,2090
39868,2020-02-22,(05000) Portal Américas,9268,4310,6077,19655
39869,2020-02-27,(02201) Prado,5878,3760,2971,12609
39870,2020-09-06,(10000) Portal 20 de Julio - alimentacion,1628,638,1253,3519
39871,2020-08-20,(09100) Calle 40 Sur,1594,902,1058,3554
39872,2020-08-10,(09000) Cabecera Usme,1584,1005,1192,3781
39873,2020-03-23,(06000) Portal Eldorado - alimentacion,1246,482,443,2171
39874,2020-02-17,(02105) Calle 142,7211,4596,3811,15618
39875,2020-01-21,(06102) Salitre El Greco,929,560,459,1948
39876,2020-02-09,(10000) Portal 20 de Julio - alimentacion,3638,1364,2936,7938
39877,2020-02-27,(05107) Américas - Cr.53,2615,1489,1402,5506
39878,2020-01-31,(09104) Restrepo,5100,2993,3996,12089
39879,2020-08-04,(09104) Restrepo,1451,825,1010,3286
39880,2020-09-22,(09104) Restrepo,1827,994,1404,4225
39881,2020-06-17,(03000) Portal Suba - alimentacion,6087,3636,3361,13084
39882,2020-01-16,(02204) Pepe Sierra,4130,2754,2295,9179
39883,2020-02-10,(09115) Calle 34,4768,2991,2443,10202
39884,2020-01-07,(10006) San Victorino,1266,745,963,2974
39885,2020-03-05,(04104) Avenida 68,3612,1900,1905,7417
39886,2020-01-04,(07112) COMUNEROS,1232,669,926,2827
39887,2020-01-31,(07110) PALOQUEMAO,2300,1364,1135,4799
39888,2020-01-27,(09004) Santa Lucía,7072,4057,4076,15205
39889,2020-07-04,(07102) NQS - CALLE 75,294,223,270,787
39890,2020-08-24,(07102) NQS - CALLE 75,414,274,214,902
39891,2020-05-20,(03013) RIO NEGRO,240,158,161,559
39892,2020-02-29,(03000) Portal Suba - alimentacion,17147,8434,12331,37912
39893,2020-03-25,(09103) Olaya,466,276,247,989
39894,2020-01-08,(14001) La Sabana,262,228,269,759
39895,2020-06-19,(14001) La Sabana,185,117,96,398
39896,2020-05-20,(02000) Cabecera Autopista Norte,1052,688,611,2351
39897,2020-03-07,(10007) Las Nieves,1018,832,972,2822
39898,2020-01-20,(04105) Carrera 53,1264,678,765,2707
39899,2020-08-02,(09001) Molinos,690,326,539,1555
39900,2020-02-28,(07007) NQS - Calle 38A Sur,2206,1249,1239,4694
39901,2020-01-21,(02104) Calle 146,6775,3602,3133,13510
39902,2020-08-07,(07112) COMUNEROS,322,182,217,721
39903,2020-09-09,(09120) Calle 63,1260,807,861,2928
39904,2020-07-02,(10001) Country Sur,1388,659,744,2791
39905,2020-10-05,(09111) Calle 19,787,452,648,1887
39906,2020-09-24,(10006) San Victorino,814,389,422,1625
39907,2020-06-07,(08000) Portal Tunal - alimentacion,1804,826,1124,3754
39908,2020-05-25,(09123) Calle 76,211,171,142,524
39909,2020-09-17,(09123) Calle 76,1113,772,706,2591
39910,2020-10-03,(02101) Toberín,1256,609,1340,3205
39911,2020-03-01,(09004) Santa Lucía,2187,823,1766,4776
39912,2020-01-04,(12001) Carrera 43,412,260,424,1096
39913,2020-01-20,(09107) Hortúa,2117,1298,1430,4845
39914,2020-03-04,(10005) Bicentenario - alimentacion,723,362,518,1603
39915,2020-04-22,(02000) Cabecera Autopista Norte - intermunicipal,167,111,110,388
39916,2020-01-24,(02302) Virrey,3558,2453,1909,7920
39917,2020-09-23,(02304) Heroes,1027,681,633,2341
39918,2020-07-15,(03000) Portal Suba,1136,717,695,2548
39919,2020-08-27,(03000) Portal Suba,1230,764,883,2877
39920,2020-03-16,(02000) Cabecera Autopista Norte - intermunicipal,2815,1898,1711,6424
39921,2020-02-25,(09101) Quiroga,1685,1076,1156,3917
39922,2020-09-14,(09101) Quiroga,557,294,434,1285
39923,2020-06-28,(03000) Portal Suba - alimentacion,2084,990,1335,4409
39924,2020-07-01,(02303) Calle 85,772,522,366,1660
39925,2020-03-18,(02001) Centro Comercial Santa Fe,1804,1141,1046,3991
39926,2020-03-09,(10002) Av. Primero de Mayo,417,1753,1275,3445
39927,2020-02-05,(07008) NQS - Calle 30 Sur,2020,1145,1121,4286
39928,2020-02-02,(07001) PERDOMO,929,401,966,2296
39929,2020-08-18,(02000) Cabecera Autopista Norte - alimentacion,4120,2269,2397,8786
39930,2020-02-17,(09120) Calle 63,7569,4723,3699,15991
39931,2020-06-04,(09123) Calle 76,934,644,509,2087
39932,2020-06-17,(09123) Calle 76,1029,754,580,2363
39933,2020-01-30,(05105) Pradera,2412,1445,1224,5081
39934,2020-05-29,(50003) Corral Molinos,1298,657,1005,2960
39935,2020-09-12,(02300) Calle 100,721,587,668,1976
39936,2020-09-20,(02300) Calle 100,233,239,410,882
39937,2020-05-20,(03012) SUBA - CALLE 95,296,192,137,625
39938,2020-02-06,(50002) Corral Calle 40 Sur,129,89,153,371
39939,2020-03-06,(08000) Portal Tunal,2150,1183,1155,4488
39940,2020-06-18,(05101) Mandalay - Cr.73,128,77,72,277
39941,2020-01-13,(08000) Portal Tunal,1768,982,995,3745
39942,2020-06-18,(08000) Portal Tunal,798,356,301,1455
39943,2020-08-10,(07104) Simon Bolivar,347,249,233,829
39944,2020-06-01,(05005) Transversal 86,257,160,186,603
39945,2020-03-04,(04105) Carrera 53,1486,849,748,3083
39946,2020-07-27,(06109) Centro Memoria,250,133,134,517
39947,2020-08-17,(06109) Centro Memoria,73,49,58,180
39948,2020-03-28,(05000) Portal Américas,832,546,697,2075
39949,2020-02-08,(03009) Av. Suba- Calle 116,1151,831,995,2977
39950,2020-08-22,(03009) Av. Suba- Calle 116,312,205,216,733
39951,2020-08-27,(03009) Av. Suba- Calle 116,498,320,222,1040
39952,2020-07-27,(02205) Calle 106,334,226,168,728
39953,2020-08-25,(09101) Quiroga,524,265,362,1151
39954,2020-06-16,(04108) El Polo,461,302,237,1000
39955,2020-02-09,(09118) Marly,1435,860,1517,3812
39956,2020-07-02,(02200) Alcalá,1968,1297,1145,4410
39957,2020-07-17,(10006) San Victorino,377,225,250,852
39958,2020-07-24,(07000) Portal Sur,1473,929,912,3314
39959,2020-10-05,(07000) Portal Sur,2324,1373,1769,5466
39960,2020-03-08,(04103) Las Ferias,255,147,316,718
39961,2020-04-04,(03000) Portal Suba - alimentacion,2350,1284,1120,4754
39962,2020-10-04,(07000) Portal Sur,538,266,672,1476
39963,2020-01-09,(07110) PALOQUEMAO,1770,1026,923,3719
39964,2020-06-17,(10010) San Bernardo,585,338,415,1338
39965,2020-07-17,(09000) Cabecera Usme,1157,763,940,2860
39966,2020-08-26,(09109) Tercer Milenio,332,213,218,763
39967,2020-02-22,(07103) AV. CHILE,2107,1410,1588,5105
39968,2020-07-17,(05001) Patio Bonito,1606,880,960,3446
39969,2020-04-15,(07109) CAD,407,269,192,868
39970,2020-10-07,(03001) LA CAMPIÑA,1497,823,976,3296
39971,2020-01-02,(02104) Calle 146,2836,1791,1967,6594
39972,2020-10-05,(02104) Calle 146,995,656,921,2572
39973,2020-05-28,(09114) Calle 26,246,205,171,622
39974,2020-09-18,(09101) Quiroga,671,345,439,1455
39975,2020-03-22,(02202) Calle 127,358,249,183,790
39976,2020-06-05,(02204) Pepe Sierra,779,497,377,1653
39977,2020-05-26,(09002) Consuelo,455,230,245,930
39978,2020-08-25,(06106) Recinto Ferial,211,129,107,447
39979,2020-01-11,(06103) CAN,567,400,583,1550
39980,2020-06-01,(06000) Portal Eldorado,951,672,456,2079
39981,2020-05-31,(03010) PUENTE LARGO,77,59,60,196
39982,2020-05-12,(04104) Avenida 68,478,279,237,994
39983,2020-05-29,(02105) Calle 142,694,428,406,1528
39984,2020-03-14,(10008) San Diego,586,423,622,1631
39985,2020-07-13,(09109) Tercer Milenio,181,119,151,451
39986,2020-08-22,(03002) SUBA - TV- 91,531,276,377,1184
39987,2020-09-18,(07103) AV. CHILE,1011,630,640,2281
39988,2020-09-24,(06109) Centro Memoria,294,173,179,646
39989,2020-07-01,(10005) Bicentenario,119,67,81,267
39990,2020-07-02,(40002) Manitas,459,269,321,1049
39991,2020-07-22,(09001) Molinos,1924,1039,1389,4352
39992,2020-02-26,(07006) General Santander,2928,1677,1556,6161
39993,2020-05-28,(04105) Carrera 53,239,142,128,509
39994,2020-09-11,(09123) Calle 76,1031,690,651,2372
39995,2020-03-25,(06103) CAN,363,289,165,817
39996,2020-09-30,(10008) San Diego,320,208,240,768
39997,2020-07-28,(08002) Biblioteca,298,159,172,629
39998,2020-01-03,(04101) Minuto de Dios,976,585,856,2417
39999,2020-09-23,(08000) Portal Tunal,796,336,375,1507
40000,2020-05-15,(10009) Museo Nacional,395,249,262,906
40001,2020-07-10,(10009) Museo Nacional,492,314,375,1181
40002,2020-10-10,(06111) Universidades,371,199,487,1057
40003,2020-05-11,(40001) Juan Pablo II,399,243,232,874
40004,2020-08-20,(04002) Carrera 90,621,331,353,1305
40005,2020-05-24,(07005) ALQUERIA,138,79,80,297
40006,2020-07-19,(07110) PALOQUEMAO,135,90,84,309
40007,2020-05-18,(02101) Toberín,1143,708,765,2616
40008,2020-05-16,(07004) VENECIA,553,313,298,1164
40009,2020-01-04,(07008) NQS - Calle 30 Sur,559,259,445,1263
40010,2020-02-02,(10009) Museo Nacional,204,270,647,1121
40011,2020-07-04,(10009) Museo Nacional,243,176,308,727
40012,2020-05-19,(09118) Marly,1255,851,564,2670
40013,2020-06-27,(06109) Centro Memoria,227,139,140,506
40014,2020-09-17,(06109) Centro Memoria,289,168,200,657
40015,2020-01-05,(07002) MADELENA,675,270,574,1519
40016,2020-08-30,(06102) Salitre El Greco,85,61,69,215
40017,2020-05-31,(09103) Olaya,307,150,167,624
40018,2020-07-05,(09103) Olaya,366,197,266,829
40019,2020-08-04,(06104) Gobernación,245,133,91,469
40020,2020-03-22,(04000) Cabecera Calle 80,156,110,130,396
40021,2020-05-01,(50003) Corral Molinos,511,237,369,1117
40022,2020-06-19,(07105) MOVISTAR ARENA,261,166,167,594
40023,2020-08-28,(07105) MOVISTAR ARENA,258,137,171,566
40024,2020-08-12,(50003) Corral Molinos,1420,727,968,3115
40025,2020-03-14,(07104) Simon Bolivar,1322,872,940,3134
40026,2020-02-09,(12001) Carrera 43,165,139,277,581
40027,2020-07-17,(06102) Salitre El Greco,211,119,110,440
40028,2020-06-20,(05102) Av. Américas - Av. Boyacá,167,86,109,362
40029,2020-04-23,(12003) Ricaurte,175,122,87,384
40030,2020-04-28,(07007) NQS - Calle 38A Sur,202,119,113,434
40031,2020-07-24,(08002) Biblioteca,262,135,152,549
40032,2020-04-28,(12000) Puente Aranda,47,34,20,101
40033,2020-07-22,(12000) Puente Aranda,91,53,44,188
40034,2020-06-08,(07109) CAD,629,378,276,1283
40035,2020-03-19,(03005) SUBA - AV. BOYACA,1237,752,694,2683
40036,2020-05-27,(03005) SUBA - AV. BOYACA,378,247,208,833
40037,2020-04-20,(07002) MADELENA,347,189,217,753
40038,2020-03-15,(02303) Calle 85,392,336,464,1192
40039,2020-07-05,(04106) Carrera 47,107,65,84,256
40040,2020-07-29,(04106) Carrera 47,303,159,168,630
40041,2020-04-27,(09119) Calle 57,76,116,44,236
40042,2020-09-11,(07107) U. NACIONAL,382,228,251,861
40043,2020-07-20,(04002) Carrera 90,168,93,114,375
40044,2020-04-07,(09120) Calle 63,546,395,375,1316
40045,2020-09-06,(40001) Juan Pablo II,199,100,197,496
40046,2020-02-16,(09122) Calle 72,998,786,1513,3297
40047,2020-04-18,(14001) La Sabana,65,59,50,174
40048,2020-04-09,(09115) Calle 34,128,87,78,293
40049,2020-04-15,(04102) Avenida Boyaca,144,86,88,318
40050,2020-06-23,(12002) CDS - Carrera 32,210,144,93,447
40051,2020-05-05,(40001) Juan Pablo II,370,213,247,830
40052,2020-09-16,(04000) Cabecera Calle 80 - intermunicipal,414,212,454,1080
40053,2020-09-11,(04102) Avenida Boyaca,422,210,295,927
40054,2020-05-12,(06002) Normandía,253,142,141,536
40055,2020-06-24,(06100) Av. Rojas,248,143,121,512
40056,2020-08-14,(04001) Quirigua,347,171,232,750
40057,2020-04-18,(04102) Avenida Boyaca,109,76,74,259
40058,2020-04-03,(07103) AV. CHILE,421,320,248,989
40059,2020-06-12,(07006) General Santander - alimentacion,378,231,253,862
40060,2020-07-30,(05105) Pradera,476,311,263,1050
40061,2020-05-10,(04103) Las Ferias,83,57,45,185
40062,2020-04-04,(02204) Pepe Sierra,311,230,155,696
40063,2020-08-20,(07105) MOVISTAR ARENA,229,135,131,495
40064,2020-04-27,(07108) Av. El Dorado,17,28,13,58
40065,2020-04-21,(07107) U. NACIONAL,209,146,95,450
40066,2020-07-30,(07005) ALQUERIA,477,297,281,1055
40067,2020-07-30,(40002) Manitas,405,248,251,904
40068,2020-06-09,(12002) CDS - Carrera 32,181,132,67,380
40069,2020-05-08,(06102) Salitre El Greco,151,96,96,343
40070,2020-04-16,(07003) SEVILLANA,208,127,119,454
40071,2020-08-08,(06001) Modelia,184,142,143,469
40072,2020-06-28,(07010) Bosa,218,92,168,478
40073,2020-08-12,(03010) PUENTE LARGO,269,184,187,640
40074,2020-08-14,(06105) Quinta Paredes,137,82,90,309
40075,2020-05-02,(06108) Concejo de Bogotá,73,50,42,165
40076,2020-06-06,(07506) DESPENSA,368,198,211,777
40077,2020-04-03,(09114) Calle 26,146,139,125,410
40078,2020-05-06,(09114) Calle 26,182,129,145,456
40079,2020-06-18,(10005) Bicentenario,115,53,75,243
40080,2020-07-04,(05101) Mandalay - Cr.73,117,58,76,251
40081,2020-07-18,(04107) Escuela Militar,91,64,65,220
40082,2020-07-16,(14005) Las Aguas,145,86,148,379
40083,2020-04-11,(03009) Av. Suba- Calle 116,205,152,120,477
40084,2020-08-23,(06001) Modelia,72,40,84,196
40085,2020-09-20,(12004) Carrera 22,67,66,101,234
40086,2020-03-26,(12002) CDS - Carrera 32,143,106,62,311
40087,2020-03-20,(04106) Carrera 47,148,90,47,285
40088,2020-09-06,(07109) CAD,191,137,176,504
40089,2020-06-16,(07101) CASTELLANA,190,117,105,412
40090,2020-01-25,(12004) Carrera 22,448,293,365,1106
40091,2020-08-25,(50002) Corral Calle 40 Sur,18,14,24,56
40092,2020-09-09,(09105) Río Fucha,0,74,177,251
40093,2020-03-21,(09002) Consuelo,103,55,70,228
40094,2020-04-26,(03004) GRATAMIRA,14,7,4,25
40095,2020-03-31,(07113) SANTA ISABEL,179,120,136,435
40096,2020-09-06,(09108) Hospital,8,22,46,76
40097,2020-06-07,(07101) CASTELLANA,25,23,32,80
40098,2020-09-13,(07006) General Santander - alimentacion,88,45,129,262
40099,2020-08-19,(03014) SAN MARTIN,0,10,34,44
40100,2020-04-15,(12000) Puente Aranda,46,24,21,91
40101,2020-03-30,(50002) Corral Calle 40 Sur,9,5,10,24
40102,2020-06-29,(12000) Puente Aranda,11,11,16,38
40103,2020-08-02,(09105) Río Fucha,0,17,36,53
40104,2020-08-02,(50002) Corral Calle 40 Sur,2,1,3,6
40105,2020-02-21,(04000) Cabecera Calle 80 - alimentacion,23871,12809,14561,51241
40106,2020-07-06,(04000) Cabecera Calle 80 - alimentacion,4346,2639,2869,9854
40107,2020-10-03,(04000) Cabecera Calle 80 - alimentacion,3889,1774,3576,9239
40108,2020-10-06,(07005) ALQUERIA,661,361,489,1511
40109,2020-01-07,(09002) Consuelo,1035,528,702,2265
40110,2020-07-02,(02502) Terminal,421,301,347,1069
40111,2020-01-13,(07504) TERREROS,15314,8995,8418,32727
40112,2020-01-14,(09122) Calle 72,5415,3558,3374,12347
40113,2020-02-17,(07503) SAN MATEO,41490,23966,17518,82974
40114,2020-01-21,(09003) Socorro,1278,595,683,2556
40115,2020-02-29,(08001) Parque el Tunal,1125,564,813,2502
40116,2020-01-19,(50003) Corral Molinos,1068,436,1096,2600
40117,2020-04-13,(05000) Portal Américas - alimentacion,6026,3221,2574,11821
40118,2020-04-14,(04000) Cabecera Calle 80 - alimentacion,1968,1127,1173,4268
40119,2020-03-01,(02000) Cabecera Autopista Norte - alimentacion,6415,2619,5218,14252
40120,2020-01-30,(03000) Portal Suba,9048,5216,5154,19418
40121,2020-03-18,(09004) Santa Lucía,5089,2594,2577,10260
40122,2020-01-28,(09000) Cabecera Usme,5664,3401,3880,12945
40123,2020-02-05,(09000) Cabecera Usme,6107,3600,4111,13818
40124,2020-01-31,(05100) Banderas P. Central - alimentacion,12906,7760,8416,29082
40125,2020-03-18,(05100) Banderas P. Central - alimentacion,7892,3940,4124,15956
40126,2020-01-15,(07009) SENA,2895,1716,1907,6518
40127,2020-01-24,(10005) Bicentenario - alimentacion,654,286,516,1456
40128,2020-06-03,(07001) PERDOMO,830,463,446,1739
40129,2020-01-08,(02000) Cabecera Autopista Norte,6667,4099,4315,15081
40130,2020-07-30,(09104) Restrepo,1509,892,1021,3422
40131,2020-09-09,(09104) Restrepo,1731,968,1317,4016
40132,2020-06-18,(09000) Cabecera Usme,1731,1116,1150,3997
40133,2020-07-15,(04100) Carrera 77,1130,659,707,2496
40134,2020-03-24,(07102) NQS - CALLE 75,247,203,197,647
40135,2020-09-07,(03000) Portal Suba - alimentacion,6516,3781,4019,14316
40136,2020-02-06,(02103) Mazurén,3665,2262,1920,7847
40137,2020-01-29,(09119) Calle 57,3379,2217,2067,7663
40138,2020-03-07,(09103) Olaya,2571,1267,1974,5812
40139,2020-09-21,(09103) Olaya,899,459,495,1853
40140,2020-07-24,(02000) Cabecera Autopista Norte,1138,683,667,2488
40141,2020-08-24,(02000) Cabecera Autopista Norte,1193,753,729,2675
40142,2020-09-15,(02000) Cabecera Autopista Norte,1538,961,1083,3582
40143,2020-09-25,(09113) Calle 22,446,236,421,1103
40144,2020-01-17,(50003) Corral Molinos,3049,1984,3318,8351
40145,2020-01-29,(50003) Corral Molinos,3381,2161,3378,8920
40146,2020-02-16,(05000) Portal Américas,2683,1236,2602,6521
40147,2020-09-05,(05000) Portal Américas,2683,1351,2220,6254
40148,2020-09-09,(09123) Calle 76,1129,746,738,2613
40149,2020-03-07,(09104) Restrepo,3362,2008,3297,8667
40150,2020-06-27,(08000) Portal Tunal - alimentacion,5429,2833,3164,11426
40151,2020-09-04,(09110) Avenida Jimenez,1587,1129,947,3663
40152,2020-03-03,(06106) Recinto Ferial,1552,927,807,3286
40153,2020-01-21,(10001) Country Sur,3498,1207,1760,6465
40154,2020-06-05,(12001) Carrera 43,379,223,204,806
40155,2020-07-22,(12001) Carrera 43,407,209,227,843
40156,2020-08-05,(12001) Carrera 43,385,201,210,796
40157,2020-03-12,(07505) LEON XIII,366,1891,1148,3405
40158,2020-09-23,(10002) Av. Primero de Mayo,2398,1292,1690,5380
40159,2020-01-07,(09107) Hortúa,1557,977,1133,3667
40160,2020-06-05,(09107) Hortúa,578,371,316,1265
40161,2020-01-13,(06101) El Tiempo,2289,1227,1096,4612
40162,2020-08-25,(03000) Portal Suba,1195,750,875,2820
40163,2020-06-16,(02000) Cabecera Autopista Norte - intermunicipal,557,391,414,1362
40164,2020-08-12,(02000) Cabecera Autopista Norte - intermunicipal,513,316,365,1194
40165,2020-10-08,(10000) Portal 20 de Julio - alimentacion,4673,1957,3249,9879
40166,2020-01-25,(09101) Quiroga,915,510,917,2342
40167,2020-03-03,(09108) Hospital,243,157,221,621
40168,2020-02-05,(04108) El Polo,1963,1235,1191,4389
40169,2020-01-25,(02303) Calle 85,1405,1119,1241,3765
40170,2020-09-09,(02303) Calle 85,841,535,494,1870
40171,2020-09-25,(02303) Calle 85,879,577,533,1989
40172,2020-08-19,(10002) Av. Primero de Mayo,1977,944,1165,4086
40173,2020-01-23,(10004) Policarpa,773,404,593,1770
40174,2020-05-30,(07503) SAN MATEO,6948,3925,3468,14341
40175,2020-10-07,(08001) Parque el Tunal,544,306,440,1290
40176,2020-09-15,(09116) Avenida 39,461,252,307,1020
40177,2020-06-09,(02101) Toberín,1444,860,862,3166
40178,2020-07-19,(10001) Country Sur,230,87,168,485
40179,2020-02-01,(14004) Museo del Oro,724,744,1143,2611
40180,2020-03-14,(02105) Calle 142,2528,1213,2065,5806
40181,2020-01-29,(05103) Marsella,2895,1708,1426,6029
40182,2020-07-21,(02000) Cabecera Autopista Norte,1200,776,732,2708
40183,2020-02-16,(06111) Universidades,477,293,851,1621
40184,2020-07-17,(40003) Mirador del Paraiso,1158,764,759,2681
40185,2020-02-02,(05103) Marsella,484,198,438,1120
40186,2020-06-07,(02300) Calle 100,301,208,221,730
40187,2020-08-05,(50002) Corral Calle 40 Sur,19,15,22,56
40188,2020-08-21,(04000) Cabecera Calle 80,1020,622,815,2457
40189,2020-07-27,(07104) Simon Bolivar,556,352,238,1146
40190,2020-03-12,(02302) Virrey,1884,100,411,2395
40191,2020-06-30,(05105) Pradera,592,300,280,1172
40192,2020-08-29,(10008) San Diego,238,120,178,536
40193,2020-01-09,(08000) Portal Tunal,1539,887,903,3329
40194,2020-08-10,(06109) Centro Memoria,251,122,137,510
40195,2020-09-09,(05107) Américas - Cr.53,463,291,294,1048
40196,2020-06-10,(02205) Calle 106,300,198,207,705
40197,2020-06-24,(03000) Portal Suba - alimentacion,6283,3781,3550,13614
40198,2020-01-03,(04002) Carrera 90,1777,923,1204,3904
40199,2020-04-08,(10002) Av. Primero de Mayo,1069,603,707,2379
40200,2020-08-20,(09101) Quiroga,463,255,336,1054
40201,2020-08-30,(04000) Cabecera Calle 80,266,168,357,791
40202,2020-07-31,(06000) Portal Eldorado - alimentacion,3032,1595,1622,6249
40203,2020-03-17,(04108) El Polo,1197,804,712,2713
40204,2020-08-26,(04108) El Polo,485,287,228,1000
40205,2020-09-14,(04108) El Polo,533,315,294,1142
40206,2020-10-08,(02304) Heroes,990,732,686,2408
40207,2020-05-27,(07103) AV. CHILE,845,559,382,1786
40208,2020-03-01,(06111) Universidades,530,310,823,1663
40209,2020-08-19,(05103) Marsella,373,187,209,769
40210,2020-09-23,(03007) HUMEDAL CORDOBA,185,128,106,419
40211,2020-06-09,(10006) San Victorino,532,274,306,1112
40212,2020-03-05,(08002) Biblioteca,1022,604,624,2250
40213,2020-04-23,(08002) Biblioteca,149,107,95,351
40214,2020-06-03,(07000) Portal Sur,1630,1029,939,3598
40215,2020-09-09,(02101) Toberín,1561,1014,1139,3714
40216,2020-03-09,(05103) Marsella,197,777,403,1377
40217,2020-03-19,(10000) Portal 20 de Julio,5020,2255,2278,9553
40218,2020-03-07,(07000) Portal Sur,4718,2239,3614,10571
40219,2020-08-09,(05100) Banderas P. Central - alimentacion,859,358,533,1750
40220,2020-05-15,(02304) Heroes,636,450,338,1424
40221,2020-04-11,(09100) Calle 40 Sur,474,273,359,1106
40222,2020-06-15,(09100) Calle 40 Sur,622,353,443,1418
40223,2020-07-25,(07104) Simon Bolivar,428,265,205,898
40224,2020-05-06,(10005) Bicentenario - alimentacion,175,79,122,376
40225,2020-06-30,(04107) Escuela Militar,137,107,85,329
40226,2020-02-09,(07109) CAD,558,363,560,1481
40227,2020-09-15,(10010) San Bernardo,608,324,483,1415
40228,2020-06-19,(07000) Portal Sur,1958,1226,1194,4378
40229,2020-01-20,(03001) LA CAMPIÑA,5772,3505,3881,13158
40230,2020-05-28,(05103) Marsella,345,146,184,675
40231,2020-10-11,(09117) Calle 45,253,160,347,760
40232,2020-05-21,(04002) Carrera 90,549,337,283,1169
40233,2020-09-05,(07004) VENECIA,845,483,612,1940
40234,2020-01-03,(09117) Calle 45,1338,1078,1393,3809
40235,2020-03-03,(12003) Ricaurte,1295,820,708,2823
40236,2020-02-14,(04001) Quirigua,2199,1221,1261,4681
40237,2020-03-10,(04108) El Polo,841,202,296,1339
40238,2020-03-24,(04108) El Polo,327,218,261,806
40239,2020-04-20,(04108) El Polo,220,162,113,495
40240,2020-07-28,(02105) Calle 142,731,452,413,1596
40241,2020-06-04,(06000) Portal Eldorado,952,632,454,2038
40242,2020-04-13,(02302) Virrey,350,244,200,794
40243,2020-07-03,(06000) Portal Eldorado - alimentacion,4309,2173,2253,8735
40244,2020-06-15,(07009) SENA,236,130,168,534
40245,2020-04-29,(07106) EL CAMPIN,195,148,127,470
40246,2020-08-19,(07200) Tygua-San José,233,139,150,522
40247,2020-06-02,(04104) Avenida 68,566,306,317,1189
40248,2020-05-31,(04100) Carrera 77,324,142,253,719
40249,2020-01-26,(03012) SUBA - CALLE 95,321,201,356,878
40250,2020-08-14,(07103) AV. CHILE,715,451,450,1616
40251,2020-05-20,(09002) Consuelo,408,214,217,839
40252,2020-06-24,(07007) NQS - Calle 38A Sur,401,252,244,897
40253,2020-04-03,(10010) San Bernardo,332,251,279,862
40254,2020-06-28,(02104) Calle 146,266,169,200,635
40255,2020-06-07,(07103) AV. CHILE,165,99,164,428
40256,2020-09-14,(12007) Zona Industrial,372,233,199,804
40257,2020-09-28,(06109) Centro Memoria,296,178,197,671
40258,2020-08-25,(10005) Bicentenario,87,48,78,213
40259,2020-03-20,(40002) Manitas,137,81,87,305
40260,2020-02-23,(05100) Banderas P. Central - alimentacion,3047,1178,2210,6435
40261,2020-06-25,(02001) Centro Comercial Santa Fe,533,329,387,1249
40262,2020-06-02,(09123) Calle 76,914,635,495,2044
40263,2020-01-07,(07102) NQS - CALLE 75,1047,632,653,2332
40264,2020-04-08,(06100) Av. Rojas,104,69,73,246
40265,2020-06-07,(09004) Santa Lucía,729,321,455,1505
40266,2020-09-17,(02202) Calle 127,1153,825,744,2722
40267,2020-07-11,(07110) PALOQUEMAO,486,331,260,1077
40268,2020-06-08,(02105) Calle 142,736,460,470,1666
40269,2020-09-24,(09107) Hortúa,619,389,497,1505
40270,2020-01-06,(05101) Mandalay - Cr.73,90,29,81,200
40271,2020-04-29,(09122) Calle 72,715,509,400,1624
40272,2020-02-16,(10007) Las Nieves,182,193,451,826
40273,2020-09-06,(07111) NQS - RICAURTE,231,172,228,631
40274,2020-07-03,(07201) Guatoque -Veraguas,227,127,131,485
40275,2020-09-18,(07201) Guatoque -Veraguas,209,142,176,527
40276,2020-04-23,(07105) MOVISTAR ARENA,162,111,73,346
40277,2020-02-02,(02000) Cabecera Autopista Norte - intermunicipal,655,415,788,1858
40278,2020-06-20,(04102) Avenida Boyaca,284,158,205,647
40279,2020-07-24,(03003) 21 ANGELES,286,135,152,573
40280,2020-09-13,(03001) LA CAMPIÑA,344,162,328,834
40281,2020-09-10,(02502) Terminal,410,300,374,1084
40282,2020-10-01,(10004) Policarpa,294,143,208,645
40283,2020-05-17,(04001) Quirigua,97,60,71,228
40284,2020-09-21,(05103) Marsella,297,172,228,697
40285,2020-03-24,(04103) Las Ferias,270,181,167,618
40286,2020-08-01,(07009) SENA,387,223,284,894
40287,2020-10-02,(03005) SUBA - AV. BOYACA,532,310,454,1296
40288,2020-09-30,(07506) DESPENSA,497,286,370,1153
40289,2020-09-18,(02102) Calle 161,282,171,244,697
40290,2020-05-06,(02103) Mazurén,126,69,104,299
40291,2020-08-04,(02502) Terminal,361,237,286,884
40292,2020-07-27,(10009) Museo Nacional,440,243,266,949
40293,2020-07-06,(07101) CASTELLANA,221,140,149,510
40294,2020-10-01,(09003) Socorro,627,335,422,1384
40295,2020-06-08,(07002) MADELENA,717,433,436,1586
40296,2020-06-05,(09113) Calle 22,375,218,376,969
40297,2020-04-21,(10004) Policarpa,121,60,100,281
40298,2020-08-24,(04002) Carrera 90,598,325,338,1261
40299,2020-07-12,(50003) Corral Molinos,605,281,509,1395
40300,2020-06-15,(09000) Cabecera Usme,534,315,425,1274
40301,2020-05-09,(06106) Recinto Ferial,131,78,52,261
40302,2020-05-15,(07004) VENECIA,756,448,404,1608
40303,2020-04-10,(40001) Juan Pablo II,85,49,46,180
40304,2020-09-04,(07108) Av. El Dorado,163,104,116,383
40305,2020-07-27,(06002) Normandía,256,159,155,570
40306,2020-05-20,(04101) Minuto de Dios,265,167,158,590
40307,2020-09-14,(04001) Quirigua,389,240,292,921
40308,2020-10-02,(09108) Hospital,57,53,82,192
40309,2020-10-05,(09108) Hospital,62,51,94,207
40310,2020-08-08,(07009) SENA,412,223,331,966
40311,2020-01-03,(09105) Río Fucha,335,191,278,804
40312,2020-04-12,(02304) Heroes,159,135,78,372
40313,2020-06-06,(03010) PUENTE LARGO,224,140,135,499
40314,2020-05-10,(03011) SUBA - CALLE 100,127,67,74,268
40315,2020-07-03,(04106) Carrera 47,339,187,211,737
40316,2020-10-03,(05101) Mandalay - Cr.73,128,60,117,305
40317,2020-06-07,(04106) Carrera 47,102,52,69,223
40318,2020-05-08,(07005) ALQUERIA,392,223,174,789
40319,2020-04-03,(09108) Hospital,34,19,33,86
40320,2020-05-08,(09108) Hospital,60,33,53,146
40321,2020-05-20,(07003) SEVILLANA,354,186,182,722
40322,2020-07-17,(02304) Heroes,639,446,414,1499
40323,2020-06-09,(12007) Zona Industrial,322,198,137,657
40324,2020-05-03,(06102) Salitre El Greco,51,40,33,124
40325,2020-03-01,(06109) Centro Memoria,210,134,239,583
40326,2020-06-16,(04001) Quirigua,405,242,269,916
40327,2020-03-21,(06111) Universidades,0,48,145,193
40328,2020-06-02,(10003) Ciudad Jardín,172,94,104,370
40329,2020-07-30,(14004) Museo del Oro,265,147,185,597
40330,2020-02-16,(09106) Nariño,430,237,528,1195
40331,2020-07-06,(07003) SEVILLANA,487,251,248,986
40332,2020-04-09,(09121) Las Flores,169,134,78,381
40333,2020-03-28,(05100) Banderas P. Central,156,110,118,384
40334,2020-05-16,(14005) Las Aguas,0,34,117,151
40335,2020-06-07,(09106) Nariño,115,64,97,276
40336,2020-08-30,(08000) Portal Tunal,217,123,157,497
40337,2020-10-05,(09003) Socorro,648,323,440,1411
40338,2020-03-29,(03006) NIZA - CALLE 127,107,89,42,238
40339,2020-05-25,(08002) Biblioteca,104,57,51,212
40340,2020-03-27,(05103) Marsella,169,93,87,349
40341,2020-08-05,(05103) Marsella,347,193,188,728
40342,2020-08-03,(03005) SUBA - AV. BOYACA,299,196,202,697
40343,2020-06-19,(09105) Río Fucha,149,66,97,312
40344,2020-04-26,(09106) Nariño,91,44,61,196
40345,2020-04-12,(04104) Avenida 68,100,81,73,254
40346,2020-04-13,(07506) DESPENSA,208,126,121,455
40347,2020-07-24,(07101) CASTELLANA,187,100,83,370
40348,2020-04-27,(04000) Cabecera Calle 80 - intermunicipal,99,24,37,160
40349,2020-03-29,(06103) CAN,139,100,85,324
40350,2020-06-30,(05101) Mandalay - Cr.73,137,80,63,280
40351,2020-06-22,(09105) Río Fucha,39,19,42,100
40352,2020-04-21,(06106) Recinto Ferial,169,107,78,354
40353,2020-07-09,(03014) SAN MARTIN,27,17,11,55
40354,2020-04-09,(07010) Bosa,124,80,92,296
40355,2020-10-08,(50006) Corral Carrera 77,1,2,15,18
40356,2020-05-17,(05101) Mandalay - Cr.73,13,9,4,26
40357,2020-08-16,(09114) Calle 26,65,52,71,188
40358,2020-06-07,(06106) Recinto Ferial,65,38,59,162
40359,2020-03-29,(09105) Río Fucha,20,14,21,55
40360,2020-08-23,(06105) Quinta Paredes,29,26,34,89
40361,2020-09-13,(09105) Río Fucha,0,25,67,92
40362,2020-05-10,(10003) Ciudad Jardín,39,26,32,97
40363,2020-07-19,(14005) Las Aguas,44,30,57,131
40364,2020-01-04,(04000) Cabecera Calle 80 - alimentacion,7017,3232,5685,15934
40365,2020-01-30,(04000) Cabecera Calle 80 - alimentacion,22782,13358,14088,50228
40366,2020-05-07,(04000) Cabecera Calle 80 - alimentacion,2506,1437,1551,5494
40367,2020-02-13,(07005) ALQUERIA,2758,1462,1437,5657
40368,2020-02-07,(09002) Consuelo,1381,753,878,3012
40369,2020-02-17,(09002) Consuelo,1450,824,868,3142
40370,2020-08-18,(09002) Consuelo,438,250,265,953
40371,2020-02-21,(09118) Marly,6101,4941,4642,15684
40372,2020-05-21,(07504) TERREROS,4319,2565,1975,8859
40373,2020-02-11,(03000) Portal Suba - alimentacion,29966,18097,17081,65144
40374,2020-01-17,(06000) Portal Eldorado - alimentacion,15435,7847,8880,32162
40375,2020-01-20,(05000) Portal Américas,13339,7779,7434,28552
40376,2020-02-11,(09000) Cabecera Usme - alimentacion,26736,15107,16214,58057
40377,2020-03-15,(07503) SAN MATEO,7906,3564,4850,16320
40378,2020-10-03,(05000) Portal Américas - alimentacion,9802,4642,7588,22032
40379,2020-09-21,(07503) SAN MATEO,10409,4855,5364,20628
40380,2020-10-02,(09001) Molinos,2936,1494,2535,6965
40381,2020-03-06,(04103) Las Ferias,1512,829,866,3207
40382,2020-06-09,(08000) Portal Tunal - alimentacion,6112,3363,3093,12568
40383,2020-03-17,(02102) Calle 161,960,560,577,2097
40384,2020-01-26,(07000) Portal Sur - alimentacion,7492,3156,4961,15609
40385,2020-06-27,(07001) PERDOMO,745,366,531,1642
40386,2020-06-22,(07505) LEON XIII,861,474,426,1761
40387,2020-01-14,(04104) Avenida 68,2845,1454,1638,5937
40388,2020-05-07,(07110) PALOQUEMAO,565,302,197,1064
40389,2020-03-16,(12003) Ricaurte,1061,693,525,2279
40390,2020-09-30,(07000) Portal Sur - alimentacion,9343,4966,5555,19864
40391,2020-05-28,(09101) Quiroga,410,226,261,897
40392,2020-07-06,(09101) Quiroga,589,320,419,1328
40393,2020-03-17,(03013) RIO NEGRO,786,481,567,1834
40394,2020-05-16,(03013) RIO NEGRO,148,96,110,354
40395,2020-08-16,(03013) RIO NEGRO,70,36,66,172
40396,2020-09-02,(50003) Corral Molinos,1531,802,1208,3541
40397,2020-06-30,(07000) Portal Sur - alimentacion,8438,4851,4201,17490
40398,2020-07-31,(07000) Portal Sur - alimentacion,6701,3753,3455,13909
40399,2020-05-14,(09103) Olaya,752,423,357,1532
40400,2020-10-11,(02000) Cabecera Autopista Norte - alimentacion,2290,864,1869,5023
40401,2020-02-17,(07112) COMUNEROS,3739,2356,2261,8356
40402,2020-03-17,(02201) Prado,3024,1965,1665,6654
40403,2020-02-04,(10007) Las Nieves,2099,1271,1223,4593
40404,2020-06-19,(09001) Molinos,2586,1428,1846,5860
40405,2020-04-06,(50003) Corral Molinos,760,359,566,1685
40406,2020-10-01,(07010) Bosa,0,367,1008,1375
40407,2020-01-16,(09123) Calle 76,4231,2910,2628,9769
40408,2020-09-08,(09110) Avenida Jimenez,957,799,917,2673
40409,2020-10-07,(02201) Prado,988,673,824,2485
40410,2020-05-06,(10006) San Victorino,250,162,213,625
40411,2020-09-10,(10006) San Victorino,650,282,379,1311
40412,2020-06-12,(03000) Portal Suba,1296,797,837,2930
40413,2020-01-13,(09107) Hortúa,1873,1115,1302,4290
40414,2020-06-07,(09107) Hortúa,188,124,137,449
40415,2020-01-20,(10005) Bicentenario - alimentacion,585,267,535,1387
40416,2020-03-25,(10006) San Victorino,187,147,149,483
40417,2020-09-30,(02201) Prado,1054,684,782,2520
40418,2020-05-13,(05100) Banderas P. Central - alimentacion,2115,1031,1034,4180
40419,2020-09-02,(02000) Cabecera Autopista Norte - intermunicipal,560,358,468,1386
40420,2020-03-14,(07106) EL CAMPIN,1057,730,844,2631
40421,2020-04-27,(02000) Cabecera Autopista Norte - intermunicipal,155,34,32,221
40422,2020-07-29,(10000) Portal 20 de Julio,2210,1135,1082,4427
40423,2020-04-19,(07112) COMUNEROS,122,89,75,286
40424,2020-05-20,(07112) COMUNEROS,651,371,362,1384
40425,2020-04-20,(08002) Biblioteca,182,100,109,391
40426,2020-08-12,(09004) Santa Lucía,2351,1207,1287,4845
40427,2020-02-22,(10007) Las Nieves,1064,856,987,2907
40428,2020-04-07,(09000) Cabecera Usme - alimentacion,4478,2075,2584,9137
40429,2020-08-26,(04100) Carrera 77,1184,644,843,2671
40430,2020-04-13,(07503) SAN MATEO,5312,3318,2436,11066
40431,2020-09-18,(02101) Toberín,1723,1037,1426,4186
40432,2020-05-13,(07503) SAN MATEO,7945,4827,3615,16387
40433,2020-08-15,(02201) Prado,680,435,470,1585
40434,2020-09-22,(02201) Prado,1026,675,723,2424
40435,2020-03-10,(03005) SUBA - AV. BOYACA,616,509,464,1589
40436,2020-03-13,(40003) Mirador del Paraiso,171,1018,700,1889
40437,2020-04-26,(05002) Tintal,460,263,219,942
40438,2020-08-31,(05002) Tintal,2381,1485,1453,5319
40439,2020-09-17,(05002) Tintal,2838,1694,1895,6427
40440,2020-03-14,(05002) Tintal,6028,2902,4033,12963
40441,2020-03-09,(06106) Recinto Ferial,504,159,215,878
40442,2020-07-25,(02300) Calle 100,703,468,369,1540
40443,2020-06-18,(10000) Portal 20 de Julio,2303,1135,1209,4647
40444,2020-02-24,(07006) General Santander,2945,1695,1512,6152
40445,2020-02-17,(07006) General Santander,2921,1690,1541,6152
40446,2020-09-02,(06109) Centro Memoria,274,159,159,592
40447,2020-07-18,(03009) Av. Suba- Calle 116,346,206,164,716
40448,2020-09-09,(03009) Av. Suba- Calle 116,552,349,277,1178
40449,2020-01-10,(03006) NIZA - CALLE 127,1661,978,1095,3734
40450,2020-06-02,(06000) Portal Eldorado - alimentacion,3707,1831,1826,7364
40451,2020-03-11,(12007) Zona Industrial,1166,744,610,2520
40452,2020-08-18,(02304) Heroes,698,480,425,1603
40453,2020-01-30,(03003) 21 ANGELES,1717,893,964,3574
40454,2020-05-13,(03003) 21 ANGELES,261,116,133,510
40455,2020-04-06,(10006) San Victorino,186,138,135,459
40456,2020-08-03,(03001) LA CAMPIÑA,868,502,545,1915
40457,2020-04-10,(02101) Toberín,102,93,91,286
40458,2020-08-08,(02101) Toberín,771,426,638,1835
40459,2020-01-09,(04103) Las Ferias,1076,610,750,2436
40460,2020-04-21,(07104) Simon Bolivar,248,166,147,561
40461,2020-03-01,(02000) Cabecera Autopista Norte,1869,937,1836,4642
40462,2020-03-26,(12001) Carrera 43,249,177,130,556
40463,2020-07-08,(05001) Patio Bonito,1394,1004,1356,3754
40464,2020-01-12,(04000) Cabecera Calle 80,1203,557,1384,3144
40465,2020-09-28,(02202) Calle 127,1218,891,879,2988
40466,2020-02-09,(04001) Quirigua,432,206,446,1084
40467,2020-02-24,(04001) Quirigua,2067,1338,1158,4563
40468,2020-09-12,(09121) Las Flores,509,344,482,1335
40469,2020-06-23,(04001) Quirigua,423,269,262,954
40470,2020-09-06,(02205) Calle 106,61,62,98,221
40471,2020-10-12,(02205) Calle 106,68,74,125,267
40472,2020-10-03,(40001) Juan Pablo II,521,249,434,1204
40473,2020-03-24,(09001) Molinos,1853,995,1444,4292
40474,2020-08-05,(06106) Recinto Ferial,209,127,102,438
40475,2020-09-03,(06106) Recinto Ferial,270,164,138,572
40476,2020-06-06,(06100) Av. Rojas,105,73,118,296
40477,2020-02-16,(02302) Virrey,371,346,529,1246
40478,2020-09-23,(12003) Ricaurte,465,312,218,995
40479,2020-09-27,(03010) PUENTE LARGO,74,59,129,262
40480,2020-08-23,(10010) San Bernardo,216,119,213,548
40481,2020-08-25,(10010) San Bernardo,583,277,368,1228
40482,2020-01-19,(07200) Tygua-San José,184,89,257,530
40483,2020-05-24,(02105) Calle 142,174,120,123,417
40484,2020-06-18,(02105) Calle 142,804,514,433,1751
40485,2020-04-22,(09116) Avenida 39,181,137,118,436
40486,2020-06-19,(05102) Av. Américas - Av. Boyacá,218,129,166,513
40487,2020-09-11,(07007) NQS - Calle 38A Sur,415,234,299,948
40488,2020-10-04,(09122) Calle 72,391,291,602,1284
40489,2020-02-18,(07105) MOVISTAR ARENA,1478,857,768,3103
40490,2020-02-19,(07105) MOVISTAR ARENA,1405,826,734,2965
40491,2020-09-01,(02304) Heroes,856,592,538,1986
40492,2020-08-06,(02104) Calle 146,606,383,418,1407
40493,2020-06-21,(09118) Marly,501,316,331,1148
40494,2020-07-29,(09120) Calle 63,1058,699,631,2388
40495,2020-07-15,(05107) Américas - Cr.53,399,237,229,865
40496,2020-05-13,(09004) Santa Lucía,1947,979,1036,3962
40497,2020-05-20,(09004) Santa Lucía,2084,1064,1056,4204
40498,2020-09-20,(07110) PALOQUEMAO,148,118,176,442
40499,2020-10-02,(10003) Ciudad Jardín,281,128,229,638
40500,2020-10-04,(07101) CASTELLANA,32,22,67,121
40501,2020-04-24,(12004) Carrera 22,82,52,72,206
40502,2020-02-08,(09106) Nariño,1212,638,1010,2860
40503,2020-09-13,(05102) Av. Américas - Av. Boyacá,76,38,77,191
40504,2020-04-28,(03012) SUBA - CALLE 95,212,142,112,466
40505,2020-09-27,(03012) SUBA - CALLE 95,85,56,123,264
40506,2020-04-28,(09122) Calle 72,699,506,418,1623
40507,2020-06-03,(04003) Avenida Ciudad de Cali,981,575,627,2183
40508,2020-08-06,(06104) Gobernación,236,145,112,493
40509,2020-08-17,(02202) Calle 127,301,303,230,834
40510,2020-08-08,(07110) PALOQUEMAO,388,251,225,864
40511,2020-06-10,(06104) Gobernación,228,165,99,492
40512,2020-03-31,(04000) Cabecera Calle 80,493,321,317,1131
40513,2020-02-11,(50002) Corral Calle 40 Sur,167,87,138,392
40514,2020-08-28,(07107) U. NACIONAL,332,220,218,770
40515,2020-09-14,(07107) U. NACIONAL,420,239,253,912
40516,2020-05-08,(09123) Calle 76,646,451,352,1449
40517,2020-05-16,(09123) Calle 76,471,364,333,1168
40518,2020-04-26,(06109) Centro Memoria,58,34,45,137
40519,2020-08-20,(04102) Avenida Boyaca,347,200,236,783
40520,2020-05-30,(05102) Av. Américas - Av. Boyacá,133,58,93,284
40521,2020-08-10,(03003) 21 ANGELES,282,156,173,611
40522,2020-09-06,(07001) PERDOMO,306,147,286,739
40523,2020-04-04,(09121) Las Flores,286,198,175,659
40524,2020-06-20,(02104) Calle 146,582,366,391,1339
40525,2020-06-03,(06107) Ciudad Universitaria,169,103,92,364
40526,2020-06-24,(06107) Ciudad Universitaria,184,120,106,410
40527,2020-05-05,(04103) Las Ferias,251,142,113,506
40528,2020-05-30,(07001) PERDOMO,554,284,364,1202
40529,2020-03-24,(07103) AV. CHILE,703,517,443,1663
40530,2020-10-03,(14001) La Sabana,133,90,134,357
40531,2020-04-28,(07002) MADELENA,393,229,247,869
40532,2020-08-26,(12004) Carrera 22,261,157,124,542
40533,2020-05-02,(07111) NQS - RICAURTE,430,288,196,914
40534,2020-04-23,(07107) U. NACIONAL,233,143,112,488
40535,2020-01-18,(07102) NQS - CALLE 75,706,568,727,2001
40536,2020-01-12,(05100) Banderas P. Central,728,333,758,1819
40537,2020-03-25,(07009) SENA,280,173,165,618
40538,2020-06-01,(04106) Carrera 47,307,164,170,641
40539,2020-09-09,(04106) Carrera 47,366,186,194,746
40540,2020-05-03,(09119) Calle 57,107,70,88,265
40541,2020-05-23,(09118) Marly,954,651,533,2138
40542,2020-07-14,(08001) Parque el Tunal,342,203,209,754
40543,2020-02-23,(09113) Calle 22,630,313,549,1492
40544,2020-09-09,(40001) Juan Pablo II,597,348,399,1344
40545,2020-08-04,(10007) Las Nieves,657,380,315,1352
40546,2020-05-12,(07003) SEVILLANA,342,181,178,701
40547,2020-09-10,(06106) Recinto Ferial,250,119,154,523
40548,2020-09-26,(04101) Minuto de Dios,278,146,312,736
40549,2020-06-22,(03006) NIZA - CALLE 127,206,128,91,425
40550,2020-08-27,(07008) NQS - Calle 30 Sur,294,158,182,634
40551,2020-07-08,(06101) El Tiempo,373,230,197,800
40552,2020-03-30,(09100) Calle 40 Sur,853,470,504,1827
40553,2020-09-22,(04001) Quirigua,443,266,328,1037
40554,2020-04-04,(50003) Corral Molinos,616,270,393,1279
40555,2020-01-12,(06102) Salitre El Greco,265,173,234,672
40556,2020-02-02,(07108) Av. El Dorado,126,101,236,463
40557,2020-04-06,(07010) Bosa,281,161,183,625
40558,2020-03-26,(02502) Terminal,121,101,122,344
40559,2020-04-11,(02302) Virrey,242,178,131,551
40560,2020-06-17,(07108) Av. El Dorado,134,87,101,322
40561,2020-05-17,(03006) NIZA - CALLE 127,137,88,62,287
40562,2020-03-20,(12002) CDS - Carrera 32,123,94,44,261
40563,2020-04-04,(09117) Calle 45,321,231,151,703
40564,2020-06-24,(06102) Salitre El Greco,264,130,124,518
40565,2020-04-25,(06101) El Tiempo,132,120,84,336
40566,2020-04-01,(07506) DESPENSA,155,109,138,402
40567,2020-06-22,(09121) Las Flores,221,155,170,546
40568,2020-06-02,(40002) Manitas,362,213,250,825
40569,2020-08-08,(09111) Calle 19,544,352,411,1307
40570,2020-05-24,(06111) Universidades,0,30,90,120
40571,2020-05-11,(07106) EL CAMPIN,211,159,145,515
40572,2020-01-09,(03014) SAN MARTIN,187,110,134,431
40573,2020-05-25,(08001) Parque el Tunal,109,71,76,256
40574,2020-03-30,(10008) San Diego,145,101,106,352
40575,2020-05-24,(12004) Carrera 22,30,18,26,74
40576,2020-04-14,(07006) General Santander,250,158,128,536
40577,2020-06-04,(06106) Recinto Ferial,236,132,86,454
40578,2020-08-13,(07101) CASTELLANA,181,92,114,387
40579,2020-05-12,(04102) Avenida Boyaca,231,135,126,492
40580,2020-03-01,(12007) Zona Industrial,134,153,208,495
40581,2020-06-14,(07007) NQS - Calle 38A Sur,150,67,88,305
40582,2020-07-26,(09105) Río Fucha,17,7,19,43
40583,2020-07-12,(02102) Calle 161,62,43,64,169
40584,2020-10-12,(05102) Av. Américas - Av. Boyacá,82,39,62,183
40585,2020-03-21,(03014) SAN MARTIN,11,9,9,29
40586,2020-08-23,(05101) Mandalay - Cr.73,21,10,17,48
40587,2020-01-11,(50006) Corral Carrera 77,15,11,15,41
40588,2020-03-22,(03007) HUMEDAL CORDOBA,46,27,22,95
40589,2020-05-06,(03014) SAN MARTIN,21,6,24,51
40590,2020-04-19,(10005) Bicentenario - alimentacion,39,26,37,102
40591,2020-05-24,(03014) SAN MARTIN,9,2,6,17
40592,2020-03-16,(07005) ALQUERIA,1751,987,934,3672
40593,2020-09-29,(09002) Consuelo,504,270,388,1162
40594,2020-01-18,(07504) TERREROS,11404,5557,7291,24252
40595,2020-07-01,(07504) TERREROS,6374,3552,3118,13044
40596,2020-06-06,(05000) Portal Américas - alimentacion,7503,3739,3839,15081
40597,2020-02-03,(03002) SUBA - TV- 91,4532,2758,2472,9762
40598,2020-03-11,(07505) LEON XIII,8037,4397,3618,16052
40599,2020-02-13,(09122) Calle 72,8736,5621,4430,18787
40600,2020-02-06,(09000) Cabecera Usme - alimentacion,25488,14661,16094,56243
40601,2020-08-26,(10000) Portal 20 de Julio - alimentacion,3782,1703,2346,7831
40602,2020-06-17,(07503) SAN MATEO,11040,6827,5724,23591
40603,2020-09-06,(04000) Cabecera Calle 80 - alimentacion,1399,668,1440,3507
40604,2020-07-16,(05001) Patio Bonito,1528,815,923,3266
40605,2020-09-05,(04103) Las Ferias,305,150,221,676
40606,2020-01-10,(05001) Patio Bonito,5226,2895,2910,11031
40607,2020-01-22,(02000) Cabecera Autopista Norte - intermunicipal,4565,3088,2853,10506
40608,2020-02-01,(05005) Transversal 86,1411,555,974,2940
40609,2020-01-17,(07112) COMUNEROS,3289,1897,2223,7409
40610,2020-09-16,(07503) SAN MATEO,12670,7031,6695,26396
40611,2020-08-07,(10001) Country Sur,463,206,333,1002
40612,2020-08-18,(09100) Calle 40 Sur,1608,924,1049,3581
40613,2020-03-13,(05100) Banderas P. Central - alimentacion,684,2801,2167,5652
40614,2020-02-03,(09113) Calle 22,1560,865,1149,3574
40615,2020-01-15,(10003) Ciudad Jardín,909,468,620,1997
40616,2020-02-25,(02204) Pepe Sierra,5208,3419,2494,11121
40617,2020-10-10,(10005) Bicentenario - alimentacion,161,86,196,443
40618,2020-08-10,(07001) PERDOMO,883,484,521,1888
40619,2020-01-17,(09120) Calle 63,3882,2926,3112,9920
40620,2020-01-02,(07113) SANTA ISABEL,828,517,732,2077
40621,2020-03-16,(09000) Cabecera Usme - alimentacion,19841,10833,11872,42546
40622,2020-10-01,(09000) Cabecera Usme - alimentacion,9837,4845,6664,21346
40623,2020-07-12,(09000) Cabecera Usme,581,315,513,1409
40624,2020-03-17,(06002) Normandía,1160,685,673,2518
40625,2020-01-11,(09110) Avenida Jimenez,2629,1874,1693,6196
40626,2020-03-18,(07102) NQS - CALLE 75,934,702,553,2189
40627,2020-05-31,(09000) Cabecera Usme - alimentacion,2241,1071,1344,4656
40628,2020-02-16,(09103) Olaya,1070,450,936,2456
40629,2020-03-11,(03007) HUMEDAL CORDOBA,965,595,511,2071
40630,2020-01-24,(09116) Avenida 39,2315,1552,1398,5265
40631,2020-01-08,(05001) Patio Bonito,4871,2782,2935,10588
40632,2020-07-27,(05100) Banderas P. Central - alimentacion,2561,1331,1366,5258
40633,2020-04-21,(09103) Olaya,545,321,309,1175
40634,2020-08-20,(07002) MADELENA,738,427,454,1619
40635,2020-02-27,(02104) Calle 146,9485,5909,4956,20350
40636,2020-09-02,(09113) Calle 22,429,227,323,979
40637,2020-06-08,(02204) Pepe Sierra,735,514,406,1655
40638,2020-02-29,(07007) NQS - Calle 38A Sur,1390,746,978,3114
40639,2020-03-09,(04000) Cabecera Calle 80,958,1997,1459,4414
40640,2020-06-24,(04000) Cabecera Calle 80,1188,692,883,2763
40641,2020-02-16,(03002) SUBA - TV- 91,867,406,926,2199
40642,2020-05-15,(09000) Cabecera Usme - alimentacion,6682,3588,3673,13943
40643,2020-02-26,(09107) Hortúa,2255,1444,1512,5211
40644,2020-02-14,(02302) Virrey,3708,2557,1897,8162
40645,2020-05-21,(02000) Cabecera Autopista Norte - intermunicipal,393,266,260,919
40646,2020-08-26,(09000) Cabecera Usme - alimentacion,8148,4288,4607,17043
40647,2020-02-03,(04108) El Polo,1938,1165,1156,4259
40648,2020-08-08,(07000) Portal Sur,1268,683,893,2844
40649,2020-04-24,(07503) SAN MATEO,5667,3634,2470,11771
40650,2020-05-08,(08001) Parque el Tunal,312,175,171,658
40651,2020-01-30,(06108) Concejo de Bogotá,914,434,411,1759
40652,2020-06-05,(07010) Bosa,680,346,370,1396
40653,2020-05-08,(09120) Calle 63,743,496,439,1678
40654,2020-01-14,(07007) NQS - Calle 38A Sur,1750,1016,1066,3832
40655,2020-09-13,(06001) Modelia,98,50,100,248
40656,2020-09-19,(06001) Modelia,273,185,268,726
40657,2020-03-13,(04000) Cabecera Calle 80 - alimentacion,753,4339,3964,9056
40658,2020-06-16,(09107) Hortúa,625,363,385,1373
40659,2020-06-29,(09123) Calle 76,219,196,199,614
40660,2020-09-30,(05105) Pradera,661,402,392,1455
40661,2020-01-10,(03011) SUBA - CALLE 100,1938,907,1058,3903
40662,2020-01-21,(03011) SUBA - CALLE 100,1459,564,798,2821
40663,2020-08-06,(03012) SUBA - CALLE 95,257,156,159,572
40664,2020-08-01,(50002) Corral Calle 40 Sur,14,7,16,37
40665,2020-02-17,(05107) Américas - Cr.53,2559,1506,1370,5435
40666,2020-04-09,(05005) Transversal 86,78,43,36,157
40667,2020-01-11,(08000) Portal Tunal,1168,685,699,2552
40668,2020-09-19,(05107) Américas - Cr.53,340,221,314,875
40669,2020-07-14,(03009) Av. Suba- Calle 116,482,280,193,955
40670,2020-04-14,(02205) Calle 106,212,152,125,489
40671,2020-09-02,(04003) Avenida Ciudad de Cali,1089,624,822,2535
40672,2020-01-07,(12007) Zona Industrial,936,617,500,2053
40673,2020-02-07,(12007) Zona Industrial,1256,787,690,2733
40674,2020-09-05,(07106) EL CAMPIN,340,228,243,811
40675,2020-06-09,(07103) AV. CHILE,924,564,394,1882
40676,2020-02-22,(06102) Salitre El Greco,698,464,555,1717
40677,2020-07-23,(03007) HUMEDAL CORDOBA,127,83,58,268
40678,2020-03-17,(09117) Calle 45,2047,1390,1400,4837
40679,2020-02-07,(03005) SUBA - AV. BOYACA,2945,1660,1622,6227
40680,2020-02-09,(05101) Mandalay - Cr.73,129,56,118,303
40681,2020-07-12,(02101) Toberín,332,235,373,940
40682,2020-01-20,(14005) Las Aguas,2386,1531,1583,5500
40683,2020-09-24,(10005) Bicentenario - alimentacion,222,108,231,561
40684,2020-09-04,(04107) Escuela Militar,146,107,101,354
40685,2020-02-09,(02000) Cabecera Autopista Norte,1833,924,1845,4602
40686,2020-10-03,(04003) Avenida Ciudad de Cali,951,453,997,2401
40687,2020-07-01,(05103) Marsella,437,240,215,892
40688,2020-02-13,(09109) Tercer Milenio,1475,892,882,3249
40689,2020-06-26,(09109) Tercer Milenio,389,214,262,865
40690,2020-05-06,(05001) Patio Bonito,1217,664,675,2556
40691,2020-02-01,(03003) 21 ANGELES,908,377,628,1913
40692,2020-04-08,(07505) LEON XIII,1059,641,591,2291
40693,2020-09-04,(03001) LA CAMPIÑA,1386,726,829,2941
40694,2020-09-02,(06101) El Tiempo,373,225,230,828
40695,2020-06-08,(10001) Country Sur,1156,532,650,2338
40696,2020-04-15,(05001) Patio Bonito,883,500,524,1907
40697,2020-07-19,(09000) Cabecera Usme - alimentacion,1832,965,1151,3948
40698,2020-09-26,(40001) Juan Pablo II,532,261,411,1204
40699,2020-07-27,(09120) Calle 63,1049,723,631,2403
40700,2020-10-07,(07009) SENA,751,442,633,1826
40701,2020-01-06,(03010) PUENTE LARGO,258,171,252,681
40702,2020-08-11,(03010) PUENTE LARGO,259,173,186,618
40703,2020-03-24,(03006) NIZA - CALLE 127,391,307,288,986
40704,2020-05-30,(02105) Calle 142,514,315,303,1132
40705,2020-09-20,(02105) Calle 142,231,155,261,647
40706,2020-03-27,(09109) Tercer Milenio,139,88,80,307
40707,2020-05-11,(09109) Tercer Milenio,265,168,179,612
40708,2020-07-16,(09109) Tercer Milenio,211,125,168,504
40709,2020-04-05,(09116) Avenida 39,76,43,51,170
40710,2020-10-12,(09001) Molinos,955,393,964,2312
40711,2020-03-31,(10010) San Bernardo,331,231,241,803
40712,2020-05-31,(10010) San Bernardo,228,115,179,522
40713,2020-09-05,(09123) Calle 76,729,571,705,2005
40714,2020-02-17,(40002) Manitas,1343,780,821,2944
40715,2020-04-11,(40002) Manitas,99,65,65,229
40716,2020-07-10,(02102) Calle 161,268,142,173,583
40717,2020-05-23,(09123) Calle 76,529,384,349,1262
40718,2020-10-07,(09122) Calle 72,1348,914,1182,3444
40719,2020-01-06,(50003) Corral Molinos,718,450,1027,2195
40720,2020-08-30,(10008) San Diego,90,58,84,232
40721,2020-08-09,(09120) Calle 63,338,203,320,861
40722,2020-05-12,(04107) Escuela Militar,100,70,63,233
40723,2020-08-12,(10009) Museo Nacional,486,296,282,1064
40724,2020-03-19,(10004) Policarpa,461,233,307,1001
40725,2020-07-13,(06111) Universidades,209,121,192,522
40726,2020-07-31,(06111) Universidades,309,163,262,734
40727,2020-04-18,(02104) Calle 146,272,213,153,638
40728,2020-08-31,(02200) Alcalá,1790,1216,1019,4025
40729,2020-05-31,(03006) NIZA - CALLE 127,134,98,85,317
40730,2020-03-08,(04107) Escuela Militar,124,73,182,379
40731,2020-05-09,(02304) Heroes,353,265,216,834
40732,2020-01-03,(14005) Las Aguas,716,473,736,1925
40733,2020-01-05,(02105) Calle 142,623,327,754,1704
40734,2020-02-09,(07111) NQS - RICAURTE,525,405,573,1503
40735,2020-10-01,(07005) ALQUERIA,629,384,478,1491
40736,2020-04-02,(03010) PUENTE LARGO,191,141,111,443
40737,2020-08-08,(07004) VENECIA,646,352,369,1367
40738,2020-05-01,(03012) SUBA - CALLE 95,66,49,53,168
40739,2020-06-29,(09122) Calle 72,366,244,288,898
40740,2020-06-24,(06104) Gobernación,260,164,116,540
40741,2020-06-19,(06109) Centro Memoria,290,178,149,617
40742,2020-06-23,(06109) Centro Memoria,291,152,131,574
40743,2020-07-22,(09114) Calle 26,264,162,168,594
40744,2020-07-12,(07104) Simon Bolivar,131,89,119,339
40745,2020-05-24,(09121) Las Flores,144,97,120,361
40746,2020-06-01,(02502) Terminal,375,265,278,918
40747,2020-04-24,(40001) Juan Pablo II,310,157,208,675
40748,2020-02-23,(04001) Quirigua,376,215,469,1060
40749,2020-03-15,(07004) VENECIA,775,381,692,1848
40750,2020-05-03,(02104) Calle 146,176,126,110,412
40751,2020-06-19,(03011) SUBA - CALLE 100,533,268,229,1030
40752,2020-05-09,(09121) Las Flores,335,234,231,800
40753,2020-07-05,(07001) PERDOMO,275,133,242,650
40754,2020-04-02,(09119) Calle 57,219,196,175,590
40755,2020-04-06,(09110) Avenida Jimenez,253,227,284,764
40756,2020-03-15,(09121) Las Flores,491,301,545,1337
40757,2020-05-13,(40002) Manitas,285,166,202,653
40758,2020-05-08,(12000) Puente Aranda,60,37,22,119
40759,2020-09-13,(07109) CAD,182,148,163,493
40760,2020-04-13,(02102) Calle 161,90,61,60,211
40761,2020-08-26,(02102) Calle 161,211,126,152,489
40762,2020-07-09,(12004) Carrera 22,258,139,148,545
40763,2020-09-22,(12004) Carrera 22,271,173,163,607
40764,2020-03-10,(07108) Av. El Dorado,409,93,189,691
40765,2020-08-10,(06001) Modelia,342,198,196,736
40766,2020-01-31,(09108) Hospital,244,115,197,556
40767,2020-07-22,(06100) Av. Rojas,199,124,115,438
40768,2020-08-06,(10007) Las Nieves,624,383,313,1320
40769,2020-08-13,(09114) Calle 26,300,168,194,662
40770,2020-05-25,(07004) VENECIA,249,144,161,554
40771,2020-07-17,(04102) Avenida Boyaca,312,167,192,671
40772,2020-07-25,(04102) Avenida Boyaca,257,124,174,555
40773,2020-09-25,(04102) Avenida Boyaca,461,271,413,1145
40774,2020-05-08,(06101) El Tiempo,259,157,107,523
40775,2020-05-26,(06101) El Tiempo,298,185,131,614
40776,2020-07-02,(06101) El Tiempo,371,232,240,843
40777,2020-05-02,(03012) SUBA - CALLE 95,131,89,83,303
40778,2020-05-14,(02502) Terminal,289,205,224,718
40779,2020-05-24,(04000) Cabecera Calle 80,213,130,178,521
40780,2020-05-07,(09111) Calle 19,467,286,344,1097
40781,2020-01-04,(07006) General Santander - alimentacion,483,277,431,1191
40782,2020-08-08,(03011) SUBA - CALLE 100,224,148,184,556
40783,2020-09-02,(07006) General Santander - alimentacion,392,219,283,894
40784,2020-04-06,(10008) San Diego,157,108,91,356
40785,2020-02-07,(12002) CDS - Carrera 32,574,377,326,1277
40786,2020-04-23,(09106) Nariño,232,132,140,504
40787,2020-10-07,(07201) Guatoque -Veraguas,217,126,176,519
40788,2020-05-28,(07107) U. NACIONAL,288,169,140,597
40789,2020-09-23,(07107) U. NACIONAL,423,254,284,961
40790,2020-04-09,(04003) Avenida Ciudad de Cali,202,113,130,445
40791,2020-04-26,(07109) CAD,173,117,76,366
40792,2020-04-21,(03010) PUENTE LARGO,202,147,100,449
40793,2020-04-10,(02303) Calle 85,145,99,78,322
40794,2020-03-31,(07004) VENECIA,497,291,269,1057
40795,2020-07-04,(08002) Biblioteca,242,140,185,567
40796,2020-07-27,(04102) Avenida Boyaca,333,197,243,773
40797,2020-06-11,(04001) Quirigua,385,232,194,811
40798,2020-04-12,(04000) Cabecera Calle 80 - alimentacion,518,338,319,1175
40799,2020-08-17,(08001) Parque el Tunal,124,64,97,285
40800,2020-05-03,(07004) VENECIA,193,94,127,414
40801,2020-03-27,(07105) MOVISTAR ARENA,115,110,98,323
40802,2020-07-20,(07001) PERDOMO,236,112,163,511
40803,2020-07-16,(07007) NQS - Calle 38A Sur,344,200,218,762
40804,2020-03-30,(09101) Quiroga,177,122,148,447
40805,2020-04-11,(06104) Gobernación,65,51,25,141
40806,2020-08-26,(14005) Las Aguas,158,110,196,464
40807,2020-04-14,(10003) Ciudad Jardín,112,60,57,229
40808,2020-09-07,(03007) HUMEDAL CORDOBA,160,105,84,349
40809,2020-07-05,(06109) Centro Memoria,70,45,71,186
40810,2020-07-26,(12001) Carrera 43,44,39,42,125
40811,2020-03-28,(09105) Río Fucha,38,30,48,116
40812,2020-04-04,(10005) Bicentenario,33,20,31,84
40813,2020-04-28,(12007) Zona Industrial,223,167,97,487
40814,2020-03-26,(07106) EL CAMPIN,124,118,99,341
40815,2020-04-07,(07106) EL CAMPIN,136,119,96,351
40816,2020-03-23,(07006) General Santander,141,65,63,269
40817,2020-07-05,(09111) Calle 19,202,130,214,546
40818,2020-04-08,(07106) EL CAMPIN,151,124,96,371
40819,2020-03-28,(05101) Mandalay - Cr.73,43,21,20,84
40820,2020-09-03,(09114) Calle 26,327,207,245,779
40821,2020-10-05,(10005) Bicentenario,130,76,135,341
40822,2020-04-01,(14005) Las Aguas,0,31,86,117
40823,2020-05-05,(50006) Corral Carrera 77,6,1,6,13
40824,2020-08-24,(50006) Corral Carrera 77,4,0,9,13
40825,2020-05-18,(04000) Cabecera Calle 80 - alimentacion,3121,1853,1932,6906
40826,2020-01-17,(07005) ALQUERIA,2226,1206,1454,4886
40827,2020-08-27,(09002) Consuelo,461,255,294,1010
40828,2020-03-07,(09118) Marly,3695,2513,3096,9304
40829,2020-01-23,(05000) Portal Américas - alimentacion,34478,19246,18994,72718
40830,2020-06-09,(05000) Portal Américas - alimentacion,10225,5208,5034,20467
40831,2020-02-16,(06000) Portal Eldorado - alimentacion,4452,1900,3642,9994
40832,2020-02-19,(06000) Portal Eldorado - alimentacion,19071,10346,9791,39208
40833,2020-01-21,(14005) Las Aguas,952,1042,1350,3344
40834,2020-02-13,(09003) Socorro,1756,1020,1093,3869
40835,2020-02-01,(09001) Molinos,5562,2548,4448,12558
40836,2020-02-15,(07111) NQS - RICAURTE,2148,1511,1408,5067
40837,2020-09-24,(09001) Molinos,2881,1428,2104,6413
40838,2020-02-17,(05005) Transversal 86,2827,1698,1344,5869
40839,2020-02-14,(02102) Calle 161,1968,1138,1210,4316
40840,2020-06-26,(09115) Calle 34,694,458,464,1616
40841,2020-01-10,(09113) Calle 22,922,704,943,2569
40842,2020-02-27,(04000) Cabecera Calle 80,7622,4583,4724,16929
40843,2020-10-12,(02101) Toberín,340,249,584,1173
40844,2020-10-07,(10000) Portal 20 de Julio - alimentacion,4687,2009,3247,9943
40845,2020-03-06,(05100) Banderas P. Central,7939,4201,4027,16167
40846,2020-04-28,(02105) Calle 142,467,323,216,1006
40847,2020-02-22,(09109) Tercer Milenio,904,487,737,2128
40848,2020-01-09,(04000) Cabecera Calle 80 - intermunicipal,1344,975,1457,3776
40849,2020-03-07,(10006) San Victorino,1106,926,1108,3140
40850,2020-03-11,(09110) Avenida Jimenez,5198,3308,2851,11357
40851,2020-03-03,(07102) NQS - CALLE 75,1502,1025,1003,3530
40852,2020-09-22,(07102) NQS - CALLE 75,495,322,296,1113
40853,2020-08-15,(03013) RIO NEGRO,183,118,170,471
40854,2020-01-13,(02304) Heroes,3613,2461,1951,8025
40855,2020-02-14,(09103) Olaya,4530,2506,2522,9558
40856,2020-07-06,(03001) LA CAMPIÑA,1245,695,735,2675
40857,2020-06-01,(03007) HUMEDAL CORDOBA,134,99,57,290
40858,2020-05-04,(07503) SAN MATEO,6597,4039,3189,13825
40859,2020-08-23,(09103) Olaya,315,157,208,680
40860,2020-09-07,(14001) La Sabana,142,94,101,337
40861,2020-09-14,(14001) La Sabana,143,85,115,343
40862,2020-08-12,(07111) NQS - RICAURTE,1121,669,451,2241
40863,2020-09-03,(08000) Portal Tunal - alimentacion,6658,3749,4108,14515
40864,2020-02-22,(07112) COMUNEROS,2339,1300,1774,5413
40865,2020-06-26,(02000) Cabecera Autopista Norte,1380,932,878,3190
40866,2020-07-15,(02000) Cabecera Autopista Norte,1204,728,668,2600
40867,2020-02-04,(02104) Calle 146,9724,6189,5032,20945
40868,2020-10-03,(02204) Pepe Sierra,588,440,533,1561
40869,2020-01-25,(02001) Centro Comercial Santa Fe,1926,905,1696,4527
40870,2020-02-01,(04105) Carrera 53,796,409,591,1796
40871,2020-10-01,(04105) Carrera 53,322,153,229,704
40872,2020-02-27,(50003) Corral Molinos,3196,2349,3559,9104
40873,2020-07-28,(50003) Corral Molinos,1417,716,983,3116
40874,2020-04-21,(04000) Cabecera Calle 80,593,348,416,1357
40875,2020-03-04,(05107) Américas - Cr.53,2551,1446,1409,5406
40876,2020-07-08,(07112) COMUNEROS,846,507,466,1819
40877,2020-02-21,(05002) Tintal,11391,5943,5820,23154
40878,2020-04-22,(10001) Country Sur,563,264,388,1215
40879,2020-09-08,(10001) Country Sur,1341,594,840,2775
40880,2020-07-11,(10006) San Victorino,551,311,367,1229
40881,2020-01-13,(40003) Mirador del Paraiso,4158,2270,2483,8911
40882,2020-01-06,(07000) Portal Sur - alimentacion,5828,2652,3904,12384
40883,2020-02-13,(07106) EL CAMPIN,2016,1369,1266,4651
40884,2020-01-14,(09108) Hospital,192,104,178,474
40885,2020-01-28,(08002) Biblioteca,984,533,679,2196
40886,2020-10-10,(10000) Portal 20 de Julio,2053,892,1643,4588
40887,2020-08-14,(07112) COMUNEROS,842,492,460,1794
40888,2020-01-30,(07000) Portal Sur,7809,4674,4313,16796
40889,2020-03-02,(07000) Portal Sur,7752,4667,4185,16604
40890,2020-06-01,(09116) Avenida 39,289,199,211,699
40891,2020-02-12,(02001) Centro Comercial Santa Fe,5008,3197,2733,10938
40892,2020-09-11,(08001) Parque el Tunal,461,268,286,1015
40893,2020-09-22,(08001) Parque el Tunal,522,276,348,1146
40894,2020-10-06,(08001) Parque el Tunal,552,301,399,1252
40895,2020-03-12,(09120) Calle 63,3078,391,717,4186
40896,2020-09-29,(02201) Prado,1034,667,756,2457
40897,2020-04-02,(03000) Portal Suba - alimentacion,3183,1749,1760,6692
40898,2020-03-10,(09107) Hortúa,466,469,420,1355
40899,2020-08-21,(05101) Mandalay - Cr.73,112,71,68,251
40900,2020-01-07,(05105) Pradera,1629,1010,979,3618
40901,2020-09-25,(02103) Mazurén,266,156,287,709
40902,2020-08-18,(02201) Prado,784,562,482,1828
40903,2020-07-13,(02300) Calle 100,1112,697,533,2342
40904,2020-02-10,(14005) Las Aguas,3559,2151,1844,7554
40905,2020-03-31,(09104) Restrepo,656,505,558,1719
40906,2020-05-06,(05105) Pradera,444,293,164,901
40907,2020-02-27,(08000) Portal Tunal,2298,1280,1059,4637
40908,2020-08-28,(06109) Centro Memoria,254,153,152,559
40909,2020-09-28,(03009) Av. Suba- Calle 116,568,337,337,1242
40910,2020-05-12,(02205) Calle 106,247,163,134,544
40911,2020-09-18,(02205) Calle 106,453,296,297,1046
40912,2020-01-02,(02001) Centro Comercial Santa Fe,1611,1046,1103,3760
40913,2020-03-12,(04003) Avenida Ciudad de Cali,214,1318,936,2468
40914,2020-09-19,(06000) Portal Eldorado - alimentacion,3422,1600,2460,7482
40915,2020-06-20,(04108) El Polo,331,199,214,744
40916,2020-09-25,(04108) El Polo,560,357,380,1297
40917,2020-01-15,(12007) Zona Industrial,1162,743,604,2509
40918,2020-01-25,(07101) CASTELLANA,373,279,417,1069
40919,2020-07-30,(07106) EL CAMPIN,348,269,182,799
40920,2020-08-28,(07103) AV. CHILE,887,543,518,1948
40921,2020-05-20,(02200) Alcalá,1485,1015,725,3225
40922,2020-07-01,(06111) Universidades,340,213,374,927
40923,2020-01-03,(03007) HUMEDAL CORDOBA,374,208,263,845
40924,2020-03-03,(03007) HUMEDAL CORDOBA,1011,653,544,2208
40925,2020-05-20,(03007) HUMEDAL CORDOBA,108,75,54,237
40926,2020-07-25,(03007) HUMEDAL CORDOBA,92,51,40,183
40927,2020-08-22,(06000) Portal Eldorado - alimentacion,2855,1317,1644,5816
40928,2020-02-07,(07108) Av. El Dorado,922,609,621,2152
40929,2020-02-10,(09121) Las Flores,3578,2173,2034,7785
40930,2020-05-07,(02304) Heroes,548,396,302,1246
40931,2020-08-20,(07104) Simon Bolivar,619,359,274,1252
40932,2020-04-21,(10005) Bicentenario - alimentacion,137,73,120,330
40933,2020-05-20,(10010) San Bernardo,545,289,340,1174
40934,2020-09-24,(09121) Las Flores,723,472,526,1721
40935,2020-08-27,(04003) Avenida Ciudad de Cali,933,542,716,2191
40936,2020-03-13,(05103) Marsella,163,512,396,1071
40937,2020-06-01,(05103) Marsella,256,155,191,602
40938,2020-10-08,(09117) Calle 45,742,477,651,1870
40939,2020-06-28,(40003) Mirador del Paraiso,664,333,462,1459
40940,2020-09-15,(03002) SUBA - TV- 91,824,489,533,1846
40941,2020-03-08,(04001) Quirigua,405,178,449,1032
40942,2020-09-17,(04001) Quirigua,411,271,322,1004
40943,2020-04-11,(10002) Av. Primero de Mayo,666,371,418,1455
40944,2020-02-06,(07004) VENECIA,4447,2571,2538,9556
40945,2020-04-21,(05100) Banderas P. Central - alimentacion,1612,799,681,3092
40946,2020-07-13,(06000) Portal Eldorado,827,536,429,1792
40947,2020-08-03,(06000) Portal Eldorado,782,539,421,1742
40948,2020-04-24,(12003) Ricaurte,158,141,92,391
40949,2020-08-10,(10010) San Bernardo,595,303,402,1300
40950,2020-09-12,(07009) SENA,545,286,433,1264
40951,2020-03-25,(10008) San Diego,140,106,143,389
40952,2020-03-15,(09110) Avenida Jimenez,739,717,915,2371
40953,2020-01-16,(05102) Av. Américas - Av. Boyacá,1426,818,833,3077
40954,2020-06-16,(06000) Portal Eldorado - alimentacion,3737,1909,1882,7528
40955,2020-02-03,(04001) Quirigua,2009,1279,1282,4570
40956,2020-09-17,(07007) NQS - Calle 38A Sur,482,288,352,1122
40957,2020-04-17,(09123) Calle 76,502,398,292,1192
40958,2020-07-17,(07103) AV. CHILE,914,571,411,1896
40959,2020-09-30,(07103) AV. CHILE,975,621,612,2208
40960,2020-07-05,(08000) Portal Tunal - alimentacion,2141,1003,1376,4520
40961,2020-06-27,(10005) Bicentenario,86,57,74,217
40962,2020-07-07,(10005) Bicentenario,123,55,86,264
40963,2020-01-10,(40002) Manitas,992,572,640,2204
40964,2020-04-03,(40002) Manitas,169,77,134,380
40965,2020-01-14,(07006) General Santander,2367,1389,1365,5121
40966,2020-08-04,(02104) Calle 146,579,403,428,1410
40967,2020-01-11,(07102) NQS - CALLE 75,622,448,539,1609
40968,2020-10-08,(08000) Portal Tunal,798,363,435,1596
40969,2020-06-30,(10009) Museo Nacional,489,299,359,1147
40970,2020-03-08,(04102) Avenida Boyaca,579,316,565,1460
40971,2020-08-19,(09003) Socorro,551,310,356,1217
40972,2020-03-24,(03002) SUBA - TV- 91,760,440,458,1658
40973,2020-10-01,(06111) Universidades,470,266,455,1191
40974,2020-05-23,(40001) Juan Pablo II,375,218,233,826
40975,2020-05-08,(09115) Calle 34,477,337,266,1080
40976,2020-02-16,(07005) ALQUERIA,632,304,582,1518
40977,2020-02-23,(04108) El Polo,272,192,395,859
40978,2020-04-16,(02000) Cabecera Autopista Norte,537,376,311,1224
40979,2020-07-26,(02000) Cabecera Autopista Norte - alimentacion,1443,678,868,2989
40980,2020-08-05,(07101) CASTELLANA,179,88,124,391
40981,2020-01-27,(09111) Calle 19,2092,1316,1491,4899
40982,2020-05-06,(06109) Centro Memoria,221,122,93,436
40983,2020-10-08,(06109) Centro Memoria,302,175,208,685
40984,2020-09-04,(05103) Marsella,516,243,363,1122
40985,2020-09-19,(07009) SENA,562,323,539,1424
40986,2020-08-08,(09002) Consuelo,367,173,256,796
40987,2020-05-23,(07105) MOVISTAR ARENA,159,105,94,358
40988,2020-10-03,(50003) Corral Molinos,1332,663,1322,3317
40989,2020-07-13,(09121) Las Flores,546,350,319,1215
40990,2020-01-09,(07107) U. NACIONAL,944,684,831,2459
40991,2020-07-15,(07107) U. NACIONAL,344,196,180,720
40992,2020-10-12,(07107) U. NACIONAL,102,90,160,352
40993,2020-09-10,(03003) 21 ANGELES,351,161,172,684
40994,2020-08-14,(07105) MOVISTAR ARENA,203,118,149,470
40995,2020-06-06,(02104) Calle 146,533,303,313,1149
40996,2020-08-03,(04103) Las Ferias,283,146,152,581
40997,2020-06-09,(09110) Avenida Jimenez,982,734,780,2496
40998,2020-09-20,(09110) Avenida Jimenez,545,468,480,1493
40999,2020-05-29,(10007) Las Nieves,536,313,346,1195
41000,2020-06-02,(08002) Biblioteca,289,155,145,589
41001,2020-05-05,(07006) General Santander - alimentacion,222,134,130,486
41002,2020-07-31,(12000) Puente Aranda,71,53,41,165
41003,2020-03-09,(07004) VENECIA,559,1094,785,2438
41004,2020-06-11,(07506) DESPENSA,509,255,255,1019
41005,2020-09-19,(14001) La Sabana,155,98,130,383
41006,2020-10-07,(03013) RIO NEGRO,310,205,275,790
41007,2020-07-23,(09114) Calle 26,263,159,164,586
41008,2020-10-06,(07003) SEVILLANA,503,299,391,1193
41009,2020-03-01,(07006) General Santander - alimentacion,285,156,351,792
41010,2020-02-21,(09108) Hospital,236,142,208,586
41011,2020-04-19,(09118) Marly,417,289,204,910
41012,2020-05-27,(02300) Calle 100,1130,740,530,2400
41013,2020-01-14,(07200) Tygua-San José,701,383,544,1628
41014,2020-06-12,(07200) Tygua-San José,250,112,154,516
41015,2020-04-13,(05001) Patio Bonito,892,517,519,1928
41016,2020-08-10,(10007) Las Nieves,691,403,381,1475
41017,2020-03-25,(09115) Calle 34,414,295,279,988
41018,2020-07-03,(07108) Av. El Dorado,147,90,99,336
41019,2020-08-14,(07506) DESPENSA,483,250,241,974
41020,2020-01-01,(03002) SUBA - TV- 91,268,140,429,837
41021,2020-07-19,(14004) Museo del Oro,26,23,39,88
41022,2020-03-15,(07010) Bosa,393,220,439,1052
41023,2020-06-08,(06001) Modelia,381,248,186,815
41024,2020-09-09,(09108) Hospital,67,51,57,175
41025,2020-05-15,(04000) Cabecera Calle 80 - intermunicipal,231,141,190,562
41026,2020-01-19,(05105) Pradera,443,336,453,1232
41027,2020-03-08,(05105) Pradera,505,345,485,1335
41028,2020-05-06,(09003) Socorro,354,185,188,727
41029,2020-01-19,(05005) Transversal 86,442,177,393,1012
41030,2020-04-18,(07009) SENA,202,124,133,459
41031,2020-06-02,(06105) Quinta Paredes,120,73,63,256
41032,2020-06-20,(09105) Río Fucha,92,53,85,230
41033,2020-07-24,(40002) Manitas,290,163,184,637
41034,2020-08-20,(40002) Manitas,357,237,241,835
41035,2020-10-08,(05101) Mandalay - Cr.73,152,95,103,350
41036,2020-04-08,(09116) Avenida 39,164,124,119,407
41037,2020-08-23,(05107) Américas - Cr.53,73,65,90,228
41038,2020-04-19,(10008) San Diego,54,41,31,126
41039,2020-04-14,(07107) U. NACIONAL,206,171,104,481
41040,2020-08-02,(04101) Minuto de Dios,62,36,70,168
41041,2020-07-17,(09108) Hospital,64,33,70,167
41042,2020-03-29,(07006) General Santander - alimentacion,58,49,27,134
41043,2020-09-13,(07111) NQS - RICAURTE,225,191,175,591
41044,2020-10-09,(06105) Quinta Paredes,164,100,143,407
41045,2020-03-25,(04003) Avenida Ciudad de Cali,527,325,403,1255
41046,2020-05-12,(09113) Calle 22,356,216,243,815
41047,2020-04-12,(04108) El Polo,44,38,23,105
41048,2020-08-10,(04001) Quirigua,289,196,179,664
41049,2020-09-11,(09106) Nariño,435,245,327,1007
41050,2020-04-02,(08000) Portal Tunal,397,217,195,809
41051,2020-06-13,(03002) SUBA - TV- 91,520,296,347,1163
41052,2019-12-31,(10009) Museo Nacional,28,16,36,80
41053,2020-08-29,(09106) Nariño,328,195,263,786
41054,2020-07-26,(09121) Las Flores,156,101,161,418
41055,2020-10-04,(06111) Universidades,153,84,274,511
41056,2020-04-20,(07007) NQS - Calle 38A Sur,181,110,117,408
41057,2020-04-18,(07007) NQS - Calle 38A Sur,115,77,52,244
41058,2020-08-31,(04101) Minuto de Dios,294,205,288,787
41059,2020-06-22,(02000) Cabecera Autopista Norte - intermunicipal,133,114,121,368
41060,2020-04-21,(14005) Las Aguas,0,46,103,149
41061,2020-05-03,(09114) Calle 26,45,34,43,122
41062,2020-08-09,(02502) Terminal,71,46,97,214
41063,2020-04-17,(14004) Museo del Oro,0,42,126,168
41064,2020-05-07,(07101) CASTELLANA,119,84,100,303
41065,2020-05-22,(06102) Salitre El Greco,161,104,99,364
41066,2020-05-06,(03005) SUBA - AV. BOYACA,249,161,162,572
41067,2020-03-22,(07108) Av. El Dorado,23,19,19,61
41068,2020-08-30,(07108) Av. El Dorado,35,31,32,98
41069,2020-04-11,(03003) 21 ANGELES,77,44,31,152
41070,2020-03-29,(07101) CASTELLANA,10,20,23,53
41071,2020-04-05,(10005) Bicentenario - alimentacion,55,23,46,124
41072,2020-10-12,(02102) Calle 161,68,45,112,225
41073,2020-06-21,(09105) Río Fucha,43,18,37,98
41074,2020-03-21,(04102) Avenida Boyaca,93,66,63,222
41075,2020-08-02,(04103) Las Ferias,88,59,76,223
41076,2020-09-06,(06103) CAN,134,76,120,330
41077,2020-05-25,(05102) Av. Américas - Av. Boyacá,69,32,46,147
41078,2020-06-10,(03014) SAN MARTIN,28,8,30,66
41079,2020-08-26,(03004) GRATAMIRA,0,11,21,32
41080,2020-08-05,(05000) Portal Américas - alimentacion,9376,4924,4665,18965
41081,2020-08-28,(09119) Calle 57,576,364,403,1343
41082,2020-02-04,(08000) Portal Tunal - alimentacion,24739,13489,12299,50527
41083,2020-02-17,(02303) Calle 85,3880,2548,1834,8262
41084,2020-01-13,(05000) Portal Américas - alimentacion,29791,17057,18163,65011
41085,2020-01-30,(02101) Toberín,14644,9140,7510,31294
41086,2020-08-27,(07503) SAN MATEO,11158,6319,5260,22737
41087,2020-06-18,(05000) Portal Américas,2489,1856,1943,6288
41088,2020-01-03,(09100) Calle 40 Sur,4013,2001,2622,8636
41089,2020-01-22,(09003) Socorro,1523,845,995,3363
41090,2020-02-13,(10000) Portal 20 de Julio - alimentacion,11261,5872,7443,24576
41091,2020-02-27,(04101) Minuto de Dios,3604,2188,1840,7632
41092,2020-02-15,(09121) Las Flores,1687,1192,1561,4440
41093,2020-08-28,(09001) Molinos,2677,1425,1860,5962
41094,2020-07-09,(05000) Portal Américas - alimentacion,11237,6021,5497,22755
41095,2020-10-04,(04000) Cabecera Calle 80 - alimentacion,1532,670,1798,4000
41096,2020-01-17,(06107) Ciudad Universitaria,1051,667,854,2572
41097,2020-07-21,(05001) Patio Bonito,1500,872,907,3279
41098,2020-02-07,(04103) Las Ferias,1581,872,907,3360
41099,2020-01-22,(05005) Transversal 86,2408,1416,1249,5073
41100,2020-02-23,(05005) Transversal 86,445,161,399,1005
41101,2020-01-11,(09000) Cabecera Usme - alimentacion,15115,7187,10376,32678
41102,2020-05-13,(10001) Country Sur,891,404,536,1831
41103,2020-10-02,(09100) Calle 40 Sur,2043,1143,1683,4869
41104,2020-02-07,(05100) Banderas P. Central - alimentacion,16133,8809,9010,33952
41105,2020-02-15,(07009) SENA,2323,1211,1679,5213
41106,2020-03-10,(06000) Portal Eldorado - alimentacion,2011,4059,2933,9003
41107,2020-04-03,(10005) Bicentenario - alimentacion,148,79,125,352
41108,2020-09-29,(07001) PERDOMO,1126,661,816,2603
41109,2020-07-25,(40003) Mirador del Paraiso,1008,633,759,2400
41110,2020-08-31,(07505) LEON XIII,2713,1467,1252,5432
41111,2020-09-01,(07505) LEON XIII,2790,1477,1253,5520
41112,2020-01-08,(04104) Avenida 68,2288,1248,1450,4986
41113,2020-01-17,(05001) Patio Bonito,6195,3437,3489,13121
41114,2020-02-04,(02502) Terminal,5492,3615,3099,12206
41115,2020-01-26,(09123) Calle 76,570,506,853,1929
41116,2020-10-12,(05000) Portal Américas,1044,530,1079,2653
41117,2020-02-21,(04100) Carrera 77,6725,3677,3811,14213
41118,2020-02-24,(07102) NQS - CALLE 75,1527,994,1003,3524
41119,2020-05-04,(03013) RIO NEGRO,193,122,113,428
41120,2020-06-27,(50003) Corral Molinos,1356,686,969,3011
41121,2020-09-29,(07000) Portal Sur - alimentacion,9202,4876,5350,19428
41122,2020-01-13,(09103) Olaya,3226,1870,2162,7258
41123,2020-03-21,(09103) Olaya,303,171,145,619
41124,2020-09-25,(07111) NQS - RICAURTE,1249,780,639,2668
41125,2020-08-15,(02000) Cabecera Autopista Norte,1001,588,770,2359
41126,2020-08-24,(09113) Calle 22,232,185,252,669
41127,2020-08-13,(08000) Portal Tunal - alimentacion,5946,3298,3245,12489
41128,2020-03-06,(50003) Corral Molinos,3185,2261,3731,9177
41129,2020-04-29,(50003) Corral Molinos,881,434,577,1892
41130,2020-02-14,(05107) Américas - Cr.53,2575,1482,1538,5595
41131,2020-06-16,(07112) COMUNEROS,804,471,429,1704
41132,2020-01-31,(09114) Calle 26,2657,1887,1832,6376
41133,2020-02-23,(09114) Calle 26,210,188,446,844
41134,2020-01-24,(10001) Country Sur,4872,1979,2600,9451
41135,2020-03-09,(04100) Carrera 77,461,1736,1171,3368
41136,2020-09-09,(10006) San Victorino,814,397,367,1578
41137,2020-06-11,(03000) Portal Suba,1210,763,713,2686
41138,2020-04-04,(10000) Portal 20 de Julio - alimentacion,2045,768,998,3811
41139,2020-01-15,(07505) LEON XIII,7592,4201,3552,15345
41140,2020-01-14,(10002) Av. Primero de Mayo,7111,3506,4342,14959
41141,2020-01-12,(04104) Avenida 68,597,322,596,1515
41142,2020-09-13,(06101) El Tiempo,99,83,113,295
41143,2020-02-04,(09101) Quiroga,1621,1036,1228,3885
41144,2020-07-30,(08001) Parque el Tunal,470,253,282,1005
41145,2020-02-12,(10010) San Bernardo,1907,1058,1385,4350
41146,2020-07-09,(10000) Portal 20 de Julio,2445,1216,1213,4874
41147,2020-02-02,(07000) Portal Sur,1511,682,1526,3719
41148,2020-04-23,(09116) Avenida 39,190,133,121,444
41149,2020-09-21,(04002) Carrera 90,664,328,360,1352
41150,2020-06-09,(09004) Santa Lucía,2438,1250,1326,5014
41151,2020-08-10,(09003) Socorro,574,309,342,1225
41152,2020-10-11,(09003) Socorro,233,97,214,544
41153,2020-04-12,(07503) SAN MATEO,2154,1294,949,4397
41154,2020-09-08,(09116) Avenida 39,440,235,316,991
41155,2020-09-25,(09116) Avenida 39,462,280,342,1084
41156,2020-01-10,(03000) Portal Suba,6275,3500,3967,13742
41157,2020-07-29,(10002) Av. Primero de Mayo,2059,1002,1180,4241
41158,2020-06-02,(05000) Portal Américas,2061,1420,1568,5049
41159,2020-01-16,(03001) LA CAMPIÑA,5590,3069,3885,12544
41160,2020-05-16,(09107) Hortúa,333,220,199,752
41161,2020-08-09,(09107) Hortúa,174,115,124,413
41162,2020-09-06,(05103) Marsella,152,74,153,379
41163,2020-02-20,(03011) SUBA - CALLE 100,2733,1375,1326,5434
41164,2020-10-09,(03012) SUBA - CALLE 95,361,230,302,893
41165,2020-05-10,(10000) Portal 20 de Julio,526,269,299,1094
41166,2020-02-09,(07104) Simon Bolivar,446,272,482,1200
41167,2020-02-23,(07104) Simon Bolivar,397,247,457,1101
41168,2020-03-01,(03012) SUBA - CALLE 95,330,184,356,870
41169,2020-05-27,(02202) Calle 127,1020,700,452,2172
41170,2020-07-11,(05105) Pradera,502,312,271,1085
41171,2020-08-08,(10008) San Diego,183,126,141,450
41172,2020-08-17,(10008) San Diego,80,47,62,189
41173,2020-07-02,(06109) Centro Memoria,282,168,148,598
41174,2020-02-04,(09106) Nariño,2105,1320,1470,4895
41175,2020-02-05,(09106) Nariño,2113,1295,1429,4837
41176,2020-08-21,(03009) Av. Suba- Calle 116,523,315,262,1100
41177,2020-04-22,(02205) Calle 106,164,119,92,375
41178,2020-10-06,(02205) Calle 106,424,306,341,1071
41179,2020-09-14,(04003) Avenida Ciudad de Cali,1046,598,830,2474
41180,2020-04-03,(02300) Calle 100,721,551,408,1680
41181,2020-10-06,(06000) Portal Eldorado - alimentacion,4452,2258,2861,9571
41182,2020-06-16,(07010) Bosa,721,380,438,1539
41183,2020-05-12,(02101) Toberín,1067,668,642,2377
41184,2020-01-24,(02202) Calle 127,5669,3549,2934,12152
41185,2020-07-04,(07104) Simon Bolivar,483,318,315,1116
41186,2020-01-05,(07000) Portal Sur,1100,518,1153,2771
41187,2020-08-20,(04104) Avenida 68,613,289,322,1224
41188,2020-03-17,(07108) Av. El Dorado,536,345,339,1220
41189,2020-05-14,(05103) Marsella,258,119,150,527
41190,2020-02-26,(09109) Tercer Milenio,1090,844,983,2917
41191,2020-08-27,(09109) Tercer Milenio,333,210,265,808
41192,2020-10-01,(09109) Tercer Milenio,378,228,311,917
41193,2020-07-07,(09100) Calle 40 Sur,1878,1131,1182,4191
41194,2020-07-09,(06101) El Tiempo,361,231,178,770
41195,2020-06-30,(09117) Calle 45,696,466,482,1644
41196,2020-03-29,(07505) LEON XIII,518,247,215,980
41197,2020-06-01,(04100) Carrera 77,1154,632,773,2559
41198,2020-01-10,(06104) Gobernación,890,568,541,1999
41199,2020-05-12,(05001) Patio Bonito,1211,695,698,2604
41200,2020-01-04,(07004) VENECIA,1543,850,1168,3561
41201,2020-01-21,(07103) AV. CHILE,2555,1611,1252,5418
41202,2020-10-09,(07003) SEVILLANA,541,294,386,1221
41203,2020-08-01,(09120) Calle 63,811,552,533,1896
41204,2020-05-28,(09104) Restrepo,1278,760,865,2903
41205,2020-05-03,(09117) Calle 45,208,130,109,447
41206,2020-08-18,(10010) San Bernardo,572,308,420,1300
41207,2020-06-05,(03009) Av. Suba- Calle 116,469,300,239,1008
41208,2020-06-25,(02105) Calle 142,789,514,456,1759
41209,2020-08-09,(09109) Tercer Milenio,103,65,123,291
41210,2020-01-12,(09120) Calle 63,799,636,1201,2636
41211,2020-05-24,(09116) Avenida 39,90,66,63,219
41212,2020-01-15,(05102) Av. Américas - Av. Boyacá,1361,831,822,3014
41213,2020-04-20,(09002) Consuelo,251,138,145,534
41214,2020-06-01,(09123) Calle 76,882,632,505,2019
41215,2020-08-05,(02103) Mazurén,154,90,142,386
41216,2020-06-13,(07004) VENECIA,751,407,458,1616
41217,2020-03-25,(10005) Bicentenario,52,38,44,134
41218,2020-01-06,(02001) Centro Comercial Santa Fe,403,285,575,1263
41219,2020-09-23,(02001) Centro Comercial Santa Fe,594,393,469,1456
41220,2020-01-05,(10003) Ciudad Jardín,181,78,202,461
41221,2020-04-24,(05100) Banderas P. Central - alimentacion,1657,817,679,3153
41222,2020-09-08,(07006) General Santander,587,347,376,1310
41223,2020-08-20,(02200) Alcalá,1630,1092,908,3630
41224,2020-10-03,(10008) San Diego,226,164,245,635
41225,2020-08-10,(08002) Biblioteca,299,174,180,653
41226,2020-01-20,(10004) Policarpa,781,417,540,1738
41227,2020-03-05,(04102) Avenida Boyaca,3001,1828,1651,6480
41228,2020-07-02,(06111) Universidades,351,218,347,916
41229,2020-08-19,(06100) Av. Rojas,226,135,132,493
41230,2020-09-18,(09115) Calle 34,716,442,598,1756
41231,2020-02-15,(12001) Carrera 43,891,543,880,2314
41232,2020-06-11,(03006) NIZA - CALLE 127,432,246,229,907
41233,2020-05-02,(02304) Heroes,318,224,217,759
41234,2020-01-26,(07004) VENECIA,1000,512,901,2413
41235,2020-09-27,(05002) Tintal,836,376,786,1998
41236,2020-09-12,(09122) Calle 72,881,614,876,2371
41237,2020-02-09,(04002) Carrera 90,735,298,702,1735
41238,2020-02-02,(04000) Cabecera Calle 80 - intermunicipal,269,196,443,908
41239,2020-03-29,(10000) Portal 20 de Julio,425,209,174,808
41240,2020-02-08,(06109) Centro Memoria,549,365,524,1438
41241,2020-03-01,(03002) SUBA - TV- 91,851,401,867,2119
41242,2020-08-23,(07111) NQS - RICAURTE,171,141,135,447
41243,2020-04-21,(09123) Calle 76,517,406,298,1221
41244,2020-01-11,(06104) Gobernación,304,232,375,911
41245,2020-09-28,(02302) Virrey,764,512,510,1786
41246,2020-02-09,(09114) Calle 26,207,180,443,830
41247,2020-07-28,(09114) Calle 26,317,199,205,721
41248,2020-08-16,(03000) Portal Suba,313,178,311,802
41249,2020-09-06,(04100) Carrera 77,440,225,431,1096
41250,2020-07-11,(03003) 21 ANGELES,269,131,175,575
41251,2020-08-01,(10006) San Victorino,492,253,266,1011
41252,2020-01-05,(04101) Minuto de Dios,335,159,332,826
41253,2020-10-01,(05103) Marsella,529,296,357,1182
41254,2020-04-07,(02104) Calle 146,360,269,219,848
41255,2020-08-07,(09119) Calle 57,258,151,201,610
41256,2020-06-02,(06107) Ciudad Universitaria,176,104,98,378
41257,2020-04-19,(08000) Portal Tunal,186,95,69,350
41258,2020-03-27,(09119) Calle 57,234,182,176,592
41259,2020-08-27,(05005) Transversal 86,354,200,208,762
41260,2020-08-15,(05102) Av. Américas - Av. Boyacá,182,84,151,417
41261,2020-09-05,(05102) Av. Américas - Av. Boyacá,213,104,187,504
41262,2020-10-08,(40002) Manitas,439,251,342,1032
41263,2020-07-13,(09114) Calle 26,267,160,165,592
41264,2020-05-09,(12000) Puente Aranda,36,25,18,79
41265,2020-01-04,(03005) SUBA - AV. BOYACA,704,422,610,1736
41266,2020-06-27,(04107) Escuela Militar,102,89,95,286
41267,2020-07-05,(10009) Museo Nacional,81,76,102,259
41268,2020-07-12,(03006) NIZA - CALLE 127,188,101,112,401
41269,2020-07-28,(07009) SENA,531,334,338,1203
41270,2020-08-09,(08001) Parque el Tunal,100,60,82,242
41271,2020-07-06,(06002) Normandía,308,201,213,722
41272,2020-04-29,(07008) NQS - Calle 30 Sur,168,102,83,353
41273,2020-02-20,(07200) Tygua-San José,773,468,525,1766
41274,2020-05-09,(40003) Mirador del Paraiso,923,579,574,2076
41275,2020-06-23,(07008) NQS - Calle 30 Sur,289,181,175,645
41276,2020-07-29,(07008) NQS - Calle 30 Sur,235,124,140,499
41277,2020-04-03,(02103) Mazurén,78,59,73,210
41278,2020-06-14,(07005) ALQUERIA,167,85,126,378
41279,2020-07-09,(04102) Avenida Boyaca,367,232,232,831
41280,2020-09-09,(04102) Avenida Boyaca,438,249,326,1013
41281,2020-04-24,(04101) Minuto de Dios,157,111,108,376
41282,2020-05-06,(04101) Minuto de Dios,219,124,141,484
41283,2020-04-10,(04000) Cabecera Calle 80 - intermunicipal,14,16,21,51
41284,2020-02-23,(09003) Socorro,522,223,406,1151
41285,2020-05-10,(09114) Calle 26,45,30,68,143
41286,2020-01-21,(10003) Ciudad Jardín,613,271,432,1316
41287,2020-03-24,(07101) CASTELLANA,112,109,129,350
41288,2020-07-20,(03009) Av. Suba- Calle 116,173,117,73,363
41289,2020-06-24,(07108) Av. El Dorado,144,91,92,327
41290,2020-01-19,(09101) Quiroga,431,224,481,1136
41291,2020-06-20,(03010) PUENTE LARGO,253,189,161,603
41292,2020-04-05,(07112) COMUNEROS,134,101,73,308
41293,2020-04-09,(03006) NIZA - CALLE 127,110,91,49,250
41294,2020-08-17,(04102) Avenida Boyaca,155,72,86,313
41295,2020-03-21,(09122) Calle 72,356,252,218,826
41296,2020-08-26,(05103) Marsella,362,188,217,767
41297,2020-07-20,(07000) Portal Sur,429,252,349,1030
41298,2020-04-20,(07006) General Santander - alimentacion,198,124,110,432
41299,2020-10-01,(07006) General Santander - alimentacion,395,244,366,1005
41300,2020-07-24,(09108) Hospital,58,33,51,142
41301,2020-04-09,(07006) General Santander - alimentacion,57,46,62,165
41302,2020-09-30,(06105) Quinta Paredes,175,116,112,403
41303,2020-06-14,(02304) Heroes,180,146,142,468
41304,2020-04-19,(04101) Minuto de Dios,63,34,45,142
41305,2020-04-25,(09111) Calle 19,269,179,239,687
41306,2020-02-28,(03004) GRATAMIRA,312,158,160,630
41307,2020-04-07,(07105) MOVISTAR ARENA,151,116,74,341
41308,2020-07-01,(03005) SUBA - AV. BOYACA,483,273,283,1039
41309,2020-06-04,(03005) SUBA - AV. BOYACA,398,226,223,847
41310,2020-05-06,(09121) Las Flores,466,326,265,1057
41311,2020-08-11,(03011) SUBA - CALLE 100,417,205,216,838
41312,2020-06-13,(07007) NQS - Calle 38A Sur,296,162,216,674
41313,2020-04-27,(07110) PALOQUEMAO,39,238,84,361
41314,2020-04-05,(03012) SUBA - CALLE 95,66,46,37,149
41315,2020-06-21,(07111) NQS - RICAURTE,184,126,155,465
41316,2020-07-25,(04105) Carrera 53,193,100,108,401
41317,2020-05-28,(07108) Av. El Dorado,140,76,62,278
41318,2020-06-14,(07006) General Santander - alimentacion,79,48,76,203
41319,2020-08-11,(07101) CASTELLANA,184,102,113,399
41320,2020-04-28,(09105) Río Fucha,75,47,53,175
41321,2020-05-10,(02103) Mazurén,24,18,33,75
41322,2020-09-06,(02102) Calle 161,70,50,94,214
41323,2020-03-20,(07506) DESPENSA,162,103,106,371
41324,2019-12-31,(07109) CAD,28,14,25,67
41325,2020-04-09,(12001) Carrera 43,48,28,27,103
41326,2020-04-11,(10005) Bicentenario - alimentacion,76,39,58,173
41327,2020-04-02,(06106) Recinto Ferial,131,95,69,295
41328,2020-05-17,(06104) Gobernación,45,27,25,97
41329,2020-04-12,(10005) Bicentenario,32,12,19,63
41330,2020-04-12,(05103) Marsella,62,41,32,135
41331,2020-01-10,(04000) Cabecera Calle 80 - alimentacion,16708,8697,11600,37005
41332,2020-01-20,(04000) Cabecera Calle 80 - alimentacion,20755,12379,13663,46797
41333,2020-03-05,(07504) TERREROS,16947,10249,9253,36449
41334,2020-05-06,(10000) Portal 20 de Julio - alimentacion,2826,1279,1568,5673
41335,2020-10-05,(03000) Portal Suba - alimentacion,7412,4049,5357,16818
41336,2020-01-30,(05000) Portal Américas - alimentacion,35898,20526,19674,76098
41337,2020-03-04,(05000) Portal Américas - alimentacion,36364,21525,21600,79489
41338,2020-02-05,(03002) SUBA - TV- 91,4796,2725,2595,10116
41339,2020-01-07,(07503) SAN MATEO,30132,16469,14586,61187
41340,2020-02-12,(02200) Alcalá,15384,9717,6828,31929
41341,2020-08-12,(05000) Portal Américas,2699,1747,1842,6288
41342,2020-09-04,(05000) Portal Américas,3562,2048,2565,8175
41343,2020-02-20,(09114) Calle 26,3375,2175,1710,7260
41344,2020-02-13,(08001) Parque el Tunal,1770,963,994,3727
41345,2020-02-14,(04002) Carrera 90,3837,2142,2108,8087
41346,2020-01-20,(09100) Calle 40 Sur,6622,3677,3804,14103
41347,2020-09-03,(06107) Ciudad Universitaria,198,121,146,465
41348,2020-09-19,(06107) Ciudad Universitaria,135,92,165,392
41349,2020-08-15,(09001) Molinos,2142,1025,1614,4781
41350,2020-02-06,(02000) Cabecera Autopista Norte - alimentacion,23811,13639,13267,50717
41351,2020-01-03,(07010) Bosa,1204,707,930,2841
41352,2020-02-25,(02201) Prado,5936,3770,2963,12669
41353,2020-02-22,(50006) Corral Carrera 77,21,13,20,54
41354,2020-01-25,(09000) Cabecera Usme - alimentacion,17392,8455,11779,37626
41355,2020-07-01,(05100) Banderas P. Central,829,446,561,1836
41356,2020-04-09,(06000) Portal Eldorado - alimentacion,917,395,340,1652
41357,2020-03-06,(09115) Calle 34,4247,2742,2646,9635
41358,2020-03-02,(07009) SENA,3633,2165,2097,7895
41359,2020-09-22,(06102) Salitre El Greco,251,156,160,567
41360,2020-06-18,(08000) Portal Tunal - alimentacion,6294,3636,3361,13291
41361,2020-04-25,(07001) PERDOMO,340,196,179,715
41362,2020-09-12,(40003) Mirador del Paraiso,0,571,1606,2177
41363,2020-01-10,(07505) LEON XIII,6867,3617,3344,13828
41364,2020-09-09,(03000) Portal Suba - alimentacion,6757,3856,4380,14993
41365,2020-01-25,(02204) Pepe Sierra,1997,1322,1529,4848
41366,2020-01-07,(06002) Normandía,1390,834,866,3090
41367,2020-01-10,(12003) Ricaurte,846,591,546,1983
41368,2020-03-09,(03013) RIO NEGRO,427,128,232,787
41369,2020-02-29,(07110) PALOQUEMAO,1310,943,1016,3269
41370,2020-03-02,(02103) Mazurén,3313,2162,1810,7285
41371,2020-01-30,(14001) La Sabana,488,343,348,1179
41372,2020-05-15,(07002) MADELENA,589,304,320,1213
41373,2020-08-03,(02000) Cabecera Autopista Norte,1119,712,686,2517
41374,2020-01-29,(02104) Calle 146,9374,5814,4829,20017
41375,2020-02-14,(03003) 21 ANGELES,1851,882,989,3722
41376,2020-07-19,(09001) Molinos,584,295,371,1250
41377,2020-02-13,(09114) Calle 26,3376,2175,1755,7306
41378,2020-04-14,(08000) Portal Tunal - alimentacion,3543,1854,1844,7241
41379,2020-01-15,(06105) Quinta Paredes,815,514,470,1799
41380,2020-02-13,(07007) NQS - Calle 38A Sur,2337,1286,1224,4847
41381,2020-05-19,(50003) Corral Molinos,1263,645,756,2664
41382,2020-02-11,(07506) DESPENSA,1495,1005,934,3434
41383,2020-05-12,(09000) Cabecera Usme - alimentacion,6146,3478,3600,13224
41384,2020-01-30,(04001) Quirigua,1937,1188,1187,4312
41385,2020-03-30,(08000) Portal Tunal - alimentacion,3398,1643,1699,6740
41386,2020-01-10,(07113) SANTA ISABEL,1504,880,1189,3573
41387,2020-03-09,(07113) SANTA ISABEL,268,475,382,1125
41388,2020-02-10,(10005) Bicentenario - alimentacion,711,335,539,1585
41389,2020-05-25,(09101) Quiroga,147,76,133,356
41390,2020-08-22,(09101) Quiroga,363,182,263,808
41391,2020-01-11,(06111) Universidades,975,602,1133,2710
41392,2020-01-17,(09116) Avenida 39,2067,1486,1430,4983
41393,2020-07-16,(07112) COMUNEROS,774,456,435,1665
41394,2020-01-27,(07000) Portal Sur,7582,4682,4173,16437
41395,2020-02-24,(07000) Portal Sur,7996,4878,4150,17024
41396,2020-02-27,(07000) Portal Sur,8043,4724,4365,17132
41397,2020-03-08,(10000) Portal 20 de Julio - alimentacion,3392,1267,2783,7442
41398,2020-01-27,(04003) Avenida Ciudad de Cali,5164,3066,3317,11547
41399,2020-01-31,(10004) Policarpa,863,422,601,1886
41400,2020-06-29,(04100) Carrera 77,413,212,312,937
41401,2020-09-27,(09003) Socorro,222,96,177,495
41402,2020-08-02,(07503) SAN MATEO,2810,1471,1589,5870
41403,2020-03-13,(09118) Marly,2461,451,758,3670
41404,2020-06-24,(08001) Parque el Tunal,521,316,287,1124
41405,2020-10-11,(09000) Cabecera Usme - alimentacion,2924,1196,2419,6539
41406,2020-09-23,(07505) LEON XIII,3123,1656,1552,6331
41407,2020-01-16,(09113) Calle 22,970,775,960,2705
41408,2020-02-04,(06108) Concejo de Bogotá,946,433,484,1863
41409,2020-06-26,(06108) Concejo de Bogotá,148,87,81,316
41410,2020-01-06,(02000) Cabecera Autopista Norte,1237,647,1111,2995
41411,2020-08-20,(06102) Salitre El Greco,182,110,119,411
41412,2020-03-10,(10000) Portal 20 de Julio,295,2069,1344,3708
41413,2020-09-26,(05103) Marsella,423,174,321,918
41414,2020-02-27,(10009) Museo Nacional,4689,2495,1916,9100
41415,2020-03-09,(02103) Mazurén,186,959,491,1636
41416,2020-01-22,(02300) Calle 100,7025,4288,3640,14953
41417,2020-08-01,(02300) Calle 100,656,464,423,1543
41418,2020-08-29,(02300) Calle 100,733,544,632,1909
41419,2020-03-08,(04106) Carrera 47,393,195,366,954
41420,2020-02-02,(14005) Las Aguas,256,220,645,1121
41421,2020-09-17,(07006) General Santander,611,358,449,1418
41422,2020-09-18,(07006) General Santander,662,350,447,1459
41423,2020-02-08,(02300) Calle 100,2848,2043,2836,7727
41424,2020-04-04,(05005) Transversal 86,137,68,54,259
41425,2020-07-31,(05005) Transversal 86,304,168,211,683
41426,2020-03-07,(10008) San Diego,636,510,727,1873
41427,2020-03-20,(07009) SENA,308,206,122,636
41428,2020-03-16,(08000) Portal Tunal,1642,926,791,3359
41429,2020-02-11,(06109) Centro Memoria,1258,691,593,2542
41430,2020-03-11,(06109) Centro Memoria,1115,606,608,2329
41431,2020-08-31,(06109) Centro Memoria,268,157,164,589
41432,2020-07-22,(08000) Portal Tunal,605,238,230,1073
41433,2020-09-11,(03009) Av. Suba- Calle 116,530,332,302,1164
41434,2020-10-05,(03009) Av. Suba- Calle 116,586,344,390,1320
41435,2020-05-15,(02205) Calle 106,265,167,152,584
41436,2020-07-25,(04003) Avenida Ciudad de Cali,634,368,447,1449
41437,2020-05-08,(03000) Portal Suba,756,508,497,1761
41438,2020-05-28,(04108) El Polo,399,243,181,823
41439,2020-10-03,(04108) El Polo,356,250,337,943
41440,2020-02-01,(12007) Zona Industrial,690,493,512,1695
41441,2020-01-26,(07201) Guatoque -Veraguas,105,83,246,434
41442,2020-05-26,(07103) AV. CHILE,894,541,374,1809
41443,2020-02-14,(05103) Marsella,3166,1787,1519,6472
41444,2020-10-01,(03007) HUMEDAL CORDOBA,159,112,119,390
41445,2020-02-27,(06101) El Tiempo,2945,1666,1475,6086
41446,2020-03-20,(06101) El Tiempo,241,152,98,491
41447,2020-04-24,(07000) Portal Sur,941,624,626,2191
41448,2020-04-03,(02304) Heroes,392,321,259,972
41449,2020-03-28,(07110) PALOQUEMAO,201,176,146,523
41450,2020-02-14,(04107) Escuela Militar,677,436,446,1559
41451,2020-09-15,(04107) Escuela Militar,171,106,116,393
41452,2020-02-26,(04003) Avenida Ciudad de Cali,5721,3206,3647,12574
41453,2020-08-08,(07002) MADELENA,487,239,342,1068
41454,2020-02-12,(03012) SUBA - CALLE 95,1549,993,998,3540
41455,2020-05-12,(04108) El Polo,366,229,189,784
41456,2020-09-23,(09106) Nariño,488,280,390,1158
41457,2020-02-19,(07104) Simon Bolivar,2503,1520,1208,5231
41458,2020-07-04,(09001) Molinos,2286,1147,1680,5113
41459,2020-09-22,(06101) El Tiempo,363,242,257,862
41460,2020-07-10,(09117) Calle 45,759,478,477,1714
41461,2020-09-20,(09101) Quiroga,195,98,200,493
41462,2020-03-20,(10001) Country Sur,516,233,257,1006
41463,2020-08-31,(07101) CASTELLANA,241,114,115,470
41464,2020-06-18,(07003) SEVILLANA,455,257,217,929
41465,2020-08-29,(06106) Recinto Ferial,199,132,122,453
41466,2020-06-11,(07009) SENA,642,395,365,1402
41467,2020-03-14,(04103) Las Ferias,768,429,585,1782
41468,2020-08-04,(03012) SUBA - CALLE 95,248,146,150,544
41469,2020-04-05,(03010) PUENTE LARGO,89,78,47,214
41470,2020-02-15,(07107) U. NACIONAL,858,614,988,2460
41471,2020-03-21,(10000) Portal 20 de Julio - alimentacion,1424,637,841,2902
41472,2020-05-01,(02105) Calle 142,190,147,118,455
41473,2020-08-22,(02105) Calle 142,516,307,374,1197
41474,2020-04-22,(10008) San Diego,154,97,93,344
41475,2020-08-22,(07103) AV. CHILE,607,388,401,1396
41476,2020-02-10,(10005) Bicentenario,870,430,330,1630
41477,2020-04-10,(10010) San Bernardo,140,91,101,332
41478,2019-12-31,(09000) Cabecera Usme - alimentacion,256,224,405,885
41479,2020-05-23,(10001) Country Sur,711,321,466,1498
41480,2020-08-23,(07103) AV. CHILE,181,131,181,493
41481,2020-02-08,(10005) Bicentenario,220,139,275,634
41482,2020-01-27,(03005) SUBA - AV. BOYACA,2706,1581,1536,5823
41483,2020-01-04,(10003) Ciudad Jardín,342,170,307,819
41484,2020-05-10,(05100) Banderas P. Central - alimentacion,535,258,259,1052
41485,2020-06-26,(02102) Calle 161,242,159,171,572
41486,2020-07-01,(02102) Calle 161,249,158,196,603
41487,2020-06-19,(07003) SEVILLANA,456,245,258,959
41488,2020-05-07,(02104) Calle 146,497,318,299,1114
41489,2020-08-08,(04000) Cabecera Calle 80,572,357,543,1472
41490,2020-01-19,(05107) Américas - Cr.53,381,249,475,1105
41491,2020-07-07,(09003) Socorro,658,351,355,1364
41492,2020-07-14,(06111) Universidades,243,134,209,586
41493,2020-06-09,(07111) NQS - RICAURTE,1087,692,448,2227
41494,2020-01-01,(09115) Calle 34,173,155,373,701
41495,2020-08-10,(09115) Calle 34,589,374,386,1349
41496,2020-04-14,(02104) Calle 146,395,302,238,935
41497,2020-01-13,(05102) Av. Américas - Av. Boyacá,1317,782,790,2889
41498,2020-09-26,(07110) PALOQUEMAO,475,345,339,1159
41499,2020-03-13,(05102) Av. Américas - Av. Boyacá,146,284,233,663
41500,2020-01-21,(05101) Mandalay - Cr.73,711,235,262,1208
41501,2020-03-09,(03012) SUBA - CALLE 95,586,168,236,990
41502,2020-04-26,(09123) Calle 76,152,123,96,371
41503,2020-05-04,(02302) Virrey,446,295,268,1009
41504,2020-05-22,(02302) Virrey,522,370,290,1182
41505,2020-07-09,(07201) Guatoque -Veraguas,189,114,132,435
41506,2020-07-03,(07107) U. NACIONAL,338,205,205,748
41507,2020-01-11,(07105) MOVISTAR ARENA,527,349,501,1377
41508,2020-07-19,(04102) Avenida Boyaca,124,50,62,236
41509,2020-09-30,(03003) 21 ANGELES,405,196,281,882
41510,2020-05-20,(10006) San Victorino,402,239,253,894
41511,2020-10-11,(10007) Las Nieves,100,100,217,417
41512,2020-06-01,(04104) Avenida 68,578,315,293,1186
41513,2020-08-25,(09114) Calle 26,287,174,203,664
41514,2020-03-27,(07103) AV. CHILE,377,304,233,914
41515,2020-06-07,(07109) CAD,158,112,127,397
41516,2020-06-15,(07109) CAD,199,141,138,478
41517,2020-09-22,(07506) DESPENSA,447,295,336,1078
41518,2020-07-02,(06001) Modelia,410,279,204,893
41519,2020-04-03,(03013) RIO NEGRO,123,71,93,287
41520,2020-06-07,(10009) Museo Nacional,69,50,97,216
41521,2020-05-29,(04106) Carrera 47,329,173,133,635
41522,2020-06-25,(04106) Carrera 47,344,166,196,706
41523,2020-08-10,(07009) SENA,587,337,379,1303
41524,2020-05-22,(04106) Carrera 47,287,165,160,612
41525,2020-06-02,(07109) CAD,605,387,280,1272
41526,2020-08-09,(02201) Prado,185,154,206,545
41527,2020-07-03,(02000) Cabecera Autopista Norte - intermunicipal,610,400,401,1411
41528,2020-04-15,(07003) SEVILLANA,220,116,96,432
41529,2020-08-06,(09114) Calle 26,294,187,203,684
41530,2020-02-29,(05101) Mandalay - Cr.73,521,220,393,1134
41531,2020-05-07,(07004) VENECIA,596,365,324,1285
41532,2020-09-14,(07008) NQS - Calle 30 Sur,340,188,227,755
41533,2020-05-29,(04102) Avenida Boyaca,279,163,161,603
41534,2020-08-14,(12002) CDS - Carrera 32,198,113,84,395
41535,2020-06-06,(06002) Normandía,182,123,124,429
41536,2020-06-15,(04104) Avenida 68,224,132,134,490
41537,2020-09-01,(14004) Museo del Oro,345,205,279,829
41538,2020-09-25,(09108) Hospital,70,40,71,181
41539,2020-08-08,(09117) Calle 45,442,298,368,1108
41540,2020-06-24,(06101) El Tiempo,354,247,183,784
41541,2020-08-02,(07002) MADELENA,160,82,137,379
41542,2020-03-23,(04000) Cabecera Calle 80,209,141,186,536
41543,2020-01-05,(09111) Calle 19,362,239,457,1058
41544,2020-03-27,(09116) Avenida 39,161,137,127,425
41545,2020-08-02,(05002) Tintal,543,298,429,1270
41546,2020-09-07,(05101) Mandalay - Cr.73,147,90,92,329
41547,2020-05-12,(03011) SUBA - CALLE 100,326,163,159,648
41548,2020-08-09,(07506) DESPENSA,125,55,88,268
41549,2020-03-21,(07005) ALQUERIA,177,92,71,340
41550,2020-09-13,(08000) Portal Tunal,100,56,168,324
41551,2020-10-04,(12007) Zona Industrial,61,51,88,200
41552,2020-04-25,(04003) Avenida Ciudad de Cali,388,242,285,915
41553,2020-04-26,(08002) Biblioteca,77,42,36,155
41554,2020-05-17,(06103) CAN,125,81,80,286
41555,2020-09-29,(07201) Guatoque -Veraguas,235,145,182,562
41556,2020-07-25,(04001) Quirigua,267,145,169,581
41557,2020-07-12,(09111) Calle 19,268,205,258,731
41558,2020-09-01,(14005) Las Aguas,197,114,188,499
41559,2020-08-30,(04106) Carrera 47,105,65,89,259
41560,2020-09-20,(07101) CASTELLANA,31,24,48,103
41561,2020-09-08,(07106) EL CAMPIN,436,272,249,957
41562,2020-04-29,(09106) Nariño,268,153,142,563
41563,2020-05-19,(06100) Av. Rojas,177,85,97,359
41564,2020-08-28,(06104) Gobernación,239,143,140,522
41565,2020-09-13,(12002) CDS - Carrera 32,31,43,35,109
41566,2020-08-07,(12007) Zona Industrial,112,71,71,254
41567,2020-05-05,(07006) General Santander,327,195,173,695
41568,2020-07-20,(07002) MADELENA,187,97,122,406
41569,2020-04-21,(09114) Calle 26,170,138,141,449
41570,2020-05-24,(09115) Calle 34,132,99,95,326
41571,2020-04-20,(14005) Las Aguas,0,29,86,115
41572,2020-05-10,(07113) SANTA ISABEL,83,53,58,194
41573,2020-07-30,(07101) CASTELLANA,187,119,97,403
41574,2020-06-08,(07101) CASTELLANA,194,119,103,416
41575,2020-07-12,(07200) Tygua-San José,85,46,79,210
41576,2020-06-01,(07101) CASTELLANA,172,96,107,375
41577,2020-07-05,(06108) Concejo de Bogotá,43,28,42,113
41578,2020-04-23,(05101) Mandalay - Cr.73,58,33,30,121
41579,2020-05-24,(05101) Mandalay - Cr.73,21,11,13,45
41580,2020-03-28,(06106) Recinto Ferial,97,66,45,208
41581,2020-02-28,(50006) Corral Carrera 77,33,26,41,100
41582,2020-03-26,(50006) Corral Carrera 77,6,6,5,17
41583,2020-09-26,(03014) SAN MARTIN,0,9,38,47
41584,2020-07-26,(03014) SAN MARTIN,0,2,8,10
41585,2020-07-05,(50006) Corral Carrera 77,3,1,3,7
41586,2020-07-01,(09002) Consuelo,505,275,321,1101
41587,2020-07-21,(02502) Terminal,386,274,294,954
41588,2020-08-13,(02502) Terminal,399,243,319,961
41589,2020-04-17,(07504) TERREROS,2445,1617,1231,5293
41590,2020-05-13,(09119) Calle 57,437,291,281,1009
41591,2020-02-28,(07111) NQS - RICAURTE,3169,2072,1778,7019
41592,2020-01-02,(02200) Alcalá,4476,2803,2902,10181
41593,2020-02-02,(07503) SAN MATEO,9780,4324,6741,20845
41594,2020-06-10,(07503) SAN MATEO,9776,6226,5132,21134
41595,2020-06-26,(05000) Portal Américas - alimentacion,11629,6308,5898,23835
41596,2020-07-27,(05001) Patio Bonito,1420,814,866,3100
41597,2020-02-22,(05005) Transversal 86,1410,538,953,2901
41598,2020-01-18,(09004) Santa Lucía,4857,2260,3435,10552
41599,2020-01-31,(07103) AV. CHILE,3462,2215,1877,7554
41600,2020-01-29,(40001) Juan Pablo II,1584,915,921,3420
41601,2020-01-29,(09115) Calle 34,4056,2637,2365,9058
41602,2020-01-10,(07009) SENA,2493,1387,1657,5537
41603,2020-09-12,(10005) Bicentenario - alimentacion,164,71,188,423
41604,2020-10-12,(10005) Bicentenario - alimentacion,57,39,130,226
41605,2020-08-31,(09104) Restrepo,1549,848,1107,3504
41606,2020-04-16,(07505) LEON XIII,1155,771,609,2535
41607,2020-01-13,(02101) Toberín,11682,7201,6447,25330
41608,2020-08-29,(02204) Pepe Sierra,558,412,385,1355
41609,2020-02-06,(04104) Avenida 68,3669,2005,1969,7643
41610,2020-02-12,(04104) Avenida 68,3898,2020,1890,7808
41611,2020-02-13,(02502) Terminal,5472,3507,3117,12096
41612,2020-10-10,(04100) Carrera 77,1095,511,1028,2634
41613,2020-03-06,(03013) RIO NEGRO,1216,781,883,2880
41614,2020-03-31,(07110) PALOQUEMAO,337,240,181,758
41615,2020-01-17,(06001) Modelia,2026,1187,1191,4404
41616,2020-03-04,(03007) HUMEDAL CORDOBA,1045,668,541,2254
41617,2020-01-24,(09103) Olaya,3818,2136,2397,8351
41618,2020-05-11,(14001) La Sabana,113,73,74,260
41619,2020-03-28,(07111) NQS - RICAURTE,248,159,120,527
41620,2020-01-14,(07107) U. NACIONAL,1167,844,1010,3021
41621,2020-09-17,(09113) Calle 22,444,247,379,1070
41622,2020-07-29,(09110) Avenida Jimenez,1287,908,768,2963
41623,2020-07-03,(09001) Molinos,2742,1485,1926,6153
41624,2020-06-26,(04002) Carrera 90,824,422,431,1677
41625,2020-09-03,(02101) Toberín,1487,944,1084,3515
41626,2020-02-05,(12001) Carrera 43,1761,986,1066,3813
41627,2020-02-18,(12001) Carrera 43,1798,1070,1097,3965
41628,2020-07-25,(12001) Carrera 43,239,132,117,488
41629,2020-08-10,(12001) Carrera 43,398,216,229,843
41630,2020-07-11,(10002) Av. Primero de Mayo,1799,875,1339,4013
41631,2020-10-02,(10002) Av. Primero de Mayo,2608,1237,1963,5808
41632,2020-07-06,(03000) Portal Suba,1345,889,974,3208
41633,2020-08-04,(10000) Portal 20 de Julio - alimentacion,3913,1672,2386,7971
41634,2020-01-21,(09101) Quiroga,1137,617,798,2552
41635,2020-10-02,(09101) Quiroga,673,314,557,1544
41636,2020-08-29,(10002) Av. Primero de Mayo,1649,818,1299,3766
41637,2020-02-01,(05100) Banderas P. Central - alimentacion,7853,3825,6032,17710
41638,2020-01-15,(09116) Avenida 39,2177,1440,1288,4905
41639,2020-05-04,(09116) Avenida 39,227,145,149,521
41640,2020-03-10,(10002) Av. Primero de Mayo,435,1879,1409,3723
41641,2020-02-28,(04002) Carrera 90,3864,2121,2110,8095
41642,2020-02-07,(09004) Santa Lucía,7673,4219,4300,16192
41643,2020-07-23,(08001) Parque el Tunal,337,220,190,747
41644,2020-01-18,(02302) Virrey,1284,952,1162,3398
41645,2020-02-12,(06108) Concejo de Bogotá,915,462,467,1844
41646,2020-09-20,(06108) Concejo de Bogotá,39,23,47,109
41647,2020-10-02,(14004) Museo del Oro,449,319,387,1155
41648,2020-08-11,(02201) Prado,688,476,514,1678
41649,2020-03-16,(02304) Heroes,3126,2295,1647,7068
41650,2020-05-19,(09123) Calle 76,779,571,451,1801
41651,2020-05-18,(05002) Tintal,1678,963,964,3605
41652,2020-01-01,(07112) COMUNEROS,256,160,368,784
41653,2020-02-05,(05105) Pradera,2702,1640,1331,5673
41654,2020-01-03,(02300) Calle 100,3499,2291,2225,8015
41655,2020-07-06,(03012) SUBA - CALLE 95,355,210,199,764
41656,2020-05-27,(10000) Portal 20 de Julio,2098,1079,1026,4203
41657,2020-09-12,(09001) Molinos,2317,1070,1843,5230
41658,2020-02-12,(07006) General Santander,3033,1774,1557,6364
41659,2020-01-30,(02104) Calle 146,9369,5752,5012,20133
41660,2020-05-24,(08000) Portal Tunal,186,106,91,383
41661,2020-02-17,(08000) Portal Tunal,2237,1298,1113,4648
41662,2020-08-25,(06109) Centro Memoria,250,147,130,527
41663,2020-01-19,(10007) Las Nieves,204,211,462,877
41664,2020-01-31,(09106) Nariño,1992,1103,1417,4512
41665,2020-07-17,(03009) Av. Suba- Calle 116,508,303,221,1032
41666,2020-09-02,(03009) Av. Suba- Calle 116,537,315,253,1105
41667,2020-09-18,(04108) El Polo,547,342,324,1213
41668,2020-06-03,(02300) Calle 100,1220,794,572,2586
41669,2020-01-12,(05001) Patio Bonito,1498,686,1265,3449
41670,2020-01-29,(07101) CASTELLANA,990,579,554,2123
41671,2020-09-08,(02201) Prado,949,627,618,2194
41672,2020-01-01,(07113) SANTA ISABEL,180,84,271,535
41673,2020-03-15,(09000) Cabecera Usme,1023,467,1057,2547
41674,2020-04-15,(03007) HUMEDAL CORDOBA,76,44,29,149
41675,2020-01-24,(07108) Av. El Dorado,835,538,626,1999
41676,2020-07-17,(07000) Portal Sur,1598,1014,956,3568
41677,2020-07-20,(05100) Banderas P. Central - alimentacion,816,359,426,1601
41678,2020-04-08,(07110) PALOQUEMAO,294,232,174,700
41679,2020-06-05,(10005) Bicentenario - alimentacion,236,104,178,518
41680,2020-08-10,(09109) Tercer Milenio,325,219,238,782
41681,2020-05-18,(05001) Patio Bonito,1330,702,802,2834
41682,2020-03-02,(04001) Quirigua,2010,1272,1190,4472
41683,2020-08-14,(03001) LA CAMPIÑA,964,528,594,2086
41684,2020-10-10,(06101) El Tiempo,221,184,313,718
41685,2020-03-28,(40003) Mirador del Paraiso,557,312,340,1209
41686,2020-08-22,(09110) Avenida Jimenez,679,579,638,1896
41687,2020-04-08,(02202) Calle 127,675,484,358,1517
41688,2020-09-23,(09121) Las Flores,780,476,576,1832
41689,2020-06-23,(05002) Tintal,2738,1513,1487,5738
41690,2020-06-29,(05000) Portal Américas - alimentacion,3902,1785,1896,7583
41691,2020-08-07,(02304) Heroes,266,193,201,660
41692,2020-10-02,(04002) Carrera 90,885,451,650,1986
41693,2020-01-04,(02105) Calle 142,1407,681,1259,3347
41694,2020-03-13,(06106) Recinto Ferial,325,110,166,601
41695,2020-04-27,(02302) Virrey,61,174,105,340
41696,2020-03-04,(04101) Minuto de Dios,3566,2155,1884,7605
41697,2020-05-23,(07106) EL CAMPIN,201,156,128,485
41698,2020-03-15,(03010) PUENTE LARGO,230,146,250,626
41699,2020-05-01,(03009) Av. Suba- Calle 116,170,127,93,390
41700,2020-01-05,(06103) CAN,233,161,224,618
41701,2020-02-15,(06103) CAN,727,598,871,2196
41702,2020-04-09,(09109) Tercer Milenio,74,47,46,167
41703,2020-04-09,(09116) Avenida 39,88,62,51,201
41704,2020-10-03,(03006) NIZA - CALLE 127,417,258,332,1007
41705,2020-02-17,(10005) Bicentenario,828,436,378,1642
41706,2020-09-08,(03002) SUBA - TV- 91,861,514,533,1908
41707,2020-09-19,(02104) Calle 146,716,390,613,1719
41708,2020-01-09,(06107) Ciudad Universitaria,637,383,586,1606
41709,2020-06-03,(02304) Heroes,763,516,370,1649
41710,2020-05-17,(07112) COMUNEROS,176,103,128,407
41711,2020-05-22,(02001) Centro Comercial Santa Fe,370,219,241,830
41712,2020-03-09,(03006) NIZA - CALLE 127,729,340,344,1413
41713,2020-01-14,(07102) NQS - CALLE 75,1338,810,846,2994
41714,2020-10-10,(10008) San Diego,227,154,233,614
41715,2020-09-02,(09120) Calle 63,1253,788,824,2865
41716,2020-09-06,(09120) Calle 63,417,309,430,1156
41717,2020-07-09,(03011) SUBA - CALLE 100,559,272,231,1062
41718,2020-02-23,(03001) LA CAMPIÑA,1106,484,1063,2653
41719,2020-08-28,(09117) Calle 45,648,415,437,1500
41720,2020-03-22,(05105) Pradera,96,69,49,214
41721,2020-09-28,(06111) Universidades,490,269,443,1202
41722,2020-07-10,(03006) NIZA - CALLE 127,561,302,240,1103
41723,2020-06-24,(07110) PALOQUEMAO,667,419,298,1384
41724,2020-09-05,(14004) Museo del Oro,158,135,242,535
41725,2020-04-26,(08000) Portal Tunal - alimentacion,1461,739,788,2988
41726,2020-05-08,(02101) Toberín,946,625,567,2138
41727,2020-04-15,(06100) Av. Rojas,117,80,84,281
41728,2020-06-13,(09122) Calle 72,848,561,618,2027
41729,2020-04-18,(06104) Gobernación,83,69,40,192
41730,2020-09-25,(04105) Carrera 53,333,180,244,757
41731,2020-07-21,(50003) Corral Molinos,1223,673,865,2761
41732,2020-09-06,(07105) MOVISTAR ARENA,52,49,97,198
41733,2020-08-25,(07003) SEVILLANA,390,251,233,874
41734,2020-08-04,(09113) Calle 22,383,221,268,872
41735,2020-01-19,(09110) Avenida Jimenez,982,785,1051,2818
41736,2020-04-20,(10006) San Victorino,204,157,141,502
41737,2020-07-20,(07110) PALOQUEMAO,137,119,119,375
41738,2020-08-16,(08000) Portal Tunal,221,132,147,500
41739,2020-06-15,(07001) PERDOMO,258,136,193,587
41740,2020-09-03,(05005) Transversal 86,422,218,303,943
41741,2020-07-23,(03009) Av. Suba- Calle 116,476,283,195,954
41742,2020-09-13,(09110) Avenida Jimenez,535,445,434,1414
41743,2020-05-08,(07109) CAD,465,294,204,963
41744,2020-06-15,(12000) Puente Aranda,14,15,10,39
41745,2020-06-16,(14005) Las Aguas,124,98,165,387
41746,2020-07-06,(03005) SUBA - AV. BOYACA,484,299,304,1087
41747,2020-01-26,(14001) La Sabana,69,70,141,280
41748,2020-01-29,(09111) Calle 19,2161,1337,1450,4948
41749,2020-06-16,(06106) Recinto Ferial,233,156,134,523
41750,2020-08-15,(04106) Carrera 47,264,140,166,570
41751,2020-10-05,(10004) Policarpa,282,146,218,646
41752,2020-07-17,(08001) Parque el Tunal,349,199,210,758
41753,2020-02-27,(07200) Tygua-San José,804,492,553,1849
41754,2020-07-30,(07200) Tygua-San José,216,126,137,479
41755,2020-06-22,(02502) Terminal,91,72,122,285
41756,2020-10-09,(09117) Calle 45,761,465,697,1923
41757,2020-08-25,(07005) ALQUERIA,519,307,294,1120
41758,2020-08-09,(04003) Avenida Ciudad de Cali,213,135,205,553
41759,2020-05-17,(02001) Centro Comercial Santa Fe,84,64,82,230
41760,2020-02-20,(12002) CDS - Carrera 32,673,409,304,1386
41761,2020-09-07,(06002) Normandía,340,192,202,734
41762,2020-06-16,(06100) Av. Rojas,234,137,134,505
41763,2020-10-01,(07110) PALOQUEMAO,704,426,427,1557
41764,2020-07-23,(40001) Juan Pablo II,373,227,272,872
41765,2020-05-17,(03012) SUBA - CALLE 95,65,54,40,159
41766,2020-05-22,(07006) General Santander,394,265,195,854
41767,2020-08-12,(07506) DESPENSA,432,245,247,924
41768,2020-07-01,(07006) General Santander - alimentacion,422,235,289,946
41769,2020-09-02,(14005) Las Aguas,196,130,214,540
41770,2020-04-14,(07006) General Santander - alimentacion,195,121,120,436
41771,2020-08-30,(07005) ALQUERIA,165,87,182,434
41772,2020-08-17,(03011) SUBA - CALLE 100,155,71,98,324
41773,2020-04-27,(07009) SENA,190,62,41,293
41774,2020-09-07,(05105) Pradera,599,373,288,1260
41775,2020-03-31,(05100) Banderas P. Central,325,196,204,725
41776,2020-08-11,(05102) Av. Américas - Av. Boyacá,244,120,167,531
41777,2020-10-11,(04105) Carrera 53,98,41,133,272
41778,2020-06-22,(05107) Américas - Cr.53,126,88,90,304
41779,2020-05-02,(03010) PUENTE LARGO,163,106,88,357
41780,2020-05-29,(07506) DESPENSA,458,219,247,924
41781,2020-08-29,(04103) Las Ferias,303,153,185,641
41782,2020-07-04,(12007) Zona Industrial,302,175,182,659
41783,2020-06-05,(06108) Concejo de Bogotá,125,68,77,270
41784,2020-07-21,(03004) GRATAMIRA,30,14,23,67
41785,2020-04-08,(07002) MADELENA,323,179,190,692
41786,2020-10-11,(40001) Juan Pablo II,188,97,197,482
41787,2020-06-07,(07113) SANTA ISABEL,118,50,116,284
41788,2020-04-21,(04105) Carrera 53,173,113,83,369
41789,2020-06-10,(06102) Salitre El Greco,201,125,111,437
41790,2020-06-05,(14005) Las Aguas,0,71,213,284
41791,2020-02-15,(03014) SAN MARTIN,117,72,142,331
41792,2020-04-21,(03003) 21 ANGELES,163,74,73,310
41793,2020-09-28,(07201) Guatoque -Veraguas,236,134,202,572
41794,2020-08-04,(07113) SANTA ISABEL,298,185,216,699
41795,2020-08-22,(05103) Marsella,269,120,194,583
41796,2020-08-07,(04105) Carrera 53,91,46,64,201
41797,2020-04-25,(07004) VENECIA,369,228,204,801
41798,2020-04-06,(07008) NQS - Calle 30 Sur,152,97,80,329
41799,2020-06-28,(07008) NQS - Calle 30 Sur,109,57,75,241
41800,2020-05-31,(14005) Las Aguas,0,20,62,82
41801,2020-08-24,(09114) Calle 26,224,166,179,569
41802,2020-09-10,(07201) Guatoque -Veraguas,188,110,145,443
41803,2020-05-30,(10003) Ciudad Jardín,160,63,96,319
41804,2020-06-29,(07006) General Santander,194,112,133,439
41805,2020-07-22,(03007) HUMEDAL CORDOBA,131,83,66,280
41806,2020-07-26,(10007) Las Nieves,55,45,74,174
41807,2020-05-16,(10003) Ciudad Jardín,115,57,75,247
41808,2020-08-09,(06104) Gobernación,54,32,32,118
41809,2020-09-15,(50002) Corral Calle 40 Sur,21,14,21,56
41810,2020-04-11,(04102) Avenida Boyaca,78,48,46,172
41811,2020-05-03,(04000) Cabecera Calle 80 - intermunicipal,19,12,17,48
41812,2020-07-02,(03014) SAN MARTIN,34,11,24,69
41813,2020-04-27,(02102) Calle 161,49,38,16,103
41814,2020-05-14,(10005) Bicentenario,91,38,52,181
41815,2020-04-14,(50002) Corral Calle 40 Sur,8,2,6,16
41816,2020-07-12,(03014) SAN MARTIN,11,3,9,23
41817,2020-06-07,(50002) Corral Calle 40 Sur,8,2,5,15
41818,2020-01-22,(04000) Cabecera Calle 80 - alimentacion,21267,12513,13789,47569
41819,2020-03-03,(04000) Cabecera Calle 80 - alimentacion,24048,14490,15025,53563
41820,2020-10-02,(07005) ALQUERIA,685,381,485,1551
41821,2020-02-18,(10000) Portal 20 de Julio - alimentacion,11558,5677,7477,24712
41822,2020-09-28,(03000) Portal Suba - alimentacion,7245,3951,4906,16102
41823,2020-01-21,(05000) Portal Américas - alimentacion,25461,9155,11909,46525
41824,2020-03-10,(03002) SUBA - TV- 91,246,1368,903,2517
41825,2020-03-03,(09100) Calle 40 Sur,7475,4268,4112,15855
41826,2020-02-24,(09114) Calle 26,3401,2168,1772,7341
41827,2020-06-23,(04002) Carrera 90,759,446,420,1625
41828,2020-02-13,(07111) NQS - RICAURTE,2583,1985,1873,6441
41829,2020-08-18,(05000) Portal Américas - alimentacion,10289,5448,5403,21140
41830,2020-06-20,(05000) Portal Américas - alimentacion,8540,4588,4655,17783
41831,2020-06-25,(05000) Portal Américas - alimentacion,11225,6188,5540,22953
41832,2020-03-17,(08000) Portal Tunal - alimentacion,16073,8321,7788,32182
41833,2020-02-18,(08000) Portal Tunal - alimentacion,25254,14002,12019,51275
41834,2020-10-02,(10000) Portal 20 de Julio - alimentacion,4935,2089,3347,10371
41835,2020-10-03,(09004) Santa Lucía,2443,1037,1787,5267
41836,2020-02-05,(03009) Av. Suba- Calle 116,2651,1693,1508,5852
41837,2020-09-18,(09100) Calle 40 Sur,1950,1144,1485,4579
41838,2020-10-07,(09100) Calle 40 Sur,2010,1125,1616,4751
41839,2020-03-06,(09000) Cabecera Usme,5952,3332,3948,13232
41840,2020-09-22,(09000) Cabecera Usme,1915,1171,1523,4609
41841,2020-09-25,(09000) Cabecera Usme,1972,1140,1551,4663
41842,2020-04-26,(06000) Portal Eldorado - alimentacion,847,404,421,1672
41843,2020-02-14,(02105) Calle 142,7498,4129,3901,15528
41844,2020-05-21,(10000) Portal 20 de Julio - alimentacion,3514,1594,1876,6984
41845,2020-02-08,(07005) ALQUERIA,1779,873,1116,3768
41846,2020-09-13,(02000) Cabecera Autopista Norte,487,300,463,1250
41847,2020-05-30,(09109) Tercer Milenio,268,174,190,632
41848,2020-08-20,(09104) Restrepo,1510,869,1013,3392
41849,2020-06-12,(03000) Portal Suba - alimentacion,6241,3640,3396,13277
41850,2020-08-26,(03000) Portal Suba - alimentacion,5620,3249,3443,12312
41851,2020-03-17,(07110) PALOQUEMAO,1731,1047,788,3566
41852,2020-02-12,(02000) Cabecera Autopista Norte - alimentacion,24979,14463,13322,52764
41853,2020-02-14,(02000) Cabecera Autopista Norte - alimentacion,23828,13465,13770,51063
41854,2020-02-20,(07111) NQS - RICAURTE,3216,2078,1654,6948
41855,2020-02-26,(03005) SUBA - AV. BOYACA,2862,1626,1545,6033
41856,2020-07-09,(09101) Quiroga,598,312,431,1341
41857,2020-01-29,(02302) Virrey,3781,2508,1691,7980
41858,2020-03-01,(02302) Virrey,373,339,630,1342
41859,2020-01-20,(06001) Modelia,2268,1374,1295,4937
41860,2020-02-17,(06001) Modelia,2713,1585,1264,5562
41861,2020-01-21,(02303) Calle 85,2144,1847,1520,5511
41862,2020-10-05,(07106) EL CAMPIN,491,332,370,1193
41863,2020-08-18,(02000) Cabecera Autopista Norte,1171,779,794,2744
41864,2020-06-13,(09113) Calle 22,365,246,318,929
41865,2020-02-05,(10007) Las Nieves,2037,1267,1221,4525
41866,2020-09-28,(04105) Carrera 53,291,179,184,654
41867,2020-01-30,(07109) CAD,2849,1740,1647,6236
41868,2020-05-20,(50003) Corral Molinos,1289,613,791,2693
41869,2020-05-13,(04000) Cabecera Calle 80,812,525,546,1883
41870,2020-03-08,(07010) Bosa,407,226,519,1152
41871,2020-01-30,(05002) Tintal,10866,6347,5914,23127
41872,2020-01-11,(09114) Calle 26,548,463,783,1794
41873,2020-03-16,(04002) Carrera 90,2501,1437,1428,5366
41874,2020-01-03,(06109) Centro Memoria,519,299,376,1194
41875,2020-02-19,(40003) Mirador del Paraiso,4980,2826,2666,10472
41876,2020-03-18,(40003) Mirador del Paraiso,3375,1921,1916,7212
41877,2020-01-12,(05002) Tintal,1938,850,1821,4609
41878,2020-06-09,(12001) Carrera 43,409,210,212,831
41879,2020-03-08,(04104) Avenida 68,611,328,621,1560
41880,2020-02-27,(02001) Centro Comercial Santa Fe,4912,3064,2586,10562
41881,2020-07-26,(06105) Quinta Paredes,31,13,25,69
41882,2020-08-02,(06105) Quinta Paredes,25,19,32,76
41883,2020-05-14,(02000) Cabecera Autopista Norte - intermunicipal,338,240,242,820
41884,2020-08-30,(10002) Av. Primero de Mayo,604,299,595,1498
41885,2020-01-31,(09115) Calle 34,3919,2596,2469,8984
41886,2020-02-17,(04106) Carrera 47,1520,847,857,3224
41887,2020-08-14,(10000) Portal 20 de Julio,2180,1099,1122,4401
41888,2020-10-01,(02303) Calle 85,868,569,549,1986
41889,2020-02-25,(10004) Policarpa,947,479,584,2010
41890,2020-05-22,(09003) Socorro,526,269,276,1071
41891,2020-08-19,(08001) Parque el Tunal,438,230,285,953
41892,2020-10-02,(09116) Avenida 39,441,284,404,1129
41893,2020-05-14,(04000) Cabecera Calle 80,838,528,542,1908
41894,2020-02-21,(09120) Calle 63,6129,4432,3968,14529
41895,2020-04-20,(05002) Tintal,1413,769,694,2876
41896,2020-10-01,(05002) Tintal,3038,1724,2036,6798
41897,2020-02-26,(03007) HUMEDAL CORDOBA,1048,631,576,2255
41898,2020-01-30,(03011) SUBA - CALLE 100,2598,1283,1467,5348
41899,2020-01-02,(03012) SUBA - CALLE 95,575,408,471,1454
41900,2020-07-11,(03012) SUBA - CALLE 95,230,167,173,570
41901,2020-07-17,(03012) SUBA - CALLE 95,318,191,151,660
41902,2020-02-22,(04104) Avenida 68,1744,1015,1421,4180
41903,2020-03-13,(04104) Avenida 68,976,341,451,1768
41904,2020-09-01,(02202) Calle 127,1084,788,638,2510
41905,2020-10-04,(02202) Calle 127,349,303,384,1036
41906,2020-08-12,(10008) San Diego,304,159,165,628
41907,2020-04-16,(08000) Portal Tunal,457,271,239,967
41908,2020-06-08,(08000) Portal Tunal,758,303,265,1326
41909,2020-09-11,(02205) Calle 106,373,220,277,870
41910,2020-09-22,(04101) Minuto de Dios,382,233,387,1002
41911,2020-07-28,(06000) Portal Eldorado - alimentacion,3430,1780,1818,7028
41912,2020-02-05,(07201) Guatoque -Veraguas,1088,555,625,2268
41913,2020-02-17,(06000) Portal Eldorado,6826,4007,2871,13704
41914,2020-05-01,(07505) LEON XIII,702,399,344,1445
41915,2020-08-24,(07103) AV. CHILE,883,525,406,1814
41916,2020-01-02,(03007) HUMEDAL CORDOBA,285,189,244,718
41917,2020-01-10,(08002) Biblioteca,785,401,555,1741
41918,2020-03-10,(10003) Ciudad Jardín,54,259,179,492
41919,2020-01-03,(02202) Calle 127,2495,1670,1613,5778
41920,2020-03-26,(02202) Calle 127,688,507,345,1540
41921,2020-08-13,(09100) Calle 40 Sur,1655,961,1030,3646
41922,2020-01-27,(07104) Simon Bolivar,2260,1384,1182,4826
41923,2020-09-23,(10005) Bicentenario - alimentacion,206,101,217,524
41924,2020-06-01,(05000) Portal Américas,2045,1485,1611,5141
41925,2020-01-12,(05107) Américas - Cr.53,356,222,407,985
41926,2020-09-12,(04003) Avenida Ciudad de Cali,882,434,732,2048
41927,2020-01-14,(02105) Calle 142,5755,3463,3411,12629
41928,2020-08-26,(04104) Avenida 68,617,299,320,1236
41929,2020-01-18,(05103) Marsella,1207,555,929,2691
41930,2020-07-18,(07002) MADELENA,401,210,321,932
41931,2020-09-08,(03001) LA CAMPIÑA,1217,709,692,2618
41932,2020-10-12,(03002) SUBA - TV- 91,246,114,305,665
41933,2020-05-30,(02204) Pepe Sierra,505,363,283,1151
41934,2020-03-03,(07101) CASTELLANA,917,591,618,2126
41935,2020-08-11,(40001) Juan Pablo II,511,321,332,1164
41936,2020-09-06,(06100) Av. Rojas,34,33,65,132
41937,2020-07-10,(02302) Virrey,746,491,409,1646
41938,2020-05-15,(12003) Ricaurte,263,199,130,592
41939,2020-07-21,(12003) Ricaurte,249,175,152,576
41940,2020-09-13,(03010) PUENTE LARGO,71,42,104,217
41941,2020-05-01,(04100) Carrera 77,331,165,247,743
41942,2020-08-02,(02105) Calle 142,146,129,157,432
41943,2020-03-26,(09109) Tercer Milenio,136,97,82,315
41944,2020-03-27,(10010) San Bernardo,325,225,253,803
41945,2020-03-10,(09123) Calle 76,3157,237,750,4144
41946,2020-06-14,(09000) Cabecera Usme - alimentacion,2319,1143,1479,4941
41947,2020-01-08,(10005) Bicentenario,566,292,278,1136
41948,2020-08-19,(10005) Bicentenario,79,37,66,182
41949,2020-01-09,(40002) Manitas,954,549,632,2135
41950,2020-03-11,(12002) CDS - Carrera 32,580,347,343,1270
41951,2020-09-04,(09106) Nariño,497,265,400,1162
41952,2020-06-13,(05100) Banderas P. Central - alimentacion,1693,814,1140,3647
41953,2020-04-25,(09120) Calle 63,479,340,287,1106
41954,2020-05-25,(09002) Consuelo,146,66,94,306
41955,2020-01-04,(05107) Américas - Cr.53,811,509,581,1901
41956,2020-05-21,(06111) Universidades,0,114,306,420
41957,2020-10-03,(06100) Av. Rojas,170,119,245,534
41958,2020-06-24,(07111) NQS - RICAURTE,1246,729,478,2453
41959,2020-07-24,(07111) NQS - RICAURTE,757,476,340,1573
41960,2020-05-18,(04002) Carrera 90,610,330,332,1272
41961,2020-02-17,(03004) GRATAMIRA,313,171,136,620
41962,2020-03-30,(05102) Av. Américas - Av. Boyacá,130,83,75,288
41963,2020-07-29,(07006) General Santander,486,282,257,1025
41964,2020-09-01,(09004) Santa Lucía,2530,1304,1425,5259
41965,2020-10-10,(06001) Modelia,225,184,261,670
41966,2020-09-09,(05102) Av. Américas - Av. Boyacá,276,157,214,647
41967,2020-08-07,(06102) Salitre El Greco,106,56,56,218
41968,2020-05-23,(09103) Olaya,632,322,351,1305
41969,2020-05-12,(02303) Calle 85,514,351,275,1140
41970,2020-02-13,(07006) General Santander - alimentacion,1542,876,1013,3431
41971,2020-03-07,(07006) General Santander - alimentacion,914,526,759,2199
41972,2020-03-28,(06101) El Tiempo,139,104,93,336
41973,2020-06-03,(02302) Virrey,613,402,314,1329
41974,2020-05-05,(09114) Calle 26,190,159,145,494
41975,2020-05-12,(07105) MOVISTAR ARENA,197,131,95,423
41976,2020-09-27,(07104) Simon Bolivar,157,88,174,419
41977,2020-06-24,(07107) U. NACIONAL,356,221,184,761
41978,2020-04-04,(07113) SANTA ISABEL,126,82,94,302
41979,2020-09-02,(14004) Museo del Oro,377,226,283,886
41980,2020-02-09,(06107) Ciudad Universitaria,206,149,386,741
41981,2020-05-08,(09121) Las Flores,472,341,295,1108
41982,2020-06-05,(09110) Avenida Jimenez,1027,690,701,2418
41983,2020-06-14,(40001) Juan Pablo II,154,76,116,346
41984,2020-08-30,(40001) Juan Pablo II,186,96,180,462
41985,2020-09-12,(04101) Minuto de Dios,264,141,229,634
41986,2020-05-01,(10007) Las Nieves,88,64,96,248
41987,2020-10-03,(14005) Las Aguas,195,125,350,670
41988,2020-04-16,(12000) Puente Aranda,50,26,15,91
41989,2020-10-03,(07109) CAD,467,310,468,1245
41990,2020-05-10,(02102) Calle 161,38,34,28,100
41991,2020-07-07,(12004) Carrera 22,281,133,154,568
41992,2020-04-17,(07107) U. NACIONAL,211,153,129,493
41993,2020-09-29,(07101) CASTELLANA,276,143,184,603
41994,2020-09-07,(09003) Socorro,549,300,349,1198
41995,2020-08-09,(08000) Portal Tunal,188,109,108,405
41996,2020-02-15,(09105) Río Fucha,462,273,414,1149
41997,2020-09-06,(02502) Terminal,97,82,171,350
41998,2020-10-07,(10007) Las Nieves,734,443,521,1698
41999,2020-06-14,(04108) El Polo,88,54,86,228
42000,2020-08-04,(03006) NIZA - CALLE 127,330,208,186,724
42001,2020-04-04,(03002) SUBA - TV- 91,290,160,146,596
42002,2020-10-11,(14004) Museo del Oro,39,51,114,204
42003,2020-05-06,(09117) Calle 45,549,335,294,1178
42004,2020-05-02,(02103) Mazurén,70,42,49,161
42005,2020-04-26,(09104) Restrepo,276,183,236,695
42006,2020-03-24,(07005) ALQUERIA,385,234,298,917
42007,2020-07-14,(07101) CASTELLANA,170,99,98,367
42008,2020-03-10,(07006) General Santander - alimentacion,85,345,282,712
42009,2020-04-07,(07009) SENA,289,169,165,623
42010,2020-04-12,(03006) NIZA - CALLE 127,124,86,39,249
42011,2020-07-22,(40002) Manitas,291,183,193,667
42012,2020-09-11,(12002) CDS - Carrera 32,181,104,117,402
42013,2020-05-30,(06102) Salitre El Greco,158,79,89,326
42014,2020-07-07,(06102) Salitre El Greco,250,151,125,526
42015,2020-03-27,(12007) Zona Industrial,143,138,82,363
42016,2020-07-13,(07109) CAD,553,359,273,1185
42017,2020-04-26,(06108) Concejo de Bogotá,40,32,24,96
42018,2020-01-06,(03004) GRATAMIRA,41,24,30,95
42019,2020-06-04,(03004) GRATAMIRA,24,19,12,55
42020,2020-07-04,(03004) GRATAMIRA,35,14,20,69
42021,2020-08-30,(06111) Universidades,132,70,165,367
42022,2020-06-15,(14004) Museo del Oro,14,20,51,85
42023,2020-06-30,(02102) Calle 161,257,154,185,596
42024,2020-08-04,(04102) Avenida Boyaca,249,155,198,602
42025,2020-03-25,(03002) SUBA - TV- 91,453,272,222,947
42026,2020-03-23,(07010) Bosa,112,73,103,288
42027,2020-07-06,(10003) Ciudad Jardín,235,114,141,490
42028,2020-05-25,(02201) Prado,280,197,174,651
42029,2020-08-11,(09116) Avenida 39,355,207,222,784
42030,2020-04-19,(03004) GRATAMIRA,13,7,3,23
42031,2020-03-13,(05101) Mandalay - Cr.73,34,206,118,358
42032,2020-07-04,(04001) Quirigua,322,184,206,712
42033,2020-10-02,(07108) Av. El Dorado,187,120,122,429
42034,2020-08-11,(07108) Av. El Dorado,135,83,108,326
42035,2020-04-26,(10009) Museo Nacional,50,51,54,155
42036,2020-06-24,(10005) Bicentenario,119,53,85,257
42037,2020-06-10,(07108) Av. El Dorado,116,81,72,269
42038,2020-06-15,(07105) MOVISTAR ARENA,69,44,54,167
42039,2020-03-21,(07105) MOVISTAR ARENA,72,55,73,200
42040,2020-04-20,(12003) Ricaurte,149,128,78,355
42041,2020-06-29,(07201) Guatoque -Veraguas,37,24,70,131
42042,2020-08-07,(09116) Avenida 39,103,67,87,257
42043,2020-03-27,(10003) Ciudad Jardín,92,52,57,201
42044,2020-04-26,(07008) NQS - Calle 30 Sur,64,26,37,127
42045,2020-10-04,(07006) General Santander,216,91,234,541
42046,2020-04-27,(06107) Ciudad Universitaria,19,49,19,87
42047,2020-04-09,(03007) HUMEDAL CORDOBA,44,28,15,87
42048,2020-03-29,(05103) Marsella,52,20,38,110
42049,2020-08-28,(03014) SAN MARTIN,0,12,43,55
42050,2020-04-22,(03004) GRATAMIRA,18,12,11,41
42051,2020-08-21,(07005) ALQUERIA,499,281,345,1125
42052,2020-08-04,(09002) Consuelo,487,239,271,997
42053,2020-08-28,(02502) Terminal,415,272,397,1084
42054,2020-07-09,(07504) TERREROS,6432,3614,2901,12947
42055,2020-07-29,(05000) Portal Américas - alimentacion,9215,4932,4586,18733
42056,2020-02-18,(04106) Carrera 47,1583,895,843,3321
42057,2020-01-18,(03002) SUBA - TV- 91,2114,1006,1518,4638
42058,2020-02-26,(07503) SAN MATEO,41426,23147,17636,82209
42059,2020-10-05,(05000) Portal Américas,3974,2122,2929,9025
42060,2020-02-08,(06104) Gobernación,369,285,470,1124
42061,2020-02-11,(09003) Socorro,1779,1028,1068,3875
42062,2020-02-25,(09121) Las Flores,3599,2231,2080,7910
42063,2020-09-04,(07111) NQS - RICAURTE,1184,722,605,2511
42064,2020-07-27,(07503) SAN MATEO,10706,6204,5062,21972
42065,2020-10-08,(05000) Portal Américas - alimentacion,12297,6346,8025,26668
42066,2020-08-18,(09001) Molinos,2415,1296,1641,5352
42067,2020-01-28,(02000) Cabecera Autopista Norte - alimentacion,22629,12999,12748,48376
42068,2020-01-17,(05000) Portal Américas,13471,7044,7508,28023
42069,2020-01-27,(07010) Bosa,2078,1265,1390,4733
42070,2020-02-04,(04103) Las Ferias,1603,908,922,3433
42071,2020-10-05,(08000) Portal Tunal - alimentacion,6841,3678,4885,15404
42072,2020-05-08,(03009) Av. Suba- Calle 116,365,267,196,828
42073,2020-05-27,(09100) Calle 40 Sur,1469,857,888,3214
42074,2020-08-22,(09100) Calle 40 Sur,1279,665,929,2873
42075,2020-03-11,(02000) Cabecera Autopista Norte,10832,6608,5633,23073
42076,2020-02-15,(10003) Ciudad Jardín,568,291,501,1360
42077,2020-01-05,(07000) Portal Sur - alimentacion,5907,2392,4012,12311
42078,2020-02-03,(02204) Pepe Sierra,5066,3340,2450,10856
42079,2020-06-18,(09000) Cabecera Usme - alimentacion,8547,4786,4868,18201
42080,2020-06-29,(07505) LEON XIII,910,463,425,1798
42081,2020-03-01,(03000) Portal Suba - alimentacion,6024,2804,5554,14382
42082,2020-05-19,(09000) Cabecera Usme,1340,892,969,3201
42083,2020-02-22,(10006) San Victorino,1044,818,919,2781
42084,2020-02-19,(06002) Normandía,2700,1575,1372,5647
42085,2020-06-04,(09101) Quiroga,462,256,323,1041
42086,2020-09-13,(07102) NQS - CALLE 75,66,60,121,247
42087,2020-06-30,(03013) RIO NEGRO,289,179,219,687
42088,2020-01-31,(03001) LA CAMPIÑA,6138,3451,4375,13964
42089,2020-05-10,(50003) Corral Molinos,362,170,251,783
42090,2020-02-06,(09116) Avenida 39,3191,2152,1766,7109
42091,2020-02-22,(07000) Portal Sur - alimentacion,19201,9784,11362,40347
42092,2020-07-30,(05100) Banderas P. Central - alimentacion,2536,1421,1555,5512
42093,2020-06-17,(09103) Olaya,1027,576,566,2169
42094,2020-07-29,(09103) Olaya,928,566,557,2051
42095,2020-06-01,(14001) La Sabana,137,82,93,312
42096,2020-07-11,(02000) Cabecera Autopista Norte - alimentacion,4277,2280,2487,9044
42097,2020-02-27,(03003) 21 ANGELES,1753,946,870,3569
42098,2020-09-05,(04105) Carrera 53,190,123,213,526
42099,2020-02-19,(09114) Calle 26,3542,2225,1818,7585
42100,2020-05-15,(50003) Corral Molinos,1183,584,802,2569
42101,2020-01-17,(04000) Cabecera Calle 80,6452,3567,4569,14588
42102,2020-09-03,(07010) Bosa,715,323,466,1504
42103,2020-09-28,(09110) Avenida Jimenez,1512,1045,1024,3581
42104,2020-01-25,(05002) Tintal,6355,3170,4130,13655
42105,2020-09-26,(02201) Prado,786,502,665,1953
42106,2020-03-31,(04002) Carrera 90,335,182,152,669
42107,2020-06-27,(04002) Carrera 90,625,309,347,1281
42108,2020-06-18,(04100) Carrera 77,1308,738,779,2825
42109,2020-02-14,(03000) Portal Suba,9902,5398,5389,20689
42110,2020-02-11,(10008) San Diego,1612,868,785,3265
42111,2020-01-23,(12001) Carrera 43,1508,931,954,3393
42112,2020-05-14,(12001) Carrera 43,346,203,165,714
42113,2020-06-20,(12001) Carrera 43,302,167,217,686
42114,2020-08-13,(12001) Carrera 43,458,237,204,899
42115,2020-10-07,(12001) Carrera 43,533,311,357,1201
42116,2020-08-17,(07505) LEON XIII,829,411,488,1728
42117,2020-02-15,(09107) Hortúa,1341,812,1166,3319
42118,2020-09-06,(02304) Heroes,231,199,239,669
42119,2020-05-27,(03000) Portal Suba,1063,674,708,2445
42120,2020-03-04,(09101) Quiroga,1691,1026,1220,3937
42121,2020-03-03,(10010) San Bernardo,1753,1009,1372,4134
42122,2020-02-13,(09119) Calle 57,3947,2440,2114,8501
42123,2020-06-27,(07112) COMUNEROS,698,390,426,1514
42124,2020-06-28,(07000) Portal Sur - alimentacion,2634,1242,1342,5218
42125,2020-01-02,(02303) Calle 85,1492,1066,1002,3560
42126,2020-01-31,(02300) Calle 100,7034,4408,3945,15387
42127,2020-07-04,(02300) Calle 100,829,578,630,2037
42128,2020-07-03,(07004) VENECIA,1106,639,646,2391
42129,2020-05-28,(09118) Marly,1289,915,666,2870
42130,2020-09-29,(07505) LEON XIII,3069,1601,1623,6293
42131,2020-02-05,(05102) Av. Américas - Av. Boyacá,1969,1221,995,4185
42132,2020-10-09,(07007) NQS - Calle 38A Sur,464,289,423,1176
42133,2020-05-16,(06108) Concejo de Bogotá,77,45,60,182
42134,2020-06-04,(07010) Bosa,677,353,387,1417
42135,2020-07-22,(09000) Cabecera Usme - alimentacion,6204,3356,3811,13371
42136,2020-01-25,(03003) 21 ANGELES,910,350,583,1843
42137,2020-02-16,(08001) Parque el Tunal,406,173,338,917
42138,2020-03-09,(06001) Modelia,604,420,350,1374
42139,2020-01-23,(10009) Museo Nacional,3765,2031,1815,7611
42140,2020-03-23,(09107) Hortúa,242,158,123,523
42141,2020-06-25,(05101) Mandalay - Cr.73,148,83,71,302
42142,2020-09-23,(02103) Mazurén,258,173,225,656
42143,2020-03-10,(02300) Calle 100,3140,433,857,4430
42144,2020-06-26,(03012) SUBA - CALLE 95,339,230,191,760
42145,2020-05-07,(09001) Molinos,1576,907,1106,3589
42146,2020-08-23,(02000) Cabecera Autopista Norte - alimentacion,1605,729,1049,3383
42147,2020-03-09,(02104) Calle 146,620,2442,1290,4352
42148,2020-02-08,(08000) Portal Tunal,1445,853,855,3153
42149,2020-06-23,(08000) Portal Tunal,788,310,327,1425
42150,2020-09-18,(05005) Transversal 86,470,245,356,1071
42151,2020-05-30,(02202) Calle 127,834,585,407,1826
42152,2020-08-01,(02202) Calle 127,700,555,474,1729
42153,2020-08-06,(02202) Calle 127,1019,687,515,2221
42154,2020-09-02,(02202) Calle 127,1178,835,716,2729
42155,2020-02-11,(09106) Nariño,2171,1332,1482,4985
42156,2020-04-07,(08000) Portal Tunal,354,177,164,695
42157,2020-07-13,(02205) Calle 106,348,208,179,735
42158,2020-09-15,(06000) Portal Eldorado - alimentacion,4079,2032,2391,8502
42159,2020-07-16,(09101) Quiroga,365,197,248,810
42160,2020-09-28,(04108) El Polo,543,327,338,1208
42161,2020-06-16,(07000) Portal Sur,1897,1196,1017,4110
42162,2020-01-19,(02304) Heroes,575,440,672,1687
42163,2020-07-05,(07113) SANTA ISABEL,111,54,157,322
42164,2020-03-02,(14004) Museo del Oro,4142,2478,2091,8711
42165,2020-02-25,(05103) Marsella,3380,1910,1473,6763
42166,2020-03-09,(09116) Avenida 39,1532,177,358,2067
42167,2020-06-14,(10010) San Bernardo,240,111,172,523
42168,2020-07-01,(09100) Calle 40 Sur,1894,1114,1266,4274
42169,2020-08-03,(10005) Bicentenario - alimentacion,197,91,183,471
42170,2020-08-31,(10005) Bicentenario - alimentacion,196,111,228,535
42171,2020-02-11,(04107) Escuela Militar,736,467,442,1645
42172,2020-06-02,(04107) Escuela Militar,137,87,85,309
42173,2020-07-23,(07109) CAD,499,309,243,1051
42174,2020-01-25,(03012) SUBA - CALLE 95,703,481,642,1826
42175,2020-01-31,(04001) Quirigua,2006,1121,1186,4313
42176,2020-10-05,(03001) LA CAMPIÑA,1454,806,942,3202
42177,2020-02-22,(14005) Las Aguas,1171,757,1263,3191
42178,2020-04-22,(04104) Avenida 68,369,212,179,760
42179,2020-09-12,(09110) Avenida Jimenez,1331,940,817,3088
42180,2020-09-09,(08000) Portal Tunal,827,344,380,1551
42181,2020-06-04,(05001) Patio Bonito,1321,734,855,2910
42182,2020-07-24,(05001) Patio Bonito,1315,748,741,2804
42183,2020-10-09,(40001) Juan Pablo II,632,355,493,1480
42184,2020-03-20,(02000) Cabecera Autopista Norte,585,395,321,1301
42185,2020-04-29,(04108) El Polo,287,181,131,599
42186,2020-02-15,(02001) Centro Comercial Santa Fe,2078,1009,1878,4965
42187,2020-03-27,(09120) Calle 63,515,381,329,1225
42188,2020-05-04,(12003) Ricaurte,225,171,112,508
42189,2020-09-16,(12003) Ricaurte,423,292,231,946
42190,2020-03-10,(04101) Minuto de Dios,915,603,531,2049
42191,2020-08-05,(05002) Tintal,2058,1165,1256,4479
42192,2020-05-29,(03009) Av. Suba- Calle 116,468,322,179,969
42193,2020-04-03,(09004) Santa Lucía,1132,538,616,2286
42194,2020-08-09,(09116) Avenida 39,65,57,80,202
42195,2020-04-02,(03013) RIO NEGRO,136,89,86,311
42196,2020-02-16,(07103) AV. CHILE,551,390,728,1669
42197,2020-01-18,(10005) Bicentenario,200,126,264,590
42198,2020-10-02,(10005) Bicentenario,134,71,124,329
42199,2020-02-08,(06001) Modelia,1022,654,948,2624
42200,2020-03-24,(12002) CDS - Carrera 32,186,146,98,430
42201,2020-06-06,(10006) San Victorino,280,184,232,696
42202,2020-07-05,(02200) Alcalá,567,371,431,1369
42203,2020-03-18,(07104) Simon Bolivar,1292,867,628,2787
42204,2020-07-30,(07004) VENECIA,898,572,510,1980
42205,2020-04-08,(09120) Calle 63,527,385,328,1240
42206,2020-09-26,(02200) Alcalá,1719,1012,1202,3933
42207,2020-03-20,(05107) Américas - Cr.53,386,306,165,857
42208,2020-03-17,(03006) NIZA - CALLE 127,1255,811,724,2790
42209,2020-06-02,(03006) NIZA - CALLE 127,370,228,198,796
42210,2020-06-25,(03006) NIZA - CALLE 127,530,294,236,1060
42211,2020-03-02,(03004) GRATAMIRA,298,160,170,628
42212,2020-02-02,(07005) ALQUERIA,655,308,621,1584
42213,2020-04-15,(02204) Pepe Sierra,418,340,237,995
42214,2020-06-19,(09110) Avenida Jimenez,1242,941,891,3074
42215,2020-03-07,(06109) Centro Memoria,521,338,543,1402
42216,2020-05-26,(06102) Salitre El Greco,197,121,112,430
42217,2020-02-20,(07006) General Santander - alimentacion,1524,903,908,3335
42218,2020-04-19,(03000) Portal Suba,191,147,134,472
42219,2020-04-22,(03000) Portal Suba,619,397,360,1376
42220,2020-01-07,(07105) MOVISTAR ARENA,915,559,540,2014
42221,2020-04-27,(10001) Country Sur,429,56,88,573
42222,2020-06-13,(09114) Calle 26,152,128,133,413
42223,2020-04-11,(07113) SANTA ISABEL,110,75,88,273
42224,2020-10-03,(10004) Policarpa,235,103,197,535
42225,2020-05-09,(09122) Calle 72,554,380,418,1352
42226,2020-06-10,(09122) Calle 72,1106,740,599,2445
42227,2020-05-09,(09000) Cabecera Usme,818,493,580,1891
42228,2020-04-10,(07103) AV. CHILE,127,77,58,262
42229,2020-08-30,(07109) CAD,170,122,151,443
42230,2020-02-01,(03005) SUBA - AV. BOYACA,1337,792,1131,3260
42231,2020-06-16,(02102) Calle 161,241,154,170,565
42232,2020-09-23,(12004) Carrera 22,314,170,164,648
42233,2020-10-04,(02101) Toberín,382,219,644,1245
42234,2020-04-29,(04000) Cabecera Calle 80,677,416,519,1612
42235,2020-07-26,(10004) Policarpa,79,35,49,163
42236,2020-07-17,(04001) Quirigua,352,224,209,785
42237,2020-07-05,(04104) Avenida 68,204,105,148,457
42238,2020-04-29,(03012) SUBA - CALLE 95,204,135,104,443
42239,2020-08-29,(40001) Juan Pablo II,486,240,369,1095
42240,2020-08-10,(09114) Calle 26,297,169,217,683
42241,2020-09-01,(07008) NQS - Calle 30 Sur,314,167,214,695
42242,2020-04-07,(03002) SUBA - TV- 91,423,238,245,906
42243,2020-06-12,(04000) Cabecera Calle 80 - intermunicipal,325,174,287,786
42244,2020-07-17,(04000) Cabecera Calle 80 - intermunicipal,305,154,242,701
42245,2020-07-25,(07108) Av. El Dorado,88,52,58,198
42246,2020-06-08,(05107) Américas - Cr.53,423,261,231,915
42247,2020-04-22,(04000) Cabecera Calle 80 - intermunicipal,121,83,127,331
42248,2020-07-03,(04000) Cabecera Calle 80 - intermunicipal,370,182,300,852
42249,2020-08-16,(06103) CAN,129,73,64,266
42250,2020-01-17,(07200) Tygua-San José,659,384,577,1620
42251,2020-07-07,(07109) CAD,679,401,334,1414
42252,2020-08-07,(14004) Museo del Oro,34,33,61,128
42253,2020-08-19,(06001) Modelia,333,199,208,740
42254,2020-02-17,(09108) Hospital,259,139,202,600
42255,2020-07-03,(09108) Hospital,76,53,57,186
42256,2020-02-04,(12002) CDS - Carrera 32,610,344,372,1326
42257,2020-03-28,(02204) Pepe Sierra,309,250,206,765
42258,2020-01-13,(07006) General Santander - alimentacion,1237,721,824,2782
42259,2020-09-14,(07105) MOVISTAR ARENA,265,149,169,583
42260,2020-08-02,(07108) Av. El Dorado,29,14,27,70
42261,2020-04-24,(07006) General Santander,274,184,126,584
42262,2020-07-27,(07200) Tygua-San José,214,129,138,481
42263,2020-10-12,(03010) PUENTE LARGO,92,66,116,274
42264,2020-03-22,(09100) Calle 40 Sur,283,192,166,641
42265,2020-04-09,(07003) SEVILLANA,74,34,37,145
42266,2020-04-08,(04101) Minuto de Dios,146,94,116,356
42267,2020-06-11,(07006) General Santander - alimentacion,378,227,231,836
42268,2020-04-02,(07006) General Santander - alimentacion,162,111,130,403
42269,2020-04-16,(06001) Modelia,249,176,157,582
42270,2020-05-30,(07107) U. NACIONAL,193,128,130,451
42271,2020-08-20,(07107) U. NACIONAL,313,176,202,691
42272,2020-04-26,(04003) Avenida Ciudad de Cali,170,113,133,416
42273,2019-12-31,(04000) Cabecera Calle 80,84,52,66,202
42274,2020-05-26,(04001) Quirigua,329,215,200,744
42275,2020-07-25,(07008) NQS - Calle 30 Sur,184,98,99,381
42276,2020-03-12,(03004) GRATAMIRA,49,39,38,126
42277,2020-05-03,(07010) Bosa,126,65,88,279
42278,2020-05-22,(06101) El Tiempo,305,176,147,628
42279,2020-04-25,(02000) Cabecera Autopista Norte - intermunicipal,96,72,81,249
42280,2020-01-02,(04107) Escuela Militar,201,126,211,538
42281,2020-04-24,(07506) DESPENSA,255,147,130,532
42282,2020-03-27,(07008) NQS - Calle 30 Sur,135,76,71,282
42283,2020-07-02,(08002) Biblioteca,336,197,178,711
42284,2020-09-19,(07200) Tygua-San José,216,128,177,521
42285,2020-04-11,(07006) General Santander,156,98,67,321
42286,2020-07-06,(06107) Ciudad Universitaria,198,125,137,460
42287,2020-03-28,(06103) CAN,199,154,95,448
42288,2020-09-27,(12001) Carrera 43,90,53,107,250
42289,2020-04-18,(14005) Las Aguas,0,30,64,94
42290,2020-08-21,(09105) Río Fucha,0,53,121,174
42291,2020-08-16,(12001) Carrera 43,64,43,60,167
42292,2020-05-25,(04102) Avenida Boyaca,83,57,65,205
42293,2019-12-31,(09003) Socorro,25,15,39,79
42294,2020-09-20,(10005) Bicentenario - alimentacion,48,42,113,203
42295,2020-01-01,(50006) Corral Carrera 77,2,0,7,9
42296,2019-12-31,(07006) General Santander,38,23,45,106
42297,2020-03-22,(06104) Gobernación,45,47,31,123
42298,2020-07-03,(50006) Corral Carrera 77,4,2,9,15
42299,2020-05-23,(03014) SAN MARTIN,15,3,17,35
42300,2020-10-13,(02200) Alcalá,0,2,0,2
42301,2020-04-20,(04000) Cabecera Calle 80 - alimentacion,2014,1152,1238,4404
42302,2020-05-11,(04000) Cabecera Calle 80 - alimentacion,2757,1678,1644,6079
42303,2020-02-07,(07005) ALQUERIA,2735,1435,1522,5692
42304,2020-01-07,(09119) Calle 57,2030,1352,1448,4830
42305,2020-10-07,(09119) Calle 57,671,435,593,1699
42306,2020-01-27,(02303) Calle 85,3571,2358,1797,7726
42307,2020-01-03,(03002) SUBA - TV- 91,2002,1089,1397,4488
42308,2020-02-21,(09003) Socorro,1649,913,949,3511
42309,2020-07-12,(04000) Cabecera Calle 80 - alimentacion,1275,666,1121,3062
42310,2020-02-13,(06107) Ciudad Universitaria,1530,1006,979,3515
42311,2020-06-04,(06107) Ciudad Universitaria,149,102,84,335
42312,2020-05-20,(08000) Portal Tunal - alimentacion,5212,2848,2625,10685
42313,2020-10-06,(09000) Cabecera Usme,1996,1156,1671,4823
42314,2020-01-08,(09113) Calle 22,1027,642,893,2562
42315,2020-02-12,(02000) Cabecera Autopista Norte,12219,7462,6145,25826
42316,2020-02-13,(07009) SENA,3749,2186,2027,7962
42317,2020-09-30,(07001) PERDOMO,1149,634,878,2661
42318,2020-01-14,(04000) Cabecera Calle 80 - intermunicipal,1662,1154,1655,4471
42319,2020-01-27,(05103) Marsella,2802,1622,1464,5888
42320,2020-03-05,(10006) San Victorino,2395,1306,1310,5011
42321,2020-01-15,(09110) Avenida Jimenez,3883,2766,2453,9102
42322,2020-02-06,(05001) Patio Bonito,6779,4025,3684,14488
42323,2020-01-16,(09101) Quiroga,1371,821,1140,3332
42324,2020-06-01,(09101) Quiroga,446,255,318,1019
42325,2020-09-02,(04100) Carrera 77,1343,817,908,3068
42326,2020-03-19,(07102) NQS - CALLE 75,902,630,544,2076
42327,2020-04-06,(07102) NQS - CALLE 75,166,120,87,373
42328,2020-04-21,(07102) NQS - CALLE 75,178,143,119,440
42329,2020-02-13,(03013) RIO NEGRO,1279,836,855,2970
42330,2020-08-11,(03013) RIO NEGRO,239,155,158,552
42331,2020-01-23,(09103) Olaya,3768,2202,2377,8347
42332,2020-06-19,(09103) Olaya,1084,587,671,2342
42333,2020-08-10,(09103) Olaya,988,574,550,2112
42334,2020-09-08,(14001) La Sabana,122,99,101,322
42335,2020-07-06,(07002) MADELENA,917,553,496,1966
42336,2020-02-24,(07112) COMUNEROS,3764,2362,2279,8405
42337,2020-08-19,(02000) Cabecera Autopista Norte,1191,726,851,2768
42338,2020-05-20,(09118) Marly,1312,879,615,2806
42339,2020-02-12,(06105) Quinta Paredes,1134,623,546,2303
42340,2020-08-13,(04000) Cabecera Calle 80,888,598,726,2212
42341,2020-07-03,(02000) Cabecera Autopista Norte - alimentacion,5238,2813,3004,11055
42342,2020-01-15,(05107) Américas - Cr.53,2197,1215,1240,4652
42343,2020-02-04,(05107) Américas - Cr.53,2677,1468,1436,5581
42344,2020-01-08,(04002) Carrera 90,2563,1372,1602,5537
42345,2020-01-28,(03000) Portal Suba,8903,5336,5081,19320
42346,2020-02-21,(03000) Portal Suba,9365,4892,5333,19590
42347,2020-07-29,(06000) Portal Eldorado,848,547,444,1839
42348,2020-02-05,(10002) Av. Primero de Mayo,8593,4298,4812,17703
42349,2020-01-14,(09107) Hortúa,1944,1170,1405,4519
42350,2020-05-30,(09107) Hortúa,419,237,256,912
42351,2020-06-27,(10005) Bicentenario - alimentacion,165,103,147,415
42352,2020-02-28,(02000) Cabecera Autopista Norte - intermunicipal,4930,3108,3245,11283
42353,2020-02-01,(09101) Quiroga,1004,557,955,2516
42354,2020-05-05,(08001) Parque el Tunal,306,169,187,662
42355,2020-06-02,(07112) COMUNEROS,705,427,408,1540
42356,2020-07-11,(07112) COMUNEROS,678,421,442,1541
42357,2020-03-12,(08002) Biblioteca,80,211,174,465
42358,2020-01-17,(02300) Calle 100,6245,3951,3701,13897
42359,2020-08-15,(02300) Calle 100,694,503,543,1740
42360,2020-08-01,(09004) Santa Lucía,1877,865,1068,3810
42361,2020-10-06,(09003) Socorro,645,316,444,1405
42362,2020-10-04,(07503) SAN MATEO,4075,1818,3117,9010
42363,2020-01-24,(08001) Parque el Tunal,1614,803,940,3357
42364,2020-06-14,(08001) Parque el Tunal,146,73,93,312
42365,2020-08-25,(08001) Parque el Tunal,437,245,268,950
42366,2020-09-14,(08001) Parque el Tunal,475,297,319,1091
42367,2020-02-26,(06103) CAN,2644,1561,1122,5327
42368,2020-09-06,(10002) Av. Primero de Mayo,682,299,732,1713
42369,2020-09-14,(10002) Av. Primero de Mayo,2189,1131,1504,4824
42370,2020-02-21,(07007) NQS - Calle 38A Sur,2237,1284,1213,4734
42371,2020-01-25,(06002) Normandía,867,497,873,2237
42372,2020-04-21,(09107) Hortúa,469,305,194,968
42373,2020-07-01,(09123) Calle 76,1085,750,666,2501
42374,2020-08-26,(05002) Tintal,2234,1349,1405,4988
42375,2020-02-06,(03011) SUBA - CALLE 100,2519,1371,1476,5366
42376,2020-02-17,(02300) Calle 100,7335,4650,3852,15837
42377,2020-01-16,(03012) SUBA - CALLE 95,1245,769,878,2892
42378,2020-10-06,(09119) Calle 57,640,465,628,1733
42379,2020-07-13,(04104) Avenida 68,609,277,264,1150
42380,2020-07-01,(08000) Portal Tunal,821,313,335,1469
42381,2020-01-03,(07104) Simon Bolivar,984,589,689,2262
42382,2020-10-07,(02302) Virrey,764,566,544,1874
42383,2020-05-13,(10008) San Diego,229,132,137,498
42384,2020-03-12,(07106) EL CAMPIN,779,154,237,1170
42385,2020-09-14,(06109) Centro Memoria,283,161,201,645
42386,2020-08-11,(08000) Portal Tunal,806,304,287,1397
42387,2020-01-22,(03009) Av. Suba- Calle 116,2423,1523,1336,5282
42388,2020-02-15,(03009) Av. Suba- Calle 116,1118,811,1017,2946
42389,2020-06-06,(09113) Calle 22,382,227,312,921
42390,2020-09-01,(07113) SANTA ISABEL,373,235,275,883
42391,2020-02-23,(02300) Calle 100,798,699,1125,2622
42392,2020-07-22,(10009) Museo Nacional,413,232,220,865
42393,2020-06-03,(07103) AV. CHILE,887,525,400,1812
42394,2020-09-16,(07113) SANTA ISABEL,385,251,345,981
42395,2020-01-29,(03007) HUMEDAL CORDOBA,1017,657,516,2190
42396,2020-06-07,(03007) HUMEDAL CORDOBA,34,38,25,97
42397,2020-08-25,(03007) HUMEDAL CORDOBA,140,92,79,311
42398,2020-05-12,(07000) Portal Sur,1329,840,778,2947
42399,2020-04-18,(02101) Toberín,365,261,248,874
42400,2020-08-23,(02101) Toberín,254,173,295,722
42401,2020-03-26,(03011) SUBA - CALLE 100,322,188,151,661
42402,2020-02-25,(06101) El Tiempo,2979,1796,1433,6208
42403,2020-04-02,(07110) PALOQUEMAO,330,247,193,770
42404,2020-03-06,(04000) Cabecera Calle 80 - intermunicipal,1806,1486,2576,5868
42405,2020-04-24,(10005) Bicentenario - alimentacion,161,83,114,358
42406,2020-06-18,(04107) Escuela Militar,138,84,64,286
42407,2020-09-08,(04107) Escuela Militar,167,110,91,368
42408,2020-04-09,(05000) Portal Américas,499,363,321,1183
42409,2020-01-21,(04003) Avenida Ciudad de Cali,3920,1877,2118,7915
42410,2020-01-10,(02000) Cabecera Autopista Norte - intermunicipal,3160,2012,2290,7462
42411,2020-06-22,(02000) Cabecera Autopista Norte,459,316,326,1101
42412,2020-09-16,(04003) Avenida Ciudad de Cali,1112,642,946,2700
42413,2020-05-23,(05103) Marsella,213,106,133,452
42414,2020-07-27,(04103) Las Ferias,354,190,163,707
42415,2020-06-24,(09109) Tercer Milenio,342,205,253,800
42416,2020-03-24,(12001) Carrera 43,337,251,216,804
42417,2020-08-08,(03003) 21 ANGELES,185,82,114,381
42418,2020-02-27,(06105) Quinta Paredes,1098,608,515,2221
42419,2020-08-05,(06101) El Tiempo,299,184,160,643
42420,2020-05-14,(02202) Calle 127,880,657,474,2011
42421,2020-06-27,(04100) Carrera 77,995,539,673,2207
42422,2020-09-26,(06002) Normandía,260,163,255,678
42423,2020-04-12,(04100) Carrera 77,188,117,117,422
42424,2020-04-17,(05002) Tintal,1336,720,603,2659
42425,2020-07-17,(02204) Pepe Sierra,722,506,363,1591
42426,2020-09-20,(03000) Portal Suba,440,216,506,1162
42427,2020-01-12,(02302) Virrey,318,325,536,1179
42428,2020-06-11,(02302) Virrey,628,406,335,1369
42429,2020-09-20,(02302) Virrey,167,139,206,512
42430,2020-05-12,(12003) Ricaurte,278,201,120,599
42431,2020-09-07,(12003) Ricaurte,410,279,196,885
42432,2020-02-12,(03013) RIO NEGRO,1343,833,905,3081
42433,2020-05-11,(10010) San Bernardo,541,291,317,1149
42434,2020-07-13,(05100) Banderas P. Central,662,346,429,1437
42435,2020-03-09,(03009) Av. Suba- Calle 116,1100,228,406,1734
42436,2020-02-04,(07003) SEVILLANA,2104,1196,1151,4451
42437,2020-05-23,(02105) Calle 142,501,297,288,1086
42438,2020-01-31,(06107) Ciudad Universitaria,1486,901,981,3368
42439,2020-05-13,(09002) Consuelo,391,201,232,824
42440,2020-04-23,(05107) Américas - Cr.53,332,216,184,732
42441,2020-09-24,(05107) Américas - Cr.53,490,272,318,1080
42442,2020-04-28,(10010) San Bernardo,448,231,255,934
42443,2020-03-15,(07103) AV. CHILE,421,302,539,1262
42444,2020-06-12,(40002) Manitas,393,252,272,917
42445,2020-05-24,(03001) LA CAMPIÑA,203,103,143,449
42446,2020-02-25,(10005) Bicentenario,833,399,394,1626
42447,2020-06-08,(09120) Calle 63,1015,704,649,2368
42448,2020-09-03,(10009) Museo Nacional,564,294,394,1252
42449,2020-08-17,(03001) LA CAMPIÑA,260,148,208,616
42450,2020-05-23,(04101) Minuto de Dios,186,110,138,434
42451,2020-09-19,(09115) Calle 34,458,310,527,1295
42452,2020-07-25,(03006) NIZA - CALLE 127,328,202,150,680
42453,2020-07-30,(03006) NIZA - CALLE 127,494,278,256,1028
42454,2020-08-07,(09109) Tercer Milenio,165,99,134,398
42455,2020-01-25,(06105) Quinta Paredes,403,201,366,970
42456,2020-06-19,(09111) Calle 19,754,503,488,1745
42457,2020-01-15,(12004) Carrera 22,604,369,439,1412
42458,2020-07-28,(03012) SUBA - CALLE 95,300,172,171,643
42459,2020-06-11,(04003) Avenida Ciudad de Cali,943,564,619,2126
42460,2020-09-23,(09111) Calle 19,823,504,553,1880
42461,2020-08-06,(07111) NQS - RICAURTE,1003,600,446,2049
42462,2020-04-29,(07105) MOVISTAR ARENA,160,113,93,366
42463,2020-08-20,(07201) Guatoque -Veraguas,172,81,109,362
42464,2020-09-08,(07009) SENA,665,398,460,1523
42465,2020-06-06,(07107) U. NACIONAL,189,128,134,451
42466,2020-07-20,(04100) Carrera 77,318,183,242,743
42467,2020-07-21,(04003) Avenida Ciudad de Cali,861,497,625,1983
42468,2020-10-12,(05001) Patio Bonito,733,340,584,1657
42469,2020-07-29,(10006) San Victorino,684,314,301,1299
42470,2020-07-16,(09119) Calle 57,422,293,242,957
42471,2020-08-13,(07110) PALOQUEMAO,626,380,242,1248
42472,2020-04-14,(04000) Cabecera Calle 80,527,374,367,1268
42473,2020-03-21,(03002) SUBA - TV- 91,250,134,133,517
42474,2020-01-31,(50002) Corral Calle 40 Sur,126,84,160,370
42475,2020-07-14,(12000) Puente Aranda,87,49,32,168
42476,2020-03-09,(07109) CAD,1209,248,380,1837
42477,2020-09-09,(07506) DESPENSA,433,275,328,1036
42478,2020-08-27,(03013) RIO NEGRO,272,147,210,629
42479,2020-03-30,(03010) PUENTE LARGO,208,177,99,484
42480,2020-05-07,(04106) Carrera 47,220,107,141,468
42481,2020-06-23,(10009) Museo Nacional,538,327,360,1225
42482,2020-04-13,(09002) Consuelo,244,139,108,491
42483,2020-10-12,(07104) Simon Bolivar,137,120,200,457
42484,2020-06-28,(07111) NQS - RICAURTE,227,166,141,534
42485,2020-08-17,(07001) PERDOMO,243,124,189,556
42486,2020-09-08,(05105) Pradera,619,367,304,1290
42487,2020-01-16,(12002) CDS - Carrera 32,517,342,307,1166
42488,2020-06-02,(12002) CDS - Carrera 32,182,129,69,380
42489,2020-04-28,(40001) Juan Pablo II,316,173,196,685
42490,2020-07-07,(04102) Avenida Boyaca,410,237,233,880
42491,2020-04-28,(04000) Cabecera Calle 80 - intermunicipal,152,80,126,358
42492,2020-07-02,(04000) Cabecera Calle 80 - intermunicipal,331,160,328,819
42493,2020-06-23,(07005) ALQUERIA,588,343,326,1257
42494,2020-07-29,(03010) PUENTE LARGO,302,197,190,689
42495,2020-04-08,(05105) Pradera,357,237,124,718
42496,2020-03-29,(02502) Terminal,43,37,42,122
42497,2020-07-14,(07200) Tygua-San José,148,92,98,338
42498,2020-04-24,(07108) Av. El Dorado,71,53,43,167
42499,2020-08-21,(07506) DESPENSA,429,244,248,921
42500,2020-07-18,(03002) SUBA - TV- 91,494,264,317,1075
42501,2020-08-19,(07006) General Santander - alimentacion,351,189,239,779
42502,2020-08-02,(05101) Mandalay - Cr.73,16,9,21,46
42503,2020-07-27,(07107) U. NACIONAL,326,184,157,667
42504,2020-05-03,(07111) NQS - RICAURTE,102,84,79,265
42505,2020-08-09,(10004) Policarpa,85,45,86,216
42506,2020-05-03,(04104) Avenida 68,144,88,85,317
42507,2020-08-25,(04101) Minuto de Dios,310,184,209,703
42508,2020-02-02,(06104) Gobernación,124,111,227,462
42509,2020-09-26,(03011) SUBA - CALLE 100,381,227,341,949
42510,2020-08-19,(03004) GRATAMIRA,0,18,24,42
42511,2020-02-25,(03004) GRATAMIRA,331,189,127,647
42512,2020-03-24,(05103) Marsella,324,201,196,721
42513,2020-08-08,(03004) GRATAMIRA,0,11,30,41
42514,2020-10-08,(03004) GRATAMIRA,0,24,49,73
42515,2020-04-21,(06111) Universidades,0,77,219,296
42516,2020-07-20,(04105) Carrera 53,90,38,56,184
42517,2020-03-28,(07006) General Santander,170,106,113,389
42518,2020-05-12,(07200) Tygua-San José,187,93,109,389
42519,2020-01-21,(03014) SAN MARTIN,149,74,142,365
42520,2020-05-24,(02103) Mazurén,26,18,32,76
42521,2019-12-31,(04000) Cabecera Calle 80 - intermunicipal,4,4,19,27
42522,2020-08-23,(10003) Ciudad Jardín,69,23,66,158
42523,2020-05-19,(07113) SANTA ISABEL,343,218,226,787
42524,2020-04-05,(12004) Carrera 22,11,8,16,35
42525,2020-07-19,(04105) Carrera 53,84,31,58,173
42526,2020-05-10,(07006) General Santander,107,61,77,245
42527,2020-08-12,(07006) General Santander - alimentacion,359,196,247,802
42528,2020-05-17,(06107) Ciudad Universitaria,40,29,40,109
42529,2020-04-01,(06104) Gobernación,130,127,73,330
42530,2020-07-09,(07106) EL CAMPIN,440,278,227,945
42531,2020-08-23,(07008) NQS - Calle 30 Sur,85,34,62,181
42532,2020-08-23,(09122) Calle 72,296,214,294,804
42533,2020-04-18,(07003) SEVILLANA,163,102,72,337
42534,2020-08-23,(06104) Gobernación,43,39,47,129
42535,2020-04-06,(07101) CASTELLANA,65,50,62,177
42536,2020-06-28,(07101) CASTELLANA,33,26,44,103
42537,2020-04-03,(06105) Quinta Paredes,66,51,49,166
42538,2020-04-19,(07200) Tygua-San José,35,26,26,87
42539,2020-03-23,(07200) Tygua-San José,24,21,36,81
42540,2019-12-31,(07006) General Santander - alimentacion,16,17,19,52
42541,2020-07-26,(08002) Biblioteca,83,44,59,186
42542,2020-03-29,(04104) Avenida 68,112,76,59,247
42543,2020-04-14,(05102) Av. Américas - Av. Boyacá,125,70,59,254
42544,2020-03-22,(06106) Recinto Ferial,57,29,24,110
42545,2020-04-05,(09101) Quiroga,52,35,61,148
42546,2020-03-28,(03003) 21 ANGELES,121,57,49,227
42547,2019-12-31,(07102) NQS - CALLE 75,21,12,24,57
42548,2020-08-17,(06104) Gobernación,45,36,34,115
42549,2019-12-31,(02205) Calle 106,6,7,19,32
42550,2020-06-12,(50006) Corral Carrera 77,4,3,8,15
42551,2020-08-24,(03014) SAN MARTIN,0,7,26,33
42552,2020-03-29,(03004) GRATAMIRA,9,6,2,17
42553,2020-02-25,(50004) Corral Avenida Ciudad de Cali,0,0,1,1
42554,2020-06-16,(04000) Cabecera Calle 80 - alimentacion,3999,2366,2428,8793
42555,2020-07-21,(09118) Marly,1299,829,629,2757
42556,2020-06-08,(10000) Portal 20 de Julio - alimentacion,4098,1880,2411,8389
42557,2020-03-13,(03000) Portal Suba - alimentacion,884,5531,4447,10862
42558,2020-02-11,(02200) Alcalá,15469,9865,7048,32382
42559,2020-01-23,(06000) Portal Eldorado - alimentacion,16571,8736,8908,34215
42560,2020-03-06,(06104) Gobernación,1266,798,799,2863
42561,2020-06-27,(05000) Portal Américas - alimentacion,8977,4575,4721,18273
42562,2020-08-21,(09001) Molinos,2461,1356,1680,5497
42563,2020-02-15,(08000) Portal Tunal - alimentacion,16510,8078,9674,34262
42564,2020-03-04,(02201) Prado,5936,3735,3109,12780
42565,2020-02-07,(14004) Museo del Oro,3749,2472,2155,8376
42566,2020-01-06,(09000) Cabecera Usme - alimentacion,4808,2277,3982,11067
42567,2020-07-31,(10001) Country Sur,1191,536,653,2380
42568,2020-10-09,(09100) Calle 40 Sur,1958,1152,1679,4789
42569,2020-03-16,(09115) Calle 34,2987,1921,1664,6572
42570,2020-02-15,(05100) Banderas P. Central - alimentacion,9161,4219,6054,19434
42571,2020-07-15,(40003) Mirador del Paraiso,1033,665,678,2376
42572,2020-06-26,(09104) Restrepo,1613,931,1144,3688
42573,2020-07-06,(09104) Restrepo,1602,1011,1163,3776
42574,2020-10-06,(07505) LEON XIII,3085,1573,1741,6399
42575,2020-01-19,(07110) PALOQUEMAO,379,290,424,1093
42576,2020-02-01,(07110) PALOQUEMAO,1256,871,967,3094
42577,2020-02-27,(12003) Ricaurte,1297,829,671,2797
42578,2020-01-15,(09101) Quiroga,1383,829,1118,3330
42579,2020-04-24,(09101) Quiroga,333,166,227,726
42580,2020-02-10,(06106) Recinto Ferial,1596,950,817,3363
42581,2020-08-13,(09118) Marly,1386,873,746,3005
42582,2020-09-08,(09118) Marly,1445,975,898,3318
42583,2020-09-29,(03001) LA CAMPIÑA,1453,832,981,3266
42584,2020-01-10,(09116) Avenida 39,1611,1159,1176,3946
42585,2020-01-21,(05100) Banderas P. Central - alimentacion,9608,3385,4449,17442
42586,2020-01-02,(09103) Olaya,1914,1133,1373,4420
42587,2020-06-12,(14001) La Sabana,156,98,102,356
42588,2020-07-29,(14001) La Sabana,155,98,86,339
42589,2020-05-06,(07111) NQS - RICAURTE,688,447,256,1391
42590,2020-09-04,(09113) Calle 22,418,240,359,1017
42591,2020-01-15,(09001) Molinos,6780,3730,5128,15638
42592,2020-06-16,(04100) Carrera 77,1255,741,763,2759
42593,2020-05-19,(03000) Portal Suba,981,624,652,2257
42594,2020-09-01,(40003) Mirador del Paraiso,1672,1024,1110,3806
42595,2020-01-03,(04001) Quirigua,909,484,729,2122
42596,2020-05-15,(10002) Av. Primero de Mayo,1713,848,951,3512
42597,2020-07-28,(10002) Av. Primero de Mayo,2048,1047,1203,4298
42598,2020-03-08,(06111) Universidades,520,328,839,1687
42599,2020-03-09,(02205) Calle 106,1211,211,293,1715
42600,2020-02-11,(02105) Calle 142,7600,4758,4020,16378
42601,2020-06-09,(06105) Quinta Paredes,120,83,63,266
42602,2020-01-13,(09119) Calle 57,2479,1709,1709,5897
42603,2020-01-07,(40001) Juan Pablo II,1217,655,798,2670
42604,2020-06-18,(06101) El Tiempo,348,208,219,775
42605,2020-01-17,(02304) Heroes,3693,2647,2146,8486
42606,2020-10-02,(03000) Portal Suba,1806,1034,1482,4322
42607,2020-06-02,(02000) Cabecera Autopista Norte - intermunicipal,471,313,303,1087
42608,2020-05-18,(09000) Cabecera Usme - alimentacion,6558,3689,4081,14328
42609,2020-08-03,(09000) Cabecera Usme - alimentacion,7712,4054,4418,16184
42610,2020-09-01,(10000) Portal 20 de Julio,2201,1117,1253,4571
42611,2020-08-10,(10000) Portal 20 de Julio,2173,1114,1132,4419
42612,2020-06-08,(07112) COMUNEROS,780,428,416,1624
42613,2020-08-22,(02303) Calle 85,386,277,287,950
42614,2020-06-20,(09116) Avenida 39,189,131,191,511
42615,2020-04-30,(09004) Santa Lucía,1464,751,781,2996
42616,2020-08-11,(09004) Santa Lucía,2435,1231,1347,5013
42617,2020-06-17,(09116) Avenida 39,317,209,205,731
42618,2020-10-12,(07505) LEON XIII,933,446,762,2141
42619,2020-08-16,(05000) Portal Américas,626,364,594,1584
42620,2020-02-15,(05100) Banderas P. Central,3438,1590,2611,7639
42621,2020-07-23,(09000) Cabecera Usme,1202,771,875,2848
42622,2020-08-19,(09107) Hortúa,562,309,336,1207
42623,2020-09-17,(02103) Mazurén,234,165,214,613
42624,2020-09-03,(02300) Calle 100,1207,811,758,2776
42625,2020-01-10,(06000) Portal Eldorado,4849,2910,2439,10198
42626,2020-03-27,(10000) Portal 20 de Julio - alimentacion,2408,850,1224,4482
42627,2020-01-01,(09001) Molinos,713,298,959,1970
42628,2020-05-30,(09001) Molinos,1738,893,1141,3772
42629,2020-06-26,(05005) Transversal 86,464,203,252,919
42630,2020-01-18,(02202) Calle 127,2773,1667,1914,6354
42631,2020-06-11,(02202) Calle 127,1101,758,527,2386
42632,2020-07-22,(02202) Calle 127,1036,679,498,2213
42633,2020-03-08,(09114) Calle 26,211,184,465,860
42634,2020-09-08,(05107) Américas - Cr.53,453,268,296,1017
42635,2020-01-31,(09002) Consuelo,1430,708,853,2991
42636,2020-06-04,(03000) Portal Suba - alimentacion,5467,3185,2872,11524
42637,2020-02-07,(04101) Minuto de Dios,3461,2021,2081,7563
42638,2020-09-07,(04003) Avenida Ciudad de Cali,1095,615,798,2508
42639,2020-09-09,(06000) Portal Eldorado - alimentacion,4201,2166,2427,8794
42640,2020-03-09,(04108) El Polo,816,169,286,1271
42641,2020-03-12,(04108) El Polo,696,144,252,1092
42642,2020-05-28,(05001) Patio Bonito,1529,748,875,3152
42643,2020-01-18,(12007) Zona Industrial,656,453,486,1595
42644,2020-02-27,(07201) Guatoque -Veraguas,1023,511,599,2133
42645,2020-06-07,(07010) Bosa,178,80,157,415
42646,2020-02-15,(06000) Portal Eldorado,2682,2047,2498,7227
42647,2020-10-07,(04100) Carrera 77,1477,835,1210,3522
42648,2020-09-08,(02200) Alcalá,1950,1286,1090,4326
42649,2020-09-05,(03007) HUMEDAL CORDOBA,103,75,62,240
42650,2020-09-25,(03007) HUMEDAL CORDOBA,194,135,104,433
42651,2020-03-29,(09004) Santa Lucía,399,208,191,798
42652,2020-02-17,(03005) SUBA - AV. BOYACA,2752,1668,1634,6054
42653,2020-02-20,(04105) Carrera 53,1400,793,695,2888
42654,2020-04-27,(09116) Avenida 39,50,95,51,196
42655,2020-03-05,(04101) Minuto de Dios,3531,2079,1902,7512
42656,2020-03-20,(07110) PALOQUEMAO,389,234,162,785
42657,2020-02-24,(04107) Escuela Militar,665,423,416,1504
42658,2020-06-16,(04107) Escuela Militar,135,101,90,326
42659,2020-01-16,(07109) CAD,2259,1548,1497,5304
42660,2020-05-16,(02105) Calle 142,467,293,254,1014
42661,2020-06-24,(07004) VENECIA,1033,605,575,2213
42662,2020-09-14,(03001) LA CAMPIÑA,1217,711,768,2696
42663,2020-09-22,(03001) LA CAMPIÑA,1379,797,900,3076
42664,2020-03-09,(06101) El Tiempo,1104,291,431,1826
42665,2020-04-17,(09117) Calle 45,459,297,240,996
42666,2020-03-29,(40003) Mirador del Paraiso,266,170,169,605
42667,2020-09-04,(04001) Quirigua,444,265,289,998
42668,2020-08-23,(02200) Alcalá,492,355,344,1191
42669,2020-10-12,(02001) Centro Comercial Santa Fe,161,117,213,491
42670,2020-09-23,(02302) Virrey,777,548,454,1779
42671,2020-06-24,(12003) Ricaurte,398,280,199,877
42672,2020-03-09,(04103) Las Ferias,349,259,209,817
42673,2020-07-20,(10000) Portal 20 de Julio - alimentacion,1284,521,770,2575
42674,2020-07-19,(02105) Calle 142,179,114,141,434
42675,2020-01-16,(05005) Transversal 86,2260,1220,1180,4660
42676,2020-07-04,(05002) Tintal,0,756,2338,3094
42677,2020-07-08,(05002) Tintal,2116,1394,1586,5096
42678,2020-03-13,(09109) Tercer Milenio,268,165,193,626
42679,2020-08-30,(09002) Consuelo,160,79,144,383
42680,2020-03-17,(06104) Gobernación,767,506,342,1615
42681,2020-02-23,(03002) SUBA - TV- 91,867,409,810,2086
42682,2020-10-07,(05107) Américas - Cr.53,513,330,409,1252
42683,2020-08-13,(10005) Bicentenario,103,52,83,238
42684,2020-10-12,(10005) Bicentenario,30,23,46,99
42685,2020-01-20,(40002) Manitas,1156,659,782,2597
42686,2020-03-14,(40002) Manitas,878,426,584,1888
42687,2020-01-05,(09120) Calle 63,738,509,891,2138
42688,2020-03-07,(04000) Cabecera Calle 80 - intermunicipal,956,641,1309,2906
42689,2020-06-06,(06108) Concejo de Bogotá,74,46,60,180
42690,2020-02-16,(02000) Cabecera Autopista Norte - intermunicipal,637,438,765,1840
42691,2020-09-28,(07003) SEVILLANA,533,286,312,1131
42692,2020-04-27,(05100) Banderas P. Central - alimentacion,1199,128,140,1467
42693,2020-06-20,(10005) Bicentenario - alimentacion,190,87,150,427
42694,2020-02-29,(10005) Bicentenario,242,153,246,641
42695,2020-06-19,(09120) Calle 63,1141,752,763,2656
42696,2020-01-26,(05105) Pradera,480,366,430,1276
42697,2020-03-21,(06102) Salitre El Greco,128,83,62,273
42698,2020-06-01,(03000) Portal Suba,1115,718,716,2549
42699,2020-07-23,(05105) Pradera,430,233,209,872
42700,2020-06-12,(06111) Universidades,116,141,362,619
42701,2020-05-22,(09004) Santa Lucía,2181,1146,1042,4369
42702,2020-02-23,(07111) NQS - RICAURTE,455,415,525,1395
42703,2020-06-10,(07111) NQS - RICAURTE,1131,693,359,2183
42704,2020-05-22,(03006) NIZA - CALLE 127,369,231,171,771
42705,2020-06-16,(03006) NIZA - CALLE 127,440,274,239,953
42706,2020-07-11,(07000) Portal Sur,1547,890,1069,3506
42707,2020-05-01,(07002) MADELENA,177,83,117,377
42708,2020-09-14,(10003) Ciudad Jardín,210,119,179,508
42709,2020-02-16,(12004) Carrera 22,97,93,199,389
42710,2020-07-21,(03012) SUBA - CALLE 95,325,161,152,638
42711,2020-04-23,(06109) Centro Memoria,170,124,105,399
42712,2020-09-16,(06109) Centro Memoria,295,184,192,671
42713,2020-04-20,(03002) SUBA - TV- 91,422,255,198,875
42714,2020-10-11,(07111) NQS - RICAURTE,206,184,236,626
42715,2020-02-08,(07108) Av. El Dorado,426,267,418,1111
42716,2020-04-18,(07105) MOVISTAR ARENA,101,70,54,225
42717,2020-06-20,(07105) MOVISTAR ARENA,201,119,121,441
42718,2020-08-13,(07105) MOVISTAR ARENA,204,119,123,446
42719,2020-07-28,(07003) SEVILLANA,397,228,194,819
42720,2020-06-29,(07104) Simon Bolivar,170,95,139,404
42721,2020-07-23,(14005) Las Aguas,138,85,144,367
42722,2020-03-20,(02200) Alcalá,973,621,375,1969
42723,2020-06-12,(06109) Centro Memoria,287,165,150,602
42724,2020-09-20,(04102) Avenida Boyaca,157,101,150,408
42725,2020-05-24,(07110) PALOQUEMAO,152,92,84,328
42726,2020-08-04,(14004) Museo del Oro,270,163,209,642
42727,2020-04-21,(07004) VENECIA,513,326,291,1130
42728,2020-02-02,(10003) Ciudad Jardín,245,95,304,644
42729,2020-05-17,(10001) Country Sur,247,108,180,535
42730,2020-06-24,(04103) Las Ferias,374,217,162,753
42731,2020-05-08,(10004) Policarpa,158,85,128,371
42732,2020-06-13,(10007) Las Nieves,425,284,336,1045
42733,2020-08-15,(10007) Las Nieves,493,362,337,1192
42734,2020-01-06,(12003) Ricaurte,114,92,138,344
42735,2020-06-09,(07109) CAD,604,364,274,1242
42736,2020-09-14,(07506) DESPENSA,501,263,324,1088
42737,2020-04-17,(02102) Calle 161,112,72,71,255
42738,2020-05-15,(02102) Calle 161,184,113,112,409
42739,2020-07-31,(02102) Calle 161,224,145,140,509
42740,2020-06-21,(02104) Calle 146,248,180,189,617
42741,2020-10-07,(06000) Portal Eldorado,989,687,731,2407
42742,2020-07-25,(02101) Toberín,796,461,541,1798
42743,2020-04-28,(07009) SENA,352,230,200,782
42744,2020-06-05,(10004) Policarpa,209,105,138,452
42745,2020-05-26,(07113) SANTA ISABEL,373,223,215,811
42746,2020-06-19,(02300) Calle 100,1325,831,738,2894
42747,2020-03-30,(09002) Consuelo,226,110,127,463
42748,2020-06-12,(06002) Normandía,325,187,173,685
42749,2020-04-09,(02202) Calle 127,337,243,171,751
42750,2020-08-29,(14001) La Sabana,141,103,103,347
42751,2020-10-12,(07103) AV. CHILE,220,164,302,686
42752,2020-07-14,(12002) CDS - Carrera 32,173,106,84,363
42753,2020-04-11,(09003) Socorro,182,81,93,356
42754,2020-07-25,(06101) El Tiempo,173,122,133,428
42755,2020-07-18,(06002) Normandía,170,104,142,416
42756,2020-07-11,(07506) DESPENSA,379,211,265,855
42757,2020-03-26,(06100) Av. Rojas,124,69,80,273
42758,2020-06-08,(04003) Avenida Ciudad de Cali,959,585,658,2202
42759,2020-01-13,(09108) Hospital,173,96,191,460
42760,2020-06-18,(09108) Hospital,79,49,60,188
42761,2020-10-09,(09108) Hospital,73,44,72,189
42762,2020-04-04,(03003) 21 ANGELES,104,58,51,213
42763,2020-03-05,(03014) SAN MARTIN,229,150,174,553
42764,2020-07-18,(07009) SENA,486,252,295,1033
42765,2020-04-29,(07004) VENECIA,548,338,312,1198
42766,2020-07-07,(06107) Ciudad Universitaria,169,111,114,394
42767,2020-06-03,(07006) General Santander,493,304,245,1042
42768,2020-04-26,(09100) Calle 40 Sur,321,186,191,698
42769,2020-05-23,(07200) Tygua-San José,176,91,109,376
42770,2020-05-10,(07108) Av. El Dorado,28,20,20,68
42771,2020-07-07,(14005) Las Aguas,209,118,232,559
42772,2020-08-12,(06100) Av. Rojas,223,131,128,482
42773,2020-01-11,(07006) General Santander - alimentacion,729,444,625,1798
42774,2020-09-21,(09121) Las Flores,544,384,427,1355
42775,2020-05-05,(14004) Museo del Oro,0,70,175,245
42776,2020-01-03,(09108) Hospital,115,66,130,311
42777,2020-04-15,(07006) General Santander - alimentacion,185,119,120,424
42778,2020-04-08,(07006) General Santander - alimentacion,158,95,112,365
42779,2020-04-10,(07006) General Santander - alimentacion,42,46,43,131
42780,2020-07-09,(07006) General Santander,587,363,318,1268
42781,2020-05-17,(06000) Portal Eldorado,194,139,151,484
42782,2020-05-01,(09115) Calle 34,179,126,95,400
42783,2020-04-22,(12007) Zona Industrial,239,171,112,522
42784,2020-10-10,(06106) Recinto Ferial,214,146,191,551
42785,2020-02-02,(10008) San Diego,140,142,336,618
42786,2020-09-24,(07201) Guatoque -Veraguas,228,136,189,553
42787,2020-07-19,(06111) Universidades,82,43,95,220
42788,2020-04-30,(06105) Quinta Paredes,83,50,42,175
42789,2020-06-27,(07003) SEVILLANA,348,189,216,753
42790,2020-03-20,(14005) Las Aguas,0,44,97,141
42791,2020-03-15,(12004) Carrera 22,86,94,160,340
42792,2020-08-21,(05102) Av. Américas - Av. Boyacá,218,122,149,489
42793,2020-08-26,(07007) NQS - Calle 38A Sur,368,228,251,847
42794,2020-08-17,(12002) CDS - Carrera 32,37,41,24,102
42795,2020-04-28,(04102) Avenida Boyaca,180,114,115,409
42796,2020-05-10,(06103) CAN,137,86,77,300
42797,2020-05-02,(04000) Cabecera Calle 80 - intermunicipal,78,44,74,196
42798,2020-08-30,(09003) Socorro,225,93,138,456
42799,2020-06-10,(10005) Bicentenario,107,43,66,216
42800,2020-05-16,(06101) El Tiempo,172,123,116,411
42801,2020-03-27,(05101) Mandalay - Cr.73,58,32,27,117
42802,2020-10-11,(10003) Ciudad Jardín,84,35,116,235
42803,2020-03-22,(09114) Calle 26,46,44,45,135
42804,2020-03-21,(04003) Avenida Ciudad de Cali,276,183,193,652
42805,2020-06-11,(03010) PUENTE LARGO,328,228,190,746
42806,2020-08-23,(04105) Carrera 53,70,42,64,176
42807,2020-05-25,(07101) CASTELLANA,27,20,34,81
42808,2020-04-26,(07104) Simon Bolivar,73,52,44,169
42809,2020-05-30,(03014) SAN MARTIN,15,7,17,39
42810,2020-07-19,(04001) Quirigua,128,79,68,275
42811,2020-04-04,(07108) Av. El Dorado,37,25,37,99
42812,2020-04-12,(07106) EL CAMPIN,72,44,30,146
42813,2019-12-31,(07111) NQS - RICAURTE,13,23,42,78
42814,2019-12-31,(04106) Carrera 47,18,16,13,47
42815,2020-09-16,(03014) SAN MARTIN,0,15,45,60
42816,2020-08-09,(10009) Museo Nacional,78,67,94,239
42817,2020-06-15,(06104) Gobernación,42,44,58,144
42818,2020-06-30,(03014) SAN MARTIN,30,13,22,65
42819,2020-06-23,(03004) GRATAMIRA,36,24,26,86
42820,2020-01-13,(04000) Cabecera Calle 80 - alimentacion,18519,10760,12471,41750
42821,2020-07-08,(07005) ALQUERIA,570,344,408,1322
42822,2020-03-02,(09002) Consuelo,1409,786,915,3110
42823,2020-08-28,(05000) Portal Américas - alimentacion,11119,5989,6130,23238
42824,2020-09-01,(10000) Portal 20 de Julio - alimentacion,4213,1833,2682,8728
42825,2020-03-16,(05000) Portal Américas - alimentacion,28058,15660,15371,59089
42826,2020-02-23,(14005) Las Aguas,270,214,582,1066
42827,2020-06-08,(05000) Portal Américas,2243,1538,1821,5602
42828,2020-01-22,(07003) SEVILLANA,1959,1123,1090,4172
42829,2020-02-06,(07003) SEVILLANA,2020,1081,1126,4227
42830,2020-03-16,(50003) Corral Molinos,2979,1611,2430,7020
42831,2020-01-24,(04002) Carrera 90,3472,1908,2004,7384
42832,2020-04-15,(05000) Portal Américas - alimentacion,5435,3042,2708,11185
42833,2020-08-22,(06107) Ciudad Universitaria,104,66,92,262
42834,2020-08-26,(06107) Ciudad Universitaria,160,101,115,376
42835,2020-02-05,(02201) Prado,6043,3800,3160,13003
42836,2020-01-30,(07000) Portal Sur - alimentacion,27885,16031,14121,58037
42837,2020-01-27,(08000) Portal Tunal - alimentacion,22940,12493,11257,46690
42838,2020-02-12,(07103) AV. CHILE,3807,2385,1910,8102
42839,2020-02-26,(07103) AV. CHILE,3770,2332,1935,8037
42840,2020-03-06,(10001) Country Sur,5047,2081,2783,9911
42841,2020-01-23,(09000) Cabecera Usme,5410,3310,3871,12591
42842,2020-08-30,(09000) Cabecera Usme,520,241,507,1268
42843,2020-03-05,(05100) Banderas P. Central - alimentacion,15669,8872,8558,33099
42844,2020-03-11,(05100) Banderas P. Central - alimentacion,14538,8377,8300,31215
42845,2020-02-03,(07009) SENA,3608,2172,2063,7843
42846,2020-01-22,(06102) Salitre El Greco,1479,834,674,2987
42847,2020-03-02,(06102) Salitre El Greco,1612,849,657,3118
42848,2020-06-02,(09109) Tercer Milenio,328,192,210,730
42849,2020-01-24,(09104) Restrepo,4994,2974,3731,11699
42850,2020-05-17,(07505) LEON XIII,499,314,263,1076
42851,2020-02-09,(02204) Pepe Sierra,624,473,793,1890
42852,2020-01-07,(05002) Tintal,7752,4248,4621,16621
42853,2020-07-12,(07102) NQS - CALLE 75,81,67,91,239
42854,2020-03-19,(03013) RIO NEGRO,639,403,441,1483
42855,2020-04-16,(03013) RIO NEGRO,138,100,105,343
42856,2020-06-07,(09000) Cabecera Usme - alimentacion,2252,1113,1359,4724
42857,2020-02-24,(09103) Olaya,4200,2594,2376,9170
42858,2020-02-20,(09116) Avenida 39,3329,2086,1603,7018
42859,2020-09-10,(14001) La Sabana,150,85,100,335
42860,2020-10-07,(02000) Cabecera Autopista Norte - alimentacion,5463,2858,3942,12263
42861,2020-02-25,(07002) MADELENA,5221,3045,2586,10852
42862,2020-09-13,(08000) Portal Tunal - alimentacion,2220,954,1541,4715
42863,2020-08-29,(02000) Cabecera Autopista Norte,1015,609,783,2407
42864,2020-01-27,(10006) San Victorino,2315,1131,1208,4654
42865,2020-02-10,(04106) Carrera 47,1531,857,934,3322
42866,2020-03-17,(09114) Calle 26,1706,1152,995,3853
42867,2020-05-07,(04002) Carrera 90,467,259,284,1010
42868,2020-02-14,(09111) Calle 19,2374,1424,1613,5411
42869,2020-10-02,(09111) Calle 19,830,498,687,2015
42870,2020-05-08,(09000) Cabecera Usme - alimentacion,5567,3066,3313,11946
42871,2020-09-16,(10006) San Victorino,818,434,424,1676
42872,2020-03-10,(12001) Carrera 43,336,350,310,996
42873,2020-05-02,(50003) Corral Molinos,721,313,498,1532
42874,2020-03-11,(06111) Universidades,5496,3431,2509,11436
42875,2020-01-04,(02201) Prado,1583,856,1137,3576
42876,2020-03-14,(02302) Virrey,1268,1006,1197,3471
42877,2020-07-13,(02000) Cabecera Autopista Norte - intermunicipal,483,317,325,1125
42878,2020-09-26,(09101) Quiroga,447,217,420,1084
42879,2020-03-09,(10010) San Bernardo,245,277,347,869
42880,2020-02-25,(08002) Biblioteca,1076,639,658,2373
42881,2020-05-27,(07112) COMUNEROS,674,382,357,1413
42882,2020-03-05,(08001) Parque el Tunal,1727,981,995,3703
42883,2020-07-27,(08001) Parque el Tunal,451,261,270,982
42884,2020-10-06,(09116) Avenida 39,459,291,379,1129
42885,2020-01-04,(02302) Virrey,774,600,769,2143
42886,2020-03-19,(06108) Concejo de Bogotá,412,222,204,838
42887,2020-03-03,(09120) Calle 63,7600,4775,3787,16162
42888,2020-03-16,(09120) Calle 63,3802,2549,2326,8677
42889,2020-04-01,(14004) Museo del Oro,0,49,98,147
42890,2020-03-16,(07001) PERDOMO,3153,1975,1727,6855
42891,2020-02-12,(02304) Heroes,4944,3442,2325,10711
42892,2020-03-05,(02304) Heroes,4597,3194,2379,10170
42893,2020-01-06,(05105) Pradera,381,295,348,1024
42894,2020-01-13,(05105) Pradera,1969,1196,1131,4296
42895,2020-08-11,(03012) SUBA - CALLE 95,270,158,163,591
42896,2020-10-08,(50002) Corral Calle 40 Sur,37,15,42,94
42897,2020-02-23,(10000) Portal 20 de Julio - alimentacion,3430,1297,2800,7527
42898,2020-03-03,(14005) Las Aguas,3533,2135,1919,7587
42899,2020-07-22,(05005) Transversal 86,241,162,234,637
42900,2020-01-06,(02104) Calle 146,886,426,823,2135
42901,2020-02-13,(03009) Av. Suba- Calle 116,2645,1669,1466,5780
42902,2020-09-23,(03009) Av. Suba- Calle 116,589,364,336,1289
42903,2020-07-11,(03000) Portal Suba - alimentacion,5278,2766,3221,11265
42904,2020-02-21,(12007) Zona Industrial,1223,770,631,2624
42905,2020-01-01,(07101) CASTELLANA,34,37,118,189
42906,2020-06-21,(05001) Patio Bonito,566,285,392,1243
42907,2020-02-28,(07113) SANTA ISABEL,2225,1276,1405,4906
42908,2020-07-04,(07113) SANTA ISABEL,297,191,252,740
42909,2020-06-26,(06111) Universidades,326,197,349,872
42910,2020-05-26,(10006) San Victorino,459,258,279,996
42911,2020-07-17,(04104) Avenida 68,562,269,269,1100
42912,2020-04-29,(02000) Cabecera Autopista Norte - alimentacion,3007,1697,1474,6178
42913,2020-08-24,(02101) Toberín,1167,761,813,2741
42914,2020-05-09,(09100) Calle 40 Sur,881,492,550,1923
42915,2020-05-01,(09100) Calle 40 Sur,484,284,325,1093
42916,2020-07-21,(10010) San Bernardo,534,288,346,1168
42917,2020-10-05,(09121) Las Flores,773,479,608,1860
42918,2020-07-29,(09000) Cabecera Usme,1601,994,1073,3668
42919,2020-09-20,(04003) Avenida Ciudad de Cali,374,192,455,1021
42920,2020-05-01,(04002) Carrera 90,177,96,91,364
42921,2020-03-16,(09109) Tercer Milenio,993,641,656,2290
42922,2020-08-10,(05001) Patio Bonito,1817,970,1067,3854
42923,2020-02-14,(07109) CAD,2772,1729,1620,6121
42924,2020-02-20,(06101) El Tiempo,3025,1651,1252,5928
42925,2020-01-19,(09001) Molinos,1866,822,1896,4584
42926,2020-10-03,(02104) Calle 146,764,397,745,1906
42927,2020-05-03,(05001) Patio Bonito,357,191,237,785
42928,2020-06-22,(05001) Patio Bonito,648,318,402,1368
42929,2020-06-28,(07109) CAD,181,131,110,422
42930,2020-05-25,(06100) Av. Rojas,42,24,45,111
42931,2020-01-06,(07009) SENA,664,321,632,1617
42932,2020-08-26,(10010) San Bernardo,577,286,353,1216
42933,2020-04-23,(10008) San Diego,172,110,98,380
42934,2020-04-03,(09109) Tercer Milenio,149,95,107,351
42935,2020-01-26,(05102) Av. Américas - Av. Boyacá,255,115,301,671
42936,2020-04-18,(06107) Ciudad Universitaria,73,51,48,172
42937,2020-06-30,(05107) Américas - Cr.53,483,238,284,1005
42938,2020-02-09,(10010) San Bernardo,396,281,579,1256
42939,2020-03-14,(04000) Cabecera Calle 80 - intermunicipal,847,509,1056,2412
42940,2020-10-03,(07103) AV. CHILE,650,458,595,1703
42941,2020-02-02,(06107) Ciudad Universitaria,219,142,353,714
42942,2020-03-10,(40002) Manitas,77,355,250,682
42943,2020-07-13,(02001) Centro Comercial Santa Fe,454,286,278,1018
42944,2020-09-01,(02001) Centro Comercial Santa Fe,493,301,356,1150
42945,2020-10-07,(02001) Centro Comercial Santa Fe,636,383,542,1561
42946,2020-04-15,(05100) Banderas P. Central - alimentacion,1382,718,697,2797
42947,2020-09-07,(02102) Calle 161,269,153,208,630
42948,2020-06-08,(09123) Calle 76,968,662,485,2115
42949,2020-05-30,(10006) San Victorino,281,211,239,731
42950,2020-06-16,(10008) San Diego,305,184,175,664
42951,2020-09-18,(08002) Biblioteca,365,203,246,814
42952,2020-03-14,(10005) Bicentenario,198,142,273,613
42953,2020-03-28,(02202) Calle 127,554,376,283,1213
42954,2020-05-21,(05001) Patio Bonito,1385,751,801,2937
42955,2020-06-01,(05105) Pradera,518,327,226,1071
42956,2020-04-01,(02300) Calle 100,763,553,400,1716
42957,2020-03-01,(40001) Juan Pablo II,476,209,412,1097
42958,2020-04-03,(09115) Calle 34,330,244,236,810
42959,2020-04-01,(02204) Pepe Sierra,397,315,251,963
42960,2020-08-05,(02204) Pepe Sierra,744,494,362,1600
42961,2020-03-30,(02104) Calle 146,358,272,243,873
42962,2020-09-18,(03013) RIO NEGRO,327,183,252,762
42963,2020-06-02,(07000) Portal Sur,1602,1010,923,3535
42964,2020-08-28,(07002) MADELENA,844,498,568,1910
42965,2020-08-16,(03006) NIZA - CALLE 127,170,102,87,359
42966,2020-03-10,(05001) Patio Bonito,249,1986,1307,3542
42967,2020-07-07,(09110) Avenida Jimenez,1564,1122,881,3567
42968,2020-08-01,(07006) General Santander,355,216,216,787
42969,2020-07-20,(09000) Cabecera Usme - alimentacion,2244,1144,1255,4643
42970,2020-06-04,(07006) General Santander,470,287,241,998
42971,2020-02-02,(03001) LA CAMPIÑA,1152,486,1221,2859
42972,2020-09-02,(02302) Virrey,680,487,429,1596
42973,2020-05-22,(07201) Guatoque -Veraguas,177,115,109,401
42974,2020-07-13,(06108) Concejo de Bogotá,124,57,70,251
42975,2020-05-16,(03003) 21 ANGELES,170,97,90,357
42976,2020-04-24,(07004) VENECIA,548,341,279,1168
42977,2020-09-02,(07107) U. NACIONAL,395,228,186,809
42978,2020-10-07,(04103) Las Ferias,380,202,232,814
42979,2020-03-18,(05005) Transversal 86,1352,717,570,2639
42980,2020-02-05,(07006) General Santander - alimentacion,1520,914,987,3421
42981,2020-04-18,(07103) AV. CHILE,321,236,146,703
42982,2020-03-16,(10003) Ciudad Jardín,648,337,425,1410
42983,2020-08-28,(09111) Calle 19,737,429,489,1655
42984,2020-05-19,(03013) RIO NEGRO,233,152,167,552
42985,2020-07-04,(09107) Hortúa,450,263,308,1021
42986,2020-04-08,(09003) Socorro,278,123,162,563
42987,2020-06-29,(03006) NIZA - CALLE 127,213,136,110,459
42988,2020-01-03,(10004) Policarpa,408,231,429,1068
42989,2020-07-15,(10010) San Bernardo,503,238,318,1059
42990,2020-04-12,(50003) Corral Molinos,274,129,216,619
42991,2020-03-25,(02103) Mazurén,94,64,70,228
42992,2020-05-03,(02001) Centro Comercial Santa Fe,66,51,59,176
42993,2020-04-08,(02502) Terminal,146,98,122,366
42994,2020-03-31,(40001) Juan Pablo II,248,126,142,516
42995,2020-08-01,(40001) Juan Pablo II,395,231,277,903
42996,2020-09-20,(03003) 21 ANGELES,110,41,111,262
42997,2020-06-17,(09108) Hospital,82,51,51,184
42998,2020-07-26,(02103) Mazurén,32,32,37,101
42999,2020-06-21,(10002) Av. Primero de Mayo,505,309,529,1343
43000,2020-03-03,(09105) Río Fucha,782,443,550,1775
43001,2020-08-08,(08001) Parque el Tunal,325,162,238,725
43002,2020-06-26,(05101) Mandalay - Cr.73,145,77,86,308
43003,2020-07-08,(07009) SENA,669,421,442,1532
43004,2020-06-30,(09113) Calle 22,451,250,351,1052
43005,2020-04-18,(10004) Policarpa,89,51,67,207
43006,2020-04-08,(04106) Carrera 47,178,87,96,361
43007,2020-07-08,(04101) Minuto de Dios,344,195,265,804
43008,2020-05-31,(04000) Cabecera Calle 80 - intermunicipal,49,17,42,108
43009,2020-04-25,(06000) Portal Eldorado,509,384,279,1172
43010,2020-05-29,(09111) Calle 19,684,445,480,1609
43011,2020-04-14,(06108) Concejo de Bogotá,105,78,62,245
43012,2020-07-15,(07006) General Santander,477,291,246,1014
43013,2020-06-21,(14004) Museo del Oro,23,22,50,95
43014,2020-05-09,(06001) Modelia,216,142,114,472
43015,2020-04-14,(03005) SUBA - AV. BOYACA,212,143,135,490
43016,2020-08-08,(06105) Quinta Paredes,82,56,50,188
43017,2020-03-27,(14004) Museo del Oro,0,42,114,156
43018,2020-05-25,(09106) Nariño,125,83,93,301
43019,2020-08-30,(09121) Las Flores,173,107,220,500
43020,2020-05-17,(07007) NQS - Calle 38A Sur,97,53,54,204
43021,2020-03-27,(07200) Tygua-San José,49,44,70,163
43022,2020-04-16,(06105) Quinta Paredes,66,52,40,158
43023,2020-06-29,(14005) Las Aguas,52,34,87,173
43024,2020-04-05,(09114) Calle 26,38,35,21,94
43025,2020-07-23,(10008) San Diego,199,124,125,448
43026,2020-03-22,(03006) NIZA - CALLE 127,132,100,53,285
43027,2020-08-09,(03003) 21 ANGELES,67,27,52,146
43028,2020-05-17,(12004) Carrera 22,24,17,28,69
43029,2020-08-05,(09106) Nariño,372,184,284,840
43030,2020-05-06,(06106) Recinto Ferial,182,118,74,374
43031,2020-07-22,(10003) Ciudad Jardín,167,79,129,375
43032,2020-10-11,(10004) Policarpa,108,52,121,281
43033,2020-04-28,(14004) Museo del Oro,0,60,116,176
43034,2020-06-17,(10005) Bicentenario,115,42,75,232
43035,2020-10-04,(05101) Mandalay - Cr.73,41,15,43,99
43036,2020-09-10,(04101) Minuto de Dios,342,169,284,795
43037,2020-07-26,(07112) COMUNEROS,172,113,126,411
43038,2020-05-07,(14004) Museo del Oro,0,61,144,205
43039,2020-05-31,(02000) Cabecera Autopista Norte - intermunicipal,65,68,76,209
43040,2020-04-01,(05101) Mandalay - Cr.73,47,24,25,96
43041,2020-07-11,(09108) Hospital,71,39,67,177
43042,2020-05-05,(12000) Puente Aranda,49,32,33,114
43043,2020-03-22,(06107) Ciudad Universitaria,32,24,29,85
43044,2020-05-17,(12001) Carrera 43,32,29,44,105
43045,2020-03-22,(06100) Av. Rojas,41,23,25,89
43046,2020-05-25,(03014) SAN MARTIN,11,3,6,20
43047,2020-06-15,(06106) Recinto Ferial,79,47,53,179
43048,2020-05-22,(03014) SAN MARTIN,27,13,31,71
43049,2020-04-29,(03004) GRATAMIRA,18,16,8,42
43050,2020-03-12,(07005) ALQUERIA,286,515,377,1178
43051,2020-01-28,(09002) Consuelo,1418,747,825,2990
43052,2020-02-04,(09002) Consuelo,1476,820,876,3172
43053,2020-09-28,(09002) Consuelo,514,296,385,1195
43054,2020-04-01,(09118) Marly,1034,745,496,2275
43055,2020-09-24,(09118) Marly,1558,996,982,3536
43056,2020-02-03,(07111) NQS - RICAURTE,3041,1978,1833,6852
43057,2020-08-15,(07503) SAN MATEO,8919,4623,4790,18332
43058,2020-02-09,(06104) Gobernación,145,115,196,456
43059,2020-06-12,(10000) Portal 20 de Julio - alimentacion,4195,1986,2333,8514
43060,2020-06-24,(10000) Portal 20 de Julio - alimentacion,4335,2006,2511,8852
43061,2020-03-08,(06107) Ciudad Universitaria,216,138,379,733
43062,2020-02-03,(09001) Molinos,7387,4507,5973,17867
43063,2020-02-25,(05001) Patio Bonito,7357,4267,3812,15436
43064,2020-03-14,(08000) Portal Tunal - alimentacion,13831,6809,8515,29155
43065,2020-02-03,(07010) Bosa,2176,1299,1426,4901
43066,2020-01-09,(05000) Portal Américas,10954,6175,6360,23489
43067,2020-02-03,(05005) Transversal 86,2704,1593,1268,5565
43068,2020-05-03,(05005) Transversal 86,68,39,36,143
43069,2020-02-11,(04100) Carrera 77,7235,4374,4114,15723
43070,2020-01-13,(09000) Cabecera Usme,4895,2894,3573,11362
43071,2020-05-05,(06000) Portal Eldorado - alimentacion,2712,1407,1272,5391
43072,2020-01-30,(05100) Banderas P. Central - alimentacion,14766,8420,8079,31265
43073,2020-07-01,(10000) Portal 20 de Julio - alimentacion,4577,2119,2719,9415
43074,2020-03-12,(09000) Cabecera Usme - alimentacion,855,5390,4262,10507
43075,2020-07-27,(04101) Minuto de Dios,290,177,213,680
43076,2020-02-17,(07505) LEON XIII,8314,4965,3755,17034
43077,2020-07-24,(07505) LEON XIII,2432,1350,991,4773
43078,2020-09-14,(04104) Avenida 68,688,341,400,1429
43079,2020-03-21,(02000) Cabecera Autopista Norte - alimentacion,1706,878,694,3278
43080,2020-07-08,(02000) Cabecera Autopista Norte - alimentacion,5066,2844,2901,10811
43081,2020-01-16,(12003) Ricaurte,1118,743,533,2394
43082,2020-02-13,(07102) NQS - CALLE 75,1461,1019,1004,3484
43083,2020-03-11,(03001) LA CAMPIÑA,6222,3820,3962,14004
43084,2020-02-21,(06001) Modelia,2511,1462,1300,5273
43085,2020-02-26,(06001) Modelia,2662,1524,1224,5410
43086,2020-06-20,(03007) HUMEDAL CORDOBA,131,75,54,260
43087,2020-02-25,(02001) Centro Comercial Santa Fe,4854,3126,2558,10538
43088,2020-05-06,(07000) Portal Sur - alimentacion,5152,2791,2207,10150
43089,2020-02-14,(14001) La Sabana,617,411,390,1418
43090,2020-07-07,(08000) Portal Tunal - alimentacion,6656,3799,3791,14246
43091,2020-08-31,(09004) Santa Lucía,2497,1258,1454,5209
43092,2020-01-20,(06105) Quinta Paredes,888,551,476,1915
43093,2020-03-12,(07007) NQS - Calle 38A Sur,419,347,292,1058
43094,2020-03-15,(50003) Corral Molinos,855,400,972,2227
43095,2020-07-14,(50003) Corral Molinos,1005,552,731,2288
43096,2020-01-15,(05002) Tintal,9321,5483,5444,20248
43097,2020-03-04,(09114) Calle 26,3355,2154,1820,7329
43098,2020-02-15,(02201) Prado,3078,1636,2230,6944
43099,2020-03-13,(04100) Carrera 77,395,1174,1056,2625
43100,2020-06-14,(03000) Portal Suba,299,164,283,746
43101,2020-08-03,(50003) Corral Molinos,1318,675,953,2946
43102,2020-01-27,(07113) SANTA ISABEL,2016,1264,1294,4574
43103,2020-06-24,(03000) Portal Suba,1310,844,831,2985
43104,2020-09-25,(02000) Cabecera Autopista Norte - intermunicipal,727,428,614,1769
43105,2020-06-14,(03000) Portal Suba - alimentacion,1858,908,1149,3915
43106,2020-03-29,(07112) COMUNEROS,117,78,69,264
43107,2020-10-02,(07112) COMUNEROS,984,561,771,2316
43108,2020-08-07,(02303) Calle 85,200,140,139,479
43109,2020-02-06,(09105) Río Fucha,818,481,527,1826
43110,2020-05-07,(06108) Concejo de Bogotá,112,68,54,234
43111,2020-09-04,(06108) Concejo de Bogotá,135,81,105,321
43112,2020-10-08,(06108) Concejo de Bogotá,163,87,122,372
43113,2020-04-20,(04000) Cabecera Calle 80,579,395,381,1355
43114,2020-03-13,(08001) Parque el Tunal,67,323,284,674
43115,2020-03-25,(14004) Museo del Oro,0,79,152,231
43116,2020-08-23,(40003) Mirador del Paraiso,543,305,402,1250
43117,2020-06-10,(09123) Calle 76,975,662,530,2167
43118,2020-07-18,(40003) Mirador del Paraiso,978,640,651,2269
43119,2020-01-12,(07112) COMUNEROS,783,403,768,1954
43120,2020-10-06,(02103) Mazurén,269,178,295,742
43121,2020-10-08,(02103) Mazurén,278,190,309,777
43122,2020-04-07,(05000) Portal Américas,1216,783,929,2928
43123,2020-01-07,(03011) SUBA - CALLE 100,1805,883,1050,3738
43124,2020-07-14,(09001) Molinos,1648,975,1139,3762
43125,2020-02-01,(09119) Calle 57,1677,1014,1513,4204
43126,2020-06-18,(09119) Calle 57,599,395,374,1368
43127,2020-01-07,(07104) Simon Bolivar,1374,892,902,3168
43128,2020-01-31,(07104) Simon Bolivar,2344,1420,1241,5005
43129,2020-06-27,(09104) Restrepo,1307,780,1003,3090
43130,2020-03-31,(05005) Transversal 86,191,90,92,373
43131,2020-04-27,(05005) Transversal 86,150,26,21,197
43132,2020-02-18,(06109) Centro Memoria,1251,693,624,2568
43133,2020-07-04,(06109) Centro Memoria,217,128,152,497
43134,2020-10-03,(03009) Av. Suba- Calle 116,342,234,334,910
43135,2020-04-18,(02205) Calle 106,149,106,82,337
43136,2020-04-29,(02205) Calle 106,181,136,86,403
43137,2020-08-13,(07106) EL CAMPIN,393,229,212,834
43138,2020-01-12,(06106) Recinto Ferial,258,144,255,657
43139,2020-02-28,(05103) Marsella,3252,1745,1552,6549
43140,2020-10-04,(03007) HUMEDAL CORDOBA,39,37,50,126
43141,2020-01-08,(10006) San Victorino,1358,771,950,3079
43142,2020-09-24,(08002) Biblioteca,358,183,231,772
43143,2020-04-03,(02000) Cabecera Autopista Norte - alimentacion,2710,1348,1299,5357
43144,2020-08-31,(04100) Carrera 77,1210,683,846,2739
43145,2020-09-25,(04100) Carrera 77,1489,807,1174,3470
43146,2020-08-29,(09117) Calle 45,472,316,425,1213
43147,2020-05-14,(07000) Portal Sur,1351,860,732,2943
43148,2020-05-21,(02101) Toberín,1109,741,682,2532
43149,2020-03-06,(05103) Marsella,3042,1680,1558,6280
43150,2020-05-05,(10000) Portal 20 de Julio,1548,766,771,3085
43151,2020-07-07,(07104) Simon Bolivar,603,406,278,1287
43152,2020-08-28,(07104) Simon Bolivar,597,343,304,1244
43153,2020-01-24,(07004) VENECIA,4472,2488,2467,9427
43154,2020-03-10,(09121) Las Flores,1630,287,592,2509
43155,2020-05-26,(04103) Las Ferias,320,183,134,637
43156,2020-10-01,(05001) Patio Bonito,2297,1125,1496,4918
43157,2020-03-07,(07004) VENECIA,2842,1469,1872,6183
43158,2020-10-11,(09110) Avenida Jimenez,469,406,465,1340
43159,2020-10-10,(09120) Calle 63,939,677,986,2602
43160,2020-09-15,(02104) Calle 146,894,584,648,2126
43161,2020-08-12,(09111) Calle 19,760,440,420,1620
43162,2020-06-09,(02202) Calle 127,1033,734,549,2316
43163,2020-10-02,(02202) Calle 127,1200,892,873,2965
43164,2020-08-12,(09121) Las Flores,630,384,400,1414
43165,2020-03-15,(09001) Molinos,1579,672,1497,3748
43166,2020-04-24,(03001) LA CAMPIÑA,548,309,317,1174
43167,2020-03-22,(02000) Cabecera Autopista Norte,221,145,112,478
43168,2020-04-02,(04108) El Polo,196,154,135,485
43169,2020-07-18,(02001) Centro Comercial Santa Fe,308,184,216,708
43170,2020-05-08,(06000) Portal Eldorado,894,552,395,1841
43171,2020-02-20,(04101) Minuto de Dios,3440,2104,1724,7268
43172,2020-08-15,(03010) PUENTE LARGO,228,150,183,561
43173,2020-01-13,(05107) Américas - Cr.53,2127,1184,1237,4548
43174,2020-07-26,(07009) SENA,148,85,117,350
43175,2020-07-18,(02105) Calle 142,491,313,337,1141
43176,2020-05-02,(05102) Av. Américas - Av. Boyacá,79,53,58,190
43177,2020-07-03,(06108) Concejo de Bogotá,147,80,108,335
43178,2020-05-29,(02103) Mazurén,162,116,107,385
43179,2020-05-17,(07103) AV. CHILE,165,104,136,405
43180,2020-08-10,(10005) Bicentenario,88,60,76,224
43181,2020-07-08,(02102) Calle 161,265,176,176,617
43182,2020-07-22,(02102) Calle 161,226,133,133,492
43183,2020-09-21,(04100) Carrera 77,1123,589,751,2463
43184,2020-09-19,(09123) Calle 76,721,553,715,1989
43185,2020-08-10,(07003) SEVILLANA,438,218,221,877
43186,2020-04-06,(09120) Calle 63,520,389,361,1270
43187,2020-06-01,(10009) Museo Nacional,489,289,234,1012
43188,2020-08-19,(40001) Juan Pablo II,532,311,366,1209
43189,2020-08-08,(09115) Calle 34,354,225,302,881
43190,2020-01-01,(05100) Banderas P. Central - alimentacion,965,394,1143,2502
43191,2020-06-14,(07110) PALOQUEMAO,137,104,88,329
43192,2020-07-15,(07110) PALOQUEMAO,529,333,256,1118
43193,2020-09-01,(07110) PALOQUEMAO,664,409,298,1371
43194,2020-06-05,(07201) Guatoque -Veraguas,194,95,132,421
43195,2020-08-19,(12004) Carrera 22,283,163,129,575
43196,2020-10-11,(05001) Patio Bonito,738,308,630,1676
43197,2020-04-09,(09122) Calle 72,261,200,164,625
43198,2020-06-26,(09118) Marly,1492,974,816,3282
43199,2020-05-20,(06109) Centro Memoria,252,154,131,537
43200,2020-07-02,(04105) Carrera 53,301,163,166,630
43201,2020-09-14,(04105) Carrera 53,313,168,218,699
43202,2020-07-01,(07201) Guatoque -Veraguas,211,122,127,460
43203,2020-08-21,(14005) Las Aguas,114,93,203,410
43204,2020-05-19,(05105) Pradera,476,306,206,988
43205,2020-01-02,(07102) NQS - CALLE 75,621,407,481,1509
43206,2020-03-12,(10007) Las Nieves,1148,66,195,1409
43207,2020-02-16,(04001) Quirigua,471,182,470,1123
43208,2020-01-06,(06107) Ciudad Universitaria,138,98,208,444
43209,2020-05-28,(04103) Las Ferias,326,177,160,663
43210,2020-09-19,(03011) SUBA - CALLE 100,375,261,362,998
43211,2020-04-29,(09110) Avenida Jimenez,512,435,437,1384
43212,2020-03-24,(10004) Policarpa,193,120,139,452
43213,2020-07-01,(09122) Calle 72,1248,789,822,2859
43214,2020-02-09,(14005) Las Aguas,304,238,628,1170
43215,2020-03-13,(09003) Socorro,112,310,267,689
43216,2020-06-22,(05102) Av. Américas - Av. Boyacá,85,48,55,188
43217,2020-09-04,(12004) Carrera 22,275,168,150,593
43218,2020-08-17,(02103) Mazurén,28,26,55,109
43219,2020-09-29,(06001) Modelia,414,261,273,948
43220,2020-03-31,(03013) RIO NEGRO,134,91,92,317
43221,2020-06-25,(09114) Calle 26,332,212,212,756
43222,2020-08-02,(09002) Consuelo,143,58,108,309
43223,2020-01-29,(09108) Hospital,185,132,202,519
43224,2020-06-20,(06002) Normandía,219,122,169,510
43225,2020-09-07,(02000) Cabecera Autopista Norte - intermunicipal,566,374,449,1389
43226,2020-08-01,(02502) Terminal,226,149,221,596
43227,2020-08-06,(06106) Recinto Ferial,225,135,116,476
43228,2020-08-07,(05001) Patio Bonito,846,424,452,1722
43229,2020-04-28,(12002) CDS - Carrera 32,205,150,61,416
43230,2020-05-22,(12002) CDS - Carrera 32,193,120,66,379
43231,2020-04-04,(40001) Juan Pablo II,209,111,118,438
43232,2020-05-07,(07108) Av. El Dorado,82,53,65,200
43233,2020-05-05,(06002) Normandía,212,133,144,489
43234,2020-05-14,(04101) Minuto de Dios,236,151,160,547
43235,2020-05-08,(06100) Av. Rojas,155,100,98,353
43236,2020-06-10,(06001) Modelia,382,235,179,796
43237,2020-09-24,(07006) General Santander - alimentacion,418,225,325,968
43238,2020-03-12,(03010) PUENTE LARGO,583,224,270,1077
43239,2020-03-01,(06108) Concejo de Bogotá,116,75,176,367
43240,2020-06-14,(07101) CASTELLANA,25,13,35,73
43241,2020-07-23,(07108) Av. El Dorado,136,79,60,275
43242,2020-07-30,(09121) Las Flores,666,390,428,1484
43243,2020-07-27,(04106) Carrera 47,305,142,176,623
43244,2020-07-13,(05101) Mandalay - Cr.73,114,56,71,241
43245,2020-06-25,(07008) NQS - Calle 30 Sur,311,190,199,700
43246,2020-03-12,(05102) Av. Américas - Av. Boyacá,156,396,235,787
43247,2020-05-30,(09108) Hospital,64,30,38,132
43248,2020-07-18,(03005) SUBA - AV. BOYACA,283,157,194,634
43249,2020-04-26,(09003) Socorro,131,53,82,266
43250,2020-04-12,(07006) General Santander,84,60,52,196
43251,2020-07-05,(04002) Carrera 90,224,112,194,530
43252,2020-04-03,(07108) Av. El Dorado,53,37,54,144
43253,2020-08-07,(03011) SUBA - CALLE 100,162,87,98,347
43254,2020-06-19,(03004) GRATAMIRA,35,19,29,83
43255,2020-08-23,(04001) Quirigua,112,54,98,264
43256,2020-07-26,(03006) NIZA - CALLE 127,165,93,77,335
43257,2020-10-12,(10004) Policarpa,106,52,100,258
43258,2020-07-22,(03005) SUBA - AV. BOYACA,383,226,212,821
43259,2020-08-07,(14001) La Sabana,66,48,57,171
43260,2020-03-23,(12004) Carrera 22,15,20,25,60
43261,2020-06-07,(10003) Ciudad Jardín,43,21,57,121
43262,2020-06-29,(08001) Parque el Tunal,161,73,83,317
43263,2020-03-22,(09111) Calle 19,92,55,77,224
43264,2020-08-08,(04102) Avenida Boyaca,166,109,183,458
43265,2020-06-06,(07003) SEVILLANA,318,161,175,654
43266,2020-08-06,(06100) Av. Rojas,170,122,128,420
43267,2020-04-27,(06105) Quinta Paredes,20,33,16,69
43268,2020-10-11,(06107) Ciudad Universitaria,48,32,118,198
43269,2020-10-11,(09106) Nariño,151,80,221,452
43270,2020-03-18,(50002) Corral Calle 40 Sur,57,32,63,152
43271,2020-06-29,(07008) NQS - Calle 30 Sur,105,57,74,236
43272,2020-08-14,(50006) Corral Carrera 77,6,1,10,17
43273,2020-03-22,(05101) Mandalay - Cr.73,15,8,13,36
43274,2020-04-17,(09108) Hospital,37,26,34,97
43275,2020-04-26,(10007) Las Nieves,51,34,41,126
43276,2020-03-25,(03014) SAN MARTIN,20,15,15,50
43277,2020-05-12,(03004) GRATAMIRA,24,18,19,61
43278,2020-04-24,(50006) Corral Carrera 77,4,3,5,12
43279,2020-01-22,(50004) Corral Avenida Ciudad de Cali,1,0,1,2
43280,2020-05-20,(04000) Cabecera Calle 80 - alimentacion,3149,1829,1845,6823
43281,2020-01-29,(07005) ALQUERIA,2525,1460,1377,5362
43282,2020-06-18,(07005) ALQUERIA,594,336,338,1268
43283,2020-05-20,(07504) TERREROS,4294,2595,2045,8934
43284,2020-10-08,(03000) Portal Suba - alimentacion,7479,3971,5470,16920
43285,2020-02-13,(02200) Alcalá,15019,9212,6891,31122
43286,2020-08-25,(05000) Portal Américas,2791,1706,1871,6368
43287,2020-08-03,(09100) Calle 40 Sur,1611,956,969,3536
43288,2020-03-09,(07003) SEVILLANA,180,501,390,1071
43289,2020-01-23,(10000) Portal 20 de Julio - alimentacion,10736,5202,6958,22896
43290,2020-02-16,(07503) SAN MATEO,9590,4328,6490,20408
43291,2020-02-08,(09100) Calle 40 Sur,4543,2208,3227,9978
43292,2020-03-22,(05000) Portal Américas - alimentacion,2397,1106,1127,4630
43293,2020-02-24,(07503) SAN MATEO,40657,23578,17650,81885
43294,2020-03-02,(09001) Molinos,7526,4418,5826,17770
43295,2020-03-14,(05001) Patio Bonito,4465,2174,2636,9275
43296,2020-01-20,(04103) Las Ferias,1454,793,859,3106
43297,2020-09-17,(07503) SAN MATEO,12627,6916,6677,26220
43298,2020-03-01,(09000) Cabecera Usme - alimentacion,5965,2715,5113,13793
43299,2020-01-08,(09115) Calle 34,2818,1968,1815,6601
43300,2020-01-20,(07009) SENA,3081,1791,1951,6823
43301,2020-02-03,(09000) Cabecera Usme - alimentacion,24929,14400,16241,55570
43302,2020-02-11,(05103) Marsella,3341,1990,1558,6889
43303,2020-01-07,(04104) Avenida 68,2179,1176,1351,4706
43304,2020-03-12,(04104) Avenida 68,1141,405,456,2002
43305,2020-01-20,(05001) Patio Bonito,6234,3590,3592,13416
43306,2020-02-27,(09004) Santa Lucía,7666,4262,4094,16022
43307,2020-03-23,(09004) Santa Lucía,464,272,240,976
43308,2020-05-27,(09101) Quiroga,408,218,322,948
43309,2020-01-26,(02101) Toberín,1804,824,2277,4905
43310,2020-01-25,(09119) Calle 57,1352,890,1346,3588
43311,2020-06-04,(09103) Olaya,936,523,490,1949
43312,2020-02-19,(14001) La Sabana,659,414,391,1464
43313,2020-03-06,(07107) U. NACIONAL,2436,1577,1560,5573
43314,2020-02-15,(09113) Calle 22,1259,707,919,2885
43315,2020-01-11,(10007) Las Nieves,936,739,888,2563
43316,2020-07-21,(09004) Santa Lucía,1879,989,1019,3887
43317,2020-08-30,(08000) Portal Tunal - alimentacion,2206,1018,1513,4737
43318,2020-02-18,(50003) Corral Molinos,3420,2263,3683,9366
43319,2020-03-04,(06106) Recinto Ferial,1601,904,842,3347
43320,2020-09-17,(02201) Prado,1019,695,673,2387
43321,2020-08-29,(10006) San Victorino,509,270,337,1116
43322,2020-05-14,(06000) Portal Eldorado,973,627,390,1990
43323,2020-02-25,(10008) San Diego,1677,882,775,3334
43324,2020-10-08,(40003) Mirador del Paraiso,1813,1028,1332,4173
43325,2020-06-22,(12001) Carrera 43,71,59,71,201
43326,2020-03-02,(04104) Avenida 68,3640,1926,1834,7400
43327,2020-01-28,(02105) Calle 142,7126,4363,3757,15246
43328,2020-09-02,(03000) Portal Suba,1454,938,993,3385
43329,2020-09-01,(09101) Quiroga,502,250,400,1152
43330,2020-06-13,(08001) Parque el Tunal,357,179,200,736
43331,2020-03-31,(10000) Portal 20 de Julio - alimentacion,2538,880,1282,4700
43332,2020-03-22,(07000) Portal Sur - alimentacion,1606,835,623,3064
43333,2020-01-11,(07000) Portal Sur,3930,1969,2933,8832
43334,2020-08-24,(09004) Santa Lucía,2121,1039,1105,4265
43335,2020-01-18,(07008) NQS - Calle 30 Sur,991,432,710,2133
43336,2020-02-20,(07008) NQS - Calle 30 Sur,1936,1048,1022,4006
43337,2020-05-12,(09003) Socorro,445,240,234,919
43338,2020-06-02,(03003) 21 ANGELES,298,150,142,590
43339,2020-02-10,(02202) Calle 127,6066,4060,2997,13123
43340,2020-04-26,(02201) Prado,164,125,82,371
43341,2020-07-30,(02201) Prado,777,564,475,1816
43342,2020-02-08,(07007) NQS - Calle 38A Sur,1453,726,893,3072
43343,2020-03-08,(09107) Hortúa,523,292,586,1401
43344,2020-03-30,(09107) Hortúa,422,307,220,949
43345,2020-08-24,(09107) Hortúa,493,283,313,1089
43346,2020-09-08,(09107) Hortúa,624,380,413,1417
43347,2020-05-08,(05002) Tintal,1668,961,934,3563
43348,2020-07-15,(03012) SUBA - CALLE 95,310,175,158,643
43349,2020-09-04,(03012) SUBA - CALLE 95,335,186,243,764
43350,2020-05-29,(08000) Portal Tunal,757,316,259,1332
43351,2020-04-08,(09001) Molinos,1144,616,852,2612
43352,2020-05-04,(09104) Restrepo,933,606,703,2242
43353,2020-10-08,(02302) Virrey,736,553,546,1835
43354,2020-07-12,(05005) Transversal 86,0,42,148,190
43355,2020-06-04,(02000) Cabecera Autopista Norte,1139,742,647,2528
43356,2020-02-29,(02202) Calle 127,2898,1879,2113,6890
43357,2020-01-02,(08000) Portal Tunal,916,615,678,2209
43358,2020-07-22,(03009) Av. Suba- Calle 116,488,277,228,993
43359,2020-08-03,(02205) Calle 106,313,225,181,719
43360,2020-03-12,(10002) Av. Primero de Mayo,387,1483,1214,3084
43361,2020-01-24,(09101) Quiroga,1455,855,1142,3452
43362,2020-01-02,(03006) NIZA - CALLE 127,876,553,674,2103
43363,2020-01-03,(03006) NIZA - CALLE 127,986,642,795,2423
43364,2020-05-02,(05002) Tintal,932,566,525,2023
43365,2020-01-25,(04101) Minuto de Dios,1244,704,1082,3030
43366,2020-04-15,(04108) El Polo,237,156,116,509
43367,2020-01-18,(06000) Portal Eldorado,2314,1707,2094,6115
43368,2020-05-03,(08000) Portal Tunal - alimentacion,1407,750,709,2866
43369,2020-08-29,(07106) EL CAMPIN,330,192,205,727
43370,2020-02-13,(07103) AV. CHILE,3540,2271,2035,7846
43371,2020-02-18,(05101) Mandalay - Cr.73,1223,707,582,2512
43372,2020-07-22,(07000) Portal Sur,1658,1014,1030,3702
43373,2020-02-21,(06101) El Tiempo,2813,1552,1373,5738
43374,2020-05-21,(07010) Bosa,569,286,320,1175
43375,2020-07-01,(07010) Bosa,763,357,461,1581
43376,2020-01-22,(04103) Las Ferias,1466,847,836,3149
43377,2020-08-23,(10002) Av. Primero de Mayo,502,241,440,1183
43378,2020-02-10,(07109) CAD,2934,1840,1403,6177
43379,2020-01-13,(07004) VENECIA,3836,2301,2220,8357
43380,2020-01-30,(04107) Escuela Militar,623,393,427,1443
43381,2020-03-04,(09109) Tercer Milenio,1359,860,903,3122
43382,2020-03-09,(04002) Carrera 90,193,1066,672,1931
43383,2020-08-10,(03001) LA CAMPIÑA,883,527,507,1917
43384,2020-08-25,(06101) El Tiempo,335,205,199,739
43385,2020-04-24,(02202) Calle 127,696,501,362,1559
43386,2020-04-02,(03001) LA CAMPIÑA,510,287,257,1054
43387,2020-10-06,(04002) Carrera 90,879,468,612,1959
43388,2020-08-05,(04108) El Polo,356,221,177,754
43389,2020-09-03,(02302) Virrey,680,454,391,1525
43390,2020-05-22,(03010) PUENTE LARGO,298,204,168,670
43391,2020-04-12,(02105) Calle 142,158,120,76,354
43392,2020-05-25,(02105) Calle 142,196,160,130,486
43393,2020-02-09,(05102) Av. Américas - Av. Boyacá,237,127,243,607
43394,2020-07-16,(10002) Av. Primero de Mayo,1519,815,985,3319
43395,2020-06-09,(09118) Marly,1339,916,723,2978
43396,2020-08-06,(02103) Mazurén,153,87,146,386
43397,2020-07-22,(12007) Zona Industrial,350,198,157,705
43398,2020-09-21,(12007) Zona Industrial,179,220,175,574
43399,2020-06-04,(09117) Calle 45,676,408,387,1471
43400,2020-02-17,(12002) CDS - Carrera 32,628,395,324,1347
43401,2020-05-16,(02001) Centro Comercial Santa Fe,234,144,176,554
43402,2020-08-25,(02001) Centro Comercial Santa Fe,446,266,326,1038
43403,2020-04-23,(40003) Mirador del Paraiso,793,495,526,1814
43404,2020-03-12,(07104) Simon Bolivar,860,186,265,1311
43405,2020-02-13,(40001) Juan Pablo II,1713,991,953,3657
43406,2020-08-24,(10008) San Diego,239,126,130,495
43407,2020-09-15,(10008) San Diego,289,188,209,686
43408,2020-04-22,(02200) Alcalá,904,703,448,2055
43409,2020-09-04,(09003) Socorro,645,329,418,1392
43410,2020-07-20,(12007) Zona Industrial,90,52,58,200
43411,2020-04-24,(40003) Mirador del Paraiso,897,544,638,2079
43412,2020-06-26,(06100) Av. Rojas,241,141,148,530
43413,2020-09-08,(07111) NQS - RICAURTE,1159,691,510,2360
43414,2020-06-11,(04000) Cabecera Calle 80 - intermunicipal,301,176,264,741
43415,2020-10-10,(03013) RIO NEGRO,207,129,218,554
43416,2020-06-20,(07110) PALOQUEMAO,437,307,248,992
43417,2020-05-13,(05001) Patio Bonito,1240,657,711,2608
43418,2020-03-07,(04107) Escuela Militar,322,263,346,931
43419,2020-02-21,(05101) Mandalay - Cr.73,1229,544,582,2355
43420,2020-03-23,(10000) Portal 20 de Julio,564,242,267,1073
43421,2020-05-21,(07105) MOVISTAR ARENA,231,132,110,473
43422,2020-06-24,(07201) Guatoque -Veraguas,207,127,130,464
43423,2020-07-08,(06108) Concejo de Bogotá,163,91,89,343
43424,2020-09-01,(07105) MOVISTAR ARENA,262,142,133,537
43425,2020-05-26,(09121) Las Flores,600,412,403,1415
43426,2020-09-16,(09114) Calle 26,347,223,280,850
43427,2020-05-14,(02303) Calle 85,506,356,253,1115
43428,2020-09-28,(07104) Simon Bolivar,596,388,338,1322
43429,2020-06-02,(09113) Calle 22,406,239,327,972
43430,2020-01-05,(07008) NQS - Calle 30 Sur,307,123,299,729
43431,2020-10-02,(10007) Las Nieves,745,493,549,1787
43432,2020-04-25,(04100) Carrera 77,424,237,300,961
43433,2020-05-14,(09121) Las Flores,566,381,314,1261
43434,2020-05-09,(09110) Avenida Jimenez,471,361,369,1201
43435,2020-06-06,(12000) Puente Aranda,57,21,36,114
43436,2020-06-28,(12000) Puente Aranda,8,8,16,32
43437,2020-03-29,(07109) CAD,171,129,72,372
43438,2020-04-24,(07109) CAD,431,281,181,893
43439,2020-08-22,(07109) CAD,382,245,258,885
43440,2020-06-06,(10004) Policarpa,173,84,120,377
43441,2020-07-21,(09111) Calle 19,435,281,350,1066
43442,2020-04-11,(06000) Portal Eldorado,375,271,202,848
43443,2020-09-03,(04001) Quirigua,430,261,280,971
43444,2020-01-01,(09119) Calle 57,186,146,406,738
43445,2020-07-26,(10005) Bicentenario - alimentacion,41,35,50,126
43446,2020-01-02,(09003) Socorro,905,444,595,1944
43447,2020-01-01,(10004) Policarpa,92,50,139,281
43448,2020-08-04,(10004) Policarpa,218,108,146,472
43449,2020-04-04,(09118) Marly,774,533,318,1625
43450,2020-06-15,(08001) Parque el Tunal,143,75,93,311
43451,2020-09-10,(07008) NQS - Calle 30 Sur,324,164,193,681
43452,2020-06-28,(50003) Corral Molinos,525,225,417,1167
43453,2020-09-21,(40001) Juan Pablo II,517,265,347,1129
43454,2020-06-22,(02303) Calle 85,202,132,137,471
43455,2020-04-24,(07112) COMUNEROS,452,289,228,969
43456,2020-06-09,(06100) Av. Rojas,205,110,121,436
43457,2020-09-24,(04001) Quirigua,431,278,327,1036
43458,2020-04-05,(07109) CAD,175,123,67,365
43459,2020-07-20,(14004) Museo del Oro,17,15,37,69
43460,2020-03-14,(09108) Hospital,151,76,150,377
43461,2020-09-19,(07006) General Santander - alimentacion,309,169,283,761
43462,2020-06-05,(03012) SUBA - CALLE 95,331,199,171,701
43463,2020-08-11,(14004) Museo del Oro,323,173,229,725
43464,2020-02-22,(09111) Calle 19,1376,975,1268,3619
43465,2020-01-01,(05100) Banderas P. Central,231,120,373,724
43466,2020-07-31,(07506) DESPENSA,366,221,209,796
43467,2020-05-11,(03002) SUBA - TV- 91,584,346,314,1244
43468,2020-03-31,(12001) Carrera 43,220,163,118,501
43469,2020-03-21,(09113) Calle 22,115,80,83,278
43470,2020-04-02,(07506) DESPENSA,183,94,136,413
43471,2020-06-01,(05102) Av. Américas - Av. Boyacá,147,98,96,341
43472,2020-08-18,(05102) Av. Américas - Av. Boyacá,202,118,141,461
43473,2020-04-15,(09117) Calle 45,462,311,243,1016
43474,2020-07-15,(10008) San Diego,205,120,104,429
43475,2020-01-06,(07006) General Santander,479,236,389,1104
43476,2020-06-05,(06102) Salitre El Greco,193,113,116,422
43477,2020-05-10,(14001) La Sabana,26,31,28,85
43478,2020-08-21,(04103) Las Ferias,350,196,174,720
43479,2020-06-07,(07009) SENA,184,89,136,409
43480,2020-05-10,(07112) COMUNEROS,156,84,104,344
43481,2020-09-25,(07201) Guatoque -Veraguas,214,138,179,531
43482,2020-06-27,(09111) Calle 19,659,453,480,1592
43483,2020-10-11,(04108) El Polo,114,72,156,342
43484,2020-03-24,(07201) Guatoque -Veraguas,87,81,111,279
43485,2020-09-26,(06105) Quinta Paredes,116,67,112,295
43486,2020-04-16,(07008) NQS - Calle 30 Sur,146,82,81,309
43487,2020-04-13,(10003) Ciudad Jardín,107,68,80,255
43488,2020-09-13,(07003) SEVILLANA,122,68,135,325
43489,2020-04-05,(07113) SANTA ISABEL,59,46,35,140
43490,2020-09-14,(07108) Av. El Dorado,173,103,89,365
43491,2020-05-05,(06100) Av. Rojas,142,88,88,318
43492,2020-05-25,(04107) Escuela Militar,39,35,31,105
43493,2020-05-04,(09108) Hospital,65,35,54,154
43494,2020-03-28,(07106) EL CAMPIN,90,85,71,246
43495,2020-04-19,(04001) Quirigua,79,48,33,160
43496,2020-05-25,(04001) Quirigua,100,62,79,241
43497,2020-07-19,(09115) Calle 34,135,92,125,352
43498,2020-09-19,(08002) Biblioteca,252,128,192,572
43499,2020-03-23,(08002) Biblioteca,76,37,45,158
43500,2020-03-22,(09003) Socorro,95,47,35,177
43501,2020-05-22,(05101) Mandalay - Cr.73,92,45,55,192
43502,2020-09-12,(12000) Puente Aranda,53,38,51,142
43503,2020-05-17,(14004) Museo del Oro,0,10,32,42
43504,2019-12-31,(09116) Avenida 39,13,7,22,42
43505,2020-09-25,(03004) GRATAMIRA,0,22,41,63
43506,2020-10-09,(07005) ALQUERIA,672,360,557,1589
43507,2020-08-30,(09118) Marly,461,303,422,1186
43508,2020-03-09,(07504) TERREROS,382,5435,3247,9064
43509,2020-08-14,(07504) TERREROS,5985,3216,2926,12127
43510,2020-03-10,(03000) Portal Suba - alimentacion,1084,8387,5749,15220
43511,2020-03-24,(03000) Portal Suba - alimentacion,5535,2964,3387,11886
43512,2020-02-12,(07503) SAN MATEO,42513,24011,17785,84309
43513,2020-09-11,(09003) Socorro,604,293,335,1232
43514,2020-09-20,(04002) Carrera 90,282,121,287,690
43515,2020-07-24,(10000) Portal 20 de Julio - alimentacion,3119,1421,1896,6436
43516,2020-03-20,(05000) Portal Américas - alimentacion,5947,2758,2049,10754
43517,2020-03-23,(04000) Cabecera Calle 80 - alimentacion,704,415,424,1543
43518,2020-02-08,(05000) Portal Américas,9294,4304,6221,19819
43519,2020-03-12,(05000) Portal Américas,284,3491,2557,6332
43520,2020-01-27,(14004) Museo del Oro,3784,2324,1804,7912
43521,2020-03-11,(07112) COMUNEROS,3513,2122,2334,7969
43522,2020-01-22,(05100) Banderas P. Central,6940,4089,3620,14649
43523,2020-07-28,(09000) Cabecera Usme,1530,968,1113,3611
43524,2020-02-11,(40001) Juan Pablo II,1714,1026,1019,3759
43525,2020-01-04,(05100) Banderas P. Central - alimentacion,4664,2009,2943,9616
43526,2020-01-23,(05100) Banderas P. Central - alimentacion,13761,7683,7734,29178
43527,2020-01-22,(09118) Marly,5905,3976,3550,13431
43528,2020-06-14,(10000) Portal 20 de Julio - alimentacion,1369,546,856,2771
43529,2020-03-19,(10005) Bicentenario - alimentacion,461,202,363,1026
43530,2020-10-03,(40003) Mirador del Paraiso,1619,835,1336,3790
43531,2020-02-10,(09104) Restrepo,5422,3276,4143,12841
43532,2020-09-01,(04101) Minuto de Dios,332,185,245,762
43533,2020-01-30,(04100) Carrera 77,6526,3793,3974,14293
43534,2020-02-01,(07505) LEON XIII,5847,2838,3152,11837
43535,2020-01-27,(07111) NQS - RICAURTE,3048,1908,1675,6631
43536,2020-09-15,(04100) Carrera 77,1325,754,988,3067
43537,2020-09-30,(07102) NQS - CALLE 75,464,320,354,1138
43538,2020-08-13,(07000) Portal Sur - alimentacion,7565,4248,3894,15707
43539,2020-02-26,(07110) PALOQUEMAO,2749,1703,1220,5672
43540,2020-03-03,(03001) LA CAMPIÑA,6684,4143,4284,15111
43541,2020-03-05,(03001) LA CAMPIÑA,6501,3922,4132,14555
43542,2020-05-22,(07000) Portal Sur - alimentacion,6641,3666,2925,13232
43543,2020-06-02,(07000) Portal Sur - alimentacion,7137,4050,3231,14418
43544,2020-08-11,(09103) Olaya,985,574,567,2126
43545,2020-08-24,(14001) La Sabana,139,90,115,344
43546,2020-09-05,(07000) Portal Sur - alimentacion,7226,3598,4674,15498
43547,2020-06-23,(07002) MADELENA,894,507,537,1938
43548,2020-03-01,(07112) COMUNEROS,891,458,911,2260
43549,2020-08-29,(07112) COMUNEROS,685,392,425,1502
43550,2020-07-15,(05000) Portal Américas,2479,1617,1567,5663
43551,2020-01-03,(02000) Cabecera Autopista Norte - intermunicipal,1984,1250,1448,4682
43552,2020-09-20,(10006) San Victorino,207,143,181,531
43553,2020-05-30,(06000) Portal Eldorado,631,425,406,1462
43554,2020-09-04,(40003) Mirador del Paraiso,1839,1119,1197,4155
43555,2020-01-09,(12001) Carrera 43,1130,711,825,2666
43556,2020-05-26,(09107) Hortúa,570,354,314,1238
43557,2020-09-08,(06105) Quinta Paredes,145,96,113,354
43558,2020-07-24,(03000) Portal Suba,1101,653,679,2433
43559,2020-07-30,(03000) Portal Suba,1264,744,879,2887
43560,2020-06-08,(02000) Cabecera Autopista Norte - intermunicipal,527,356,342,1225
43561,2020-01-22,(09101) Quiroga,1482,895,1201,3578
43562,2020-01-20,(06111) Universidades,4623,2885,2385,9893
43563,2020-04-13,(07112) COMUNEROS,402,274,255,931
43564,2020-08-04,(02303) Calle 85,651,443,341,1435
43565,2020-02-28,(07004) VENECIA,4732,2603,2418,9753
43566,2020-04-29,(08001) Parque el Tunal,279,149,164,592
43567,2020-02-28,(05102) Av. Américas - Av. Boyacá,1984,1064,1049,4097
43568,2020-02-01,(02302) Virrey,1311,991,1291,3593
43569,2020-03-07,(09123) Calle 76,2291,1806,2311,6408
43570,2020-01-31,(06103) CAN,2500,1464,1191,5155
43571,2020-01-01,(09100) Calle 40 Sur,622,312,864,1798
43572,2020-09-03,(02201) Prado,954,642,623,2219
43573,2020-06-23,(05100) Banderas P. Central,819,522,546,1887
43574,2020-02-28,(03012) SUBA - CALLE 95,1379,927,1042,3348
43575,2020-09-08,(03012) SUBA - CALLE 95,354,213,223,790
43576,2020-02-21,(50002) Corral Calle 40 Sur,126,72,135,333
43577,2020-06-09,(04106) Carrera 47,319,179,163,661
43578,2020-01-04,(05100) Banderas P. Central,1473,606,1162,3241
43579,2020-07-07,(05005) Transversal 86,0,203,514,717
43580,2020-08-05,(02000) Cabecera Autopista Norte,1117,677,653,2447
43581,2020-05-04,(08000) Portal Tunal,488,226,202,916
43582,2020-01-22,(09106) Nariño,1847,1120,1270,4237
43583,2020-09-26,(03009) Av. Suba- Calle 116,345,219,326,890
43584,2020-09-06,(05000) Portal Américas - alimentacion,3913,1651,2622,8186
43585,2020-07-27,(06000) Portal Eldorado - alimentacion,3299,1820,1808,6927
43586,2020-01-18,(04000) Cabecera Calle 80,3320,1624,3055,7999
43587,2020-01-31,(10008) San Diego,1309,766,839,2914
43588,2020-03-07,(12007) Zona Industrial,673,488,506,1667
43589,2020-05-24,(07505) LEON XIII,562,321,309,1192
43590,2020-01-19,(06111) Universidades,468,288,733,1489
43591,2020-07-30,(03001) LA CAMPIÑA,1163,632,665,2460
43592,2020-09-01,(02101) Toberín,1410,943,964,3317
43593,2020-05-30,(09103) Olaya,667,356,389,1412
43594,2020-02-22,(09115) Calle 34,1458,1109,1648,4215
43595,2020-01-15,(06101) El Tiempo,2333,1274,1264,4871
43596,2020-03-19,(06101) El Tiempo,947,563,527,2037
43597,2020-03-20,(05100) Banderas P. Central - alimentacion,1535,693,610,2838
43598,2020-09-06,(07104) Simon Bolivar,123,93,159,375
43599,2020-09-23,(04107) Escuela Militar,179,125,126,430
43600,2020-02-05,(02105) Calle 142,7458,4572,3927,15957
43601,2020-08-12,(04002) Carrera 90,597,342,336,1275
43602,2020-07-11,(07004) VENECIA,894,479,527,1900
43603,2020-03-03,(09101) Quiroga,1645,1035,1244,3924
43604,2020-06-02,(09121) Las Flores,656,464,360,1480
43605,2020-07-12,(08000) Portal Tunal - alimentacion,2584,1135,1594,5313
43606,2020-04-13,(05002) Tintal,1320,721,639,2680
43607,2020-04-10,(02000) Cabecera Autopista Norte,175,130,89,394
43608,2020-07-12,(06100) Av. Rojas,45,41,50,136
43609,2020-04-11,(05100) Banderas P. Central,158,83,107,348
43610,2020-04-03,(03009) Av. Suba- Calle 116,312,210,178,700
43611,2020-01-24,(08002) Biblioteca,859,479,631,1969
43612,2020-01-02,(03013) RIO NEGRO,539,335,470,1344
43613,2020-03-23,(05102) Av. Américas - Av. Boyacá,74,53,33,160
43614,2020-06-21,(10010) San Bernardo,239,118,172,529
43615,2020-01-04,(07103) AV. CHILE,1089,715,834,2638
43616,2020-01-11,(07103) AV. CHILE,1653,1053,1276,3982
43617,2020-10-07,(06109) Centro Memoria,281,192,210,683
43618,2020-08-14,(09106) Nariño,389,223,324,936
43619,2020-10-12,(07006) General Santander - alimentacion,102,65,143,310
43620,2020-07-21,(04105) Carrera 53,264,131,135,530
43621,2020-07-16,(06002) Normandía,258,153,140,551
43622,2020-05-07,(07003) SEVILLANA,313,178,137,628
43623,2020-04-11,(05100) Banderas P. Central - alimentacion,789,390,319,1498
43624,2020-02-22,(10005) Bicentenario,221,162,263,646
43625,2020-09-03,(03011) SUBA - CALLE 100,600,281,303,1184
43626,2020-07-31,(08000) Portal Tunal,728,280,268,1276
43627,2020-03-07,(05102) Av. Américas - Av. Boyacá,823,412,711,1946
43628,2020-10-04,(10010) San Bernardo,257,111,297,665
43629,2020-03-06,(10004) Policarpa,903,437,577,1917
43630,2020-02-03,(04102) Avenida Boyaca,2997,1843,1605,6445
43631,2020-04-07,(09004) Santa Lucía,1079,555,597,2231
43632,2020-09-01,(02204) Pepe Sierra,809,611,420,1840
43633,2020-02-15,(14004) Museo del Oro,819,781,1246,2846
43634,2020-10-05,(07110) PALOQUEMAO,723,440,411,1574
43635,2020-01-26,(12004) Carrera 22,107,95,165,367
43636,2020-10-09,(09106) Nariño,541,258,476,1275
43637,2020-01-12,(05005) Transversal 86,454,154,363,971
43638,2020-03-07,(50002) Corral Calle 40 Sur,53,33,104,190
43639,2020-04-29,(02302) Virrey,401,267,220,888
43640,2020-05-18,(07201) Guatoque -Veraguas,143,95,105,343
43641,2020-08-12,(07201) Guatoque -Veraguas,210,106,117,433
43642,2020-04-11,(03000) Portal Suba,291,181,232,704
43643,2020-05-10,(03000) Portal Suba,205,140,160,505
43644,2020-01-23,(07102) NQS - CALLE 75,1429,916,963,3308
43645,2020-05-31,(05001) Patio Bonito,497,235,302,1034
43646,2020-09-02,(40001) Juan Pablo II,599,374,405,1378
43647,2020-04-09,(06000) Portal Eldorado,282,198,118,598
43648,2020-09-09,(06102) Salitre El Greco,280,149,150,579
43649,2020-04-26,(08000) Portal Tunal,154,107,91,352
43650,2020-05-05,(04104) Avenida 68,426,243,232,901
43651,2020-06-04,(07007) NQS - Calle 38A Sur,344,192,213,749
43652,2020-09-20,(14005) Las Aguas,65,52,143,260
43653,2020-05-16,(07109) CAD,344,237,170,751
43654,2020-06-24,(03005) SUBA - AV. BOYACA,460,286,260,1006
43655,2020-05-26,(12004) Carrera 22,212,105,123,440
43656,2020-06-17,(12004) Carrera 22,245,139,128,512
43657,2020-06-27,(06001) Modelia,258,199,206,663
43658,2020-04-30,(06111) Universidades,0,101,256,357
43659,2020-08-06,(05101) Mandalay - Cr.73,123,68,57,248
43660,2020-05-29,(07008) NQS - Calle 30 Sur,263,132,140,535
43661,2020-05-29,(12002) CDS - Carrera 32,198,136,67,401
43662,2020-09-15,(12002) CDS - Carrera 32,216,131,91,438
43663,2020-09-11,(07006) General Santander,556,303,348,1207
43664,2020-07-21,(07108) Av. El Dorado,147,95,76,318
43665,2020-02-02,(03005) SUBA - AV. BOYACA,431,249,523,1203
43666,2020-05-04,(06001) Modelia,298,204,161,663
43667,2020-07-22,(07006) General Santander - alimentacion,297,161,210,668
43668,2020-06-03,(07101) CASTELLANA,166,112,102,380
43669,2020-03-20,(03009) Av. Suba- Calle 116,438,279,192,909
43670,2020-06-28,(03001) LA CAMPIÑA,294,149,218,661
43671,2020-09-13,(09003) Socorro,203,105,153,461
43672,2020-05-07,(06105) Quinta Paredes,88,57,46,191
43673,2020-07-18,(07005) ALQUERIA,361,193,240,794
43674,2020-03-15,(04105) Carrera 53,271,147,276,694
43675,2020-04-10,(04104) Avenida 68,98,72,67,237
43676,2020-05-24,(12001) Carrera 43,59,44,47,150
43677,2020-03-25,(07506) DESPENSA,262,101,129,492
43678,2020-06-27,(07506) DESPENSA,400,212,226,838
43679,2020-07-05,(04000) Cabecera Calle 80,274,178,290,742
43680,2020-05-02,(02104) Calle 146,319,224,194,737
43681,2020-07-05,(14004) Museo del Oro,21,14,53,88
43682,2020-03-23,(06002) Normandía,78,48,46,172
43683,2020-06-25,(06101) El Tiempo,370,231,199,800
43684,2020-04-10,(04000) Cabecera Calle 80,146,102,76,324
43685,2020-01-06,(09110) Avenida Jimenez,517,425,704,1646
43686,2020-06-13,(12004) Carrera 22,160,107,96,363
43687,2020-02-10,(03014) SAN MARTIN,278,161,161,600
43688,2020-06-02,(07506) DESPENSA,455,240,234,929
43689,2020-04-09,(09110) Avenida Jimenez,119,112,121,352
43690,2020-01-05,(05102) Av. Américas - Av. Boyacá,170,80,183,433
43691,2020-03-20,(03003) 21 ANGELES,155,77,70,302
43692,2020-04-25,(08002) Biblioteca,119,81,62,262
43693,2020-05-17,(03004) GRATAMIRA,12,9,6,27
43694,2020-04-08,(06104) Gobernación,130,107,76,313
43695,2020-03-02,(50006) Corral Carrera 77,31,17,40,88
43696,2020-04-08,(09101) Quiroga,166,115,152,433
43697,2020-10-04,(06103) CAN,130,93,125,348
43698,2020-05-29,(06107) Ciudad Universitaria,156,96,118,370
43699,2020-07-31,(04102) Avenida Boyaca,258,148,213,619
43700,2020-01-19,(07201) Guatoque -Veraguas,95,84,283,462
43701,2020-03-30,(06103) CAN,341,277,169,787
43702,2020-04-05,(06001) Modelia,78,63,55,196
43703,2020-08-17,(07109) CAD,185,134,113,432
43704,2020-03-31,(10003) Ciudad Jardín,83,65,51,199
43705,2020-09-06,(07200) Tygua-San José,82,59,92,233
43706,2020-08-28,(10005) Bicentenario - alimentacion,226,100,211,537
43707,2020-09-20,(07105) MOVISTAR ARENA,63,42,87,192
43708,2020-07-07,(03014) SAN MARTIN,27,14,14,55
43709,2020-06-15,(07106) EL CAMPIN,130,93,93,316
43710,2020-03-28,(03014) SAN MARTIN,14,7,7,28
43711,2020-01-03,(12000) Puente Aranda,128,86,123,337
43712,2020-09-24,(12000) Puente Aranda,97,58,59,214
43713,2020-01-14,(50006) Corral Carrera 77,27,15,43,85
43714,2020-04-27,(50006) Corral Carrera 77,1,1,3,5
43715,2020-10-13,(08000) Portal Tunal - alimentacion,2,0,0,2
43716,2020-01-12,(04000) Cabecera Calle 80 - alimentacion,4277,1859,4379,10515
43717,2020-06-02,(04000) Cabecera Calle 80 - alimentacion,3579,2101,2097,7777
43718,2020-02-28,(02502) Terminal,5205,3161,3130,11496
43719,2020-05-19,(07504) TERREROS,4348,2654,1983,8985
43720,2020-01-09,(10000) Portal 20 de Julio - alimentacion,9042,4288,6182,19512
43721,2020-01-12,(07111) NQS - RICAURTE,438,382,570,1390
43722,2020-01-18,(08000) Portal Tunal - alimentacion,15226,7091,8840,31157
43723,2020-03-12,(03000) Portal Suba - alimentacion,948,6928,4703,12579
43724,2020-02-18,(02101) Toberín,15517,9937,7671,33125
43725,2020-03-06,(02101) Toberín,14449,8319,7766,30534
43726,2020-03-04,(09122) Calle 72,8288,5518,4405,18211
43727,2020-05-19,(07503) SAN MATEO,8607,5323,3941,17871
43728,2020-02-22,(06107) Ciudad Universitaria,652,435,660,1747
43729,2020-09-24,(06107) Ciudad Universitaria,201,115,147,463
43730,2020-01-28,(05000) Portal Américas,14443,8234,7496,30173
43731,2020-01-07,(07000) Portal Sur - alimentacion,20288,11295,11267,42850
43732,2020-02-20,(14004) Museo del Oro,3894,2487,1896,8277
43733,2020-07-31,(05100) Banderas P. Central,627,353,463,1443
43734,2020-09-23,(10001) Country Sur,1482,653,962,3097
43735,2020-02-27,(09000) Cabecera Usme,6003,3519,3857,13379
43736,2020-03-04,(06102) Salitre El Greco,1578,886,708,3172
43737,2020-08-08,(07001) PERDOMO,567,298,410,1275
43738,2020-01-09,(09120) Calle 63,3210,2325,2478,8013
43739,2020-02-11,(05107) Américas - Cr.53,2762,1531,1449,5742
43740,2020-01-20,(04101) Minuto de Dios,2281,1396,1578,5255
43741,2020-03-11,(04100) Carrera 77,6462,3784,3691,13937
43742,2020-04-09,(04100) Carrera 77,229,134,147,510
43743,2020-07-17,(03000) Portal Suba - alimentacion,5788,3263,3140,12191
43744,2020-02-18,(04104) Avenida 68,3873,2071,1907,7851
43745,2020-02-27,(02000) Cabecera Autopista Norte - alimentacion,23991,13994,13453,51438
43746,2020-03-15,(09123) Calle 76,454,415,620,1489
43747,2020-03-04,(07102) NQS - CALLE 75,1527,994,930,3451
43748,2020-02-14,(03013) RIO NEGRO,1259,837,920,3016
43749,2020-06-18,(03013) RIO NEGRO,280,181,171,632
43750,2020-08-19,(09000) Cabecera Usme - alimentacion,7983,4228,4649,16860
43751,2020-06-13,(07000) Portal Sur - alimentacion,6278,3235,3069,12582
43752,2020-03-04,(03001) LA CAMPIÑA,6636,4037,4207,14880
43753,2020-07-10,(05100) Banderas P. Central - alimentacion,3334,1727,1858,6919
43754,2020-08-10,(05100) Banderas P. Central - alimentacion,2998,1634,1633,6265
43755,2020-08-17,(09103) Olaya,392,192,237,821
43756,2020-06-17,(14001) La Sabana,163,107,94,364
43757,2020-07-02,(08000) Portal Tunal - alimentacion,6625,3777,3643,14045
43758,2020-03-19,(07112) COMUNEROS,1894,1141,1072,4107
43759,2020-03-17,(02000) Cabecera Autopista Norte,5162,3208,2923,11293
43760,2020-07-04,(02000) Cabecera Autopista Norte,1068,632,760,2460
43761,2020-07-19,(09113) Calle 22,181,95,150,426
43762,2020-02-11,(10002) Av. Primero de Mayo,8742,4554,4659,17955
43763,2020-07-20,(05000) Portal Américas,665,406,546,1617
43764,2020-08-29,(05000) Portal Américas,2420,1257,1910,5587
43765,2020-01-24,(04000) Cabecera Calle 80,6893,3829,4686,15408
43766,2020-08-25,(07010) Bosa,635,293,395,1323
43767,2020-05-14,(03002) SUBA - TV- 91,547,339,300,1186
43768,2020-10-10,(10001) Country Sur,1081,452,946,2479
43769,2020-01-12,(06109) Centro Memoria,177,124,234,535
43770,2020-02-10,(10008) San Diego,1600,812,769,3181
43771,2020-02-23,(09000) Cabecera Usme - alimentacion,6021,2682,4834,13537
43772,2020-07-09,(12001) Carrera 43,458,255,214,927
43773,2020-02-04,(10005) Bicentenario - alimentacion,742,336,519,1597
43774,2020-03-03,(02205) Calle 106,2705,1708,1331,5744
43775,2020-02-09,(09101) Quiroga,385,217,507,1109
43776,2020-06-27,(09101) Quiroga,476,221,355,1052
43777,2020-03-02,(10010) San Bernardo,1740,1046,1265,4051
43778,2020-02-07,(10000) Portal 20 de Julio,9214,4160,4235,17609
43779,2020-03-14,(08002) Biblioteca,567,301,438,1306
43780,2020-02-21,(07004) VENECIA,4584,2567,2393,9544
43781,2020-01-19,(09004) Santa Lucía,2163,775,1790,4728
43782,2020-06-01,(09004) Santa Lucía,2436,1238,1267,4941
43783,2020-07-12,(09004) Santa Lucía,1070,458,692,2220
43784,2020-01-10,(07108) Av. El Dorado,567,380,473,1420
43785,2020-08-09,(07503) SAN MATEO,2864,1498,1566,5928
43786,2020-01-21,(08001) Parque el Tunal,1310,613,675,2598
43787,2020-07-16,(06108) Concejo de Bogotá,115,63,83,261
43788,2020-01-07,(07001) PERDOMO,3114,1902,2059,7075
43789,2020-07-02,(05000) Portal Américas,2631,1834,1962,6427
43790,2020-06-05,(05002) Tintal,1836,1032,1088,3956
43791,2020-10-10,(05000) Portal Américas,2864,1317,2367,6548
43792,2020-03-01,(03007) HUMEDAL CORDOBA,176,93,157,426
43793,2020-06-06,(05100) Banderas P. Central - alimentacion,1452,764,1044,3260
43794,2020-06-18,(02300) Calle 100,1327,846,690,2863
43795,2020-08-16,(02300) Calle 100,223,202,217,642
43796,2020-01-10,(03012) SUBA - CALLE 95,1030,668,777,2475
43797,2020-02-22,(05107) Américas - Cr.53,1318,816,1028,3162
43798,2020-02-14,(07006) General Santander,2913,1610,1640,6163
43799,2020-01-26,(10010) San Bernardo,418,249,532,1199
43800,2020-06-04,(08000) Portal Tunal,696,297,264,1257
43801,2020-06-30,(07104) Simon Bolivar,615,387,308,1310
43802,2020-07-19,(05005) Transversal 86,62,40,66,168
43803,2020-05-15,(06109) Centro Memoria,237,124,137,498
43804,2020-06-30,(06109) Centro Memoria,279,150,136,565
43805,2020-02-28,(10007) Las Nieves,2021,1291,1278,4590
43806,2020-07-18,(05107) Américas - Cr.53,277,160,191,628
43807,2020-06-03,(02205) Calle 106,296,190,178,664
43808,2020-01-24,(03006) NIZA - CALLE 127,2238,1382,1471,5091
43809,2020-08-01,(04003) Avenida Ciudad de Cali,578,304,460,1342
43810,2020-01-25,(04108) El Polo,958,635,841,2434
43811,2020-02-18,(04108) El Polo,1965,1257,1162,4384
43812,2020-09-04,(04108) El Polo,538,324,276,1138
43813,2020-01-16,(12007) Zona Industrial,1149,751,643,2543
43814,2020-01-23,(07101) CASTELLANA,933,566,559,2058
43815,2020-02-25,(07103) AV. CHILE,3832,2353,1876,8061
43816,2020-06-16,(07103) AV. CHILE,949,582,480,2011
43817,2020-06-17,(07103) AV. CHILE,969,590,454,2013
43818,2020-03-17,(03003) 21 ANGELES,977,444,479,1900
43819,2020-09-29,(03007) HUMEDAL CORDOBA,172,119,109,400
43820,2020-05-05,(10006) San Victorino,241,178,212,631
43821,2020-04-23,(02101) Toberín,650,467,433,1550
43822,2020-10-11,(09103) Olaya,421,171,423,1015
43823,2020-07-24,(07104) Simon Bolivar,528,323,247,1098
43824,2020-05-11,(09001) Molinos,1805,1014,1114,3933
43825,2020-06-12,(06105) Quinta Paredes,131,95,69,295
43826,2020-10-02,(10009) Museo Nacional,600,392,523,1515
43827,2020-08-12,(09117) Calle 45,677,404,423,1504
43828,2020-08-25,(09117) Calle 45,600,372,385,1357
43829,2020-09-21,(09117) Calle 45,548,386,424,1358
43830,2020-07-27,(02104) Calle 146,667,470,422,1559
43831,2020-09-22,(02104) Calle 146,1029,637,796,2462
43832,2020-02-15,(09111) Calle 19,1478,942,1320,3740
43833,2020-03-07,(04001) Quirigua,1144,560,904,2608
43834,2020-05-05,(03011) SUBA - CALLE 100,310,172,147,629
43835,2020-07-08,(04001) Quirigua,438,268,279,985
43836,2020-09-29,(06002) Normandía,375,252,303,930
43837,2020-06-21,(09001) Molinos,760,351,552,1663
43838,2020-07-12,(02205) Calle 106,65,67,67,199
43839,2020-09-24,(02304) Heroes,941,674,618,2233
43840,2020-09-29,(02304) Heroes,1008,715,666,2389
43841,2020-05-02,(03001) LA CAMPIÑA,400,220,222,842
43842,2020-04-05,(09002) Consuelo,87,45,41,173
43843,2020-02-09,(09119) Calle 57,676,383,808,1867
43844,2020-05-24,(07113) SANTA ISABEL,81,44,69,194
43845,2020-07-31,(04108) El Polo,338,207,184,729
43846,2020-08-03,(02302) Virrey,552,403,308,1263
43847,2020-04-30,(12003) Ricaurte,226,156,97,479
43848,2020-07-02,(10010) San Bernardo,670,357,475,1502
43849,2020-05-05,(03009) Av. Suba- Calle 116,354,245,170,769
43850,2020-05-28,(03009) Av. Suba- Calle 116,441,288,199,928
43851,2020-03-22,(07106) EL CAMPIN,56,47,33,136
43852,2020-04-14,(04100) Carrera 77,646,386,431,1463
43853,2020-04-11,(09116) Avenida 39,103,72,76,251
43854,2020-02-12,(10005) Bicentenario,831,439,400,1670
43855,2020-09-22,(07007) NQS - Calle 38A Sur,462,288,368,1118
43856,2020-06-05,(05107) Américas - Cr.53,423,267,245,935
43857,2020-06-19,(07103) AV. CHILE,949,587,484,2020
43858,2020-09-28,(12007) Zona Industrial,409,250,221,880
43859,2020-02-03,(10005) Bicentenario,862,447,370,1679
43860,2020-10-10,(10005) Bicentenario,72,73,118,263
43861,2020-04-30,(40002) Manitas,215,112,139,466
43862,2020-08-22,(02304) Heroes,445,325,331,1101
43863,2020-02-20,(07003) SEVILLANA,2106,1189,1087,4382
43864,2020-05-30,(05100) Banderas P. Central - alimentacion,1866,817,965,3648
43865,2020-05-17,(10000) Portal 20 de Julio,590,274,310,1174
43866,2020-05-29,(02300) Calle 100,1182,727,546,2455
43867,2020-06-07,(02102) Calle 161,57,45,72,174
43868,2020-03-08,(04000) Cabecera Calle 80,1164,615,1528,3307
43869,2020-06-07,(09118) Marly,471,312,290,1073
43870,2020-07-27,(10008) San Diego,267,149,182,598
43871,2020-03-13,(14001) La Sabana,310,22,57,389
43872,2020-05-29,(08002) Biblioteca,271,152,176,599
43873,2020-01-12,(02103) Mazurén,269,137,381,787
43874,2020-10-01,(09120) Calle 63,1289,894,1023,3206
43875,2020-07-17,(03011) SUBA - CALLE 100,534,215,193,942
43876,2020-06-28,(10010) San Bernardo,248,113,192,553
43877,2020-02-02,(02303) Calle 85,465,376,640,1481
43878,2020-06-23,(07111) NQS - RICAURTE,1168,721,462,2351
43879,2020-03-09,(12001) Carrera 43,343,354,267,964
43880,2020-07-27,(03006) NIZA - CALLE 127,459,258,223,940
43881,2020-07-05,(07110) PALOQUEMAO,151,120,106,377
43882,2020-10-06,(10003) Ciudad Jardín,262,128,270,660
43883,2020-04-17,(12004) Carrera 22,75,63,67,205
43884,2020-03-01,(05102) Av. Américas - Av. Boyacá,207,114,240,561
43885,2020-07-26,(10000) Portal 20 de Julio - alimentacion,1160,481,719,2360
43886,2020-01-19,(08001) Parque el Tunal,377,159,342,878
43887,2020-04-14,(10000) Portal 20 de Julio,1200,679,556,2435
43888,2020-06-26,(06109) Centro Memoria,277,176,157,610
43889,2020-03-24,(07001) PERDOMO,778,429,541,1748
43890,2020-04-08,(03002) SUBA - TV- 91,423,260,222,905
43891,2020-10-09,(02200) Alcalá,2226,1366,1540,5132
43892,2020-08-06,(05103) Marsella,384,196,208,788
43893,2020-04-14,(07105) MOVISTAR ARENA,143,118,82,343
43894,2020-07-20,(07105) MOVISTAR ARENA,61,49,47,157
43895,2020-07-15,(09121) Las Flores,559,347,332,1238
43896,2020-08-07,(06109) Centro Memoria,82,55,71,208
43897,2020-05-22,(09113) Calle 22,393,228,330,951
43898,2020-08-23,(04100) Carrera 77,326,171,316,813
43899,2020-05-23,(10006) San Victorino,238,171,215,624
43900,2020-05-04,(02104) Calle 146,469,352,291,1112
43901,2020-04-06,(09119) Calle 57,229,177,189,595
43902,2020-08-16,(06102) Salitre El Greco,55,37,60,152
43903,2020-04-04,(04100) Carrera 77,380,234,228,842
43904,2020-04-08,(09110) Avenida Jimenez,256,222,294,772
43905,2020-02-23,(02205) Calle 106,187,226,390,803
43906,2020-07-16,(02102) Calle 161,213,139,137,489
43907,2020-09-26,(06001) Modelia,237,181,270,688
43908,2020-10-03,(10009) Museo Nacional,254,261,530,1045
43909,2020-09-25,(04103) Las Ferias,413,203,258,874
43910,2020-06-28,(08001) Parque el Tunal,140,78,88,306
43911,2020-09-28,(07200) Tygua-San José,277,147,202,626
43912,2020-01-08,(09105) Río Fucha,497,279,431,1207
43913,2020-10-12,(40003) Mirador del Paraiso,737,350,648,1735
43914,2020-05-21,(10010) San Bernardo,517,288,296,1101
43915,2020-09-06,(05100) Banderas P. Central,237,118,268,623
43916,2020-03-28,(09110) Avenida Jimenez,148,133,176,457
43917,2020-08-13,(12002) CDS - Carrera 32,178,98,74,350
43918,2020-08-06,(07006) General Santander,485,293,283,1061
43919,2020-07-21,(06002) Normandía,257,172,151,580
43920,2020-03-30,(04101) Minuto de Dios,150,121,105,376
43921,2020-08-26,(07008) NQS - Calle 30 Sur,294,153,209,656
43922,2020-05-19,(04102) Avenida Boyaca,233,149,161,543
43923,2020-10-12,(04000) Cabecera Calle 80 - intermunicipal,94,37,109,240
43924,2020-06-27,(05107) Américas - Cr.53,335,220,245,800
43925,2020-06-02,(09108) Hospital,65,43,47,155
43926,2020-07-30,(09108) Hospital,66,47,64,177
43927,2020-08-27,(09108) Hospital,51,48,85,184
43928,2020-06-02,(06101) El Tiempo,300,174,169,643
43929,2020-04-23,(02103) Mazurén,105,70,62,237
43930,2020-05-10,(03012) SUBA - CALLE 95,58,39,44,141
43931,2020-03-27,(02502) Terminal,102,83,142,327
43932,2020-04-04,(02502) Terminal,100,75,89,264
43933,2020-02-09,(12003) Ricaurte,155,110,216,481
43934,2020-08-24,(03004) GRATAMIRA,0,15,22,37
43935,2020-09-19,(09111) Calle 19,654,421,556,1631
43936,2020-05-26,(07006) General Santander,442,288,221,951
43937,2020-05-16,(02204) Pepe Sierra,458,353,230,1041
43938,2020-09-13,(03009) Av. Suba- Calle 116,152,112,130,394
43939,2020-07-11,(07200) Tygua-San José,222,118,180,520
43940,2020-08-02,(05105) Pradera,104,88,134,326
43941,2020-04-19,(07000) Portal Sur,265,166,198,629
43942,2020-04-02,(07112) COMUNEROS,375,266,248,889
43943,2020-07-15,(09110) Avenida Jimenez,508,412,532,1452
43944,2020-06-13,(07006) General Santander - alimentacion,280,160,187,627
43945,2020-08-12,(04106) Carrera 47,255,138,153,546
43946,2020-08-24,(07006) General Santander - alimentacion,377,194,226,797
43947,2020-06-20,(07007) NQS - Calle 38A Sur,357,200,222,779
43948,2020-07-29,(12007) Zona Industrial,250,145,119,514
43949,2020-08-16,(09120) Calle 63,270,183,260,713
43950,2020-10-11,(07109) CAD,184,136,181,501
43951,2020-05-13,(10004) Policarpa,195,105,136,436
43952,2020-06-03,(10004) Policarpa,199,105,123,427
43953,2020-06-29,(02303) Calle 85,175,155,145,475
43954,2020-04-28,(06111) Universidades,0,94,248,342
43955,2020-06-12,(06108) Concejo de Bogotá,135,71,83,289
43956,2020-10-06,(07201) Guatoque -Veraguas,250,136,208,594
43957,2020-07-31,(07007) NQS - Calle 38A Sur,288,168,241,697
43958,2020-06-28,(03006) NIZA - CALLE 127,181,112,87,380
43959,2020-07-10,(03005) SUBA - AV. BOYACA,488,274,283,1045
43960,2020-05-02,(09105) Río Fucha,56,29,50,135
43961,2020-09-16,(03005) SUBA - AV. BOYACA,538,296,333,1167
43962,2020-04-19,(09116) Avenida 39,92,54,46,192
43963,2020-08-22,(03004) GRATAMIRA,0,13,26,39
43964,2020-05-05,(07007) NQS - Calle 38A Sur,218,137,160,515
43965,2020-07-12,(07002) MADELENA,282,130,221,633
43966,2020-05-12,(14005) Las Aguas,0,53,133,186
43967,2020-06-29,(14001) La Sabana,63,37,48,148
43968,2020-08-22,(05102) Av. Américas - Av. Boyacá,150,81,125,356
43969,2020-04-24,(04000) Cabecera Calle 80 - intermunicipal,130,68,115,313
43970,2020-08-30,(09106) Nariño,157,76,173,406
43971,2020-03-22,(10005) Bicentenario,20,15,12,47
43972,2020-06-28,(12007) Zona Industrial,57,53,56,166
43973,2020-07-25,(02103) Mazurén,113,64,90,267
43974,2020-05-02,(07003) SEVILLANA,190,95,105,390
43975,2020-06-15,(04103) Las Ferias,139,67,73,279
43976,2020-09-21,(10005) Bicentenario,37,52,82,171
43977,2020-08-23,(09109) Tercer Milenio,85,48,114,247
43978,2020-05-03,(02204) Pepe Sierra,158,145,86,389
43979,2020-06-28,(07006) General Santander,174,79,117,370
43980,2020-05-22,(07101) CASTELLANA,159,105,102,366
43981,2020-04-05,(05102) Av. Américas - Av. Boyacá,56,36,11,103
43982,2020-05-02,(06106) Recinto Ferial,124,79,59,262
43983,2020-02-21,(50006) Corral Carrera 77,35,21,40,96
43984,2020-04-03,(03014) SAN MARTIN,15,10,18,43
43985,2020-04-21,(50006) Corral Carrera 77,5,1,6,12
43986,2020-09-21,(03004) GRATAMIRA,0,12,36,48
43987,2020-05-17,(03014) SAN MARTIN,12,6,8,26
43988,2020-03-26,(09118) Marly,1073,765,471,2309
43989,2020-03-18,(07504) TERREROS,11631,6414,5454,23499
43990,2020-08-18,(07504) TERREROS,5737,3096,2757,11590
43991,2020-08-27,(07504) TERREROS,5949,3306,2778,12033
43992,2020-02-11,(05000) Portal Américas - alimentacion,38876,22628,21311,82815
43993,2020-02-22,(08000) Portal Tunal - alimentacion,16420,7890,9257,33567
43994,2020-03-09,(03000) Portal Suba - alimentacion,973,7907,5265,14145
43995,2020-05-05,(05000) Portal Américas,1599,1100,1198,3897
43996,2020-02-22,(09100) Calle 40 Sur,4410,2263,3269,9942
43997,2020-02-19,(06104) Gobernación,1527,864,635,3026
43998,2020-06-20,(09000) Cabecera Usme - alimentacion,7065,3738,4328,15131
43999,2020-01-17,(07000) Portal Sur - alimentacion,25852,14197,13515,53564
44000,2020-09-22,(08000) Portal Tunal - alimentacion,6684,3705,4315,14704
44001,2020-07-01,(09000) Cabecera Usme - alimentacion,9033,4949,5486,19468
44002,2020-01-30,(10004) Policarpa,820,455,559,1834
44003,2020-09-09,(05100) Banderas P. Central,1002,606,709,2317
44004,2020-01-20,(09000) Cabecera Usme,5336,3085,3802,12223
44005,2020-02-03,(02102) Calle 161,1930,1229,1135,4294
44006,2020-09-07,(09000) Cabecera Usme,1778,1160,1386,4324
44007,2020-01-14,(09113) Calle 22,1056,755,980,2791
44008,2020-02-18,(09113) Calle 22,1590,918,1065,3573
44009,2020-03-04,(09113) Calle 22,1597,926,1003,3526
44010,2020-02-07,(02000) Cabecera Autopista Norte,11662,6737,6492,24891
44011,2020-03-03,(04000) Cabecera Calle 80,7581,4568,5001,17150
44012,2020-03-05,(09000) Cabecera Usme - alimentacion,25544,14259,15999,55802
44013,2020-03-28,(08000) Portal Tunal - alimentacion,2422,1227,1204,4853
44014,2020-07-24,(04101) Minuto de Dios,291,156,206,653
44015,2020-09-17,(07505) LEON XIII,2966,1524,1512,6002
44016,2020-01-21,(06002) Normandía,1657,867,779,3303
44017,2020-05-17,(03005) SUBA - AV. BOYACA,89,73,64,226
44018,2020-06-17,(09101) Quiroga,584,271,369,1224
44019,2020-04-13,(09118) Marly,968,732,447,2147
44020,2020-05-15,(09118) Marly,1292,887,654,2833
44021,2020-02-21,(09103) Olaya,4145,2225,2282,8652
44022,2020-06-24,(03001) LA CAMPIÑA,1143,646,623,2412
44023,2020-09-14,(50003) Corral Molinos,1542,777,1212,3531
44024,2020-04-14,(02103) Mazurén,107,73,72,252
44025,2020-06-08,(02103) Mazurén,163,114,151,428
44026,2020-02-14,(02001) Centro Comercial Santa Fe,4946,2905,2842,10693
44027,2020-08-11,(05100) Banderas P. Central - alimentacion,3062,1575,1698,6335
44028,2020-05-03,(09103) Olaya,216,94,111,421
44029,2020-07-27,(14001) La Sabana,146,105,88,339
44030,2020-06-10,(08000) Portal Tunal - alimentacion,6061,3365,3047,12473
44031,2020-10-11,(08000) Portal Tunal - alimentacion,2303,919,1991,5213
44032,2020-07-27,(02000) Cabecera Autopista Norte,1224,791,764,2779
44033,2020-08-08,(02000) Cabecera Autopista Norte,779,497,599,1875
44034,2020-02-18,(03003) 21 ANGELES,1853,945,883,3681
44035,2020-07-01,(09118) Marly,1468,922,841,3231
44036,2020-08-12,(08000) Portal Tunal - alimentacion,6027,3333,3275,12635
44037,2020-06-01,(04000) Cabecera Calle 80,959,616,657,2232
44038,2020-01-12,(09123) Calle 76,514,402,764,1680
44039,2020-06-24,(09110) Avenida Jimenez,1444,1064,842,3350
44040,2020-02-16,(07112) COMUNEROS,881,485,907,2273
44041,2020-06-19,(04002) Carrera 90,804,405,466,1675
44042,2020-06-25,(04002) Carrera 90,786,414,443,1643
44043,2020-07-04,(10002) Av. Primero de Mayo,1739,829,1279,3847
44044,2020-01-30,(09107) Hortúa,2459,1415,1492,5366
44045,2020-02-13,(02001) Centro Comercial Santa Fe,4985,3119,2650,10754
44046,2020-04-17,(03000) Portal Suba,649,404,479,1532
44047,2020-06-26,(02000) Cabecera Autopista Norte - intermunicipal,621,380,468,1469
44048,2020-07-21,(09101) Quiroga,404,224,313,941
44049,2020-01-27,(08001) Parque el Tunal,1608,910,893,3411
44050,2020-08-12,(10000) Portal 20 de Julio - alimentacion,4075,1773,2375,8223
44051,2020-03-09,(06100) Av. Rojas,626,409,326,1361
44052,2020-09-04,(02303) Calle 85,810,530,473,1813
44053,2020-08-14,(07000) Portal Sur,1919,1120,1184,4223
44054,2020-02-18,(08002) Biblioteca,1064,651,656,2371
44055,2020-03-13,(02201) Prado,761,747,650,2158
44056,2020-09-10,(07004) VENECIA,1049,490,583,2122
44057,2020-03-07,(09105) Río Fucha,428,221,404,1053
44058,2020-07-26,(07503) SAN MATEO,2661,1422,1347,5430
44059,2020-02-19,(05102) Av. Américas - Av. Boyacá,2020,1253,952,4225
44060,2020-09-09,(06108) Concejo de Bogotá,145,88,90,323
44061,2020-09-02,(04000) Cabecera Calle 80,1159,713,999,2871
44062,2020-08-02,(09000) Cabecera Usme - alimentacion,2308,1051,1538,4897
44063,2020-05-04,(10001) Country Sur,726,309,441,1476
44064,2020-05-06,(02000) Cabecera Autopista Norte - alimentacion,3282,1801,1641,6724
44065,2020-01-01,(05002) Tintal,630,311,973,1914
44066,2020-04-29,(14004) Museo del Oro,0,59,125,184
44067,2020-05-13,(14004) Museo del Oro,0,72,171,243
44068,2020-03-16,(06106) Recinto Ferial,983,602,502,2087
44069,2020-09-30,(05002) Tintal,2949,1721,2031,6701
44070,2020-02-01,(05105) Pradera,1412,947,1044,3403
44071,2020-02-07,(10009) Museo Nacional,4040,2262,2123,8425
44072,2020-03-02,(03007) HUMEDAL CORDOBA,1013,652,552,2217
44073,2020-06-04,(02300) Calle 100,1177,748,575,2500
44074,2020-07-02,(03012) SUBA - CALLE 95,345,230,211,786
44075,2020-01-23,(06000) Portal Eldorado,6121,3598,2741,12460
44076,2020-01-28,(02104) Calle 146,9363,5906,4823,20092
44077,2020-01-18,(08000) Portal Tunal,1320,794,788,2902
44078,2020-08-11,(05005) Transversal 86,331,206,225,762
44079,2020-09-26,(05005) Transversal 86,367,159,315,841
44080,2020-01-25,(02202) Calle 127,2842,1802,1849,6493
44081,2020-01-03,(02104) Calle 146,3153,1806,2133,7092
44082,2020-04-17,(05107) Américas - Cr.53,331,204,191,726
44083,2020-08-24,(08000) Portal Tunal,787,300,243,1330
44084,2020-01-21,(03009) Av. Suba- Calle 116,1499,891,847,3237
44085,2020-03-24,(02205) Calle 106,291,261,218,770
44086,2020-04-04,(10002) Av. Primero de Mayo,761,451,481,1693
44087,2020-04-07,(10002) Av. Primero de Mayo,1098,584,693,2375
44088,2020-09-07,(03006) NIZA - CALLE 127,502,285,275,1062
44089,2020-09-06,(02001) Centro Comercial Santa Fe,133,93,201,427
44090,2020-07-22,(04101) Minuto de Dios,307,160,213,680
44091,2020-07-20,(03000) Portal Suba,299,169,252,720
44092,2020-06-15,(05000) Portal Américas - alimentacion,3760,1713,1819,7292
44093,2020-09-02,(04108) El Polo,518,326,226,1070
44094,2020-09-07,(04108) El Polo,519,323,265,1107
44095,2020-02-03,(12007) Zona Industrial,1280,784,624,2688
44096,2020-07-06,(07106) EL CAMPIN,419,274,222,915
44097,2020-09-29,(07103) AV. CHILE,992,657,637,2286
44098,2019-12-31,(07113) SANTA ISABEL,38,15,38,91
44099,2020-02-12,(07108) Av. El Dorado,1015,598,613,2226
44100,2020-02-04,(03010) PUENTE LARGO,2206,1449,1269,4924
44101,2020-09-30,(05101) Mandalay - Cr.73,167,88,123,378
44102,2020-07-16,(07000) Portal Sur,1588,984,880,3452
44103,2020-08-04,(07000) Portal Sur,1686,1046,1037,3769
44104,2020-08-11,(07000) Portal Sur,1798,1095,1167,4060
44105,2020-09-23,(07000) Portal Sur,2363,1440,1625,5428
44106,2020-06-05,(02101) Toberín,1329,840,878,3047
44107,2020-06-11,(05100) Banderas P. Central,530,306,406,1242
44108,2020-05-13,(02304) Heroes,639,471,346,1456
44109,2020-07-05,(09100) Calle 40 Sur,600,305,503,1408
44110,2020-09-09,(07104) Simon Bolivar,627,397,310,1334
44111,2020-05-28,(04107) Escuela Militar,121,86,51,258
44112,2020-08-27,(04107) Escuela Militar,136,73,85,294
44113,2020-07-15,(02303) Calle 85,565,386,285,1236
44114,2020-02-08,(03006) NIZA - CALLE 127,1218,738,1006,2962
44115,2020-09-11,(07004) VENECIA,989,580,597,2166
44116,2020-08-24,(04003) Avenida Ciudad de Cali,879,479,608,1966
44117,2020-05-12,(02304) Heroes,675,483,339,1497
44118,2020-09-26,(09117) Calle 45,513,349,517,1379
44119,2020-01-06,(04105) Carrera 53,245,117,205,567
44120,2020-07-24,(06101) El Tiempo,264,175,169,608
44121,2020-04-30,(09114) Calle 26,178,137,116,431
44122,2020-10-04,(09101) Quiroga,222,100,264,586
44123,2020-08-30,(04001) Quirigua,125,71,122,318
44124,2020-05-05,(05002) Tintal,1528,880,848,3256
44125,2020-07-29,(02204) Pepe Sierra,746,530,417,1693
44126,2020-05-31,(02205) Calle 106,64,57,61,182
44127,2020-06-13,(02000) Cabecera Autopista Norte,986,591,625,2202
44128,2020-06-08,(12003) Ricaurte,322,231,168,721
44129,2020-04-08,(03010) PUENTE LARGO,188,153,106,447
44130,2020-09-04,(03010) PUENTE LARGO,383,231,231,845
44131,2020-05-26,(03009) Av. Suba- Calle 116,449,306,222,977
44132,2020-08-25,(07200) Tygua-San José,232,142,123,497
44133,2020-01-21,(08002) Biblioteca,717,365,418,1500
44134,2020-04-23,(03013) RIO NEGRO,168,108,105,381
44135,2020-09-25,(07010) Bosa,0,400,999,1399
44136,2020-06-15,(03006) NIZA - CALLE 127,192,129,103,424
44137,2020-05-16,(07007) NQS - Calle 38A Sur,223,125,141,489
44138,2020-07-11,(07103) AV. CHILE,690,419,458,1567
44139,2020-07-08,(09122) Calle 72,1265,886,765,2916
44140,2020-03-04,(07105) MOVISTAR ARENA,1305,844,746,2895
44141,2020-07-13,(10005) Bicentenario,85,42,56,183
44142,2020-08-28,(40002) Manitas,409,261,278,948
44143,2020-06-25,(09117) Calle 45,760,456,451,1667
44144,2020-05-09,(03001) LA CAMPIÑA,488,237,267,992
44145,2020-05-25,(05100) Banderas P. Central - alimentacion,779,316,404,1499
44146,2020-02-01,(02102) Calle 161,824,377,724,1925
44147,2020-01-09,(07006) General Santander,1988,1153,1153,4294
44148,2020-07-29,(07004) VENECIA,909,555,454,1918
44149,2020-04-09,(09120) Calle 63,239,168,126,533
44150,2020-07-14,(09120) Calle 63,783,511,493,1787
44151,2020-08-15,(02200) Alcalá,1430,922,813,3165
44152,2020-03-27,(05105) Pradera,381,255,160,796
44153,2020-04-10,(05105) Pradera,64,53,34,151
44154,2020-03-26,(07111) NQS - RICAURTE,335,260,208,803
44155,2020-08-31,(07111) NQS - RICAURTE,1058,648,458,2164
44156,2020-02-24,(03004) GRATAMIRA,299,172,142,613
44157,2020-04-24,(02204) Pepe Sierra,469,360,251,1080
44158,2020-01-05,(06100) Av. Rojas,134,102,210,446
44159,2020-04-13,(02201) Prado,430,278,239,947
44160,2020-07-09,(09103) Olaya,1062,637,591,2290
44161,2020-04-20,(07004) VENECIA,510,331,235,1076
44162,2020-03-10,(07105) MOVISTAR ARENA,620,111,184,915
44163,2020-02-29,(06002) Normandía,1049,559,942,2550
44164,2020-09-06,(07103) AV. CHILE,180,140,250,570
44165,2020-08-21,(04105) Carrera 53,285,158,154,597
44166,2020-07-11,(06104) Gobernación,136,77,119,332
44167,2020-02-09,(06109) Centro Memoria,204,156,243,603
44168,2020-01-21,(07008) NQS - Calle 30 Sur,1313,584,608,2505
44169,2020-09-22,(10007) Las Nieves,726,463,458,1647
44170,2020-08-24,(03003) 21 ANGELES,302,160,154,616
44171,2020-08-28,(03003) 21 ANGELES,372,190,187,749
44172,2020-03-15,(40002) Manitas,291,119,242,652
44173,2020-07-12,(06107) Ciudad Universitaria,48,39,54,141
44174,2020-02-23,(03005) SUBA - AV. BOYACA,383,279,552,1214
44175,2020-03-13,(05005) Transversal 86,57,515,380,952
44176,2020-07-25,(09122) Calle 72,700,461,490,1651
44177,2020-03-02,(50002) Corral Calle 40 Sur,145,87,135,367
44178,2020-02-13,(12000) Puente Aranda,315,172,180,667
44179,2020-04-06,(07103) AV. CHILE,438,284,243,965
44180,2020-08-19,(09113) Calle 22,390,213,294,897
44181,2020-07-13,(12004) Carrera 22,115,63,72,250
44182,2020-09-18,(12004) Carrera 22,309,186,164,659
44183,2020-04-04,(07505) LEON XIII,914,521,416,1851
44184,2020-06-22,(02103) Mazurén,38,28,48,114
44185,2020-04-24,(07005) ALQUERIA,304,168,155,627
44186,2020-06-30,(04106) Carrera 47,346,164,200,710
44187,2020-05-19,(07102) NQS - CALLE 75,329,217,188,734
44188,2020-05-05,(09113) Calle 22,330,184,276,790
44189,2020-01-21,(09108) Hospital,152,80,154,386
44190,2020-04-11,(02200) Alcalá,608,467,297,1372
44191,2020-04-05,(02300) Calle 100,248,214,168,630
44192,2020-09-02,(07008) NQS - Calle 30 Sur,342,171,257,770
44193,2020-07-30,(10007) Las Nieves,638,383,331,1352
44194,2020-04-10,(50003) Corral Molinos,259,145,176,580
44195,2020-09-01,(05101) Mandalay - Cr.73,137,76,73,286
44196,2020-02-16,(07009) SENA,891,403,833,2127
44197,2020-04-17,(02001) Centro Comercial Santa Fe,226,153,131,510
44198,2020-09-06,(04102) Avenida Boyaca,155,101,155,411
44199,2020-06-01,(07008) NQS - Calle 30 Sur,248,135,159,542
44200,2020-04-13,(40001) Juan Pablo II,242,130,115,487
44201,2020-08-10,(04105) Carrera 53,231,133,154,518
44202,2020-07-24,(04102) Avenida Boyaca,295,169,184,648
44203,2020-04-26,(07000) Portal Sur,295,199,205,699
44204,2020-05-18,(09108) Hospital,62,42,62,166
44205,2020-05-20,(09108) Hospital,63,43,45,151
44206,2020-05-22,(09108) Hospital,55,33,56,144
44207,2020-04-23,(05100) Banderas P. Central - alimentacion,1599,801,715,3115
44208,2020-04-27,(03003) 21 ANGELES,114,8,14,136
44209,2020-09-17,(07105) MOVISTAR ARENA,260,153,155,568
44210,2020-07-18,(04104) Avenida 68,415,216,247,878
44211,2020-01-04,(09111) Calle 19,752,535,795,2082
44212,2020-04-28,(07108) Av. El Dorado,79,45,49,173
44213,2020-05-25,(02302) Virrey,167,134,101,402
44214,2020-03-30,(04104) Avenida 68,311,190,166,667
44215,2020-05-29,(09114) Calle 26,251,194,192,637
44216,2020-10-04,(05005) Transversal 86,160,49,185,394
44217,2020-08-15,(12002) CDS - Carrera 32,119,75,68,262
44218,2020-08-17,(09000) Cabecera Usme,495,266,393,1154
44219,2020-09-18,(07107) U. NACIONAL,407,272,275,954
44220,2020-04-14,(09117) Calle 45,441,301,216,958
44221,2020-05-22,(12007) Zona Industrial,267,164,123,554
44222,2020-03-21,(07506) DESPENSA,120,61,68,249
44223,2020-01-01,(40002) Manitas,143,53,178,374
44224,2020-04-01,(07106) EL CAMPIN,130,116,105,351
44225,2020-07-04,(14004) Museo del Oro,115,97,195,407
44226,2020-03-04,(03004) GRATAMIRA,307,159,161,627
44227,2020-09-18,(09106) Nariño,504,293,415,1212
44228,2020-05-31,(10005) Bicentenario - alimentacion,46,25,66,137
44229,2020-03-28,(03006) NIZA - CALLE 127,177,159,99,435
44230,2020-04-10,(04108) El Polo,51,33,22,106
44231,2020-07-26,(07007) NQS - Calle 38A Sur,96,64,93,253
44232,2020-06-10,(05102) Av. Américas - Av. Boyacá,195,101,170,466
44233,2020-04-27,(06104) Gobernación,16,85,31,132
44234,2020-03-28,(10003) Ciudad Jardín,54,37,38,129
44235,2020-04-06,(04104) Avenida 68,307,173,163,643
44236,2020-04-06,(06107) Ciudad Universitaria,102,60,82,244
44237,2020-06-29,(09106) Nariño,139,79,138,356
44238,2020-04-08,(09113) Calle 22,183,115,178,476
44239,2020-10-05,(40002) Manitas,431,265,360,1056
44240,2020-03-22,(07113) SANTA ISABEL,58,41,51,150
44241,2020-04-10,(07113) SANTA ISABEL,52,36,35,123
44242,2020-03-31,(04101) Minuto de Dios,140,95,98,333
44243,2020-07-02,(07101) CASTELLANA,201,117,124,442
44244,2020-04-25,(12002) CDS - Carrera 32,134,85,37,256
44245,2020-01-03,(03014) SAN MARTIN,115,68,130,313
44246,2020-04-28,(50002) Corral Calle 40 Sur,18,12,15,45
44247,2020-07-19,(09109) Tercer Milenio,95,38,88,221
44248,2020-07-25,(06100) Av. Rojas,106,57,89,252
44249,2020-02-11,(50006) Corral Carrera 77,33,25,43,101
44250,2020-08-19,(50006) Corral Carrera 77,3,3,4,10
44251,2020-07-26,(12007) Zona Industrial,24,29,30,83
44252,2020-04-17,(03004) GRATAMIRA,22,12,12,46
44253,2020-06-06,(14005) Las Aguas,0,46,152,198
44254,2020-10-12,(04107) Escuela Militar,47,36,58,141
44255,2020-06-06,(03004) GRATAMIRA,27,7,17,51
44256,2020-08-24,(09118) Marly,1083,763,666,2512
44257,2020-01-22,(07504) TERREROS,16971,10214,9129,36314
44258,2020-06-26,(07504) TERREROS,6254,3504,3086,12844
44259,2020-02-06,(09119) Calle 57,3837,2381,2168,8386
44260,2020-10-08,(09119) Calle 57,644,440,571,1655
44261,2020-01-29,(03000) Portal Suba - alimentacion,27362,15984,15650,58996
44262,2020-01-17,(09122) Calle 72,5557,3728,3632,12917
44263,2020-03-11,(02200) Alcalá,13759,8665,6292,28716
44264,2020-02-28,(05000) Portal Américas,15180,7899,7979,31058
44265,2020-02-15,(10000) Portal 20 de Julio - alimentacion,8742,3879,6353,18974
44266,2020-03-07,(09000) Cabecera Usme - alimentacion,17997,8684,12659,39340
44267,2020-01-08,(06107) Ciudad Universitaria,569,370,547,1486
44268,2020-02-03,(09118) Marly,7717,4968,4107,16792
44269,2020-10-12,(07112) COMUNEROS,274,169,336,779
44270,2020-05-12,(08000) Portal Tunal - alimentacion,4825,2621,2419,9865
44271,2020-02-10,(05100) Banderas P. Central,8287,4970,3819,17076
44272,2020-05-15,(10001) Country Sur,933,423,552,1908
44273,2020-03-18,(09100) Calle 40 Sur,4251,2300,2299,8850
44274,2020-01-12,(09115) Calle 34,426,341,657,1424
44275,2020-05-26,(10000) Portal 20 de Julio - alimentacion,3924,1766,2215,7905
44276,2020-05-05,(07001) PERDOMO,568,332,391,1291
44277,2020-09-25,(04101) Minuto de Dios,400,231,387,1018
44278,2020-01-26,(07504) TERREROS,4595,1799,3440,9834
44279,2020-06-10,(02204) Pepe Sierra,752,506,383,1641
44280,2020-02-24,(06002) Normandía,2689,1554,1282,5525
44281,2020-02-12,(09110) Avenida Jimenez,5679,3578,3045,12302
44282,2020-07-03,(09104) Restrepo,1661,1009,1304,3974
44283,2020-09-06,(09123) Calle 76,220,179,295,694
44284,2020-01-09,(12003) Ricaurte,860,584,462,1906
44285,2020-01-18,(09101) Quiroga,1012,471,914,2397
44286,2020-08-31,(07102) NQS - CALLE 75,447,280,251,978
44287,2020-07-25,(05100) Banderas P. Central - alimentacion,1668,750,875,3293
44288,2020-08-28,(05100) Banderas P. Central - alimentacion,3236,1687,1843,6766
44289,2020-09-03,(05100) Banderas P. Central - alimentacion,3440,1822,2115,7377
44290,2020-03-05,(14001) La Sabana,565,370,352,1287
44291,2020-10-02,(02000) Cabecera Autopista Norte - alimentacion,5590,2820,4003,12413
44292,2020-09-17,(09004) Santa Lucía,2512,1395,1729,5636
44293,2020-01-28,(06105) Quinta Paredes,1048,638,497,2183
44294,2020-02-08,(02104) Calle 146,3593,1590,2940,8123
44295,2020-03-01,(09110) Avenida Jimenez,994,809,1053,2856
44296,2020-02-02,(07112) COMUNEROS,897,452,907,2256
44297,2020-09-01,(10001) Country Sur,1291,536,757,2584
44298,2020-07-14,(04002) Carrera 90,680,364,368,1412
44299,2020-05-04,(09111) Calle 19,386,257,266,909
44300,2020-01-10,(06109) Centro Memoria,797,473,535,1805
44301,2020-01-15,(12001) Carrera 43,1429,865,912,3206
44302,2020-05-12,(12001) Carrera 43,313,194,171,678
44303,2020-02-01,(09107) Hortúa,1208,732,1128,3068
44304,2020-01-08,(02304) Heroes,3020,2221,1762,7003
44305,2020-02-13,(10010) San Bernardo,1771,1119,1346,4236
44306,2019-12-31,(07000) Portal Sur - alimentacion,262,211,327,800
44307,2020-07-29,(02303) Calle 85,703,481,358,1542
44308,2020-01-18,(07000) Portal Sur,4489,2204,3310,10003
44309,2020-01-24,(07000) Portal Sur,7574,4349,4372,16295
44310,2020-09-05,(07000) Portal Sur,1656,903,1409,3968
44311,2020-09-06,(07000) Portal Sur,486,281,596,1363
44312,2020-01-19,(02300) Calle 100,829,680,1222,2731
44313,2020-01-20,(07004) VENECIA,4322,2459,2398,9179
44314,2020-06-13,(09004) Santa Lucía,2172,1073,1173,4418
44315,2020-07-06,(09004) Santa Lucía,2677,1443,1441,5561
44316,2020-02-07,(09105) Río Fucha,808,454,527,1789
44317,2020-01-12,(03000) Portal Suba,1257,561,1404,3222
44318,2020-09-13,(07505) LEON XIII,840,376,566,1782
44319,2020-02-25,(05102) Av. Américas - Av. Boyacá,2003,1231,998,4232
44320,2020-09-22,(07010) Bosa,0,394,914,1308
44321,2020-07-09,(05000) Portal Américas,2708,1903,1936,6547
44322,2020-03-07,(07007) NQS - Calle 38A Sur,1391,704,985,3080
44323,2020-02-14,(03001) LA CAMPIÑA,6900,3834,4275,15009
44324,2020-04-13,(40003) Mirador del Paraiso,693,448,476,1617
44325,2020-03-25,(09107) Hortúa,478,339,228,1045
44326,2020-08-18,(09123) Calle 76,923,607,552,2082
44327,2020-03-05,(04002) Carrera 90,3663,2121,1982,7766
44328,2020-04-21,(02300) Calle 100,756,541,389,1686
44329,2020-02-22,(03012) SUBA - CALLE 95,790,537,788,2115
44330,2020-05-13,(03012) SUBA - CALLE 95,256,144,137,537
44331,2020-01-07,(09001) Molinos,5536,3069,4796,13401
44332,2020-02-27,(05105) Pradera,2642,1578,1225,5445
44333,2020-03-09,(05105) Pradera,1058,250,276,1584
44334,2020-06-17,(05005) Transversal 86,421,217,257,895
44335,2020-08-02,(05005) Transversal 86,67,32,74,173
44336,2020-01-29,(10008) San Diego,1405,807,743,2955
44337,2020-01-29,(08000) Portal Tunal,2117,1173,991,4281
44338,2020-09-07,(06109) Centro Memoria,287,162,185,634
44339,2020-02-07,(09106) Nariño,2191,1241,1529,4961
44340,2020-06-11,(03000) Portal Suba - alimentacion,5856,3397,3134,12387
44341,2020-04-28,(05002) Tintal,1558,863,790,3211
44342,2020-02-29,(04108) El Polo,993,671,927,2591
44343,2020-07-18,(04108) El Polo,285,175,181,641
44344,2020-06-26,(07101) CASTELLANA,226,143,142,511
44345,2020-07-10,(02201) Prado,942,615,578,2135
44346,2020-05-28,(07106) EL CAMPIN,307,213,153,673
44347,2020-09-04,(07106) EL CAMPIN,427,293,292,1012
44348,2020-02-10,(07103) AV. CHILE,3786,2324,1884,7994
44349,2020-01-30,(06000) Portal Eldorado,6237,3677,2731,12645
44350,2020-01-01,(03007) HUMEDAL CORDOBA,56,47,61,164
44351,2020-01-04,(03007) HUMEDAL CORDOBA,222,129,166,517
44352,2020-05-01,(03007) HUMEDAL CORDOBA,42,18,20,80
44353,2020-06-04,(04104) Avenida 68,573,301,300,1174
44354,2020-09-09,(04104) Avenida 68,676,342,404,1422
44355,2020-06-20,(02101) Toberín,1000,580,789,2369
44356,2020-07-18,(02101) Toberín,868,501,683,2052
44357,2020-05-25,(10000) Portal 20 de Julio,718,342,369,1429
44358,2020-01-07,(05107) Américas - Cr.53,1774,1005,1038,3817
44359,2020-09-12,(09100) Calle 40 Sur,1502,783,1198,3483
44360,2020-06-16,(07104) Simon Bolivar,630,364,287,1281
44361,2020-03-18,(06000) Portal Eldorado,3725,2323,1563,7611
44362,2020-09-15,(04003) Avenida Ciudad de Cali,1059,638,811,2508
44363,2020-05-23,(07000) Portal Sur,1136,643,720,2499
44364,2020-07-08,(09000) Cabecera Usme,1786,1160,1215,4161
44365,2020-04-27,(09001) Molinos,946,148,227,1321
44366,2020-03-18,(09115) Calle 34,2081,1412,1196,4689
44367,2020-05-08,(02304) Heroes,590,428,310,1328
44368,2020-10-10,(09109) Tercer Milenio,290,189,259,738
44369,2020-08-19,(09100) Calle 40 Sur,1598,926,1004,3528
44370,2020-01-26,(07002) MADELENA,923,386,810,2119
44371,2020-02-11,(07109) CAD,3002,1814,1542,6358
44372,2020-08-21,(02104) Calle 146,681,412,507,1600
44373,2020-05-19,(02202) Calle 127,939,672,435,2046
44374,2020-08-12,(05001) Patio Bonito,1793,1001,972,3766
44375,2020-07-11,(07109) CAD,438,315,273,1026
44376,2020-01-02,(04108) El Polo,764,494,568,1826
44377,2020-03-25,(04108) El Polo,197,145,131,473
44378,2020-09-12,(02105) Calle 142,664,350,537,1551
44379,2020-09-04,(07009) SENA,694,389,503,1586
44380,2020-06-12,(06000) Portal Eldorado,972,662,476,2110
44381,2020-04-03,(02302) Virrey,320,247,191,758
44382,2020-08-07,(02302) Virrey,207,133,151,491
44383,2020-08-17,(07009) SENA,216,118,153,487
44384,2020-08-06,(10010) San Bernardo,551,290,421,1262
44385,2020-03-18,(07001) PERDOMO,2433,1412,1322,5167
44386,2020-08-31,(07106) EL CAMPIN,390,235,253,878
44387,2020-08-19,(02103) Mazurén,174,120,156,450
44388,2020-06-21,(07103) AV. CHILE,191,125,173,489
44389,2020-09-05,(12007) Zona Industrial,274,198,181,653
44390,2020-03-09,(03010) PUENTE LARGO,701,272,293,1266
44391,2020-08-13,(40002) Manitas,244,238,363,845
44392,2020-02-19,(12002) CDS - Carrera 32,640,414,289,1343
44393,2020-08-27,(10003) Ciudad Jardín,213,113,140,466
44394,2020-06-15,(02102) Calle 161,70,52,58,180
44395,2020-02-18,(40001) Juan Pablo II,1698,1035,965,3698
44396,2020-08-29,(09003) Socorro,496,238,344,1078
44397,2020-06-11,(40001) Juan Pablo II,557,340,297,1194
44398,2020-04-16,(07110) PALOQUEMAO,445,284,207,936
44399,2020-06-09,(07110) PALOQUEMAO,617,356,250,1223
44400,2020-01-14,(07005) ALQUERIA,2076,1159,1258,4493
44401,2020-06-02,(07004) VENECIA,870,518,481,1869
44402,2020-07-30,(09111) Calle 19,721,425,417,1563
44403,2020-07-06,(06104) Gobernación,276,163,114,553
44404,2020-07-23,(07110) PALOQUEMAO,499,324,222,1045
44405,2020-08-27,(06104) Gobernación,247,131,125,503
44406,2020-09-30,(06104) Gobernación,315,193,189,697
44407,2020-01-12,(07108) Av. El Dorado,119,81,188,388
44408,2020-09-24,(50003) Corral Molinos,1577,819,1233,3629
44409,2020-07-30,(07003) SEVILLANA,375,215,233,823
44410,2020-09-01,(07003) SEVILLANA,454,252,273,979
44411,2020-07-27,(09123) Calle 76,994,666,499,2159
44412,2020-05-08,(10007) Las Nieves,338,196,179,713
44413,2020-09-07,(03003) 21 ANGELES,354,192,214,760
44414,2020-01-26,(40001) Juan Pablo II,453,190,365,1008
44415,2020-05-03,(40001) Juan Pablo II,93,68,60,221
44416,2020-09-08,(08000) Portal Tunal,810,319,364,1493
44417,2020-07-02,(04103) Las Ferias,374,209,202,785
44418,2020-10-07,(03005) SUBA - AV. BOYACA,538,304,429,1271
44419,2020-05-19,(04103) Las Ferias,326,177,157,660
44420,2020-08-09,(09110) Avenida Jimenez,402,295,311,1008
44421,2020-05-19,(40002) Manitas,324,200,205,729
44422,2020-10-04,(12003) Ricaurte,68,64,97,229
44423,2020-07-27,(09114) Calle 26,294,195,199,688
44424,2020-07-10,(12000) Puente Aranda,108,53,44,205
44425,2020-09-14,(09121) Las Flores,729,445,476,1650
44426,2020-09-10,(12004) Carrera 22,260,161,132,553
44427,2020-08-24,(09111) Calle 19,497,344,398,1239
44428,2020-08-08,(12003) Ricaurte,229,178,165,572
44429,2020-08-11,(04106) Carrera 47,281,140,162,583
44430,2020-05-25,(09003) Socorro,195,117,119,431
44431,2020-08-31,(04106) Carrera 47,304,158,186,648
44432,2020-07-29,(02201) Prado,799,570,459,1828
44433,2020-06-03,(04101) Minuto de Dios,288,172,210,670
44434,2020-04-03,(07200) Tygua-San José,65,47,67,179
44435,2020-10-07,(07200) Tygua-San José,269,163,227,659
44436,2020-07-28,(10007) Las Nieves,604,360,323,1287
44437,2020-06-30,(07004) VENECIA,1044,626,643,2313
44438,2020-01-11,(12002) CDS - Carrera 32,202,149,207,558
44439,2020-04-20,(40001) Juan Pablo II,264,153,168,585
44440,2020-08-19,(04000) Cabecera Calle 80 - intermunicipal,315,170,275,760
44441,2020-08-15,(07506) DESPENSA,387,188,265,840
44442,2020-05-30,(04102) Avenida Boyaca,221,116,158,495
44443,2020-07-28,(09108) Hospital,71,33,47,151
44444,2020-01-31,(03004) GRATAMIRA,313,148,164,625
44445,2020-02-01,(03004) GRATAMIRA,126,68,127,321
44446,2020-04-02,(05105) Pradera,351,239,158,748
44447,2020-05-23,(09122) Calle 72,700,473,480,1653
44448,2020-08-16,(07102) NQS - CALLE 75,70,52,84,206
44449,2020-10-12,(03011) SUBA - CALLE 100,172,98,169,439
44450,2020-04-25,(07506) DESPENSA,171,114,132,417
44451,2020-04-03,(07107) U. NACIONAL,191,159,107,457
44452,2020-08-16,(08001) Parque el Tunal,117,53,84,254
44453,2020-05-16,(07003) SEVILLANA,261,146,132,539
44454,2020-04-27,(06001) Modelia,64,122,61,247
44455,2020-04-29,(02303) Calle 85,362,266,204,832
44456,2020-10-09,(04101) Minuto de Dios,402,231,403,1036
44457,2020-01-29,(03004) GRATAMIRA,308,161,159,628
44458,2020-06-15,(06002) Normandía,82,65,69,216
44459,2020-08-23,(02204) Pepe Sierra,209,151,160,520
44460,2020-07-16,(09105) Río Fucha,88,41,58,187
44461,2020-01-01,(02204) Pepe Sierra,269,216,390,875
44462,2020-03-30,(07007) NQS - Calle 38A Sur,162,105,90,357
44463,2020-05-01,(14005) Las Aguas,0,19,67,86
44464,2020-04-29,(09114) Calle 26,193,154,145,492
44465,2020-06-22,(03005) SUBA - AV. BOYACA,123,80,95,298
44466,2020-04-01,(04001) Quirigua,152,93,102,347
44467,2020-08-08,(04107) Escuela Militar,56,29,50,135
44468,2020-04-07,(06107) Ciudad Universitaria,106,72,81,259
44469,2020-07-12,(06102) Salitre El Greco,79,46,60,185
44470,2020-06-28,(40002) Manitas,139,79,94,312
44471,2020-04-07,(12002) CDS - Carrera 32,132,103,57,292
44472,2020-05-10,(12000) Puente Aranda,6,9,9,24
44473,2020-05-25,(09108) Hospital,33,22,25,80
44474,2020-04-15,(05102) Av. Américas - Av. Boyacá,112,66,69,247
44475,2020-06-19,(03014) SAN MARTIN,31,14,50,95
44476,2020-05-31,(12001) Carrera 43,63,46,69,178
44477,2020-09-08,(03014) SAN MARTIN,0,15,44,59
44478,2020-05-09,(06105) Quinta Paredes,63,43,35,141
44479,2020-03-21,(09106) Nariño,118,61,76,255
44480,2020-07-15,(50006) Corral Carrera 77,1,4,8,13
44481,2019-12-31,(09110) Avenida Jimenez,27,21,65,113
44482,2020-07-26,(07006) General Santander - alimentacion,49,40,73,162
44483,2020-05-01,(10005) Bicentenario - alimentacion,49,28,86,163
44484,2020-05-18,(03014) SAN MARTIN,20,9,25,54
44485,2020-05-24,(50002) Corral Calle 40 Sur,5,1,4,10
44486,2020-05-11,(50006) Corral Carrera 77,4,1,3,8
44487,2020-01-02,(04000) Cabecera Calle 80 - alimentacion,9484,5317,7234,22035
44488,2020-09-29,(02502) Terminal,518,365,541,1424
44489,2020-01-13,(03000) Portal Suba - alimentacion,22725,12832,13806,49363
44490,2020-01-27,(03002) SUBA - TV- 91,4135,2507,2281,8923
44491,2020-09-27,(03002) SUBA - TV- 91,278,130,292,700
44492,2020-02-09,(07503) SAN MATEO,9708,4230,6292,20230
44493,2020-03-29,(04002) Carrera 90,104,48,35,187
44494,2020-02-14,(04000) Cabecera Calle 80 - alimentacion,25222,14102,15105,54429
44495,2020-08-31,(07503) SAN MATEO,11317,6495,5424,23236
44496,2020-02-14,(08000) Portal Tunal - alimentacion,25336,13478,12308,51122
44497,2020-06-20,(07112) COMUNEROS,659,398,385,1442
44498,2020-06-11,(09115) Calle 34,634,423,348,1405
44499,2020-03-02,(10002) Av. Primero de Mayo,8292,4178,4613,17083
44500,2020-02-22,(02204) Pepe Sierra,2137,1421,1620,5178
44501,2020-05-18,(07001) PERDOMO,717,400,416,1533
44502,2020-01-17,(07505) LEON XIII,7705,4197,3718,15620
44503,2020-06-04,(07505) LEON XIII,2466,1381,1054,4901
44504,2020-07-28,(07505) LEON XIII,2650,1402,1051,5103
44505,2020-01-28,(07110) PALOQUEMAO,2561,1456,1186,5203
44506,2020-03-12,(09004) Santa Lucía,423,1651,1248,3322
44507,2020-03-08,(07102) NQS - CALLE 75,237,179,300,716
44508,2020-03-05,(02302) Virrey,3787,2563,1893,8243
44509,2020-01-18,(07110) PALOQUEMAO,1211,809,893,2913
44510,2020-10-09,(50003) Corral Molinos,1568,806,1523,3897
44511,2020-01-14,(07106) EL CAMPIN,1784,1155,991,3930
44512,2020-03-25,(09104) Restrepo,691,544,589,1824
44513,2020-04-11,(02103) Mazurén,70,41,38,149
44514,2020-08-29,(02103) Mazurén,143,80,150,373
44515,2020-02-11,(02303) Calle 85,3926,2648,1888,8462
44516,2020-09-16,(07000) Portal Sur - alimentacion,9235,5107,5258,19600
44517,2020-05-02,(14001) La Sabana,87,71,34,192
44518,2020-05-22,(14001) La Sabana,134,90,80,304
44519,2020-10-03,(07000) Portal Sur - alimentacion,7662,3492,5469,16623
44520,2020-09-21,(02000) Cabecera Autopista Norte - alimentacion,4103,2030,2682,8815
44521,2020-01-29,(07106) EL CAMPIN,2086,1336,1104,4526
44522,2020-02-14,(07107) U. NACIONAL,2031,1401,1477,4909
44523,2020-02-29,(02000) Cabecera Autopista Norte - intermunicipal,2068,1101,1940,5109
44524,2020-01-09,(04105) Carrera 53,954,535,623,2112
44525,2020-02-10,(04105) Carrera 53,1559,858,782,3199
44526,2020-09-05,(09004) Santa Lucía,2404,1067,1552,5023
44527,2020-07-27,(05000) Portal Américas,1947,1479,1593,5019
44528,2020-07-15,(04000) Cabecera Calle 80,953,599,692,2244
44529,2020-07-16,(04000) Cabecera Calle 80,960,589,702,2251
44530,2020-01-22,(06106) Recinto Ferial,1501,815,793,3109
44531,2020-02-21,(09114) Calle 26,2527,2116,2044,6687
44532,2020-03-11,(09114) Calle 26,3257,2104,1727,7088
44533,2020-10-10,(02201) Prado,759,454,715,1928
44534,2020-08-25,(10006) San Victorino,447,240,295,982
44535,2020-01-11,(12001) Carrera 43,648,385,621,1654
44536,2020-01-14,(12001) Carrera 43,1372,896,867,3135
44537,2020-02-10,(07505) LEON XIII,8513,4924,4031,17468
44538,2020-05-21,(03000) Portal Suba,960,612,580,2152
44539,2020-02-17,(06111) Universidades,5885,3568,2627,12080
44540,2020-01-16,(09115) Calle 34,3619,2387,2158,8164
44541,2020-04-24,(10000) Portal 20 de Julio - alimentacion,2702,1145,1485,5332
44542,2020-08-08,(03000) Portal Suba - alimentacion,3550,1899,2338,7787
44543,2020-02-28,(10004) Policarpa,955,451,604,2010
44544,2020-09-08,(08001) Parque el Tunal,471,276,287,1034
44545,2020-02-24,(06103) CAN,2743,1569,1128,5440
44546,2020-10-09,(06108) Concejo de Bogotá,162,98,122,382
44547,2020-02-04,(06001) Modelia,2679,1600,1316,5595
44548,2020-09-04,(05101) Mandalay - Cr.73,155,87,106,348
44549,2020-01-03,(03012) SUBA - CALLE 95,636,447,526,1609
44550,2020-07-07,(09119) Calle 57,617,394,439,1450
44551,2020-07-24,(09119) Calle 57,432,266,272,970
44552,2020-03-14,(05005) Transversal 86,1270,517,855,2642
44553,2020-08-05,(02202) Calle 127,997,719,571,2287
44554,2020-08-28,(02202) Calle 127,1104,783,650,2537
44555,2020-09-15,(05105) Pradera,638,378,333,1349
44556,2020-01-25,(04105) Carrera 53,743,422,553,1718
44557,2020-06-05,(05000) Portal Américas,2255,1544,1697,5496
44558,2020-04-20,(08000) Portal Tunal,382,213,213,808
44559,2020-01-29,(03009) Av. Suba- Calle 116,2542,1614,1334,5490
44560,2020-07-31,(03009) Av. Suba- Calle 116,403,269,198,870
44561,2020-09-03,(03009) Av. Suba- Calle 116,543,331,278,1152
44562,2020-04-19,(10002) Av. Primero de Mayo,385,222,269,876
44563,2020-09-29,(04101) Minuto de Dios,390,243,401,1034
44564,2020-09-24,(09101) Quiroga,566,291,447,1304
44565,2020-02-27,(04108) El Polo,2008,1205,1139,4352
44566,2020-08-31,(04108) El Polo,500,316,253,1069
44567,2020-07-18,(10009) Museo Nacional,167,140,190,497
44568,2020-09-14,(07103) AV. CHILE,934,562,537,2033
44569,2020-08-23,(07113) SANTA ISABEL,85,48,106,239
44570,2020-10-05,(06000) Portal Eldorado,949,667,770,2386
44571,2020-03-15,(04100) Carrera 77,1038,456,996,2490
44572,2020-02-20,(03007) HUMEDAL CORDOBA,1016,659,463,2138
44573,2020-06-25,(03007) HUMEDAL CORDOBA,143,113,62,318
44574,2020-06-03,(10006) San Victorino,504,288,267,1059
44575,2020-03-05,(03010) PUENTE LARGO,2070,1346,1254,4670
44576,2020-05-27,(05100) Banderas P. Central,611,345,412,1368
44577,2020-08-09,(09100) Calle 40 Sur,522,277,399,1198
44578,2020-01-05,(04003) Avenida Ciudad de Cali,757,368,854,1979
44579,2020-03-01,(05107) Américas - Cr.53,377,273,477,1127
44580,2020-09-18,(09121) Las Flores,762,483,598,1843
44581,2020-02-21,(09109) Tercer Milenio,1332,813,899,3044
44582,2020-07-06,(09109) Tercer Milenio,380,208,227,815
44583,2020-02-22,(07109) CAD,1311,877,1116,3304
44584,2020-03-07,(07109) CAD,1283,938,1161,3382
44585,2020-09-24,(06101) El Tiempo,374,243,254,871
44586,2020-09-08,(02104) Calle 146,869,537,619,2025
44587,2020-04-11,(09000) Cabecera Usme - alimentacion,2864,1464,1413,5741
44588,2020-01-23,(03003) 21 ANGELES,1577,821,876,3274
44589,2020-07-05,(07505) LEON XIII,808,374,457,1639
44590,2020-10-01,(09121) Las Flores,753,475,602,1830
44591,2020-07-03,(02204) Pepe Sierra,891,603,481,1975
44592,2020-03-26,(10001) Country Sur,502,253,349,1104
44593,2020-07-19,(02205) Calle 106,52,45,52,149
44594,2020-01-27,(40001) Juan Pablo II,1550,924,956,3430
44595,2020-02-25,(07101) CASTELLANA,984,592,576,2152
44596,2020-01-21,(09122) Calle 72,4124,2748,2627,9499
44597,2020-07-27,(12003) Ricaurte,311,202,147,660
44598,2020-04-20,(09109) Tercer Milenio,151,97,105,353
44599,2020-05-25,(09116) Avenida 39,90,58,76,224
44600,2020-04-27,(09000) Cabecera Usme,682,108,151,941
44601,2020-01-12,(09001) Molinos,1745,723,1822,4290
44602,2020-04-01,(10010) San Bernardo,330,231,264,825
44603,2020-04-06,(10010) San Bernardo,334,220,273,827
44604,2020-05-03,(10010) San Bernardo,190,110,127,427
44605,2020-06-19,(04003) Avenida Ciudad de Cali,1090,608,785,2483
44606,2020-06-16,(05100) Banderas P. Central - alimentacion,2689,1560,1688,5937
44607,2020-06-26,(03011) SUBA - CALLE 100,595,250,242,1087
44608,2020-03-12,(14005) Las Aguas,1128,199,373,1700
44609,2020-09-08,(10005) Bicentenario,100,61,76,237
44610,2020-01-11,(40002) Manitas,836,416,570,1822
44611,2020-02-06,(40002) Manitas,1351,774,835,2960
44612,2020-04-07,(06108) Concejo de Bogotá,87,79,74,240
44613,2020-05-18,(02001) Centro Comercial Santa Fe,340,219,231,790
44614,2020-03-26,(02300) Calle 100,797,609,440,1846
44615,2020-05-24,(07003) SEVILLANA,80,35,56,171
44616,2020-09-04,(07003) SEVILLANA,512,262,330,1104
44617,2020-06-08,(10009) Museo Nacional,488,275,295,1058
44618,2020-09-10,(10009) Museo Nacional,472,245,369,1086
44619,2020-05-22,(02202) Calle 127,954,672,457,2083
44620,2020-01-21,(04101) Minuto de Dios,1634,885,935,3454
44621,2020-05-14,(05105) Pradera,450,292,182,924
44622,2020-05-15,(09004) Santa Lucía,1949,955,1026,3930
44623,2020-08-31,(03006) NIZA - CALLE 127,479,273,281,1033
44624,2020-03-20,(10006) San Victorino,185,125,100,410
44625,2020-09-24,(03013) RIO NEGRO,328,196,224,748
44626,2020-05-02,(07110) PALOQUEMAO,321,207,159,687
44627,2020-07-07,(07006) General Santander,553,365,343,1261
44628,2020-02-16,(05101) Mandalay - Cr.73,137,40,120,297
44629,2020-05-16,(09122) Calle 72,655,457,468,1580
44630,2020-05-18,(09122) Calle 72,942,658,596,2196
44631,2020-09-15,(06109) Centro Memoria,294,174,174,642
44632,2020-09-18,(09111) Calle 19,811,516,563,1890
44633,2020-07-09,(06104) Gobernación,251,162,106,519
44634,2020-09-20,(09002) Consuelo,154,71,161,386
44635,2020-05-15,(02302) Virrey,483,352,257,1092
44636,2020-07-13,(02101) Toberín,1285,799,805,2889
44637,2020-08-02,(06109) Centro Memoria,67,50,59,176
44638,2020-06-24,(10007) Las Nieves,720,412,402,1534
44639,2020-10-01,(04103) Las Ferias,382,221,278,881
44640,2020-07-20,(08000) Portal Tunal,251,114,94,459
44641,2020-04-22,(09121) Las Flores,416,285,223,924
44642,2020-09-18,(04101) Minuto de Dios,386,231,353,970
44643,2020-07-11,(07001) PERDOMO,714,360,497,1571
44644,2020-07-27,(09122) Calle 72,1109,754,707,2570
44645,2020-06-02,(02102) Calle 161,218,137,152,507
44646,2020-06-13,(02102) Calle 161,198,119,147,464
44647,2020-08-19,(14001) La Sabana,152,102,77,331
44648,2020-05-23,(02103) Mazurén,81,59,92,232
44649,2020-06-23,(09114) Calle 26,343,210,208,761
44650,2020-01-02,(12003) Ricaurte,365,245,295,905
44651,2020-07-23,(07005) ALQUERIA,420,263,229,912
44652,2020-05-07,(07006) General Santander - alimentacion,225,126,134,485
44653,2020-10-02,(09003) Socorro,642,343,473,1458
44654,2020-07-20,(09119) Calle 57,165,95,136,396
44655,2020-08-11,(07008) NQS - Calle 30 Sur,276,164,155,595
44656,2020-03-17,(07200) Tygua-San José,458,289,385,1132
44657,2020-02-02,(14004) Museo del Oro,0,153,448,601
44658,2020-03-10,(06102) Salitre El Greco,602,149,185,936
44659,2020-03-08,(09106) Nariño,391,210,527,1128
44660,2020-05-09,(04102) Avenida Boyaca,137,80,121,338
44661,2020-05-14,(04001) Quirigua,302,187,172,661
44662,2020-08-31,(07008) NQS - Calle 30 Sur,317,185,211,713
44663,2020-07-29,(04105) Carrera 53,274,147,161,582
44664,2020-04-03,(09100) Calle 40 Sur,857,467,514,1838
44665,2020-03-24,(07108) Av. El Dorado,109,91,109,309
44666,2020-08-18,(07006) General Santander,504,323,299,1126
44667,2020-05-26,(09108) Hospital,72,43,60,175
44668,2020-07-31,(09108) Hospital,68,37,53,158
44669,2020-08-30,(07002) MADELENA,227,117,201,545
44670,2020-04-10,(02105) Calle 142,154,113,76,343
44671,2020-08-03,(04000) Cabecera Calle 80 - intermunicipal,276,157,245,678
44672,2020-04-20,(03003) 21 ANGELES,171,86,89,346
44673,2020-09-15,(09111) Calle 19,746,433,502,1681
44674,2020-04-22,(07101) CASTELLANA,87,67,68,222
44675,2020-09-20,(03013) RIO NEGRO,105,54,133,292
44676,2020-04-14,(02502) Terminal,146,113,120,379
44677,2020-06-15,(03001) LA CAMPIÑA,291,167,201,659
44678,2020-04-06,(03006) NIZA - CALLE 127,229,171,108,508
44679,2020-08-15,(07005) ALQUERIA,451,252,315,1018
44680,2020-06-04,(07009) SENA,605,369,339,1313
44681,2020-01-05,(14005) Las Aguas,170,123,317,610
44682,2020-05-04,(07107) U. NACIONAL,237,168,98,503
44683,2020-05-05,(06102) Salitre El Greco,153,73,66,292
44684,2020-09-20,(06001) Modelia,93,62,115,270
44685,2020-03-27,(07201) Guatoque -Veraguas,38,48,56,142
44686,2020-07-31,(09105) Río Fucha,78,42,79,199
44687,2020-09-01,(03004) GRATAMIRA,0,14,32,46
44688,2020-06-23,(07106) EL CAMPIN,391,263,219,873
44689,2020-03-20,(06111) Universidades,0,77,190,267
44690,2020-05-01,(09106) Nariño,129,72,77,278
44691,2020-04-02,(10008) San Diego,143,109,114,366
44692,2020-01-05,(07101) CASTELLANA,43,44,105,192
44693,2020-05-03,(04002) Carrera 90,101,62,75,238
44694,2020-08-12,(04103) Las Ferias,301,163,184,648
44695,2020-05-25,(12002) CDS - Carrera 32,37,40,18,95
44696,2020-08-24,(09106) Nariño,343,178,238,759
44697,2020-08-17,(02000) Cabecera Autopista Norte - intermunicipal,124,90,126,340
44698,2020-05-30,(07200) Tygua-San José,184,92,98,374
44699,2020-03-27,(04101) Minuto de Dios,135,92,91,318
44700,2020-07-02,(06106) Recinto Ferial,268,170,135,573
44701,2020-10-12,(03012) SUBA - CALLE 95,82,49,123,254
44702,2020-04-18,(10005) Bicentenario,33,20,26,79
44703,2020-06-14,(06104) Gobernación,47,29,34,110
44704,2020-07-14,(09105) Río Fucha,99,39,64,202
44705,2020-04-19,(03002) SUBA - TV- 91,156,80,86,322
44706,2020-05-31,(04102) Avenida Boyaca,88,39,70,197
44707,2019-12-31,(10001) Country Sur,27,21,54,102
44708,2020-05-24,(07111) NQS - RICAURTE,101,87,119,307
44709,2020-03-28,(07101) CASTELLANA,21,33,57,111
44710,2020-06-07,(09105) Río Fucha,34,22,38,94
44711,2020-06-06,(04105) Carrera 53,211,104,120,435
44712,2020-04-19,(07003) SEVILLANA,68,49,42,159
44713,2019-12-31,(07112) COMUNEROS,54,32,48,134
44714,2020-08-15,(04001) Quirigua,267,161,214,642
44715,2020-04-17,(05103) Marsella,198,107,103,408
44716,2020-03-29,(06111) Universidades,0,20,55,75
44717,2020-06-15,(09108) Hospital,36,26,33,95
44718,2020-05-03,(04105) Carrera 53,52,43,47,142
44719,2020-05-31,(04103) Las Ferias,98,51,55,204
44720,2020-07-22,(50006) Corral Carrera 77,5,1,14,20
44721,2020-05-25,(02102) Calle 161,57,30,36,123
44722,2020-03-26,(09108) Hospital,26,23,24,73
44723,2020-09-07,(03014) SAN MARTIN,0,16,36,52
44724,2020-06-21,(50002) Corral Calle 40 Sur,6,0,3,9
44725,2019-12-31,(12000) Puente Aranda,1,2,6,9
44726,2020-02-20,(04000) Cabecera Calle 80 - alimentacion,23713,14340,13788,51841
44727,2020-05-14,(04000) Cabecera Calle 80 - alimentacion,2919,1740,1697,6356
44728,2020-02-11,(07005) ALQUERIA,2812,1617,1487,5916
44729,2020-07-14,(02502) Terminal,362,275,273,910
44730,2020-08-19,(09118) Marly,1323,845,703,2871
44731,2020-01-04,(07504) TERREROS,7163,3541,4693,15397
44732,2020-07-30,(07504) TERREROS,5971,3168,2674,11813
44733,2020-02-28,(08000) Portal Tunal - alimentacion,24845,13111,11924,49880
44734,2020-06-01,(05000) Portal Américas - alimentacion,9740,5128,4831,19699
44735,2020-02-25,(09100) Calle 40 Sur,7631,4406,4232,16269
44736,2020-08-17,(04000) Cabecera Calle 80 - alimentacion,1098,607,852,2557
44737,2020-02-17,(09000) Cabecera Usme - alimentacion,26017,15423,16190,57630
44738,2020-05-28,(07503) SAN MATEO,9304,5511,4273,19088
44739,2020-01-28,(05100) Banderas P. Central,7723,4554,3714,15991
44740,2020-02-10,(02102) Calle 161,1966,1268,1140,4374
44741,2020-01-07,(09115) Calle 34,2721,1851,1786,6358
44742,2020-08-13,(09113) Calle 22,403,232,282,917
44743,2020-02-14,(06102) Salitre El Greco,1544,879,723,3146
44744,2020-01-03,(10003) Ciudad Jardín,556,257,391,1204
44745,2020-02-06,(02205) Calle 106,2668,1792,1492,5952
44746,2020-03-04,(09104) Restrepo,5201,3099,3973,12273
44747,2020-01-16,(04104) Avenida 68,2929,1499,1625,6053
44748,2020-02-19,(04104) Avenida 68,3794,2004,1853,7651
44749,2020-09-14,(07110) PALOQUEMAO,700,390,355,1445
44750,2020-02-28,(12003) Ricaurte,1239,816,721,2776
44751,2020-03-13,(07111) NQS - RICAURTE,1186,155,345,1686
44752,2020-09-26,(05000) Portal Américas,3024,1350,2390,6764
44753,2020-07-20,(07102) NQS - CALLE 75,99,72,69,240
44754,2020-01-04,(02101) Toberín,2918,1308,2435,6661
44755,2020-01-26,(09103) Olaya,920,419,887,2226
44756,2020-07-25,(50003) Corral Molinos,980,494,703,2177
44757,2020-06-03,(07000) Portal Sur - alimentacion,7265,4037,3286,14588
44758,2020-08-21,(07000) Portal Sur - alimentacion,7746,4243,4027,16016
44759,2020-07-23,(05100) Banderas P. Central - alimentacion,2112,1154,1089,4355
44760,2020-05-27,(09103) Olaya,875,488,481,1844
44761,2020-07-07,(14001) La Sabana,183,121,112,416
44762,2020-08-24,(07111) NQS - RICAURTE,1099,649,427,2175
44763,2020-05-25,(05000) Portal Américas,651,401,492,1544
44764,2020-07-13,(02000) Cabecera Autopista Norte - alimentacion,4362,2406,2328,9096
44765,2020-01-15,(07506) DESPENSA,1421,849,862,3132
44766,2020-01-21,(07506) DESPENSA,1310,586,662,2558
44767,2020-07-06,(10006) San Victorino,831,347,372,1550
44768,2020-09-24,(06000) Portal Eldorado,931,631,691,2253
44769,2020-06-30,(40003) Mirador del Paraiso,1905,1138,1159,4202
44770,2020-09-29,(12001) Carrera 43,495,318,343,1156
44771,2020-03-15,(40003) Mirador del Paraiso,1389,656,1003,3048
44772,2020-07-10,(03000) Portal Suba,1368,843,916,3127
44773,2020-02-10,(09101) Quiroga,1708,1041,1282,4031
44774,2020-10-04,(07000) Portal Sur - alimentacion,3232,1264,2459,6955
44775,2020-07-30,(10002) Av. Primero de Mayo,2061,1031,1217,4309
44776,2020-04-02,(09107) Hortúa,390,269,258,917
44777,2020-03-19,(09123) Calle 76,2343,1713,1492,5548
44778,2020-06-13,(10002) Av. Primero de Mayo,1520,802,1102,3424
44779,2020-01-28,(08001) Parque el Tunal,1681,923,961,3565
44780,2020-02-20,(09120) Calle 63,7324,4513,3573,15410
44781,2020-09-18,(14004) Museo del Oro,426,275,333,1034
44782,2020-03-28,(02201) Prado,305,214,220,739
44783,2020-09-06,(02201) Prado,319,209,345,873
44784,2020-09-28,(02201) Prado,1011,697,780,2488
44785,2020-01-28,(07007) NQS - Calle 38A Sur,2055,1194,1257,4506
44786,2020-01-02,(03001) LA CAMPIÑA,2611,1470,1699,5780
44787,2020-01-20,(10009) Museo Nacional,3807,1948,1776,7531
44788,2020-08-29,(09107) Hortúa,404,263,347,1014
44789,2020-06-26,(09123) Calle 76,1113,785,628,2526
44790,2020-08-10,(09123) Calle 76,963,642,524,2129
44791,2020-04-11,(05000) Portal Américas,732,515,489,1736
44792,2020-09-16,(05002) Tintal,2805,1729,1934,6468
44793,2020-10-06,(02300) Calle 100,1341,959,985,3285
44794,2020-06-06,(09119) Calle 57,396,264,285,945
44795,2020-09-16,(04104) Avenida 68,703,373,410,1486
44796,2020-04-18,(10000) Portal 20 de Julio - alimentacion,2039,908,1185,4132
44797,2020-07-17,(05005) Transversal 86,196,180,296,672
44798,2020-07-01,(05105) Pradera,588,270,322,1180
44799,2020-02-24,(10008) San Diego,1657,789,785,3231
44800,2020-08-13,(03009) Av. Suba- Calle 116,411,285,192,888
44801,2020-02-08,(02205) Calle 106,940,680,884,2504
44802,2020-06-05,(02205) Calle 106,305,203,188,696
44803,2020-02-09,(10002) Av. Primero de Mayo,1506,744,1665,3915
44804,2020-02-14,(03006) NIZA - CALLE 127,2359,1456,1561,5376
44805,2020-01-13,(10008) San Diego,1160,655,691,2506
44806,2020-06-12,(09118) Marly,1407,946,746,3099
44807,2020-08-15,(09101) Quiroga,433,180,325,938
44808,2020-01-21,(12007) Zona Industrial,435,602,517,1554
44809,2020-02-15,(12007) Zona Industrial,684,503,475,1662
44810,2020-09-05,(06000) Portal Eldorado,618,498,674,1790
44811,2020-03-15,(04102) Avenida Boyaca,500,250,365,1115
44812,2020-07-08,(03007) HUMEDAL CORDOBA,174,118,88,380
44813,2020-08-13,(04104) Avenida 68,537,272,305,1114
44814,2020-09-11,(04104) Avenida 68,627,297,375,1299
44815,2020-03-13,(03001) LA CAMPIÑA,155,1331,1092,2578
44816,2020-03-21,(09004) Santa Lucía,628,321,331,1280
44817,2020-07-16,(02101) Toberín,1273,815,847,2935
44818,2020-06-02,(02204) Pepe Sierra,695,477,359,1531
44819,2020-08-27,(10005) Bicentenario - alimentacion,204,93,186,483
44820,2020-07-12,(05000) Portal Américas,780,472,714,1966
44821,2020-06-23,(09109) Tercer Milenio,364,228,264,856
44822,2020-03-31,(07001) PERDOMO,432,234,274,940
44823,2020-01-04,(06101) El Tiempo,435,331,485,1251
44824,2020-10-11,(06101) El Tiempo,94,73,140,307
44825,2020-02-15,(09119) Calle 57,1761,1070,1553,4384
44826,2020-09-07,(09110) Avenida Jimenez,937,728,768,2433
44827,2019-12-31,(09113) Calle 22,66,17,45,128
44828,2020-04-06,(03011) SUBA - CALLE 100,269,189,140,598
44829,2020-05-06,(02204) Pepe Sierra,537,379,239,1155
44830,2020-07-27,(02204) Pepe Sierra,714,543,385,1642
44831,2020-03-22,(02205) Calle 106,51,48,62,161
44832,2020-06-29,(02205) Calle 106,75,68,69,212
44833,2020-07-17,(03001) LA CAMPIÑA,1064,601,571,2236
44834,2020-04-26,(02000) Cabecera Autopista Norte,216,159,139,514
44835,2020-07-29,(06106) Recinto Ferial,226,129,102,457
44836,2020-01-01,(07009) SENA,272,150,410,832
44837,2020-01-10,(07107) U. NACIONAL,933,719,851,2503
44838,2020-01-21,(07003) SEVILLANA,1552,676,693,2921
44839,2020-01-26,(04100) Carrera 77,1425,597,1452,3474
44840,2020-04-08,(09109) Tercer Milenio,139,93,128,360
44841,2020-05-12,(09109) Tercer Milenio,268,166,182,616
44842,2020-08-04,(09109) Tercer Milenio,329,222,201,752
44843,2020-08-20,(07103) AV. CHILE,888,539,458,1885
44844,2020-09-05,(07007) NQS - Calle 38A Sur,401,232,283,916
44845,2020-07-15,(10002) Av. Primero de Mayo,1561,816,886,3263
44846,2020-05-10,(10010) San Bernardo,205,92,137,434
44847,2020-09-30,(10010) San Bernardo,645,303,577,1525
44848,2020-08-12,(40002) Manitas,396,229,251,876
44849,2020-01-11,(06001) Modelia,710,496,760,1966
44850,2020-07-15,(02001) Centro Comercial Santa Fe,466,297,274,1037
44851,2020-06-14,(05100) Banderas P. Central - alimentacion,693,319,498,1510
44852,2020-08-21,(09120) Calle 63,923,605,648,2176
44853,2020-05-29,(09003) Socorro,518,261,293,1072
44854,2020-01-05,(09119) Calle 57,322,241,512,1075
44855,2020-09-14,(06111) Universidades,445,227,453,1125
44856,2020-09-14,(07003) SEVILLANA,465,274,301,1040
44857,2020-06-28,(09115) Calle 34,172,132,151,455
44858,2020-04-27,(02204) Pepe Sierra,108,249,134,491
44859,2020-01-04,(07201) Guatoque -Veraguas,236,142,275,653
44860,2020-03-08,(07110) PALOQUEMAO,342,299,414,1055
44861,2020-06-06,(10009) Museo Nacional,216,149,215,580
44862,2020-03-15,(02000) Cabecera Autopista Norte,1438,779,1337,3554
44863,2020-01-16,(12004) Carrera 22,629,394,408,1431
44864,2020-08-16,(09106) Nariño,135,72,117,324
44865,2020-08-29,(07005) ALQUERIA,453,265,324,1042
44866,2020-06-30,(03012) SUBA - CALLE 95,352,214,186,752
44867,2020-06-25,(04003) Avenida Ciudad de Cali,1053,627,750,2430
44868,2020-07-29,(09114) Calle 26,303,197,196,696
44869,2020-02-23,(09123) Calle 76,566,466,802,1834
44870,2020-06-13,(10006) San Victorino,356,212,277,845
44871,2020-09-23,(05103) Marsella,503,327,335,1165
44872,2020-04-26,(09119) Calle 57,111,96,84,291
44873,2020-06-07,(08000) Portal Tunal,189,117,110,416
44874,2020-09-19,(04000) Cabecera Calle 80,913,502,1013,2428
44875,2020-08-23,(10000) Portal 20 de Julio - alimentacion,1285,538,951,2774
44876,2020-05-09,(40002) Manitas,187,122,119,428
44877,2020-04-29,(12000) Puente Aranda,46,34,24,104
44878,2020-05-26,(07109) CAD,577,383,230,1190
44879,2020-07-26,(02205) Calle 106,54,46,59,159
44880,2020-02-27,(05101) Mandalay - Cr.73,1252,652,558,2462
44881,2020-09-14,(02102) Calle 161,256,156,200,612
44882,2020-04-13,(07107) U. NACIONAL,216,164,110,490
44883,2020-05-02,(07107) U. NACIONAL,159,107,82,348
44884,2020-05-26,(02102) Calle 161,220,132,109,461
44885,2020-07-01,(10003) Ciudad Jardín,257,110,147,514
44886,2020-09-11,(09114) Calle 26,327,223,244,794
44887,2020-05-29,(06106) Recinto Ferial,236,144,125,505
44888,2020-06-23,(06106) Recinto Ferial,269,165,111,545
44889,2020-05-20,(07102) NQS - CALLE 75,327,218,164,709
44890,2020-05-11,(04106) Carrera 47,217,135,133,485
44891,2020-07-22,(10010) San Bernardo,519,282,341,1142
44892,2020-03-25,(14001) La Sabana,59,50,56,165
44893,2020-08-30,(02101) Toberín,283,172,367,822
44894,2020-06-28,(04003) Avenida Ciudad de Cali,334,183,261,778
44895,2020-07-28,(04105) Carrera 53,286,154,144,584
44896,2020-05-02,(06002) Normandía,113,67,86,266
44897,2020-06-04,(06002) Normandía,277,177,151,605
44898,2020-09-08,(04001) Quirigua,410,245,290,945
44899,2020-09-06,(04000) Cabecera Calle 80 - intermunicipal,90,40,88,218
44900,2020-09-07,(03010) PUENTE LARGO,383,211,233,827
44901,2020-09-17,(07006) General Santander - alimentacion,430,237,324,991
44902,2020-08-28,(04103) Las Ferias,398,214,196,808
44903,2020-08-07,(09000) Cabecera Usme,643,357,546,1546
44904,2020-06-22,(09003) Socorro,254,112,155,521
44905,2020-02-29,(09111) Calle 19,1445,1014,1375,3834
44906,2020-06-25,(02304) Heroes,885,645,478,2008
44907,2020-08-01,(07506) DESPENSA,325,166,209,700
44908,2020-07-23,(06105) Quinta Paredes,130,66,60,256
44909,2020-05-01,(07003) SEVILLANA,105,54,76,235
44910,2020-05-23,(07107) U. NACIONAL,192,125,121,438
44911,2020-07-13,(40002) Manitas,245,163,170,578
44912,2020-09-24,(40002) Manitas,444,274,310,1028
44913,2020-01-01,(07007) NQS - Calle 38A Sur,161,93,226,480
44914,2020-04-12,(02000) Cabecera Autopista Norte - intermunicipal,24,14,31,69
44915,2020-08-07,(04002) Carrera 90,263,140,164,567
44916,2020-07-08,(03002) SUBA - TV- 91,815,502,538,1855
44917,2020-07-17,(06001) Modelia,329,215,165,709
44918,2020-10-02,(07201) Guatoque -Veraguas,231,144,194,569
44919,2020-06-15,(03009) Av. Suba- Calle 116,163,114,90,367
44920,2020-08-16,(05107) Américas - Cr.53,77,60,95,232
44921,2020-04-30,(03002) SUBA - TV- 91,478,283,235,996
44922,2020-06-20,(10003) Ciudad Jardín,173,72,137,382
44923,2020-08-23,(09117) Calle 45,195,119,174,488
44924,2020-05-23,(03013) RIO NEGRO,168,107,114,389
44925,2020-07-27,(10003) Ciudad Jardín,205,88,135,428
44926,2020-08-22,(06103) CAN,211,139,142,492
44927,2020-04-05,(10010) San Bernardo,130,91,106,327
44928,2020-08-16,(12002) CDS - Carrera 32,37,27,21,85
44929,2020-09-27,(03005) SUBA - AV. BOYACA,130,69,175,374
44930,2020-06-21,(14005) Las Aguas,51,33,81,165
44931,2020-07-05,(06103) CAN,120,80,73,273
44932,2020-03-26,(14005) Las Aguas,0,43,89,132
44933,2020-05-10,(09105) Río Fucha,37,16,26,79
44934,2020-05-02,(10005) Bicentenario,42,22,42,106
44935,2020-04-18,(14004) Museo del Oro,0,24,53,77
44936,2020-04-05,(02103) Mazurén,20,21,25,66
44937,2020-05-01,(10005) Bicentenario,35,21,36,92
44938,2020-04-24,(04001) Quirigua,207,120,98,425
44939,2020-08-02,(02204) Pepe Sierra,192,129,110,431
44940,2020-04-05,(03011) SUBA - CALLE 100,120,71,48,239
44941,2020-06-06,(50002) Corral Calle 40 Sur,12,4,10,26
44942,2020-04-05,(07002) MADELENA,109,67,66,242
44943,2020-04-19,(07010) Bosa,113,58,62,233
44944,2020-06-06,(05102) Av. Américas - Av. Boyacá,120,78,97,295
44945,2020-06-14,(10005) Bicentenario - alimentacion,39,24,71,134
44946,2020-08-31,(10005) Bicentenario,91,60,69,220
44947,2020-05-04,(05101) Mandalay - Cr.73,72,38,38,148
44948,2019-12-31,(40001) Juan Pablo II,17,15,26,58
44949,2020-10-09,(12000) Puente Aranda,92,49,74,215
44950,2020-06-15,(10005) Bicentenario - alimentacion,71,38,67,176
44951,2020-04-14,(03014) SAN MARTIN,17,7,16,40
44952,2020-08-12,(04000) Cabecera Calle 80 - alimentacion,3348,1943,2279,7570
44953,2020-01-23,(09002) Consuelo,1369,732,850,2951
44954,2020-03-07,(09002) Consuelo,971,438,790,2199
44955,2020-07-17,(09002) Consuelo,340,192,216,748
44956,2020-09-18,(09002) Consuelo,548,292,387,1227
44957,2020-10-02,(09118) Marly,1586,1072,1164,3822
44958,2020-10-01,(07504) TERREROS,7122,3612,4034,14768
44959,2020-06-24,(09119) Calle 57,585,387,399,1371
44960,2020-01-02,(05000) Portal Américas - alimentacion,17999,9499,11119,38617
44961,2020-06-08,(05000) Portal Américas - alimentacion,10267,5201,4839,20307
44962,2020-03-18,(07505) LEON XIII,5470,2928,2301,10699
44963,2020-01-13,(09122) Calle 72,5335,3505,3500,12340
44964,2020-03-07,(09122) Calle 72,3227,2301,3261,8789
44965,2020-10-09,(07503) SAN MATEO,14267,7091,8557,29915
44966,2020-02-24,(02000) Cabecera Autopista Norte - alimentacion,23752,14138,13100,50990
44967,2020-03-07,(09121) Las Flores,1722,1255,1660,4637
44968,2020-01-06,(02102) Calle 161,164,87,260,511
44969,2020-08-02,(10000) Portal 20 de Julio - alimentacion,1297,555,923,2775
44970,2020-03-12,(05100) Banderas P. Central,227,1818,1151,3196
44971,2020-02-04,(07001) PERDOMO,4713,2879,2591,10183
44972,2020-08-20,(07001) PERDOMO,844,483,525,1852
44973,2020-09-22,(07505) LEON XIII,2935,1556,1475,5966
44974,2020-10-10,(07505) LEON XIII,2420,1151,1606,5177
44975,2020-01-15,(03009) Av. Suba- Calle 116,2246,1378,1269,4893
44976,2020-05-16,(09101) Quiroga,278,137,217,632
44977,2020-02-07,(07102) NQS - CALLE 75,1457,970,1037,3464
44978,2020-05-12,(07102) NQS - CALLE 75,309,206,162,677
44979,2020-02-26,(14001) La Sabana,434,397,417,1248
44980,2020-10-01,(07111) NQS - RICAURTE,1252,764,656,2672
44981,2020-10-02,(02000) Cabecera Autopista Norte,1788,1043,1415,4246
44982,2020-10-01,(09113) Calle 22,419,254,406,1079
44983,2020-02-08,(10002) Av. Primero de Mayo,4911,2415,3839,11165
44984,2020-08-30,(05000) Portal Américas,848,446,815,2109
44985,2020-02-22,(04100) Carrera 77,3980,1892,3070,8942
44986,2020-08-28,(04100) Carrera 77,1266,677,881,2824
44987,2020-10-03,(10001) Country Sur,1189,517,1085,2791
44988,2020-02-05,(09111) Calle 19,2412,1430,1523,5365
44989,2020-02-21,(06000) Portal Eldorado,6555,3751,2936,13242
44990,2020-02-13,(10008) San Diego,1635,845,757,3237
44991,2020-02-07,(07505) LEON XIII,8867,4902,3886,17655
44992,2020-03-28,(50003) Corral Molinos,559,238,356,1153
44993,2020-10-08,(10002) Av. Primero de Mayo,2521,1187,1823,5531
44994,2020-01-04,(10005) Bicentenario - alimentacion,292,133,325,750
44995,2020-03-21,(10006) San Victorino,73,64,70,207
44996,2020-01-16,(02105) Calle 142,5832,3315,3495,12642
44997,2020-03-11,(02201) Prado,5615,3560,2898,12073
44998,2020-06-21,(05100) Banderas P. Central - alimentacion,855,431,587,1873
44999,2020-09-06,(03000) Portal Suba - alimentacion,2337,1036,1937,5310
45000,2020-03-14,(02303) Calle 85,1397,1076,1206,3679
45001,2020-05-27,(07004) VENECIA,831,477,442,1750
45002,2020-04-05,(07503) SAN MATEO,2386,1224,1029,4639
45003,2020-06-02,(06108) Concejo de Bogotá,120,74,65,259
45004,2020-02-15,(07001) PERDOMO,2783,1233,2157,6173
45005,2020-08-28,(04000) Cabecera Calle 80,1135,647,906,2688
45006,2020-05-03,(10001) Country Sur,202,99,130,431
45007,2020-07-03,(10002) Av. Primero de Mayo,2324,1173,1485,4982
45008,2020-03-12,(03000) Portal Suba,423,2249,1579,4251
45009,2020-10-02,(09120) Calle 63,1289,916,1165,3370
45010,2020-07-13,(05000) Portal Américas,2369,1633,1612,5614
45011,2020-05-13,(09107) Hortúa,500,334,251,1085
45012,2020-08-13,(09107) Hortúa,595,366,333,1294
45013,2020-06-09,(09123) Calle 76,1015,670,535,2220
45014,2020-08-20,(09123) Calle 76,927,659,499,2085
45015,2020-03-07,(05103) Marsella,1445,682,1103,3230
45016,2020-09-18,(02103) Mazurén,248,137,252,637
45017,2020-02-24,(03012) SUBA - CALLE 95,1437,921,917,3275
45018,2020-03-11,(03012) SUBA - CALLE 95,1331,917,1003,3251
45019,2020-09-15,(10000) Portal 20 de Julio,2338,1139,1354,4831
45020,2020-05-29,(09119) Calle 57,507,351,348,1206
45021,2020-02-19,(07006) General Santander,2980,1749,1542,6271
45022,2020-09-23,(07006) General Santander,622,390,423,1435
45023,2020-01-24,(10010) San Bernardo,1599,918,1256,3773
45024,2020-01-14,(08000) Portal Tunal,1784,982,1030,3796
45025,2020-06-28,(08000) Portal Tunal,220,121,122,463
45026,2020-06-02,(02205) Calle 106,311,214,164,689
45027,2020-02-18,(03006) NIZA - CALLE 127,2480,1592,1453,5525
45028,2020-07-18,(04003) Avenida Ciudad de Cali,652,368,465,1485
45029,2020-09-18,(06000) Portal Eldorado - alimentacion,4393,2179,2906,9478
45030,2020-07-10,(02304) Heroes,923,652,519,2094
45031,2020-06-12,(06000) Portal Eldorado - alimentacion,4068,1974,1963,8005
45032,2020-09-06,(07106) EL CAMPIN,146,109,113,368
45033,2020-09-05,(04100) Carrera 77,1119,536,940,2595
45034,2020-06-20,(03001) LA CAMPIÑA,793,384,453,1630
45035,2020-01-19,(14004) Museo del Oro,0,127,406,533
45036,2020-01-23,(09117) Calle 45,4741,3193,2654,10588
45037,2020-04-08,(10000) Portal 20 de Julio,1199,596,577,2372
45038,2020-08-24,(07104) Simon Bolivar,577,338,245,1160
45039,2020-08-06,(10005) Bicentenario - alimentacion,193,103,157,453
45040,2020-09-24,(04107) Escuela Militar,165,118,105,388
45041,2020-09-28,(08000) Portal Tunal,768,378,413,1559
45042,2020-09-19,(02103) Mazurén,176,87,208,471
45043,2020-04-14,(05105) Pradera,410,297,147,854
45044,2020-02-08,(07103) AV. CHILE,2122,1372,1549,5043
45045,2020-03-04,(04001) Quirigua,2009,1267,1208,4484
45046,2020-02-18,(03001) LA CAMPIÑA,6796,4217,4261,15274
45047,2020-01-02,(09117) Calle 45,1253,935,1300,3488
45048,2020-09-25,(02202) Calle 127,1249,857,834,2940
45049,2020-10-08,(04001) Quirigua,465,295,366,1126
45050,2020-06-27,(02204) Pepe Sierra,643,434,361,1438
45051,2020-05-24,(09118) Marly,490,287,229,1006
45052,2020-06-01,(05100) Banderas P. Central - alimentacion,1589,1034,1306,3929
45053,2020-06-29,(05100) Banderas P. Central,211,100,180,491
45054,2020-06-22,(02105) Calle 142,220,190,171,581
45055,2020-01-25,(05102) Av. Américas - Av. Boyacá,774,392,561,1727
45056,2020-09-25,(10010) San Bernardo,655,337,525,1517
45057,2020-06-10,(07103) AV. CHILE,927,525,397,1849
45058,2020-10-01,(06109) Centro Memoria,290,190,193,673
45059,2020-06-05,(09117) Calle 45,699,427,387,1513
45060,2020-02-16,(02001) Centro Comercial Santa Fe,628,377,906,1911
45061,2020-05-23,(05100) Banderas P. Central - alimentacion,1698,762,832,3292
45062,2020-03-18,(07006) General Santander,1472,823,754,3049
45063,2020-07-29,(07003) SEVILLANA,393,212,214,819
45064,2020-05-03,(06000) Portal Eldorado - alimentacion,898,424,417,1739
45065,2020-01-04,(14001) La Sabana,122,97,149,368
45066,2020-06-18,(40001) Juan Pablo II,556,383,330,1269
45067,2020-10-10,(09115) Calle 34,392,284,520,1196
45068,2020-06-08,(03006) NIZA - CALLE 127,417,230,217,864
45069,2020-07-17,(03006) NIZA - CALLE 127,478,250,193,921
45070,2020-08-27,(07006) General Santander,574,334,295,1203
45071,2020-03-19,(14005) Las Aguas,0,424,916,1340
45072,2020-06-28,(09123) Calle 76,216,184,201,601
45073,2020-07-07,(09111) Calle 19,821,503,486,1810
45074,2020-04-30,(09123) Calle 76,559,424,344,1327
45075,2020-06-11,(07105) MOVISTAR ARENA,235,144,130,509
45076,2020-10-04,(07104) Simon Bolivar,124,101,185,410
45077,2020-07-04,(07107) U. NACIONAL,235,171,178,584
45078,2020-08-11,(03003) 21 ANGELES,266,155,131,552
45079,2020-04-24,(07113) SANTA ISABEL,232,147,128,507
45080,2020-05-20,(04001) Quirigua,325,202,189,716
45081,2020-07-12,(40002) Manitas,185,85,145,415
45082,2020-09-29,(05103) Marsella,542,327,379,1248
45083,2020-08-20,(10007) Las Nieves,550,333,304,1187
45084,2020-09-23,(06102) Salitre El Greco,281,161,199,641
45085,2020-09-02,(05102) Av. Américas - Av. Boyacá,267,144,190,601
45086,2020-06-02,(09110) Avenida Jimenez,1021,690,653,2364
45087,2020-01-01,(02201) Prado,339,211,474,1024
45088,2020-04-09,(07007) NQS - Calle 38A Sur,64,43,22,129
45089,2020-07-30,(09122) Calle 72,1101,754,739,2594
45090,2020-08-11,(12004) Carrera 22,251,148,127,526
45091,2020-09-03,(12004) Carrera 22,258,165,154,577
45092,2020-08-26,(06000) Portal Eldorado,863,536,411,1810
45093,2020-04-21,(10009) Museo Nacional,321,184,175,680
45094,2020-10-03,(04106) Carrera 47,288,164,232,684
45095,2020-07-21,(10007) Las Nieves,388,236,286,910
45096,2020-03-13,(07003) SEVILLANA,134,339,319,792
45097,2020-08-28,(07008) NQS - Calle 30 Sur,321,184,219,724
45098,2020-01-13,(09003) Socorro,1421,743,953,3117
45099,2020-04-06,(40001) Juan Pablo II,272,138,169,579
45100,2020-10-01,(07006) General Santander,634,344,422,1400
45101,2020-06-02,(07200) Tygua-San José,239,121,137,497
45102,2020-01-09,(09108) Hospital,168,86,188,442
45103,2020-03-01,(04103) Las Ferias,296,167,306,769
45104,2020-08-17,(06108) Concejo de Bogotá,40,22,28,90
45105,2020-05-10,(02502) Terminal,55,39,60,154
45106,2020-06-06,(07006) General Santander,383,229,234,846
45107,2020-01-06,(10003) Ciudad Jardín,174,79,187,440
45108,2020-05-25,(10002) Av. Primero de Mayo,544,275,407,1226
45109,2020-03-21,(07108) Av. El Dorado,34,32,17,83
45110,2020-10-04,(09119) Calle 57,198,145,295,638
45111,2020-10-02,(05101) Mandalay - Cr.73,177,106,129,412
45112,2020-05-19,(03011) SUBA - CALLE 100,382,177,181,740
45113,2020-01-25,(10008) San Diego,612,440,613,1665
45114,2020-06-28,(02001) Centro Comercial Santa Fe,148,94,134,376
45115,2020-08-23,(02303) Calle 85,162,120,131,413
45116,2020-10-12,(03005) SUBA - AV. BOYACA,144,89,183,416
45117,2020-09-20,(07005) ALQUERIA,187,109,205,501
45118,2020-03-31,(10004) Policarpa,108,67,64,239
45119,2020-09-28,(40002) Manitas,415,265,317,997
45120,2020-04-09,(06002) Normandía,79,43,37,159
45121,2020-08-24,(07105) MOVISTAR ARENA,235,118,118,471
45122,2020-09-12,(10003) Ciudad Jardín,196,76,161,433
45123,2020-05-25,(09121) Las Flores,206,136,149,491
45124,2020-08-22,(12004) Carrera 22,184,122,126,432
45125,2020-04-08,(07007) NQS - Calle 38A Sur,152,98,89,339
45126,2020-06-09,(09114) Calle 26,297,194,197,688
45127,2020-08-04,(07101) CASTELLANA,177,91,98,366
45128,2020-05-03,(07110) PALOQUEMAO,142,103,78,323
45129,2020-04-16,(09113) Calle 22,213,133,186,532
45130,2020-07-28,(05103) Marsella,346,204,194,744
45131,2020-10-11,(04103) Las Ferias,121,63,114,298
45132,2020-05-31,(06002) Normandía,70,43,63,176
45133,2020-06-03,(03014) SAN MARTIN,28,6,20,54
45134,2020-03-29,(12003) Ricaurte,34,31,25,90
45135,2020-05-03,(10004) Policarpa,64,39,57,160
45136,2020-08-10,(06105) Quinta Paredes,130,100,70,300
45137,2020-07-12,(07006) General Santander - alimentacion,83,59,86,228
45138,2020-04-19,(07002) MADELENA,104,51,76,231
45139,2020-08-12,(05102) Av. Américas - Av. Boyacá,229,121,146,496
45140,2020-03-07,(50006) Corral Carrera 77,21,13,27,61
45141,2020-04-10,(07101) CASTELLANA,17,18,20,55
45142,2020-08-09,(07003) SEVILLANA,114,52,100,266
45143,2020-06-01,(10005) Bicentenario,108,50,71,229
45144,2020-09-10,(50006) Corral Carrera 77,4,4,9,17
45145,2020-03-29,(10008) San Diego,41,37,36,114
45146,2020-02-20,(50006) Corral Carrera 77,27,19,34,80
45147,2020-05-15,(50006) Corral Carrera 77,4,4,8,16
45148,2020-08-08,(03014) SAN MARTIN,0,10,19,29
45149,2020-09-27,(50002) Corral Calle 40 Sur,8,1,5,14
45150,2020-03-28,(04000) Cabecera Calle 80 - alimentacion,1134,686,632,2452
45151,2020-02-10,(09119) Calle 57,3945,2457,2062,8464
45152,2020-02-15,(03002) SUBA - TV- 91,2423,1137,1738,5298
45153,2020-03-09,(09122) Calle 72,3890,610,1000,5500
45154,2020-09-22,(07503) SAN MATEO,12918,6849,6766,26533
45155,2020-02-24,(06000) Portal Eldorado - alimentacion,18528,10648,9646,38822
45156,2020-08-04,(09100) Calle 40 Sur,1594,925,1012,3531
45157,2020-02-04,(09114) Calle 26,3239,2096,1815,7150
45158,2020-01-31,(09003) Socorro,1630,857,1058,3545
45159,2020-02-17,(02000) Cabecera Autopista Norte - alimentacion,24099,14418,13729,52246
45160,2020-09-03,(07111) NQS - RICAURTE,1219,723,531,2473
45161,2020-03-13,(07000) Portal Sur - alimentacion,874,5765,4003,10642
45162,2020-03-03,(14004) Museo del Oro,4259,2602,1997,8858
45163,2020-01-28,(05005) Transversal 86,2599,1491,1260,5350
45164,2020-10-08,(07112) COMUNEROS,899,522,733,2154
45165,2020-02-27,(50006) Corral Carrera 77,37,21,38,96
45166,2020-09-04,(05100) Banderas P. Central,1058,591,760,2409
45167,2020-05-14,(10001) Country Sur,868,362,507,1737
45168,2020-02-06,(09000) Cabecera Usme,5889,3625,3923,13437
45169,2020-02-02,(07000) Portal Sur - alimentacion,7665,3171,5607,16443
45170,2020-01-10,(10003) Ciudad Jardín,758,370,574,1702
45171,2020-01-17,(10003) Ciudad Jardín,887,413,636,1936
45172,2020-02-25,(02101) Toberín,14843,9647,7541,32031
45173,2020-04-08,(08000) Portal Tunal - alimentacion,3283,1721,1792,6796
45174,2020-06-03,(08000) Portal Tunal - alimentacion,5651,3280,3225,12156
45175,2020-02-24,(02105) Calle 142,7217,4449,3741,15407
45176,2020-01-13,(02205) Calle 106,2291,1435,1197,4923
45177,2020-02-28,(02205) Calle 106,2593,1688,1435,5716
45178,2020-07-24,(07001) PERDOMO,717,416,450,1583
45179,2020-09-10,(09000) Cabecera Usme - alimentacion,8553,4291,5233,18077
45180,2020-01-28,(09104) Restrepo,5087,3109,3791,11987
45181,2020-06-24,(09104) Restrepo,1569,943,1089,3601
45182,2020-01-12,(07504) TERREROS,4267,1751,3175,9193
45183,2020-07-04,(02204) Pepe Sierra,624,416,436,1476
45184,2020-01-02,(04104) Avenida 68,1420,758,986,3164
45185,2020-01-09,(06002) Normandía,1546,913,953,3412
45186,2020-03-18,(09104) Restrepo,3137,1886,2327,7350
45187,2020-01-31,(02502) Terminal,4891,2985,2976,10852
45188,2020-02-10,(07110) PALOQUEMAO,2803,1711,1209,5723
45189,2020-02-05,(06106) Recinto Ferial,1587,948,765,3300
45190,2020-06-08,(07102) NQS - CALLE 75,384,237,229,850
45191,2020-07-12,(03013) RIO NEGRO,75,59,92,226
45192,2020-07-24,(03013) RIO NEGRO,254,151,158,563
45193,2020-02-01,(09103) Olaya,2511,1157,1867,5535
45194,2020-01-13,(03001) LA CAMPIÑA,5414,3112,3327,11853
45195,2020-03-02,(03001) LA CAMPIÑA,6322,4037,4244,14603
45196,2020-07-04,(03001) LA CAMPIÑA,842,419,565,1826
45197,2020-06-13,(50003) Corral Molinos,1240,600,934,2774
45198,2020-08-20,(07000) Portal Sur - alimentacion,7429,4201,3798,15428
45199,2020-09-19,(05100) Banderas P. Central - alimentacion,2824,1274,2070,6168
45200,2020-09-30,(07111) NQS - RICAURTE,1239,817,649,2705
45201,2020-03-16,(07002) MADELENA,3418,1926,1687,7031
45202,2020-07-13,(02000) Cabecera Autopista Norte,1200,739,724,2663
45203,2020-02-10,(07107) U. NACIONAL,2629,1559,1358,5546
45204,2020-09-30,(09113) Calle 22,417,244,423,1084
45205,2020-04-29,(03003) 21 ANGELES,199,102,103,404
45206,2020-03-05,(10007) Las Nieves,2013,1230,1216,4459
45207,2020-02-19,(09004) Santa Lucía,7098,4356,4380,15834
45208,2020-09-04,(09004) Santa Lucía,2795,1517,1598,5910
45209,2020-01-24,(10002) Av. Primero de Mayo,7756,3689,4484,15929
45210,2020-01-24,(02104) Calle 146,8724,5077,4786,18587
45211,2020-06-10,(50003) Corral Molinos,1411,744,983,3138
45212,2020-08-27,(05000) Portal Américas,2986,1870,1983,6839
45213,2020-08-01,(09110) Avenida Jimenez,1081,779,628,2488
45214,2020-06-09,(04100) Carrera 77,1196,670,737,2603
45215,2020-06-13,(03000) Portal Suba,881,500,636,2017
45216,2020-05-15,(40003) Mirador del Paraiso,1356,861,876,3093
45217,2020-08-15,(40003) Mirador del Paraiso,1493,847,1024,3364
45218,2020-06-27,(12001) Carrera 43,297,172,223,692
45219,2020-02-29,(09107) Hortúa,1358,755,1193,3306
45220,2020-09-25,(06105) Quinta Paredes,173,109,127,409
45221,2020-01-10,(06101) El Tiempo,1962,1110,1088,4160
45222,2020-02-15,(09101) Quiroga,1180,575,1088,2843
45223,2020-07-08,(10000) Portal 20 de Julio,2429,1207,1217,4853
45224,2020-03-30,(07000) Portal Sur - alimentacion,3878,1904,1549,7331
45225,2020-01-24,(02300) Calle 100,6547,4227,3793,14567
45226,2020-02-10,(09004) Santa Lucía,7688,4439,4291,16418
45227,2020-05-30,(09004) Santa Lucía,1857,881,1022,3760
45228,2020-07-04,(09004) Santa Lucía,2329,1153,1329,4811
45229,2020-01-21,(02502) Terminal,3567,2048,1774,7389
45230,2020-08-30,(07504) TERREROS,1772,829,1253,3854
45231,2020-04-01,(07503) SAN MATEO,5538,3025,2763,11326
45232,2020-04-20,(07503) SAN MATEO,5565,3488,2540,11593
45233,2020-02-08,(06108) Concejo de Bogotá,314,229,401,944
45234,2020-04-08,(07001) PERDOMO,410,244,290,944
45235,2020-05-24,(07503) SAN MATEO,2291,1343,1084,4718
45236,2020-08-05,(09113) Calle 22,425,212,303,940
45237,2020-03-14,(08001) Parque el Tunal,1057,507,691,2255
45238,2020-09-09,(14004) Museo del Oro,389,232,342,963
45239,2020-02-25,(06001) Modelia,2704,1601,1245,5550
45240,2020-06-25,(05100) Banderas P. Central,807,462,512,1781
45241,2020-08-12,(03000) Portal Suba - alimentacion,5058,2912,2936,10906
45242,2020-07-12,(09107) Hortúa,207,142,189,538
45243,2020-05-13,(07112) COMUNEROS,587,364,275,1226
45244,2020-07-14,(02300) Calle 100,1071,689,547,2307
45245,2020-09-07,(02300) Calle 100,1280,862,744,2886
45246,2020-02-22,(02103) Mazurén,1045,470,1069,2584
45247,2020-01-22,(10008) San Diego,1345,750,756,2851
45248,2020-02-28,(04105) Carrera 53,1500,817,847,3164
45249,2020-08-27,(06109) Centro Memoria,245,153,125,523
45250,2020-03-25,(08000) Portal Tunal,362,216,162,740
45251,2020-02-11,(03009) Av. Suba- Calle 116,2705,1682,1498,5885
45252,2020-06-05,(06111) Universidades,0,138,419,557
45253,2020-09-28,(04101) Minuto de Dios,413,225,393,1031
45254,2020-02-07,(04003) Avenida Ciudad de Cali,5815,3200,3656,12671
45255,2020-09-23,(04108) El Polo,571,323,342,1236
45256,2020-01-08,(07101) CASTELLANA,672,442,444,1558
45257,2020-05-15,(06102) Salitre El Greco,169,97,86,352
45258,2020-06-01,(10006) San Victorino,501,276,333,1110
45259,2020-01-17,(07108) Av. El Dorado,787,520,596,1903
45260,2020-10-08,(04100) Carrera 77,1495,814,1272,3581
45261,2020-10-10,(09117) Calle 45,560,346,599,1505
45262,2020-01-16,(05107) Américas - Cr.53,2140,1247,1269,4656
45263,2020-03-26,(07110) PALOQUEMAO,315,266,205,786
45264,2020-08-30,(09100) Calle 40 Sur,617,322,525,1464
45265,2020-05-18,(10005) Bicentenario - alimentacion,188,102,151,441
45266,2020-07-10,(04107) Escuela Militar,159,94,93,346
45267,2020-09-27,(07109) CAD,213,155,188,556
45268,2020-04-05,(07004) VENECIA,186,106,102,394
45269,2020-05-26,(02304) Heroes,703,509,368,1580
45270,2020-08-13,(09109) Tercer Milenio,365,212,227,804
45271,2020-07-31,(07002) MADELENA,720,412,458,1590
45272,2020-01-01,(04105) Carrera 53,95,52,150,297
45273,2020-07-06,(09117) Calle 45,786,470,451,1707
45274,2020-01-01,(10000) Portal 20 de Julio - alimentacion,1400,563,1554,3517
45275,2020-04-19,(02202) Calle 127,347,212,145,704
45276,2020-10-06,(06002) Normandía,380,254,301,935
45277,2020-03-08,(06000) Portal Eldorado,733,587,1017,2337
45278,2020-03-23,(07113) SANTA ISABEL,69,45,61,175
45279,2020-08-14,(02105) Calle 142,714,441,532,1687
45280,2020-08-28,(02105) Calle 142,801,481,545,1827
45281,2020-09-23,(06100) Av. Rojas,287,180,236,703
45282,2020-06-19,(06000) Portal Eldorado,969,691,517,2177
45283,2020-05-05,(12003) Ricaurte,241,191,106,538
45284,2020-09-04,(03013) RIO NEGRO,312,170,241,723
45285,2020-08-04,(03010) PUENTE LARGO,252,166,155,573
45286,2020-09-08,(10010) San Bernardo,628,318,465,1411
45287,2020-03-17,(05100) Banderas P. Central,3905,2220,1902,8027
45288,2020-01-12,(03009) Av. Suba- Calle 116,352,244,385,981
45289,2020-06-19,(03006) NIZA - CALLE 127,536,283,274,1093
45290,2020-01-10,(10005) Bicentenario,549,293,339,1181
45291,2020-07-12,(07007) NQS - Calle 38A Sur,187,114,121,422
45292,2020-08-07,(07103) AV. CHILE,219,159,194,572
45293,2020-08-27,(07103) AV. CHILE,884,566,452,1902
45294,2020-07-02,(09106) Nariño,429,255,311,995
45295,2020-10-07,(02304) Heroes,1032,712,739,2483
45296,2020-06-22,(02104) Calle 146,262,182,190,634
45297,2020-06-27,(10008) San Diego,208,124,167,499
45298,2020-07-13,(09120) Calle 63,811,548,525,1884
45299,2020-09-04,(03011) SUBA - CALLE 100,580,280,328,1188
45300,2020-09-29,(07113) SANTA ISABEL,436,278,399,1113
45301,2020-03-05,(05102) Av. Américas - Av. Boyacá,1913,1122,1003,4038
45302,2020-02-27,(04102) Avenida Boyaca,3039,1822,1592,6453
45303,2020-06-06,(02000) Cabecera Autopista Norte - alimentacion,3657,1877,2036,7570
45304,2020-10-03,(04000) Cabecera Calle 80 - intermunicipal,268,137,332,737
45305,2020-04-28,(05001) Patio Bonito,1105,593,652,2350
45306,2020-04-24,(02201) Prado,466,313,222,1001
45307,2020-04-18,(07004) VENECIA,363,241,178,782
45308,2020-07-20,(02304) Heroes,168,133,139,440
45309,2020-04-17,(09122) Calle 72,630,421,378,1429
45310,2020-06-30,(09120) Calle 63,1152,774,756,2682
45311,2020-09-19,(07111) NQS - RICAURTE,937,637,589,2163
45312,2020-01-06,(03001) LA CAMPIÑA,761,380,744,1885
45313,2020-07-31,(07201) Guatoque -Veraguas,171,89,117,377
45314,2020-08-21,(07201) Guatoque -Veraguas,185,82,136,403
45315,2020-01-08,(07105) MOVISTAR ARENA,932,617,570,2119
45316,2020-06-25,(07105) MOVISTAR ARENA,255,154,153,562
45317,2020-03-30,(09121) Las Flores,380,297,247,924
45318,2020-01-25,(09105) Río Fucha,402,217,399,1018
45319,2020-06-03,(05105) Pradera,508,335,205,1048
45320,2020-09-02,(09114) Calle 26,303,195,220,718
45321,2020-04-06,(02303) Calle 85,302,257,186,745
45322,2020-04-07,(06109) Centro Memoria,132,96,91,319
45323,2020-10-06,(07104) Simon Bolivar,630,373,450,1453
45324,2020-04-04,(09119) Calle 57,175,116,114,405
45325,2020-09-04,(03005) SUBA - AV. BOYACA,531,305,333,1169
45326,2020-06-15,(06111) Universidades,61,56,123,240
45327,2020-09-01,(05102) Av. Américas - Av. Boyacá,230,129,141,500
45328,2020-04-01,(09114) Calle 26,138,127,118,383
45329,2020-05-26,(07111) NQS - RICAURTE,990,630,427,2047
45330,2020-07-28,(12000) Puente Aranda,84,41,32,157
45331,2020-05-07,(09104) Restrepo,937,601,721,2259
45332,2020-04-03,(12001) Carrera 43,234,172,125,531
45333,2020-03-30,(07103) AV. CHILE,372,281,237,890
45334,2020-09-15,(07506) DESPENSA,481,261,299,1041
45335,2020-03-28,(02102) Calle 161,49,51,42,142
45336,2020-09-28,(02102) Calle 161,332,177,234,743
45337,2020-10-10,(02102) Calle 161,217,92,216,525
45338,2020-07-20,(40002) Manitas,110,62,69,241
45339,2020-04-21,(09111) Calle 19,326,198,269,793
45340,2020-05-26,(09111) Calle 19,639,370,419,1428
45341,2020-07-03,(06001) Modelia,385,261,240,886
45342,2020-07-25,(09114) Calle 26,139,94,125,358
45343,2020-05-13,(04106) Carrera 47,264,136,132,532
45344,2020-04-14,(09002) Consuelo,261,117,159,537
45345,2020-05-04,(06101) El Tiempo,243,166,120,529
45346,2020-05-31,(09119) Calle 57,151,102,137,390
45347,2020-05-09,(07006) General Santander - alimentacion,191,103,109,403
45348,2020-05-16,(04106) Carrera 47,193,111,109,413
45349,2020-01-26,(07006) General Santander - alimentacion,280,171,318,769
45350,2020-03-06,(07200) Tygua-San José,776,443,633,1852
45351,2020-06-27,(02000) Cabecera Autopista Norte - intermunicipal,397,239,330,966
45352,2020-05-19,(07004) VENECIA,777,484,400,1661
45353,2020-04-11,(10009) Museo Nacional,116,87,79,282
45354,2020-07-17,(04105) Carrera 53,255,149,149,553
45355,2020-04-17,(04101) Minuto de Dios,147,112,127,386
45356,2020-04-15,(04000) Cabecera Calle 80 - intermunicipal,127,87,109,323
45357,2020-06-29,(04003) Avenida Ciudad de Cali,318,187,278,783
45358,2020-05-26,(06103) CAN,351,235,172,758
45359,2020-02-09,(09003) Socorro,540,225,418,1183
45360,2020-07-18,(03010) PUENTE LARGO,219,136,136,491
45361,2020-07-05,(07006) General Santander - alimentacion,81,51,109,241
45362,2020-05-17,(09117) Calle 45,210,129,170,509
45363,2020-05-16,(09105) Río Fucha,79,42,58,179
45364,2020-05-17,(02204) Pepe Sierra,165,153,114,432
45365,2020-07-30,(09116) Avenida 39,339,213,222,774
45366,2020-07-23,(04106) Carrera 47,284,127,124,535
45367,2020-07-07,(07005) ALQUERIA,595,353,352,1300
45368,2020-05-07,(12007) Zona Industrial,248,161,112,521
45369,2020-05-31,(04002) Carrera 90,166,85,113,364
45370,2020-07-20,(07109) CAD,180,106,114,400
45371,2020-06-30,(10004) Policarpa,260,128,188,576
45372,2020-07-23,(10004) Policarpa,161,82,96,339
45373,2020-02-16,(06002) Normandía,357,193,408,958
45374,2020-06-06,(07008) NQS - Calle 30 Sur,188,101,145,434
45375,2020-07-16,(10008) San Diego,190,112,130,432
45376,2020-09-27,(12004) Carrera 22,62,59,79,200
45377,2020-07-21,(14005) Las Aguas,157,89,148,394
45378,2020-09-08,(14005) Las Aguas,166,132,251,549
45379,2020-09-11,(06106) Recinto Ferial,269,147,150,566
45380,2020-05-31,(02103) Mazurén,21,22,34,77
45381,2020-04-26,(40001) Juan Pablo II,101,50,80,231
45382,2020-05-25,(40001) Juan Pablo II,145,90,88,323
45383,2020-02-09,(12002) CDS - Carrera 32,62,87,103,252
45384,2020-08-01,(06101) El Tiempo,170,139,161,470
45385,2020-07-19,(06103) CAN,109,74,66,249
45386,2020-04-16,(07108) Av. El Dorado,57,50,35,142
45387,2020-05-31,(09101) Quiroga,105,47,134,286
45388,2020-08-09,(06001) Modelia,73,43,64,180
45389,2020-05-12,(07101) CASTELLANA,131,90,96,317
45390,2020-09-06,(09106) Nariño,150,90,180,420
45391,2020-03-20,(08001) Parque el Tunal,196,116,95,407
45392,2020-08-17,(14001) La Sabana,47,32,49,128
45393,2020-04-08,(06106) Recinto Ferial,119,73,87,279
45394,2020-04-05,(07010) Bosa,103,53,83,239
45395,2020-03-21,(10008) San Diego,49,48,66,163
45396,2020-01-10,(50006) Corral Carrera 77,25,14,45,84
45397,2020-05-14,(03007) HUMEDAL CORDOBA,96,56,35,187
45398,2020-10-01,(03014) SAN MARTIN,0,9,61,70
45399,2020-10-03,(50006) Corral Carrera 77,2,1,9,12
45400,2020-04-08,(03007) HUMEDAL CORDOBA,77,51,28,156
45401,2020-04-29,(03014) SAN MARTIN,18,13,21,52
45402,2020-05-25,(50006) Corral Carrera 77,2,1,0,3
45403,2020-03-06,(04000) Cabecera Calle 80 - alimentacion,22010,13141,16325,51476
45404,2020-09-01,(04000) Cabecera Calle 80 - alimentacion,4132,2369,2865,9366
45405,2020-09-22,(04000) Cabecera Calle 80 - alimentacion,4846,2737,3702,11285
45406,2020-08-25,(02502) Terminal,373,277,321,971
45407,2020-02-29,(07504) TERREROS,11714,5885,7847,25446
45408,2020-08-06,(05000) Portal Américas - alimentacion,9605,5038,5034,19677
45409,2020-01-22,(09119) Calle 57,2993,2007,1937,6937
45410,2020-08-05,(09119) Calle 57,530,323,324,1177
45411,2020-01-27,(06000) Portal Eldorado - alimentacion,16994,9360,9211,35565
45412,2020-03-04,(06000) Portal Eldorado - alimentacion,18307,9992,9792,38091
45413,2020-02-16,(06104) Gobernación,130,123,205,458
45414,2020-06-27,(06104) Gobernación,145,114,123,382
45415,2020-08-21,(07503) SAN MATEO,10871,6098,5092,22061
45416,2020-05-23,(05000) Portal Américas - alimentacion,7075,3559,3319,13953
45417,2020-09-15,(04000) Cabecera Calle 80 - alimentacion,4401,2524,3250,10175
45418,2020-02-26,(09001) Molinos,7714,4238,5775,17727
45419,2020-09-16,(09001) Molinos,2865,1504,2076,6445
45420,2020-02-02,(09118) Marly,1374,886,1519,3779
45421,2020-01-11,(05000) Portal Américas,7266,3379,4836,15481
45422,2020-02-26,(14004) Museo del Oro,3627,2611,2347,8585
45423,2020-01-21,(50006) Corral Carrera 77,24,11,25,60
45424,2020-02-02,(08000) Portal Tunal - alimentacion,5902,2679,4259,12840
45425,2020-09-07,(09004) Santa Lucía,2608,1372,1504,5484
45426,2020-03-03,(07103) AV. CHILE,3709,2262,1846,7817
45427,2020-08-30,(10001) Country Sur,387,163,330,880
45428,2020-09-23,(09100) Calle 40 Sur,1884,1169,1471,4524
45429,2020-02-24,(05100) Banderas P. Central - alimentacion,16169,9565,8458,34192
45430,2020-01-30,(02000) Cabecera Autopista Norte,10984,6572,5808,23364
45431,2020-02-21,(04000) Cabecera Calle 80,7332,4004,5010,16346
45432,2020-02-10,(06102) Salitre El Greco,1638,922,746,3306
45433,2020-01-21,(10005) Bicentenario - alimentacion,507,216,341,1064
45434,2020-02-15,(09120) Calle 63,3660,2509,2991,9160
45435,2020-03-08,(09109) Tercer Milenio,302,178,418,898
45436,2020-02-03,(04000) Cabecera Calle 80 - intermunicipal,2154,1629,2272,6055
45437,2020-01-02,(04101) Minuto de Dios,859,540,765,2164
45438,2020-05-04,(07505) LEON XIII,1326,934,974,3234
45439,2020-01-11,(02101) Toberín,4439,2116,3700,10255
45440,2020-02-03,(09110) Avenida Jimenez,5033,3385,2982,11400
45441,2020-01-20,(09123) Calle 76,4944,3195,2825,10964
45442,2020-02-27,(09123) Calle 76,5896,3822,3160,12878
45443,2020-02-19,(07110) PALOQUEMAO,2756,1684,1179,5619
45444,2020-02-20,(07110) PALOQUEMAO,2841,1614,1147,5602
45445,2020-01-24,(06106) Recinto Ferial,1450,828,849,3127
45446,2020-02-04,(04100) Carrera 77,6935,4188,4130,15253
45447,2020-06-15,(03013) RIO NEGRO,76,56,76,208
45448,2020-02-13,(09103) Olaya,4488,2666,2385,9539
45449,2020-02-15,(02302) Virrey,1403,1102,1324,3829
45450,2020-07-22,(50003) Corral Molinos,1214,639,869,2722
45451,2020-02-18,(02103) Mazurén,3657,2258,1902,7817
45452,2020-01-24,(02103) Mazurén,3269,1816,1816,6901
45453,2020-02-28,(02103) Mazurén,3369,1899,1857,7125
45454,2020-09-10,(07000) Portal Sur - alimentacion,5958,4035,5405,15398
45455,2020-02-27,(14001) La Sabana,625,402,392,1419
45456,2020-06-12,(09113) Calle 22,402,255,341,998
45457,2020-08-23,(09113) Calle 22,209,103,159,471
45458,2020-02-08,(03003) 21 ANGELES,960,387,671,2018
45459,2020-02-03,(02001) Centro Comercial Santa Fe,4839,3117,2564,10520
45460,2020-08-14,(08000) Portal Tunal - alimentacion,6019,3346,3482,12847
45461,2020-03-14,(09104) Restrepo,2958,1763,2872,7593
45462,2020-03-19,(02000) Cabecera Autopista Norte - intermunicipal,1527,1013,1140,3680
45463,2020-06-27,(10001) Country Sur,1012,450,662,2124
45464,2020-03-18,(10008) San Diego,772,468,468,1708
45465,2020-07-07,(05002) Tintal,1547,1290,2044,4881
45466,2020-07-04,(05000) Portal Américas - alimentacion,9004,4623,4842,18469
45467,2020-01-16,(12001) Carrera 43,1423,819,994,3236
45468,2020-10-06,(12001) Carrera 43,504,304,334,1142
45469,2020-02-16,(09107) Hortúa,567,323,621,1511
45470,2020-04-16,(03000) Portal Suba,608,377,388,1373
45471,2020-09-21,(02000) Cabecera Autopista Norte - intermunicipal,489,322,405,1216
45472,2020-02-22,(06111) Universidades,2001,1290,1878,5169
45473,2020-08-29,(02303) Calle 85,461,310,291,1062
45474,2020-09-28,(06000) Portal Eldorado - alimentacion,4260,2169,2605,9034
45475,2020-05-23,(09116) Avenida 39,153,120,138,411
45476,2020-09-10,(02302) Virrey,608,426,417,1451
45477,2020-02-24,(07008) NQS - Calle 30 Sur,1920,1117,1075,4112
45478,2020-10-01,(06108) Concejo de Bogotá,149,94,125,368
45479,2020-08-01,(04000) Cabecera Calle 80,586,360,549,1495
45480,2020-05-12,(10002) Av. Primero de Mayo,1651,853,964,3468
45481,2020-05-18,(07007) NQS - Calle 38A Sur,283,143,208,634
45482,2020-07-05,(06001) Modelia,77,65,90,232
45483,2020-05-20,(09107) Hortúa,546,337,316,1199
45484,2020-01-24,(05101) Mandalay - Cr.73,1056,548,534,2138
45485,2020-03-14,(05105) Pradera,1391,955,890,3236
45486,2020-09-19,(03012) SUBA - CALLE 95,234,173,224,631
45487,2020-10-03,(10000) Portal 20 de Julio,2143,911,1706,4760
45488,2020-01-02,(05107) Américas - Cr.53,1166,699,804,2669
45489,2020-03-02,(14005) Las Aguas,3392,2060,1802,7254
45490,2020-07-14,(05005) Transversal 86,0,164,397,561
45491,2020-09-19,(05005) Transversal 86,350,143,293,786
45492,2020-09-22,(05001) Patio Bonito,2194,1130,1314,4638
45493,2020-03-22,(07504) TERREROS,1129,540,570,2239
45494,2020-08-30,(02202) Calle 127,331,268,291,890
45495,2020-02-04,(08000) Portal Tunal,2212,1264,1071,4547
45496,2020-09-04,(06109) Centro Memoria,281,168,169,618
45497,2020-05-07,(08000) Portal Tunal,517,241,212,970
45498,2020-07-08,(02205) Calle 106,366,216,203,785
45499,2020-07-02,(04003) Avenida Ciudad de Cali,1143,640,787,2570
45500,2020-01-12,(09104) Restrepo,1070,652,1293,3015
45501,2020-01-21,(02202) Calle 127,4191,2739,1974,8904
45502,2020-10-07,(07113) SANTA ISABEL,463,275,447,1185
45503,2020-06-24,(06111) Universidades,290,193,294,777
45504,2020-06-27,(03007) HUMEDAL CORDOBA,146,83,72,301
45505,2020-05-12,(10006) San Victorino,342,206,213,761
45506,2020-08-19,(08002) Biblioteca,302,166,192,660
45507,2020-02-11,(07108) Av. El Dorado,978,600,633,2211
45508,2020-02-06,(04105) Carrera 53,1465,833,739,3037
45509,2020-04-02,(07000) Portal Sur - alimentacion,3898,1957,1712,7567
45510,2020-08-31,(02101) Toberín,1415,896,1017,3328
45511,2020-02-29,(02304) Heroes,1760,1471,1725,4956
45512,2020-03-19,(07110) PALOQUEMAO,1387,935,605,2927
45513,2020-07-04,(09109) Tercer Milenio,281,159,246,686
45514,2020-01-22,(03003) 21 ANGELES,1598,791,880,3269
45515,2020-04-20,(02202) Calle 127,662,473,352,1487
45516,2020-07-14,(02202) Calle 127,1063,715,447,2225
45517,2020-04-08,(03011) SUBA - CALLE 100,272,172,148,592
45518,2020-01-14,(07003) SEVILLANA,1803,984,1021,3808
45519,2020-06-15,(05002) Tintal,709,357,470,1536
45520,2020-09-24,(06104) Gobernación,311,182,143,636
45521,2020-06-16,(02204) Pepe Sierra,849,544,479,1872
45522,2020-06-09,(10001) Country Sur,1132,508,643,2283
45523,2020-09-20,(02205) Calle 106,67,62,114,243
45524,2020-09-28,(09103) Olaya,1095,624,743,2462
45525,2020-02-26,(07004) VENECIA,4811,2715,2441,9967
45526,2020-06-05,(07113) SANTA ISABEL,384,225,255,864
45527,2020-09-28,(12003) Ricaurte,453,298,235,986
45528,2020-09-15,(04000) Cabecera Calle 80,1197,719,1044,2960
45529,2020-05-13,(10010) San Bernardo,502,291,325,1118
45530,2020-08-09,(05100) Banderas P. Central,153,81,136,370
45531,2020-02-15,(07003) SEVILLANA,1298,599,903,2800
45532,2020-03-05,(09109) Tercer Milenio,1357,859,898,3114
45533,2020-04-14,(09000) Cabecera Usme,873,513,647,2033
45534,2020-04-21,(09000) Cabecera Usme,892,557,615,2064
45535,2020-08-21,(09002) Consuelo,437,234,316,987
45536,2020-09-18,(10010) San Bernardo,634,340,513,1487
45537,2020-07-09,(02104) Calle 146,792,516,530,1838
45538,2020-05-10,(07103) AV. CHILE,163,101,113,377
45539,2020-05-16,(07103) AV. CHILE,461,315,260,1036
45540,2020-07-07,(09106) Nariño,432,271,325,1028
45541,2020-01-08,(05105) Pradera,1700,1053,923,3676
45542,2020-10-10,(07006) General Santander,497,244,451,1192
45543,2020-07-06,(02102) Calle 161,266,164,170,600
45544,2020-09-14,(04100) Carrera 77,1353,792,917,3062
45545,2020-09-11,(02200) Alcalá,1935,1191,1143,4269
45546,2020-05-07,(09120) Calle 63,713,488,444,1645
45547,2020-06-11,(09120) Calle 63,994,712,598,2304
45548,2020-05-25,(02200) Alcalá,525,399,312,1236
45549,2020-09-04,(10009) Museo Nacional,567,352,417,1336
45550,2020-04-10,(05107) Américas - Cr.53,65,33,43,141
45551,2020-04-12,(05105) Pradera,95,71,56,222
45552,2020-05-17,(03000) Portal Suba - alimentacion,1471,787,851,3109
45553,2020-03-27,(10005) Bicentenario - alimentacion,146,62,104,312
45554,2020-05-12,(40001) Juan Pablo II,417,264,237,918
45555,2020-08-26,(03006) NIZA - CALLE 127,465,266,211,942
45556,2020-09-30,(03006) NIZA - CALLE 127,567,313,339,1219
45557,2020-04-02,(02204) Pepe Sierra,362,312,204,878
45558,2020-08-13,(07201) Guatoque -Veraguas,205,98,127,430
45559,2020-04-15,(07006) General Santander,275,181,136,592
45560,2020-02-29,(07101) CASTELLANA,376,287,471,1134
45561,2020-01-21,(09111) Calle 19,1414,887,1008,3309
45562,2020-07-03,(09122) Calle 72,1261,802,885,2948
45563,2020-05-24,(02202) Calle 127,357,249,172,778
45564,2020-06-27,(09120) Calle 63,903,663,687,2253
45565,2020-10-11,(07103) AV. CHILE,211,147,299,657
45566,2020-06-05,(10007) Las Nieves,534,322,333,1189
45567,2020-04-24,(02303) Calle 85,359,261,206,826
45568,2020-05-05,(02303) Calle 85,401,301,239,941
45569,2020-09-05,(07201) Guatoque -Veraguas,165,103,160,428
45570,2020-07-08,(07105) MOVISTAR ARENA,268,141,155,564
45571,2020-06-24,(02200) Alcalá,1893,1346,997,4236
45572,2020-05-20,(05105) Pradera,459,291,194,944
45573,2020-08-30,(04102) Avenida Boyaca,176,105,112,393
45574,2020-10-02,(04102) Avenida Boyaca,489,314,378,1181
45575,2020-08-04,(07001) PERDOMO,814,489,543,1846
45576,2020-09-25,(10007) Las Nieves,730,453,471,1654
45577,2020-08-17,(09119) Calle 57,148,100,146,394
45578,2020-07-03,(04103) Las Ferias,385,221,187,793
45579,2020-02-18,(07108) Av. El Dorado,1057,617,640,2314
45580,2020-08-01,(09121) Las Flores,400,238,345,983
45581,2020-07-23,(09110) Avenida Jimenez,523,452,539,1514
45582,2020-05-16,(09110) Avenida Jimenez,638,458,477,1573
45583,2020-05-27,(40002) Manitas,340,205,221,766
45584,2020-02-21,(12000) Puente Aranda,281,177,185,643
45585,2020-07-11,(03005) SUBA - AV. BOYACA,352,189,285,826
45586,2020-05-13,(02102) Calle 161,179,114,114,407
45587,2020-07-27,(02102) Calle 161,223,143,128,494
45588,2020-05-15,(09111) Calle 19,571,359,373,1303
45589,2020-08-24,(06001) Modelia,319,200,193,712
45590,2020-09-11,(06001) Modelia,361,223,228,812
45591,2020-08-29,(03013) RIO NEGRO,209,107,168,484
45592,2020-05-15,(04106) Carrera 47,266,131,143,540
45593,2020-05-20,(07200) Tygua-San José,185,97,127,409
45594,2020-06-26,(07200) Tygua-San José,262,147,170,579
45595,2020-03-12,(14001) La Sabana,324,24,77,425
45596,2020-03-19,(05101) Mandalay - Cr.73,382,200,208,790
45597,2020-04-20,(04003) Avenida Ciudad de Cali,540,331,391,1262
45598,2020-03-25,(09110) Avenida Jimenez,279,209,264,752
45599,2020-03-08,(04105) Carrera 53,311,161,329,801
45600,2020-02-29,(04102) Avenida Boyaca,1539,833,1123,3495
45601,2020-04-30,(07108) Av. El Dorado,71,50,52,173
45602,2020-07-16,(07108) Av. El Dorado,153,99,76,328
45603,2020-10-05,(06103) CAN,426,254,262,942
45604,2020-06-07,(03003) 21 ANGELES,80,45,47,172
45605,2020-04-14,(04101) Minuto de Dios,148,100,117,365
45606,2020-07-10,(14004) Museo del Oro,316,217,246,779
45607,2020-06-28,(03012) SUBA - CALLE 95,69,63,66,198
45608,2020-04-29,(04103) Las Ferias,230,136,98,464
45609,2020-08-17,(04002) Carrera 90,193,110,133,436
45610,2020-06-09,(14004) Museo del Oro,0,128,248,376
45611,2020-07-28,(12007) Zona Industrial,229,154,142,525
45612,2020-03-24,(03007) HUMEDAL CORDOBA,105,94,72,271
45613,2020-06-12,(10004) Policarpa,257,102,161,520
45614,2020-04-06,(07002) MADELENA,350,170,234,754
45615,2020-06-15,(06000) Portal Eldorado,249,175,217,641
45616,2020-06-05,(12007) Zona Industrial,320,207,128,655
45617,2020-04-06,(06108) Concejo de Bogotá,89,69,75,233
45618,2020-07-21,(02102) Calle 161,221,140,141,502
45619,2020-09-10,(07007) NQS - Calle 38A Sur,389,184,304,877
45620,2020-05-09,(09105) Río Fucha,66,37,55,158
45621,2020-05-17,(07004) VENECIA,194,109,137,440
45622,2020-04-30,(07007) NQS - Calle 38A Sur,204,120,136,460
45623,2020-04-11,(12004) Carrera 22,23,24,23,70
45624,2020-04-07,(04107) Escuela Militar,54,34,45,133
45625,2020-08-01,(04107) Escuela Militar,44,40,60,144
45626,2020-01-11,(03014) SAN MARTIN,87,55,126,268
45627,2020-08-04,(06106) Recinto Ferial,208,125,112,445
45628,2020-05-21,(04105) Carrera 53,221,118,105,444
45629,2020-05-20,(06106) Recinto Ferial,220,148,103,471
45630,2020-08-21,(07108) Av. El Dorado,117,75,101,293
45631,2020-03-25,(50002) Corral Calle 40 Sur,13,10,16,39
45632,2020-07-05,(04101) Minuto de Dios,89,49,106,244
45633,2020-04-19,(05103) Marsella,64,40,39,143
45634,2020-04-13,(07106) EL CAMPIN,176,128,117,421
45635,2020-05-31,(09121) Las Flores,167,131,144,442
45636,2020-09-15,(50006) Corral Carrera 77,5,2,10,17
45637,2020-04-30,(03007) HUMEDAL CORDOBA,85,59,49,193
45638,2020-04-01,(07108) Av. El Dorado,61,47,35,143
45639,2020-04-08,(10005) Bicentenario - alimentacion,151,76,124,351
45640,2020-09-21,(50006) Corral Carrera 77,6,1,5,12
45641,2020-04-10,(14005) Las Aguas,0,13,27,40
45642,2020-03-08,(50006) Corral Carrera 77,5,8,22,35
45643,2020-04-18,(07200) Tygua-San José,52,35,51,138
45644,2020-03-22,(12007) Zona Industrial,26,27,34,87
45645,2020-05-07,(03014) SAN MARTIN,23,14,28,65
45646,2020-04-05,(02102) Calle 161,27,17,13,57
45647,2020-04-29,(50006) Corral Carrera 77,3,2,8,13
45648,2020-08-10,(50004) Corral Avenida Ciudad de Cali,1,1,0,2
45649,2020-10-09,(02502) Terminal,518,388,570,1476
45650,2020-10-10,(02502) Terminal,327,218,457,1002
45651,2020-04-18,(07504) TERREROS,1620,1087,810,3517
45652,2020-05-08,(07504) TERREROS,3527,2096,1730,7353
45653,2020-01-27,(10000) Portal 20 de Julio - alimentacion,10544,5256,7127,22927
45654,2020-02-14,(03000) Portal Suba - alimentacion,29841,16868,17198,63907
45655,2020-03-19,(02303) Calle 85,1626,1184,958,3768
45656,2020-01-23,(03002) SUBA - TV- 91,4066,2365,2256,8687
45657,2020-02-14,(03002) SUBA - TV- 91,4733,2561,2539,9833
45658,2020-03-06,(02200) Alcalá,14186,8324,6906,29416
45659,2020-02-25,(14005) Las Aguas,3561,2169,1910,7640
45660,2020-02-28,(06104) Gobernación,1359,829,687,2875
45661,2020-01-29,(06107) Ciudad Universitaria,1580,920,900,3400
45662,2020-08-03,(05001) Patio Bonito,1579,836,920,3335
45663,2020-01-03,(04100) Carrera 77,3149,1670,2342,7161
45664,2020-02-19,(05100) Banderas P. Central - alimentacion,16777,9603,8413,34793
45665,2020-01-20,(06102) Salitre El Greco,1435,834,711,2980
45666,2020-02-20,(09000) Cabecera Usme - alimentacion,22818,14027,14810,51655
45667,2020-03-06,(09000) Cabecera Usme - alimentacion,25688,13951,15954,55593
45668,2020-01-27,(07001) PERDOMO,4259,2759,2445,9463
45669,2020-05-24,(07001) PERDOMO,210,104,113,427
45670,2020-07-22,(07001) PERDOMO,807,391,550,1748
45671,2020-07-02,(03000) Portal Suba - alimentacion,6617,3841,3840,14298
45672,2020-03-03,(10006) San Victorino,2571,1329,1265,5165
45673,2020-02-15,(09110) Avenida Jimenez,3421,2388,2304,8113
45674,2020-02-17,(09110) Avenida Jimenez,5259,3464,2944,11667
45675,2020-01-11,(12003) Ricaurte,592,472,500,1564
45676,2020-07-23,(05000) Portal Américas,1790,1340,1443,4573
45677,2020-07-08,(07102) NQS - CALLE 75,464,298,248,1010
45678,2020-07-11,(03013) RIO NEGRO,227,125,173,525
45679,2020-07-22,(03013) RIO NEGRO,259,158,152,569
45680,2020-04-15,(09118) Marly,1005,726,453,2184
45681,2020-01-15,(09103) Olaya,3363,1937,2265,7565
45682,2020-05-25,(09103) Olaya,287,168,157,612
45683,2020-07-03,(03001) LA CAMPIÑA,1251,676,793,2720
45684,2020-02-14,(06001) Modelia,2579,1479,1313,5371
45685,2020-02-27,(02103) Mazurén,3427,2128,1808,7363
45686,2020-06-16,(07000) Portal Sur - alimentacion,7942,4615,3643,16200
45687,2020-09-25,(05100) Banderas P. Central - alimentacion,3794,1904,2401,8099
45688,2020-04-01,(09103) Olaya,444,275,256,975
45689,2020-04-28,(09103) Olaya,632,335,315,1282
45690,2020-07-24,(09103) Olaya,779,457,416,1652
45691,2020-10-09,(09103) Olaya,1188,641,906,2735
45692,2020-09-15,(07111) NQS - RICAURTE,1126,673,534,2333
45693,2020-08-24,(08000) Portal Tunal - alimentacion,5408,2729,2859,10996
45694,2020-09-09,(02000) Cabecera Autopista Norte,1553,949,1079,3581
45695,2020-01-28,(07107) U. NACIONAL,2528,1578,1325,5431
45696,2020-09-19,(09113) Calle 22,404,229,375,1008
45697,2020-02-19,(03003) 21 ANGELES,1812,956,884,3652
45698,2020-07-05,(03003) 21 ANGELES,101,47,91,239
45699,2020-01-19,(07000) Portal Sur - alimentacion,7459,3067,5052,15578
45700,2020-03-30,(02000) Cabecera Autopista Norte,509,366,327,1202
45701,2020-09-01,(04105) Carrera 53,295,149,192,636
45702,2020-01-25,(10002) Av. Primero de Mayo,4596,2166,3455,10217
45703,2020-03-17,(07109) CAD,1932,1200,862,3994
45704,2020-01-23,(06105) Quinta Paredes,981,579,443,2003
45705,2020-07-22,(08000) Portal Tunal - alimentacion,4565,2583,2680,9828
45706,2020-02-06,(50003) Corral Molinos,3453,2117,3431,9001
45707,2020-08-29,(09110) Avenida Jimenez,1300,899,808,3007
45708,2020-02-18,(05107) Américas - Cr.53,2482,1460,1465,5407
45709,2020-02-11,(04104) Avenida 68,3853,2059,1934,7846
45710,2020-04-20,(04002) Carrera 90,369,213,179,761
45711,2020-08-22,(04002) Carrera 90,476,263,295,1034
45712,2020-07-10,(10006) San Victorino,698,382,381,1461
45713,2020-09-05,(03000) Portal Suba,1143,611,919,2673
45714,2020-06-30,(06000) Portal Eldorado,976,645,542,2163
45715,2020-02-25,(04104) Avenida 68,3798,2080,1850,7728
45716,2020-01-08,(10005) Bicentenario - alimentacion,483,235,475,1193
45717,2020-09-17,(06105) Quinta Paredes,160,104,102,366
45718,2020-07-03,(10000) Portal 20 de Julio,2531,1204,1330,5065
45719,2020-03-23,(07000) Portal Sur - alimentacion,1891,914,688,3493
45720,2020-01-14,(07000) Portal Sur,6845,4121,4021,14987
45721,2020-02-23,(07000) Portal Sur,1335,669,1313,3317
45722,2020-01-14,(02001) Centro Comercial Santa Fe,3902,2399,2311,8612
45723,2020-09-16,(07004) VENECIA,1081,645,716,2442
45724,2020-09-23,(07004) VENECIA,1185,700,791,2676
45725,2020-06-18,(40003) Mirador del Paraiso,1761,1100,987,3848
45726,2020-09-26,(10001) Country Sur,1119,470,922,2511
45727,2020-09-09,(09003) Socorro,591,324,382,1297
45728,2020-02-26,(05102) Av. Américas - Av. Boyacá,1992,1101,943,4036
45729,2020-02-18,(06103) CAN,2759,1646,1187,5592
45730,2020-05-22,(06108) Concejo de Bogotá,129,65,70,264
45731,2020-10-06,(06108) Concejo de Bogotá,174,94,111,379
45732,2020-08-09,(10001) Country Sur,331,130,266,727
45733,2020-07-28,(02000) Cabecera Autopista Norte,1184,753,721,2658
45734,2020-08-14,(03000) Portal Suba - alimentacion,5468,3054,3200,11722
45735,2020-08-01,(09107) Hortúa,360,230,256,846
45736,2020-09-30,(09123) Calle 76,1157,793,808,2758
45737,2020-10-05,(05103) Marsella,542,323,380,1245
45738,2020-04-18,(02300) Calle 100,561,408,292,1261
45739,2020-06-11,(03012) SUBA - CALLE 95,348,210,169,727
45740,2020-04-23,(05005) Transversal 86,201,114,85,400
45741,2020-07-09,(10008) San Diego,331,182,195,708
45742,2020-01-26,(07009) SENA,878,392,803,2073
45743,2020-07-25,(02205) Calle 106,172,122,143,437
45744,2020-06-03,(03000) Portal Suba - alimentacion,5514,3236,2909,11659
45745,2020-03-12,(09113) Calle 22,457,173,232,862
45746,2020-01-17,(07000) Portal Sur,7132,4088,4244,15464
45747,2020-01-28,(07201) Guatoque -Veraguas,1019,525,587,2131
45748,2020-10-10,(07201) Guatoque -Veraguas,174,94,193,461
45749,2020-01-02,(07101) CASTELLANA,382,263,336,981
45750,2020-02-02,(06102) Salitre El Greco,303,184,276,763
45751,2020-06-04,(07106) EL CAMPIN,317,220,193,730
45752,2020-01-05,(09000) Cabecera Usme,906,483,1068,2457
45753,2020-04-14,(06000) Portal Eldorado,805,613,381,1799
45754,2020-09-08,(07000) Portal Sur,2124,1326,1374,4824
45755,2020-08-01,(02101) Toberín,729,445,576,1750
45756,2020-01-03,(40003) Mirador del Paraiso,3072,1579,1969,6620
45757,2020-06-11,(10010) San Bernardo,570,320,372,1262
45758,2020-06-29,(09100) Calle 40 Sur,624,348,429,1401
45759,2020-07-10,(09100) Calle 40 Sur,1905,1114,1193,4212
45760,2020-03-12,(07009) SENA,555,629,528,1712
45761,2020-10-07,(02303) Calle 85,875,577,555,2007
45762,2020-06-09,(10010) San Bernardo,609,323,373,1305
45763,2020-02-09,(09117) Calle 45,801,512,1084,2397
45764,2020-09-23,(04002) Carrera 90,883,468,580,1931
45765,2020-09-08,(12001) Carrera 43,463,264,267,994
45766,2020-10-02,(03001) LA CAMPIÑA,1566,783,1063,3412
45767,2020-04-08,(40003) Mirador del Paraiso,755,442,510,1707
45768,2020-02-26,(04001) Quirigua,2156,1225,1267,4648
45769,2020-09-30,(06002) Normandía,389,234,272,895
45770,2020-06-09,(02204) Pepe Sierra,776,523,382,1681
45771,2020-07-26,(02000) Cabecera Autopista Norte,329,211,223,763
45772,2020-03-26,(09120) Calle 63,555,383,349,1287
45773,2020-03-26,(03010) PUENTE LARGO,206,158,89,453
45774,2020-04-18,(02105) Calle 142,361,223,155,739
45775,2020-08-08,(02105) Calle 142,445,269,306,1020
45776,2020-08-31,(02105) Calle 142,759,473,515,1747
45777,2020-01-24,(07107) U. NACIONAL,2139,1357,1378,4874
45778,2020-01-25,(07103) AV. CHILE,2081,1316,1411,4808
45779,2020-03-20,(06000) Portal Eldorado,1287,894,515,2696
45780,2020-04-16,(09122) Calle 72,627,457,386,1470
45781,2020-06-29,(03002) SUBA - TV- 91,247,133,184,564
45782,2020-07-30,(02104) Calle 146,694,438,456,1588
45783,2020-07-27,(02103) Mazurén,180,120,152,452
45784,2020-08-28,(10005) Bicentenario,84,61,73,218
45785,2020-01-04,(06108) Concejo de Bogotá,182,114,182,478
45786,2020-01-09,(06105) Quinta Paredes,637,369,367,1373
45787,2020-01-08,(07102) NQS - CALLE 75,1075,632,711,2418
45788,2020-10-04,(06000) Portal Eldorado,156,214,421,791
45789,2020-04-03,(09120) Calle 63,532,386,360,1278
45790,2020-03-24,(06107) Ciudad Universitaria,160,121,129,410
45791,2020-07-10,(09115) Calle 34,696,439,454,1589
45792,2020-09-12,(09115) Calle 34,405,301,431,1137
45793,2020-05-13,(03006) NIZA - CALLE 127,306,199,156,661
45794,2020-09-15,(03006) NIZA - CALLE 127,505,285,300,1090
45795,2020-08-16,(07006) General Santander,166,88,129,383
45796,2020-05-07,(07000) Portal Sur,1159,744,647,2550
45797,2020-03-02,(09111) Calle 19,2372,1403,1531,5306
45798,2020-01-21,(09120) Calle 63,2843,2099,2254,7196
45799,2020-08-10,(07101) CASTELLANA,195,99,103,397
45800,2020-03-25,(09106) Nariño,163,117,139,419
45801,2020-06-11,(03003) 21 ANGELES,321,145,167,633
45802,2020-06-08,(07006) General Santander,507,317,262,1086
45803,2020-07-27,(05102) Av. Américas - Av. Boyacá,182,89,134,405
45804,2020-08-19,(06104) Gobernación,218,141,95,454
45805,2020-06-10,(09114) Calle 26,265,207,183,655
45806,2020-06-06,(07105) MOVISTAR ARENA,180,116,124,420
45807,2020-07-07,(09121) Las Flores,740,472,424,1636
45808,2020-07-07,(05105) Pradera,622,365,293,1280
45809,2020-07-09,(03003) 21 ANGELES,337,192,199,728
45810,2020-06-20,(10006) San Victorino,469,281,312,1062
45811,2020-05-21,(06107) Ciudad Universitaria,168,99,84,351
45812,2020-06-09,(04103) Las Ferias,352,196,144,692
45813,2020-07-05,(09121) Las Flores,175,115,179,469
45814,2020-10-06,(03013) RIO NEGRO,315,211,248,774
45815,2020-08-04,(10009) Museo Nacional,447,266,291,1004
45816,2020-09-24,(07103) AV. CHILE,1015,611,556,2182
45817,2020-04-26,(07103) AV. CHILE,137,98,79,314
45818,2020-05-02,(07109) CAD,257,175,123,555
45819,2020-05-22,(03005) SUBA - AV. BOYACA,366,224,212,802
45820,2020-04-29,(07002) MADELENA,405,242,229,876
45821,2020-03-21,(07107) U. NACIONAL,129,113,62,304
45822,2020-10-03,(07107) U. NACIONAL,285,203,325,813
45823,2020-04-08,(07005) ALQUERIA,229,143,131,503
45824,2020-04-28,(07005) ALQUERIA,316,199,172,687
45825,2020-05-20,(10009) Museo Nacional,436,265,249,950
45826,2020-07-17,(03013) RIO NEGRO,261,157,182,600
45827,2020-09-21,(07009) SENA,540,332,414,1286
45828,2020-05-18,(02502) Terminal,301,225,245,771
45829,2020-06-06,(10002) Av. Primero de Mayo,1408,729,966,3103
45830,2020-02-16,(12001) Carrera 43,193,138,301,632
45831,2020-02-29,(07200) Tygua-San José,452,271,502,1225
45832,2020-07-04,(07108) Av. El Dorado,98,56,84,238
45833,2020-08-30,(04000) Cabecera Calle 80 - intermunicipal,70,24,106,200
45834,2020-03-27,(06100) Av. Rojas,111,62,91,264
45835,2020-05-10,(04102) Avenida Boyaca,64,34,39,137
45836,2020-10-07,(04102) Avenida Boyaca,484,294,398,1176
45837,2020-07-18,(07001) PERDOMO,531,304,384,1219
45838,2020-07-19,(06101) El Tiempo,101,71,69,241
45839,2020-04-24,(03006) NIZA - CALLE 127,255,161,120,536
45840,2020-06-19,(09003) Socorro,609,306,324,1239
45841,2020-01-10,(03004) GRATAMIRA,210,89,106,405
45842,2020-08-23,(05100) Banderas P. Central,152,79,156,387
45843,2020-07-19,(08000) Portal Tunal,188,87,92,367
45844,2020-06-18,(06105) Quinta Paredes,136,92,70,298
45845,2020-05-27,(04106) Carrera 47,283,165,125,573
45846,2020-09-12,(04106) Carrera 47,271,129,178,578
45847,2020-07-23,(06102) Salitre El Greco,204,122,105,431
45848,2020-07-08,(05101) Mandalay - Cr.73,151,80,69,300
45849,2020-06-03,(14004) Museo del Oro,0,112,253,365
45850,2020-05-13,(07006) General Santander - alimentacion,284,159,169,612
45851,2020-08-10,(09111) Calle 19,751,435,469,1655
45852,2020-04-06,(06001) Modelia,233,178,155,566
45853,2020-04-23,(04003) Avenida Ciudad de Cali,571,344,338,1253
45854,2020-06-27,(07109) CAD,445,304,255,1004
45855,2020-10-04,(07109) CAD,201,156,198,555
45856,2020-05-18,(04003) Avenida Ciudad de Cali,825,500,564,1889
45857,2020-04-08,(04001) Quirigua,176,109,109,394
45858,2020-08-18,(03004) GRATAMIRA,0,17,42,59
45859,2020-09-10,(02102) Calle 161,244,137,185,566
45860,2020-06-07,(04002) Carrera 90,166,75,114,355
45861,2020-04-04,(04002) Carrera 90,231,128,111,470
45862,2020-06-01,(06101) El Tiempo,295,174,183,652
45863,2020-04-07,(09114) Calle 26,142,128,113,383
45864,2020-08-12,(09003) Socorro,574,300,318,1192
45865,2020-02-23,(50006) Corral Carrera 77,10,5,11,26
45866,2020-05-24,(10008) San Diego,61,38,49,148
45867,2020-05-11,(07101) CASTELLANA,126,83,100,309
45868,2020-03-23,(07105) MOVISTAR ARENA,49,33,46,128
45869,2020-08-28,(03007) HUMEDAL CORDOBA,156,101,97,354
45870,2020-08-23,(03011) SUBA - CALLE 100,119,73,84,276
45871,2020-04-16,(07201) Guatoque -Veraguas,79,69,51,199
45872,2020-04-06,(07201) Guatoque -Veraguas,57,34,57,148
45873,2020-06-21,(07201) Guatoque -Veraguas,22,18,52,92
45874,2020-03-23,(10008) San Diego,59,37,59,155
45875,2020-07-16,(50002) Corral Calle 40 Sur,12,10,22,44
45876,2020-05-03,(03005) SUBA - AV. BOYACA,82,48,55,185
45877,2019-12-31,(03005) SUBA - AV. BOYACA,23,15,26,64
45878,2020-09-18,(50006) Corral Carrera 77,10,3,8,21
45879,2020-05-24,(12000) Puente Aranda,8,9,7,24
45880,2020-04-09,(06105) Quinta Paredes,28,23,19,70
45881,2020-10-10,(03014) SAN MARTIN,0,10,44,54
45882,2020-05-29,(03014) SAN MARTIN,28,14,32,74
45883,2020-09-01,(50006) Corral Carrera 77,6,3,4,13
45884,2020-05-25,(10005) Bicentenario,23,11,19,53
45885,2020-03-15,(50006) Corral Carrera 77,6,3,6,15
45886,2020-05-18,(09118) Marly,1307,876,592,2775
45887,2020-09-30,(09118) Marly,1548,1030,1106,3684
45888,2020-03-19,(10000) Portal 20 de Julio - alimentacion,6990,3322,4759,15071
45889,2020-08-15,(09119) Calle 57,482,304,373,1159
45890,2020-02-26,(04106) Carrera 47,1544,842,853,3239
45891,2020-02-20,(06000) Portal Eldorado - alimentacion,18517,9965,8967,37449
45892,2020-01-31,(14005) Las Aguas,2966,1847,1974,6787
45893,2020-02-13,(14005) Las Aguas,3619,2171,1863,7653
45894,2020-02-02,(09100) Calle 40 Sur,1754,721,1647,4122
45895,2020-06-19,(05000) Portal Américas - alimentacion,11425,6095,5739,23259
45896,2020-07-10,(04000) Cabecera Calle 80 - alimentacion,4506,2495,2879,9880
45897,2020-01-30,(06107) Ciudad Universitaria,1582,942,851,3375
45898,2020-06-22,(06107) Ciudad Universitaria,55,43,48,146
45899,2020-02-05,(07010) Bosa,2242,1342,1489,5073
45900,2020-07-03,(05100) Banderas P. Central,871,470,607,1948
45901,2020-09-14,(05100) Banderas P. Central,957,574,643,2174
45902,2020-06-04,(10001) Country Sur,1093,486,620,2199
45903,2020-08-25,(09100) Calle 40 Sur,1622,917,1044,3583
45904,2020-10-07,(07503) SAN MATEO,13920,6975,7861,28756
45905,2020-01-17,(09000) Cabecera Usme,5223,2986,3799,12008
45906,2020-01-23,(02000) Cabecera Autopista Norte,10112,6109,5761,21982
45907,2020-01-09,(07009) SENA,2399,1420,1594,5413
45908,2020-02-28,(04000) Cabecera Calle 80,7574,4252,5146,16972
45909,2020-01-14,(10003) Ciudad Jardín,880,478,593,1951
45910,2020-03-03,(02204) Pepe Sierra,5001,3298,2404,10703
45911,2020-07-25,(04101) Minuto de Dios,192,99,166,457
45912,2020-07-01,(07505) LEON XIII,2845,1579,1199,5623
45913,2020-08-19,(07505) LEON XIII,2586,1432,1125,5143
45914,2020-09-14,(02101) Toberín,1607,1006,1257,3870
45915,2020-02-28,(04104) Avenida 68,3680,1990,1836,7506
45916,2020-01-21,(05001) Patio Bonito,4879,1605,2196,8680
45917,2020-08-06,(02000) Cabecera Autopista Norte - alimentacion,4211,2233,2531,8975
45918,2020-07-27,(07102) NQS - CALLE 75,413,241,215,869
45919,2020-06-24,(03013) RIO NEGRO,266,171,198,635
45920,2020-08-01,(09103) Olaya,724,388,427,1539
45921,2020-08-29,(09103) Olaya,900,411,553,1864
45922,2020-03-24,(02000) Cabecera Autopista Norte - alimentacion,4373,2183,2389,8945
45923,2020-07-03,(07106) EL CAMPIN,440,285,223,948
45924,2020-07-10,(02000) Cabecera Autopista Norte,1446,921,859,3226
45925,2020-08-31,(02000) Cabecera Autopista Norte,1372,836,948,3156
45926,2020-01-23,(07107) U. NACIONAL,2435,1526,1295,5256
45927,2020-06-28,(09001) Molinos,781,362,580,1723
45928,2020-05-12,(05000) Portal Américas,1710,1281,1431,4422
45929,2020-03-17,(04002) Carrera 90,2130,1244,1141,4515
45930,2020-02-06,(09111) Calle 19,2273,1405,1543,5221
45931,2020-03-01,(09111) Calle 19,525,338,609,1472
45932,2020-08-12,(40003) Mirador del Paraiso,1545,992,971,3508
45933,2020-08-26,(40003) Mirador del Paraiso,1553,951,956,3460
45934,2020-03-01,(05002) Tintal,1856,925,2028,4809
45935,2020-05-06,(12001) Carrera 43,337,176,153,666
45936,2020-09-22,(12001) Carrera 43,480,294,304,1078
45937,2020-01-30,(06111) Universidades,5495,3477,2530,11502
45938,2020-01-03,(02304) Heroes,1984,1506,1290,4780
45939,2020-02-05,(07004) VENECIA,4872,2771,2624,10267
45940,2020-04-24,(09107) Hortúa,447,292,213,952
45941,2020-01-29,(09109) Tercer Milenio,1356,802,859,3017
45942,2020-10-08,(09003) Socorro,641,319,448,1408
45943,2020-06-05,(09118) Marly,1426,944,708,3078
45944,2020-05-29,(08001) Parque el Tunal,427,250,246,923
45945,2020-01-14,(06103) CAN,2053,1186,1034,4273
45946,2020-02-28,(06108) Concejo de Bogotá,837,447,528,1812
45947,2020-04-29,(07010) Bosa,396,208,231,835
45948,2020-05-02,(08000) Portal Tunal - alimentacion,2913,1497,1520,5930
45949,2020-08-07,(04000) Cabecera Calle 80,330,188,282,800
45950,2020-06-03,(02000) Cabecera Autopista Norte - alimentacion,4256,2442,2271,8969
45951,2020-02-08,(05103) Marsella,1492,733,1056,3281
45952,2020-07-17,(02000) Cabecera Autopista Norte,1229,723,711,2663
45953,2020-03-07,(08001) Parque el Tunal,1143,569,757,2469
45954,2020-02-01,(07007) NQS - Calle 38A Sur,1384,691,928,3003
45955,2020-07-22,(09107) Hortúa,552,342,353,1247
45956,2020-03-05,(05105) Pradera,2528,1495,1202,5225
45957,2020-02-28,(10009) Museo Nacional,4235,2406,2157,8798
45958,2020-05-23,(50003) Corral Molinos,1072,509,684,2265
45959,2020-05-14,(10000) Portal 20 de Julio,1871,936,857,3664
45960,2020-01-08,(03011) SUBA - CALLE 100,1804,923,983,3710
45961,2020-02-06,(03012) SUBA - CALLE 95,1449,908,1030,3387
45962,2020-06-12,(03012) SUBA - CALLE 95,354,223,166,743
45963,2020-05-30,(10000) Portal 20 de Julio,1636,787,864,3287
45964,2020-10-11,(09001) Molinos,956,389,908,2253
45965,2020-03-15,(03012) SUBA - CALLE 95,200,129,249,578
45966,2020-07-21,(02202) Calle 127,1040,718,505,2263
45967,2020-04-16,(05105) Pradera,386,279,158,823
45968,2020-03-15,(09000) Cabecera Usme - alimentacion,5120,2229,4076,11425
45969,2020-10-02,(05107) Américas - Cr.53,481,306,404,1191
45970,2020-09-21,(04104) Avenida 68,546,280,353,1179
45971,2020-05-11,(02205) Calle 106,249,172,136,557
45972,2020-01-26,(06111) Universidades,481,285,785,1551
45973,2020-03-05,(04003) Avenida Ciudad de Cali,5204,3124,3746,12074
45974,2020-07-16,(04003) Avenida Ciudad de Cali,862,509,574,1945
45975,2020-03-13,(04108) El Polo,528,133,272,933
45976,2020-01-16,(10009) Museo Nacional,3529,1903,1811,7243
45977,2020-10-04,(06000) Portal Eldorado - alimentacion,1626,679,1442,3747
45978,2020-07-13,(07103) AV. CHILE,911,548,433,1892
45979,2020-07-12,(07113) SANTA ISABEL,125,62,135,322
45980,2020-02-01,(04102) Avenida Boyaca,1446,795,1073,3314
45981,2020-01-10,(03007) HUMEDAL CORDOBA,626,369,407,1402
45982,2020-02-15,(03005) SUBA - AV. BOYACA,1486,867,1166,3519
45983,2020-08-15,(10003) Ciudad Jardín,175,89,151,415
45984,2020-04-20,(05100) Banderas P. Central - alimentacion,1621,805,724,3150
45985,2020-03-25,(07110) PALOQUEMAO,314,291,213,818
45986,2020-02-19,(04107) Escuela Militar,684,440,444,1568
45987,2020-05-27,(04107) Escuela Militar,138,94,83,315
45988,2020-09-28,(10009) Museo Nacional,594,351,445,1390
45989,2020-01-31,(09109) Tercer Milenio,1321,775,888,2984
45990,2020-09-04,(09109) Tercer Milenio,394,235,245,874
45991,2020-05-19,(04002) Carrera 90,578,340,276,1194
45992,2020-05-17,(40003) Mirador del Paraiso,504,277,331,1112
45993,2020-10-09,(04104) Avenida 68,763,402,515,1680
45994,2020-09-11,(09110) Avenida Jimenez,1390,962,906,3258
45995,2020-04-14,(02202) Calle 127,655,495,299,1449
45996,2020-09-23,(02202) Calle 127,1260,884,761,2905
45997,2020-09-25,(06002) Normandía,364,233,272,869
45998,2020-04-03,(05002) Tintal,1147,632,671,2450
45999,2020-04-05,(02205) Calle 106,52,60,36,148
46000,2020-04-23,(05001) Patio Bonito,987,571,545,2103
46001,2020-05-14,(05001) Patio Bonito,1166,687,644,2497
46002,2020-05-27,(05001) Patio Bonito,1552,818,842,3212
46003,2020-06-05,(07009) SENA,602,345,360,1307
46004,2020-01-26,(06103) CAN,240,198,332,770
46005,2020-05-04,(05100) Banderas P. Central - alimentacion,1962,930,931,3823
46006,2020-09-11,(12003) Ricaurte,389,253,232,874
46007,2020-09-17,(12003) Ricaurte,437,277,230,944
46008,2020-03-01,(06000) Portal Eldorado,744,590,1121,2455
46009,2020-08-18,(07200) Tygua-San José,259,131,139,529
46010,2020-01-02,(12001) Carrera 43,657,445,598,1700
46011,2020-05-20,(06103) CAN,352,207,155,714
46012,2020-08-10,(06103) CAN,374,214,171,759
46013,2020-01-27,(09109) Tercer Milenio,1323,840,841,3004
46014,2020-07-30,(09109) Tercer Milenio,359,217,214,790
46015,2020-08-16,(03002) SUBA - TV- 91,222,92,197,511
46016,2020-07-04,(02104) Calle 146,615,346,441,1402
46017,2020-02-22,(03001) LA CAMPIÑA,3445,1449,2480,7374
46018,2020-07-18,(10005) Bicentenario,63,47,63,173
46019,2020-09-23,(10005) Bicentenario,121,61,108,290
46020,2020-05-18,(02304) Heroes,670,466,366,1502
46021,2020-07-17,(02001) Centro Comercial Santa Fe,466,314,298,1078
46022,2020-07-12,(04100) Carrera 77,446,213,374,1033
46023,2020-08-13,(02104) Calle 146,672,396,461,1529
46024,2020-04-12,(09120) Calle 63,187,150,128,465
46025,2020-08-27,(10009) Museo Nacional,463,272,344,1079
46026,2020-09-21,(10009) Museo Nacional,148,290,429,867
46027,2020-04-01,(05105) Pradera,354,251,151,756
46028,2020-01-04,(06105) Quinta Paredes,189,116,191,496
46029,2020-10-08,(06111) Universidades,496,231,531,1258
46030,2020-08-22,(09115) Calle 34,387,247,349,983
46031,2020-05-18,(02104) Calle 146,568,420,379,1367
46032,2020-06-12,(07110) PALOQUEMAO,648,387,264,1299
46033,2020-06-18,(07006) General Santander,541,330,296,1167
46034,2020-09-28,(07006) General Santander,638,395,424,1457
46035,2020-01-30,(07105) MOVISTAR ARENA,1279,791,710,2780
46036,2020-09-10,(02105) Calle 142,824,490,561,1875
46037,2020-05-10,(08000) Portal Tunal - alimentacion,1461,747,745,2953
46038,2020-05-11,(02201) Prado,649,411,381,1441
46039,2020-01-12,(07201) Guatoque -Veraguas,86,93,216,395
46040,2020-01-28,(07200) Tygua-San José,846,496,606,1948
46041,2020-05-30,(07111) NQS - RICAURTE,775,505,327,1607
46042,2020-05-03,(03012) SUBA - CALLE 95,66,44,44,154
46043,2020-01-19,(09118) Marly,1292,800,1305,3397
46044,2020-08-24,(02200) Alcalá,1579,1117,844,3540
46045,2020-04-16,(09103) Olaya,495,274,270,1039
46046,2020-06-28,(06104) Gobernación,45,27,43,115
46047,2020-09-07,(06104) Gobernación,276,146,135,557
46048,2020-06-10,(07105) MOVISTAR ARENA,245,141,122,508
46049,2020-06-10,(07107) U. NACIONAL,303,185,144,632
46050,2020-02-25,(04102) Avenida Boyaca,3136,1907,1556,6599
46051,2020-07-13,(02304) Heroes,626,426,355,1407
46052,2020-04-24,(07001) PERDOMO,460,273,232,965
46053,2020-05-16,(10006) San Victorino,202,159,168,529
46054,2020-05-25,(02104) Calle 146,240,170,120,530
46055,2020-04-08,(09119) Calle 57,227,189,186,602
46056,2020-02-09,(40002) Manitas,326,160,323,809
46057,2020-10-05,(10010) San Bernardo,640,335,571,1546
46058,2020-03-14,(06106) Recinto Ferial,723,445,490,1658
46059,2020-09-21,(04000) Cabecera Calle 80,975,587,781,2343
46060,2020-09-04,(05102) Av. Américas - Av. Boyacá,276,154,215,645
46061,2020-09-10,(05102) Av. Américas - Av. Boyacá,246,140,171,557
46062,2020-07-10,(40001) Juan Pablo II,614,381,366,1361
46063,2020-08-04,(09110) Avenida Jimenez,1368,985,754,3107
46064,2020-08-02,(12003) Ricaurte,54,45,50,149
46065,2020-03-11,(12000) Puente Aranda,261,179,180,620
46066,2020-05-22,(12000) Puente Aranda,65,43,25,133
46067,2020-04-02,(07001) PERDOMO,407,243,314,964
46068,2020-04-14,(10006) San Victorino,198,146,146,490
46069,2020-05-14,(03005) SUBA - AV. BOYACA,314,195,181,690
46070,2020-06-09,(07506) DESPENSA,460,239,221,920
46071,2020-06-01,(02102) Calle 161,234,143,148,525
46072,2020-08-12,(12004) Carrera 22,259,148,128,535
46073,2020-08-06,(06001) Modelia,304,210,180,694
46074,2020-07-24,(10009) Museo Nacional,371,239,228,838
46075,2020-01-12,(10007) Las Nieves,190,187,419,796
46076,2020-07-12,(09003) Socorro,295,110,189,594
46077,2020-06-12,(04106) Carrera 47,369,182,198,749
46078,2020-05-18,(07002) MADELENA,563,346,324,1233
46079,2020-06-28,(09120) Calle 63,377,247,308,932
46080,2020-08-30,(02303) Calle 85,176,128,145,449
46081,2020-04-16,(40001) Juan Pablo II,285,147,192,624
46082,2020-06-03,(06002) Normandía,299,179,154,632
46083,2020-08-20,(06002) Normandía,281,165,200,646
46084,2020-10-07,(09108) Hospital,54,42,80,176
46085,2020-07-19,(03006) NIZA - CALLE 127,158,102,84,344
46086,2020-04-23,(02502) Terminal,178,108,154,440
46087,2020-06-11,(06101) El Tiempo,353,219,172,744
46088,2020-03-28,(07108) Av. El Dorado,42,31,21,94
46089,2020-04-06,(07006) General Santander,258,143,137,538
46090,2020-05-02,(06102) Salitre El Greco,107,71,71,249
46091,2020-04-02,(09116) Avenida 39,163,129,124,416
46092,2020-06-10,(09111) Calle 19,737,451,452,1640
46093,2020-04-04,(04106) Carrera 47,127,69,64,260
46094,2020-09-08,(03007) HUMEDAL CORDOBA,148,96,86,330
46095,2020-03-12,(07108) Av. El Dorado,277,77,128,482
46096,2020-04-06,(09111) Calle 19,231,155,238,624
46097,2020-05-30,(09111) Calle 19,540,348,396,1284
46098,2020-01-05,(02502) Terminal,239,207,523,969
46099,2020-09-22,(07003) SEVILLANA,509,278,319,1106
46100,2020-04-19,(06103) CAN,146,95,59,300
46101,2020-05-17,(04102) Avenida Boyaca,69,40,50,159
46102,2020-04-24,(03005) SUBA - AV. BOYACA,235,134,140,509
46103,2020-03-01,(09106) Nariño,424,198,510,1132
46104,2020-09-14,(09106) Nariño,453,257,350,1060
46105,2020-06-22,(04108) El Polo,107,67,90,264
46106,2020-01-05,(07108) Av. El Dorado,111,68,152,331
46107,2020-05-01,(04107) Escuela Militar,30,17,31,78
46108,2020-06-07,(09000) Cabecera Usme,403,212,337,952
46109,2020-03-31,(04107) Escuela Militar,54,34,47,135
46110,2020-04-09,(10003) Ciudad Jardín,25,22,23,70
46111,2020-07-30,(03005) SUBA - AV. BOYACA,431,245,250,926
46112,2020-04-10,(06107) Ciudad Universitaria,32,19,30,81
46113,2020-06-26,(09105) Río Fucha,132,49,102,283
46114,2020-10-04,(14001) La Sabana,39,34,63,136
46115,2020-06-11,(07108) Av. El Dorado,132,87,86,305
46116,2020-08-30,(09108) Hospital,21,25,36,82
46117,2020-05-31,(07008) NQS - Calle 30 Sur,79,44,54,177
46118,2020-07-13,(03014) SAN MARTIN,20,13,19,52
46119,2020-08-30,(07101) CASTELLANA,32,17,44,93
46120,2020-06-16,(50006) Corral Carrera 77,5,1,6,12
46121,2020-10-13,(07003) SEVILLANA,0,0,1,1
46122,2020-10-07,(04000) Cabecera Calle 80 - alimentacion,4988,2784,4042,11814
46123,2020-02-18,(07005) ALQUERIA,2737,1527,1427,5691
46124,2020-09-03,(09002) Consuelo,538,289,323,1150
46125,2020-01-11,(02502) Terminal,1187,693,1278,3158
46126,2020-07-08,(02502) Terminal,465,310,386,1161
46127,2020-07-24,(02502) Terminal,344,223,252,819
46128,2020-02-07,(10000) Portal 20 de Julio - alimentacion,11032,5859,8034,24925
46129,2020-09-15,(09119) Calle 57,614,382,436,1432
46130,2020-09-24,(09119) Calle 57,679,431,532,1642
46131,2020-01-22,(03000) Portal Suba - alimentacion,25401,14652,14933,54986
46132,2020-01-31,(03002) SUBA - TV- 91,4454,2351,2440,9245
46133,2020-02-18,(03002) SUBA - TV- 91,4806,2812,2474,10092
46134,2020-03-04,(02101) Toberín,14922,9389,7590,31901
46135,2020-02-03,(09100) Calle 40 Sur,7407,4194,4295,15896
46136,2020-06-08,(09003) Socorro,595,313,313,1221
46137,2020-01-22,(08001) Parque el Tunal,1562,865,878,3305
46138,2020-05-27,(10000) Portal 20 de Julio - alimentacion,3776,1689,2055,7520
46139,2020-01-21,(09100) Calle 40 Sur,5512,2534,2658,10704
46140,2020-04-04,(05000) Portal Américas - alimentacion,4608,2063,1784,8455
46141,2020-07-21,(04000) Cabecera Calle 80 - alimentacion,3579,2090,2213,7882
46142,2020-07-25,(05001) Patio Bonito,1035,594,606,2235
46143,2020-09-10,(05001) Patio Bonito,2035,988,1090,4113
46144,2020-01-21,(07010) Bosa,1633,932,1081,3646
46145,2020-01-30,(14004) Museo del Oro,3954,2393,1922,8269
46146,2020-01-17,(03000) Portal Suba,7720,4247,4795,16762
46147,2020-01-29,(08000) Portal Tunal - alimentacion,23526,12716,11425,47667
46148,2020-02-20,(02102) Calle 161,1892,1172,1010,4074
46149,2020-09-27,(09000) Cabecera Usme,512,273,619,1404
46150,2020-01-05,(05100) Banderas P. Central - alimentacion,2258,868,1789,4915
46151,2020-02-06,(07009) SENA,3575,2123,2008,7706
46152,2020-02-19,(07009) SENA,3949,2310,2063,8322
46153,2020-03-16,(02205) Calle 106,1671,1141,904,3716
46154,2020-01-29,(05107) Américas - Cr.53,2518,1414,1334,5266
46155,2020-02-07,(09123) Calle 76,5317,3786,3382,12485
46156,2020-02-22,(03005) SUBA - AV. BOYACA,1434,808,1137,3379
46157,2020-05-12,(09101) Quiroga,360,210,257,827
46158,2020-03-25,(03013) RIO NEGRO,147,105,94,346
46159,2020-08-30,(09000) Cabecera Usme - alimentacion,2736,1196,2003,5935
46160,2020-04-05,(09118) Marly,414,273,191,878
46161,2020-02-23,(09103) Olaya,990,453,935,2378
46162,2020-05-04,(09103) Olaya,629,367,298,1294
46163,2020-08-25,(07002) MADELENA,749,450,498,1697
46164,2020-02-16,(02200) Alcalá,2057,1194,2097,5348
46165,2020-06-18,(09113) Calle 22,444,273,356,1073
46166,2020-10-10,(04105) Carrera 53,227,137,235,599
46167,2020-04-13,(05000) Portal Américas,1302,912,956,3170
46168,2020-06-13,(04000) Cabecera Calle 80,738,439,550,1727
46169,2020-07-09,(04000) Cabecera Calle 80,1142,722,900,2764
46170,2020-07-03,(04100) Carrera 77,1408,757,914,3079
46171,2020-03-02,(10008) San Diego,1528,822,767,3117
46172,2020-09-13,(10005) Bicentenario - alimentacion,46,35,102,183
46173,2020-03-01,(40003) Mirador del Paraiso,1775,820,1241,3836
46174,2020-02-17,(08001) Parque el Tunal,1740,1034,899,3673
46175,2020-05-04,(03000) Portal Suba - alimentacion,3972,2332,2046,8350
46176,2020-08-25,(10000) Portal 20 de Julio - alimentacion,3818,1677,2250,7745
46177,2020-04-02,(02000) Cabecera Autopista Norte - alimentacion,2583,1333,1177,5093
46178,2020-02-28,(10010) San Bernardo,1728,980,1412,4120
46179,2020-08-11,(02303) Calle 85,688,452,326,1466
46180,2020-02-28,(07000) Portal Sur,8064,4438,4515,17017
46181,2020-07-23,(09116) Avenida 39,300,189,195,684
46182,2020-02-10,(07004) VENECIA,4759,2852,2479,10090
46183,2020-08-15,(07004) VENECIA,779,454,535,1768
46184,2020-03-04,(08001) Parque el Tunal,1744,1012,998,3754
46185,2020-07-10,(09116) Avenida 39,362,239,274,875
46186,2020-01-31,(05102) Av. Américas - Av. Boyacá,1778,1010,983,3771
46187,2020-01-26,(09113) Calle 22,489,298,546,1333
46188,2020-01-27,(09113) Calle 22,1506,865,1102,3473
46189,2020-01-25,(02302) Virrey,1296,992,1238,3526
46190,2020-05-25,(09004) Santa Lucía,819,374,428,1621
46191,2020-06-01,(10002) Av. Primero de Mayo,1942,1037,1100,4079
46192,2020-06-13,(02201) Prado,742,440,422,1604
46193,2020-03-23,(02000) Cabecera Autopista Norte - alimentacion,1374,673,531,2578
46194,2020-09-24,(02000) Cabecera Autopista Norte - alimentacion,5165,2734,3487,11386
46195,2020-09-10,(07001) PERDOMO,897,501,650,2048
46196,2020-10-06,(06102) Salitre El Greco,259,141,201,601
46197,2020-08-30,(05103) Marsella,132,63,120,315
46198,2020-02-05,(10009) Museo Nacional,4408,2360,1992,8760
46199,2020-02-24,(03011) SUBA - CALLE 100,2751,1386,1464,5601
46200,2020-08-27,(02300) Calle 100,1114,746,672,2532
46201,2020-07-13,(09119) Calle 57,400,266,275,941
46202,2020-06-04,(02000) Cabecera Autopista Norte - alimentacion,4434,2464,2271,9169
46203,2020-07-04,(02202) Calle 127,920,623,536,2079
46204,2020-09-13,(05105) Pradera,147,128,148,423
46205,2020-09-22,(05105) Pradera,670,383,316,1369
46206,2020-03-17,(07009) SENA,2103,1189,1146,4438
46207,2020-04-01,(07009) SENA,270,157,158,585
46208,2020-06-21,(04104) Avenida 68,204,118,131,453
46209,2020-10-01,(03009) Av. Suba- Calle 116,564,323,349,1236
46210,2020-04-01,(02205) Calle 106,170,121,107,398
46211,2020-05-09,(02205) Calle 106,139,99,86,324
46212,2020-01-12,(06111) Universidades,450,288,619,1357
46213,2020-02-02,(06000) Portal Eldorado - alimentacion,4513,1822,3641,9976
46214,2020-08-06,(04003) Avenida Ciudad de Cali,820,426,670,1916
46215,2020-10-09,(06000) Portal Eldorado - alimentacion,4436,2129,3077,9642
46216,2020-03-02,(07201) Guatoque -Veraguas,1030,517,589,2136
46217,2020-01-18,(02304) Heroes,1680,1297,1464,4441
46218,2020-03-04,(07103) AV. CHILE,3723,2278,1912,7913
46219,2020-06-23,(07103) AV. CHILE,986,624,448,2058
46220,2020-01-01,(06111) Universidades,144,91,337,572
46221,2020-09-09,(08002) Biblioteca,330,193,214,737
46222,2020-03-28,(02000) Cabecera Autopista Norte - alimentacion,1945,985,766,3696
46223,2020-02-24,(07108) Av. El Dorado,1011,621,581,2213
46224,2020-02-17,(05101) Mandalay - Cr.73,1207,686,571,2464
46225,2020-05-27,(07000) Portal Sur,1582,1016,894,3492
46226,2020-06-28,(09100) Calle 40 Sur,584,293,481,1358
46227,2020-02-05,(07104) Simon Bolivar,2459,1495,1362,5316
46228,2020-04-13,(10005) Bicentenario - alimentacion,146,74,107,327
46229,2020-06-23,(10005) Bicentenario - alimentacion,234,125,193,552
46230,2020-07-07,(10005) Bicentenario - alimentacion,232,103,191,526
46231,2020-05-24,(05000) Portal Américas,524,346,424,1294
46232,2020-07-09,(07004) VENECIA,1079,667,604,2350
46233,2020-09-30,(03001) LA CAMPIÑA,1458,845,932,3235
46234,2020-03-14,(09120) Calle 63,3261,2195,2516,7972
46235,2020-08-18,(09117) Calle 45,641,395,386,1422
46236,2020-01-02,(06100) Av. Rojas,742,473,499,1714
46237,2020-02-16,(09111) Calle 19,552,341,630,1523
46238,2020-05-10,(02202) Calle 127,326,230,142,698
46239,2020-09-06,(02202) Calle 127,349,300,335,984
46240,2020-03-10,(04002) Carrera 90,192,1120,736,2048
46241,2020-03-07,(07003) SEVILLANA,1192,577,875,2644
46242,2020-07-25,(04108) El Polo,282,158,195,635
46243,2020-05-30,(02001) Centro Comercial Santa Fe,282,168,219,669
46244,2020-05-01,(06100) Av. Rojas,45,29,42,116
46245,2020-01-24,(12003) Ricaurte,1174,725,657,2556
46246,2020-10-05,(12003) Ricaurte,451,324,284,1059
46247,2020-05-09,(03010) PUENTE LARGO,188,117,93,398
46248,2020-04-06,(02302) Virrey,324,237,192,753
46249,2020-07-19,(05100) Banderas P. Central,168,88,138,394
46250,2020-01-26,(03009) Av. Suba- Calle 116,375,255,413,1043
46251,2020-03-12,(09109) Tercer Milenio,306,198,193,697
46252,2020-03-18,(06107) Ciudad Universitaria,512,293,361,1166
46253,2020-01-22,(10005) Bicentenario,766,382,375,1523
46254,2020-05-15,(07103) AV. CHILE,695,475,352,1522
46255,2020-06-23,(10005) Bicentenario,114,59,83,256
46256,2020-01-27,(12002) CDS - Carrera 32,598,329,293,1220
46257,2020-02-17,(09106) Nariño,2098,1283,1378,4759
46258,2020-05-11,(09106) Nariño,290,157,194,641
46259,2020-06-10,(02304) Heroes,776,549,422,1747
46260,2020-02-16,(09101) Quiroga,452,234,551,1237
46261,2020-04-05,(09120) Calle 63,202,134,121,457
46262,2020-06-29,(09120) Calle 63,379,238,283,900
46263,2020-07-18,(09120) Calle 63,670,425,458,1553
46264,2020-08-30,(09120) Calle 63,367,254,375,996
46265,2020-08-05,(10009) Museo Nacional,460,255,289,1004
46266,2020-04-25,(02202) Calle 127,546,365,296,1207
46267,2020-03-25,(06102) Salitre El Greco,178,129,104,411
46268,2020-10-10,(05105) Pradera,496,314,401,1211
46269,2020-07-10,(07004) VENECIA,1088,714,627,2429
46270,2020-10-06,(07110) PALOQUEMAO,725,407,401,1533
46271,2020-06-24,(09111) Calle 19,779,503,484,1766
46272,2020-08-19,(09106) Nariño,404,222,301,927
46273,2020-10-06,(05103) Marsella,566,300,435,1301
46274,2020-08-30,(07111) NQS - RICAURTE,222,166,210,598
46275,2020-05-20,(09103) Olaya,793,444,406,1643
46276,2020-07-16,(02303) Calle 85,546,398,251,1195
46277,2020-06-03,(06104) Gobernación,247,151,99,497
46278,2020-09-03,(07201) Guatoque -Veraguas,207,119,140,466
46279,2020-06-16,(07105) MOVISTAR ARENA,249,149,148,546
46280,2020-07-02,(07105) MOVISTAR ARENA,278,149,166,593
46281,2020-07-10,(07105) MOVISTAR ARENA,308,158,165,631
46282,2020-04-21,(09121) Las Flores,390,285,259,934
46283,2020-08-14,(02200) Alcalá,1620,1070,884,3574
46284,2020-04-19,(09120) Calle 63,223,147,143,513
46285,2020-06-18,(07107) U. NACIONAL,355,191,190,736
46286,2020-07-06,(07107) U. NACIONAL,352,225,201,778
46287,2020-04-20,(09123) Calle 76,508,379,307,1194
46288,2020-08-21,(04102) Avenida Boyaca,352,211,223,786
46289,2020-04-08,(14004) Museo del Oro,0,51,112,163
46290,2020-07-31,(40001) Juan Pablo II,492,313,318,1123
46291,2020-09-14,(40001) Juan Pablo II,277,316,507,1100
46292,2020-05-26,(06107) Ciudad Universitaria,158,103,110,371
46293,2020-01-01,(04000) Cabecera Calle 80,415,238,748,1401
46294,2020-01-02,(05005) Transversal 86,1052,546,608,2206
46295,2020-04-21,(05102) Av. Américas - Av. Boyacá,122,69,69,260
46296,2020-10-07,(05102) Av. Américas - Av. Boyacá,302,172,248,722
46297,2020-04-14,(07109) CAD,426,278,194,898
46298,2020-04-22,(07109) CAD,436,276,183,895
46299,2020-10-06,(14005) Las Aguas,259,176,339,774
46300,2020-05-09,(12001) Carrera 43,218,116,115,449
46301,2020-07-27,(07109) CAD,529,341,253,1123
46302,2020-08-06,(07109) CAD,503,355,255,1113
46303,2020-10-08,(07107) U. NACIONAL,399,248,305,952
46304,2020-03-12,(04107) Escuela Militar,203,58,88,349
46305,2020-05-02,(10009) Museo Nacional,149,104,133,386
46306,2020-08-25,(09122) Calle 72,1118,703,776,2597
46307,2020-06-13,(07102) NQS - CALLE 75,268,209,193,670
46308,2020-07-21,(07006) General Santander - alimentacion,300,176,210,686
46309,2020-07-22,(07009) SENA,636,361,397,1394
46310,2020-08-19,(07009) SENA,568,325,347,1240
46311,2020-08-08,(04101) Minuto de Dios,172,104,178,454
46312,2020-10-02,(09106) Nariño,509,291,443,1243
46313,2020-03-31,(09110) Avenida Jimenez,238,203,246,687
46314,2020-07-28,(07108) Av. El Dorado,117,87,82,286
46315,2020-08-25,(07108) Av. El Dorado,134,74,77,285
46316,2020-10-06,(04001) Quirigua,452,274,382,1108
46317,2020-03-17,(09108) Hospital,149,93,130,372
46318,2020-05-19,(09108) Hospital,61,39,54,154
46319,2020-09-28,(09108) Hospital,67,47,79,193
46320,2020-05-16,(40001) Juan Pablo II,363,183,254,800
46321,2020-01-12,(09003) Socorro,487,215,363,1065
46322,2020-02-12,(03004) GRATAMIRA,332,190,164,686
46323,2020-03-25,(04103) Las Ferias,189,133,80,402
46324,2020-08-16,(10005) Bicentenario - alimentacion,52,24,75,151
46325,2020-01-09,(09106) Nariño,1403,805,969,3177
46326,2020-02-23,(07102) NQS - CALLE 75,220,149,262,631
46327,2020-08-11,(07005) ALQUERIA,529,301,316,1146
46328,2020-01-04,(07102) NQS - CALLE 75,394,314,382,1090
46329,2020-07-24,(04106) Carrera 47,313,142,150,605
46330,2020-09-27,(05101) Mandalay - Cr.73,34,15,45,94
46331,2020-06-20,(07006) General Santander - alimentacion,299,165,225,689
46332,2020-05-18,(07107) U. NACIONAL,277,164,146,587
46333,2020-05-25,(02304) Heroes,191,143,122,456
46334,2020-04-17,(05100) Banderas P. Central,343,202,200,745
46335,2020-05-17,(07109) CAD,162,116,79,357
46336,2020-07-12,(02000) Cabecera Autopista Norte - intermunicipal,133,102,174,409
46337,2020-03-23,(03006) NIZA - CALLE 127,144,101,54,299
46338,2020-08-11,(05103) Marsella,425,203,210,838
46339,2020-08-09,(07005) ALQUERIA,135,64,117,316
46340,2020-08-29,(12004) Carrera 22,210,135,150,495
46341,2020-04-14,(07200) Tygua-San José,72,49,68,189
46342,2020-03-29,(40001) Juan Pablo II,88,42,57,187
46343,2020-03-23,(04001) Quirigua,84,55,49,188
46344,2020-08-22,(06104) Gobernación,103,80,79,262
46345,2020-03-01,(12002) CDS - Carrera 32,53,75,108,236
46346,2020-04-15,(07201) Guatoque -Veraguas,79,61,74,214
46347,2020-06-22,(07006) General Santander - alimentacion,91,60,97,248
46348,2020-06-02,(14005) Las Aguas,0,58,171,229
46349,2020-04-20,(40002) Manitas,171,97,116,384
46350,2020-08-13,(09105) Río Fucha,0,67,136,203
46351,2020-04-30,(06104) Gobernación,170,115,76,361
46352,2020-07-18,(05102) Av. Américas - Av. Boyacá,131,81,102,314
46353,2020-07-25,(03005) SUBA - AV. BOYACA,269,155,153,577
46354,2020-09-13,(06106) Recinto Ferial,78,56,81,215
46355,2020-02-23,(12003) Ricaurte,125,104,175,404
46356,2020-08-13,(05101) Mandalay - Cr.73,124,70,69,263
46357,2020-06-12,(07108) Av. El Dorado,149,90,82,321
46358,2020-04-01,(03014) SAN MARTIN,14,10,26,50
46359,2020-08-29,(06108) Concejo de Bogotá,81,51,83,215
46360,2020-08-11,(03014) SAN MARTIN,0,18,26,44
46361,2020-06-01,(07108) Av. El Dorado,118,75,88,281
46362,2020-05-10,(04107) Escuela Militar,29,20,18,67
46363,2020-04-05,(12007) Zona Industrial,15,18,25,58
46364,2020-05-03,(06106) Recinto Ferial,54,41,34,129
46365,2020-08-16,(06105) Quinta Paredes,30,20,19,69
46366,2020-04-16,(50002) Corral Calle 40 Sur,8,6,8,22
46367,2020-08-10,(03004) GRATAMIRA,0,12,29,41
46368,2020-05-24,(06107) Ciudad Universitaria,37,26,34,97
46369,2020-06-23,(50004) Corral Avenida Ciudad de Cali,1,0,1,2
46370,2020-05-31,(04000) Cabecera Calle 80 - alimentacion,917,441,731,2089
46371,2020-03-18,(07005) ALQUERIA,1419,782,790,2991
46372,2020-01-03,(09002) Consuelo,823,407,615,1845
46373,2020-08-20,(02502) Terminal,334,249,291,874
46374,2020-01-08,(07504) TERREROS,13550,7778,7671,28999
46375,2020-04-27,(07504) TERREROS,2247,212,328,2787
46376,2020-06-30,(07504) TERREROS,6381,3655,3128,13164
46377,2020-02-07,(05000) Portal Américas - alimentacion,37071,21675,22048,80794
46378,2020-09-18,(05000) Portal Américas - alimentacion,12539,6897,7858,27294
46379,2020-02-04,(09119) Calle 57,3820,2358,2047,8225
46380,2020-06-12,(09119) Calle 57,564,346,368,1278
46381,2020-07-30,(09119) Calle 57,516,320,367,1203
46382,2020-03-06,(08000) Portal Tunal - alimentacion,23974,12658,12040,48672
46383,2020-02-09,(04106) Carrera 47,395,207,337,939
46384,2020-02-14,(06000) Portal Eldorado - alimentacion,19104,9909,9818,38831
46385,2020-02-25,(06000) Portal Eldorado - alimentacion,19110,10552,9797,39459
46386,2020-03-05,(06104) Gobernación,1353,824,681,2858
46387,2020-09-17,(10000) Portal 20 de Julio - alimentacion,4477,1996,2939,9412
46388,2020-04-07,(04000) Cabecera Calle 80 - alimentacion,1886,1000,1135,4021
46389,2020-05-03,(04000) Cabecera Calle 80 - alimentacion,609,366,443,1418
46390,2020-01-21,(07000) Portal Sur - alimentacion,20381,10022,9911,40314
46391,2020-02-25,(14004) Museo del Oro,4464,2563,1919,8946
46392,2020-02-19,(07103) AV. CHILE,3818,2344,1906,8068
46393,2020-09-30,(05100) Banderas P. Central,1172,668,856,2696
46394,2020-09-11,(10001) Country Sur,1335,552,799,2686
46395,2020-03-10,(07503) SAN MATEO,1642,11245,6613,19500
46396,2020-03-04,(02000) Cabecera Autopista Norte,11597,7084,6218,24899
46397,2020-02-05,(02204) Pepe Sierra,5099,3373,2456,10928
46398,2020-01-26,(07005) ALQUERIA,661,319,564,1544
46399,2020-09-12,(05100) Banderas P. Central,712,323,579,1614
46400,2020-07-31,(07001) PERDOMO,821,462,502,1785
46401,2020-01-16,(02000) Cabecera Autopista Norte,8956,5121,5470,19547
46402,2020-03-19,(04104) Avenida 68,1565,795,871,3231
46403,2020-02-17,(06002) Normandía,2682,1585,1286,5553
46404,2020-02-11,(02102) Calle 161,2061,1251,1206,4518
46405,2020-01-25,(09103) Olaya,2193,1111,1708,5012
46406,2020-07-29,(50003) Corral Molinos,1402,726,943,3071
46407,2020-01-23,(02103) Mazurén,3143,1923,1834,6900
46408,2020-05-28,(07000) Portal Sur - alimentacion,6758,3836,2952,13546
46409,2020-01-13,(07002) MADELENA,3962,2270,2273,8505
46410,2020-02-01,(02000) Cabecera Autopista Norte,4754,2399,3958,11111
46411,2020-04-25,(09113) Calle 22,262,134,196,592
46412,2020-03-04,(03003) 21 ANGELES,1738,881,905,3524
46413,2020-04-02,(04105) Carrera 53,151,103,81,335
46414,2020-02-06,(04000) Cabecera Calle 80,7186,4551,5056,16793
46415,2020-07-07,(04000) Cabecera Calle 80,1212,749,884,2845
46416,2020-02-24,(05107) Américas - Cr.53,2599,1493,1386,5478
46417,2020-09-24,(02201) Prado,980,649,668,2297
46418,2020-04-14,(04002) Carrera 90,370,219,160,749
46419,2020-06-09,(04002) Carrera 90,687,372,402,1461
46420,2020-01-30,(40003) Mirador del Paraiso,4805,2712,2606,10123
46421,2020-08-24,(40003) Mirador del Paraiso,1473,895,913,3281
46422,2020-05-26,(12001) Carrera 43,368,234,195,797
46423,2020-09-03,(50003) Corral Molinos,1570,799,1280,3649
46424,2020-02-20,(06111) Universidades,5963,3635,2419,12017
46425,2020-08-01,(09000) Cabecera Usme - alimentacion,6157,2993,3761,12911
46426,2020-01-09,(07108) Av. El Dorado,605,401,438,1444
46427,2020-09-08,(07108) Av. El Dorado,163,123,101,387
46428,2020-01-18,(02502) Terminal,1418,798,1517,3733
46429,2020-03-19,(09116) Avenida 39,1022,696,672,2390
46430,2020-02-03,(07008) NQS - Calle 30 Sur,1884,1055,1095,4034
46431,2020-06-16,(02101) Toberín,1537,1029,981,3547
46432,2020-01-29,(06108) Concejo de Bogotá,894,453,431,1778
46433,2020-02-27,(06108) Concejo de Bogotá,903,446,464,1813
46434,2020-03-02,(06108) Concejo de Bogotá,846,436,449,1731
46435,2020-03-24,(04000) Cabecera Calle 80,911,595,729,2235
46436,2020-01-24,(03003) 21 ANGELES,1650,735,842,3227
46437,2020-02-02,(06002) Normandía,340,179,424,943
46438,2020-01-30,(06001) Modelia,2465,1544,1192,5201
46439,2020-03-02,(09107) Hortúa,2489,1488,1471,5448
46440,2020-05-28,(40003) Mirador del Paraiso,1513,971,927,3411
46441,2020-07-16,(40003) Mirador del Paraiso,1112,748,699,2559
46442,2020-05-21,(05002) Tintal,1778,936,933,3647
46443,2020-09-05,(07005) ALQUERIA,507,260,340,1107
46444,2020-09-15,(07005) ALQUERIA,560,307,380,1247
46445,2020-05-12,(10000) Portal 20 de Julio,1803,900,862,3565
46446,2020-09-14,(02300) Calle 100,1223,825,780,2828
46447,2020-09-17,(02300) Calle 100,1174,838,875,2887
46448,2020-08-12,(03012) SUBA - CALLE 95,269,157,169,595
46449,2020-09-02,(03012) SUBA - CALLE 95,359,220,193,772
46450,2020-09-24,(03012) SUBA - CALLE 95,367,220,221,808
46451,2020-04-22,(50002) Corral Calle 40 Sur,10,7,14,31
46452,2020-03-16,(07006) General Santander,2025,1076,1001,4102
46453,2020-02-21,(08000) Portal Tunal,2145,1172,1051,4368
46454,2020-07-06,(08000) Portal Tunal,859,372,339,1570
46455,2020-08-06,(02000) Cabecera Autopista Norte,1182,726,740,2648
46456,2020-03-27,(08000) Portal Tunal,329,202,182,713
46457,2020-07-09,(08000) Portal Tunal,821,372,291,1484
46458,2020-01-25,(03009) Av. Suba- Calle 116,1047,734,941,2722
46459,2020-02-27,(09113) Calle 22,1587,911,1064,3562
46460,2020-01-09,(04000) Cabecera Calle 80,5325,3097,3608,12030
46461,2020-02-05,(04101) Minuto de Dios,3542,2163,1992,7697
46462,2020-05-02,(03000) Portal Suba,449,267,279,995
46463,2020-02-04,(12007) Zona Industrial,1272,745,651,2668
46464,2020-09-08,(14004) Museo del Oro,322,230,322,874
46465,2020-01-14,(03007) HUMEDAL CORDOBA,771,473,439,1683
46466,2020-07-15,(03007) HUMEDAL CORDOBA,140,87,52,279
46467,2020-09-21,(07000) Portal Sur,1937,1042,1150,4129
46468,2020-04-15,(02101) Toberín,581,421,424,1426
46469,2020-02-29,(04103) Las Ferias,890,465,681,2036
46470,2020-04-18,(07104) Simon Bolivar,170,115,93,378
46471,2020-03-10,(05107) Américas - Cr.53,803,314,364,1481
46472,2020-01-14,(07109) CAD,2478,1541,1357,5376
46473,2020-08-28,(04003) Avenida Ciudad de Cali,1035,580,770,2385
46474,2020-06-30,(09106) Nariño,433,256,332,1021
46475,2020-02-16,(09117) Calle 45,867,539,1117,2523
46476,2020-03-21,(07001) PERDOMO,273,146,175,594
46477,2020-03-19,(03001) LA CAMPIÑA,2842,1451,1649,5942
46478,2020-09-19,(04104) Avenida 68,505,263,449,1217
46479,2020-07-15,(02104) Calle 146,656,427,415,1498
46480,2020-03-21,(06100) Av. Rojas,66,47,49,162
46481,2020-08-30,(05001) Patio Bonito,649,331,434,1414
46482,2020-04-14,(03001) LA CAMPIÑA,534,311,294,1139
46483,2020-05-07,(03001) LA CAMPIÑA,661,374,368,1403
46484,2020-04-27,(04108) El Polo,49,126,53,228
46485,2020-07-13,(03009) Av. Suba- Calle 116,469,311,200,980
46486,2020-08-13,(10010) San Bernardo,591,317,398,1306
46487,2020-10-02,(06001) Modelia,435,267,325,1027
46488,2020-06-14,(02105) Calle 142,192,145,175,512
46489,2020-05-12,(10008) San Diego,223,133,130,486
46490,2020-02-16,(05002) Tintal,1954,972,2103,5029
46491,2020-04-05,(07005) ALQUERIA,88,50,61,199
46492,2020-09-02,(03006) NIZA - CALLE 127,533,297,272,1102
46493,2020-08-05,(03002) SUBA - TV- 91,565,355,395,1315
46494,2020-07-29,(02103) Mazurén,188,110,153,451
46495,2020-01-20,(07201) Guatoque -Veraguas,914,469,609,1992
46496,2020-01-03,(10005) Bicentenario,308,173,237,718
46497,2020-09-09,(02304) Heroes,973,645,547,2165
46498,2020-04-05,(06108) Concejo de Bogotá,47,31,30,108
46499,2020-07-20,(08000) Portal Tunal - alimentacion,1722,840,952,3514
46500,2020-02-08,(08002) Biblioteca,585,312,468,1365
46501,2020-03-25,(10009) Museo Nacional,394,307,258,959
46502,2020-02-27,(03004) GRATAMIRA,325,175,154,654
46503,2020-06-27,(07110) PALOQUEMAO,453,299,260,1012
46504,2020-02-08,(04107) Escuela Militar,335,238,349,922
46505,2020-02-21,(12004) Carrera 22,641,440,508,1589
46506,2020-02-22,(12004) Carrera 22,476,351,396,1223
46507,2020-05-22,(09122) Calle 72,1021,691,630,2342
46508,2020-09-08,(07101) CASTELLANA,257,119,141,517
46509,2020-09-15,(05102) Av. Américas - Av. Boyacá,272,155,184,611
46510,2020-05-28,(12002) CDS - Carrera 32,201,133,70,404
46511,2020-01-05,(07005) ALQUERIA,436,230,401,1067
46512,2020-03-30,(10000) Portal 20 de Julio,1146,561,523,2230
46513,2020-07-21,(09121) Las Flores,607,358,357,1322
46514,2020-07-07,(07003) SEVILLANA,465,249,255,969
46515,2020-07-23,(07003) SEVILLANA,344,207,179,730
46516,2020-01-01,(06109) Centro Memoria,71,65,148,284
46517,2020-01-23,(10007) Las Nieves,1853,1189,1102,4144
46518,2020-04-25,(10006) San Victorino,138,90,123,351
46519,2020-09-01,(07107) U. NACIONAL,386,239,197,822
46520,2020-05-16,(02104) Calle 146,412,262,261,935
46521,2020-05-07,(09110) Avenida Jimenez,620,458,510,1588
46522,2020-04-24,(10007) Las Nieves,252,168,143,563
46523,2020-07-21,(09114) Calle 26,260,163,194,617
46524,2020-08-14,(09114) Calle 26,300,184,225,709
46525,2020-04-23,(12000) Puente Aranda,51,24,25,100
46526,2020-06-04,(12000) Puente Aranda,82,38,36,156
46527,2020-04-14,(14005) Las Aguas,0,36,96,132
46528,2020-04-21,(03005) SUBA - AV. BOYACA,214,146,125,485
46529,2020-09-20,(02200) Alcalá,643,419,645,1707
46530,2020-09-08,(06001) Modelia,412,247,255,914
46531,2020-04-30,(04106) Carrera 47,197,116,107,420
46532,2020-08-07,(07110) PALOQUEMAO,230,140,116,486
46533,2020-03-29,(07102) NQS - CALLE 75,31,30,25,86
46534,2020-05-18,(07102) NQS - CALLE 75,332,233,192,757
46535,2020-07-23,(07200) Tygua-San José,160,84,120,364
46536,2020-08-03,(03010) PUENTE LARGO,232,176,128,536
46537,2020-06-28,(02502) Terminal,61,54,102,217
46538,2020-04-04,(07003) SEVILLANA,161,99,83,343
46539,2020-03-29,(09113) Calle 22,102,69,80,251
46540,2020-10-12,(09117) Calle 45,267,160,309,736
46541,2020-06-12,(07006) General Santander,545,324,306,1175
46542,2020-08-10,(04000) Cabecera Calle 80 - intermunicipal,301,177,281,759
46543,2020-04-29,(06100) Av. Rojas,119,84,68,271
46544,2020-07-21,(06100) Av. Rojas,210,128,116,454
46545,2020-05-13,(04102) Avenida Boyaca,224,130,159,513
46546,2020-07-21,(07200) Tygua-San José,171,106,136,413
46547,2020-04-04,(07103) AV. CHILE,273,205,146,624
46548,2020-06-01,(09108) Hospital,69,46,58,173
46549,2020-09-02,(07006) General Santander,604,359,365,1328
46550,2020-04-28,(02103) Mazurén,95,73,76,244
46551,2020-06-08,(14004) Museo del Oro,0,130,278,408
46552,2020-07-21,(05105) Pradera,579,324,208,1111
46553,2020-02-02,(09111) Calle 19,527,348,663,1538
46554,2020-04-12,(07101) CASTELLANA,17,12,26,55
46555,2020-08-12,(07108) Av. El Dorado,137,84,84,305
46556,2020-09-13,(07108) Av. El Dorado,40,24,63,127
46557,2020-03-26,(09110) Avenida Jimenez,203,215,237,655
46558,2020-07-16,(09117) Calle 45,586,365,339,1290
46559,2020-04-25,(07009) SENA,252,157,138,547
46560,2020-10-06,(07006) General Santander - alimentacion,423,240,356,1019
46561,2020-05-23,(04002) Carrera 90,463,234,247,944
46562,2020-02-23,(07010) Bosa,475,250,561,1286
46563,2020-07-01,(06102) Salitre El Greco,234,152,141,527
46564,2020-04-01,(07107) U. NACIONAL,180,157,99,436
46565,2020-10-12,(06108) Concejo de Bogotá,43,35,46,124
46566,2020-07-12,(02303) Calle 85,212,159,174,545
46567,2020-03-15,(03011) SUBA - CALLE 100,318,203,341,862
46568,2020-04-01,(04003) Avenida Ciudad de Cali,480,297,310,1087
46569,2020-04-15,(10004) Policarpa,147,80,93,320
46570,2020-09-02,(10004) Policarpa,273,123,183,579
46571,2020-07-13,(07506) DESPENSA,464,242,232,938
46572,2020-08-13,(06000) Portal Eldorado,847,553,427,1827
46573,2020-08-06,(03005) SUBA - AV. BOYACA,342,213,225,780
46574,2020-01-05,(03003) 21 ANGELES,281,96,250,627
46575,2020-08-21,(06101) El Tiempo,330,196,175,701
46576,2020-09-05,(02502) Terminal,294,191,378,863
46577,2020-06-24,(03004) GRATAMIRA,35,23,23,81
46578,2020-10-01,(06106) Recinto Ferial,307,198,186,691
46579,2020-04-19,(50003) Corral Molinos,266,156,260,682
46580,2020-05-03,(06101) El Tiempo,85,52,51,188
46581,2020-04-18,(10001) Country Sur,382,167,255,804
46582,2020-04-16,(07010) Bosa,323,175,196,694
46583,2019-12-31,(05102) Av. Américas - Av. Boyacá,7,9,18,34
46584,2020-09-18,(07003) SEVILLANA,521,310,357,1188
46585,2020-08-12,(06106) Recinto Ferial,243,139,130,512
46586,2020-08-08,(04105) Carrera 53,141,83,110,334
46587,2020-08-16,(07105) MOVISTAR ARENA,49,29,58,136
46588,2020-04-25,(09105) Río Fucha,54,29,44,127
46589,2020-05-08,(50002) Corral Calle 40 Sur,16,5,15,36
46590,2020-03-22,(04102) Avenida Boyaca,45,37,48,130
46591,2020-04-07,(10003) Ciudad Jardín,82,66,54,202
46592,2020-10-02,(12000) Puente Aranda,92,62,80,234
46593,2020-10-11,(03014) SAN MARTIN,0,5,30,35
46594,2020-06-22,(03014) SAN MARTIN,10,5,9,24
46595,2020-04-09,(12002) CDS - Carrera 32,41,24,14,79
46596,2020-03-31,(07201) Guatoque -Veraguas,49,41,61,151
46597,2020-09-11,(12000) Puente Aranda,85,46,45,176
46598,2020-05-10,(04105) Carrera 53,54,37,47,138
46599,2020-05-08,(50006) Corral Carrera 77,3,0,1,4
46600,2020-02-02,(50006) Corral Carrera 77,8,7,17,32
46601,2020-07-03,(09002) Consuelo,536,282,346,1164
46602,2020-02-28,(09118) Marly,7862,5298,4275,17435
46603,2020-03-16,(09118) Marly,4149,2885,2404,9438
46604,2020-07-22,(09118) Marly,1309,858,639,2806
46605,2020-07-27,(07504) TERREROS,5688,3204,2596,11488
46606,2020-09-10,(10000) Portal 20 de Julio - alimentacion,4231,1853,2553,8637
46607,2020-01-12,(08000) Portal Tunal - alimentacion,5373,2238,3716,11327
46608,2020-02-13,(04106) Carrera 47,1539,821,899,3259
46609,2020-02-14,(04106) Carrera 47,1526,798,928,3252
46610,2020-01-16,(03000) Portal Suba - alimentacion,24231,12969,14503,51703
46611,2020-02-05,(05000) Portal Américas - alimentacion,37171,22151,21490,80812
46612,2020-03-05,(07505) LEON XIII,8428,4534,3821,16783
46613,2020-01-31,(02200) Alcalá,14442,8219,6851,29512
46614,2020-02-07,(02200) Alcalá,15098,8815,7146,31059
46615,2020-01-03,(06104) Gobernación,579,367,382,1328
46616,2020-03-18,(50003) Corral Molinos,2672,1383,2025,6080
46617,2020-01-20,(09001) Molinos,6951,4155,5668,16774
46618,2020-03-18,(09001) Molinos,5098,2788,3346,11232
46619,2020-08-29,(05100) Banderas P. Central,650,290,473,1413
46620,2020-02-15,(02102) Calle 161,844,420,790,2054
46621,2020-10-08,(09000) Cabecera Usme,1962,1140,1655,4757
46622,2020-03-03,(07009) SENA,3676,2172,2149,7997
46623,2020-01-16,(06102) Salitre El Greco,1279,762,670,2711
46624,2020-03-11,(02204) Pepe Sierra,4635,3100,2404,10139
46625,2020-03-15,(07001) PERDOMO,689,324,648,1661
46626,2020-01-25,(40003) Mirador del Paraiso,3785,1997,2209,7991
46627,2020-02-10,(04000) Cabecera Calle 80 - intermunicipal,2479,1821,2126,6426
46628,2020-02-06,(09104) Restrepo,5238,3242,4169,12649
46629,2020-06-24,(04101) Minuto de Dios,346,220,250,816
46630,2020-02-15,(07505) LEON XIII,6028,3031,3251,12310
46631,2020-07-22,(07505) LEON XIII,2515,1345,1074,4934
46632,2020-09-03,(07505) LEON XIII,2940,1564,1320,5824
46633,2020-10-05,(07505) LEON XIII,3089,1558,1723,6370
46634,2020-02-10,(09117) Calle 45,6608,4214,3074,13896
46635,2020-08-14,(07102) NQS - CALLE 75,336,210,208,754
46636,2020-07-27,(03013) RIO NEGRO,269,154,179,602
46637,2020-03-15,(09118) Marly,1136,698,1066,2900
46638,2020-08-26,(09103) Olaya,966,541,509,2016
46639,2020-03-09,(03001) LA CAMPIÑA,180,2036,1330,3546
46640,2020-08-09,(50003) Corral Molinos,472,199,365,1036
46641,2020-01-11,(02103) Mazurén,729,346,797,1872
46642,2020-07-24,(07000) Portal Sur - alimentacion,6099,3550,2889,12538
46643,2020-07-22,(09103) Olaya,783,456,455,1694
46644,2020-01-12,(07106) EL CAMPIN,401,272,424,1097
46645,2020-08-27,(02000) Cabecera Autopista Norte,1304,774,840,2918
46646,2020-10-01,(02104) Calle 146,1032,626,839,2497
46647,2020-05-30,(09113) Calle 22,363,218,291,872
46648,2020-06-28,(09113) Calle 22,228,133,227,588
46649,2020-01-15,(04000) Cabecera Calle 80,6405,3633,4388,14426
46650,2020-06-02,(04000) Cabecera Calle 80,968,615,671,2254
46651,2020-09-22,(09110) Avenida Jimenez,1443,1016,957,3416
46652,2020-01-03,(09114) Calle 26,1338,859,918,3115
46653,2020-02-16,(09001) Molinos,1956,861,2055,4872
46654,2020-02-18,(06000) Portal Eldorado,6918,4049,2925,13892
46655,2020-09-23,(02101) Toberín,1794,1148,1342,4284
46656,2020-03-23,(08000) Portal Tunal - alimentacion,1693,787,752,3232
46657,2020-01-06,(04104) Avenida 68,517,293,476,1286
46658,2020-01-12,(07113) SANTA ISABEL,441,226,509,1176
46659,2020-07-28,(03000) Portal Suba,1230,737,820,2787
46660,2020-04-02,(02000) Cabecera Autopista Norte - intermunicipal,131,86,94,311
46661,2020-02-07,(06100) Av. Rojas,2741,1515,1361,5617
46662,2020-06-19,(08002) Biblioteca,347,183,193,723
46663,2020-07-18,(02303) Calle 85,366,254,229,849
46664,2020-05-08,(07503) SAN MATEO,6875,4359,3154,14388
46665,2020-09-24,(09116) Avenida 39,441,271,335,1047
46666,2020-03-25,(06108) Concejo de Bogotá,90,66,75,231
46667,2020-06-18,(06108) Concejo de Bogotá,141,90,79,310
46668,2020-03-13,(09004) Santa Lucía,354,1422,1159,2935
46669,2020-10-09,(10002) Av. Primero de Mayo,2623,1190,2032,5845
46670,2020-06-26,(02201) Prado,980,613,567,2160
46671,2020-06-30,(05000) Portal Américas,2533,1797,1903,6233
46672,2020-02-18,(02304) Heroes,4951,3407,2330,10688
46673,2020-03-14,(02304) Heroes,1685,1469,1446,4600
46674,2020-02-08,(05105) Pradera,1579,1024,1013,3616
46675,2020-03-11,(05105) Pradera,2331,1516,1186,5033
46676,2020-10-07,(02103) Mazurén,259,182,283,724
46677,2020-06-26,(02300) Calle 100,1333,842,754,2929
46678,2020-09-15,(03012) SUBA - CALLE 95,369,218,220,807
46679,2020-02-15,(07006) General Santander,1631,817,1202,3650
46680,2020-02-22,(08000) Portal Tunal,1409,859,902,3170
46681,2020-05-25,(08000) Portal Tunal,254,120,108,482
46682,2020-01-04,(07104) Simon Bolivar,723,470,534,1727
46683,2020-02-01,(07104) Simon Bolivar,1400,858,1024,3282
46684,2020-08-10,(05005) Transversal 86,348,208,256,812
46685,2020-07-21,(10008) San Diego,213,119,117,449
46686,2020-09-03,(10008) San Diego,318,183,199,700
46687,2020-02-19,(09106) Nariño,2056,1274,1405,4735
46688,2020-08-10,(03009) Av. Suba- Calle 116,413,284,207,904
46689,2020-08-26,(02205) Calle 106,332,211,216,759
46690,2020-08-20,(06111) Universidades,314,162,287,763
46691,2020-07-09,(05002) Tintal,2248,1371,1482,5101
46692,2020-05-12,(09118) Marly,1261,827,562,2650
46693,2020-02-14,(12007) Zona Industrial,1319,787,696,2802
46694,2020-01-31,(07000) Portal Sur,7827,4352,4394,16573
46695,2020-07-29,(10009) Museo Nacional,444,267,260,971
46696,2020-05-07,(07010) Bosa,467,255,302,1024
46697,2020-01-13,(08002) Biblioteca,866,437,613,1916
46698,2020-09-29,(08002) Biblioteca,340,183,236,759
46699,2020-09-04,(07000) Portal Sur,2187,1330,1534,5051
46700,2020-01-26,(02304) Heroes,545,448,659,1652
46701,2020-01-17,(04107) Escuela Militar,529,359,441,1329
46702,2020-07-29,(04107) Escuela Militar,137,85,95,317
46703,2020-08-28,(06000) Portal Eldorado,900,579,533,2012
46704,2020-08-18,(05001) Patio Bonito,1734,937,995,3666
46705,2020-07-07,(09117) Calle 45,760,476,481,1717
46706,2020-08-15,(09110) Avenida Jimenez,1151,957,805,2913
46707,2020-02-15,(06100) Av. Rojas,845,548,887,2280
46708,2020-04-23,(02202) Calle 127,650,467,305,1422
46709,2020-04-29,(09120) Calle 63,667,468,412,1547
46710,2020-07-15,(06000) Portal Eldorado - alimentacion,3551,1814,1701,7066
46711,2020-09-03,(12003) Ricaurte,417,281,221,919
46712,2020-04-20,(07106) EL CAMPIN,174,122,89,385
46713,2020-03-01,(09117) Calle 45,847,576,1067,2490
46714,2020-01-05,(03010) PUENTE LARGO,243,154,239,636
46715,2020-07-12,(03010) PUENTE LARGO,74,65,80,219
46716,2020-05-07,(10010) San Bernardo,455,253,304,1012
46717,2020-08-02,(05100) Banderas P. Central,151,55,129,335
46718,2020-10-03,(06103) CAN,251,184,257,692
46719,2020-03-23,(09109) Tercer Milenio,82,54,38,174
46720,2020-04-05,(09109) Tercer Milenio,64,44,38,146
46721,2020-06-09,(05100) Banderas P. Central - alimentacion,2142,1098,1442,4682
46722,2020-08-14,(12007) Zona Industrial,367,243,173,783
46723,2020-08-22,(06002) Normandía,200,123,148,471
46724,2020-06-30,(09000) Cabecera Usme,1830,1161,1294,4285
46725,2020-10-07,(10008) San Diego,331,184,247,762
46726,2020-08-25,(02304) Heroes,713,501,426,1640
46727,2020-01-18,(07107) U. NACIONAL,711,570,807,2088
46728,2020-07-20,(09120) Calle 63,279,189,215,683
46729,2020-06-25,(10009) Museo Nacional,528,308,325,1161
46730,2020-07-26,(05105) Pradera,105,90,85,280
46731,2020-03-16,(08002) Biblioteca,753,438,477,1668
46732,2020-09-28,(03000) Portal Suba,1692,1046,1290,4028
46733,2020-09-16,(09115) Calle 34,734,447,509,1690
46734,2020-04-24,(07110) PALOQUEMAO,498,317,216,1031
46735,2020-08-17,(07110) PALOQUEMAO,178,110,94,382
46736,2020-04-30,(07004) VENECIA,598,359,283,1240
46737,2020-08-09,(09123) Calle 76,217,153,184,554
46738,2020-01-26,(12007) Zona Industrial,158,160,189,507
46739,2020-06-20,(07111) NQS - RICAURTE,925,606,418,1949
46740,2020-05-15,(09123) Calle 76,774,568,396,1738
46741,2020-08-27,(50003) Corral Molinos,1473,748,1025,3246
46742,2020-02-08,(07201) Guatoque -Veraguas,499,293,528,1320
46743,2020-01-16,(07105) MOVISTAR ARENA,868,675,787,2330
46744,2020-05-19,(07105) MOVISTAR ARENA,229,145,132,506
46745,2020-03-27,(09121) Las Flores,384,265,253,902
46746,2020-07-01,(07003) SEVILLANA,468,242,263,973
46747,2020-02-10,(07506) DESPENSA,1663,990,890,3543
46748,2020-09-15,(02200) Alcalá,1971,1307,1273,4551
46749,2020-07-19,(09123) Calle 76,212,160,169,541
46750,2020-08-31,(03003) 21 ANGELES,366,179,212,757
46751,2020-09-18,(10007) Las Nieves,766,461,510,1737
46752,2020-04-09,(02104) Calle 146,160,119,79,358
46753,2020-04-10,(05002) Tintal,360,220,181,761
46754,2020-07-03,(40001) Juan Pablo II,622,347,376,1345
46755,2020-08-29,(14005) Las Aguas,153,97,220,470
46756,2020-01-30,(12000) Puente Aranda,270,150,185,605
46757,2020-02-29,(12000) Puente Aranda,166,130,164,460
46758,2020-04-07,(07109) CAD,402,281,181,864
46759,2020-03-18,(02102) Calle 161,778,486,453,1717
46760,2020-04-06,(12004) Carrera 22,47,39,50,136
46761,2020-05-02,(07005) ALQUERIA,197,130,123,450
46762,2020-04-05,(10009) Museo Nacional,74,48,65,187
46763,2020-04-28,(10009) Museo Nacional,320,208,181,709
46764,2020-04-24,(07009) SENA,353,230,184,767
46765,2020-04-25,(10004) Policarpa,89,41,88,218
46766,2020-03-20,(14001) La Sabana,60,50,47,157
46767,2020-04-07,(09110) Avenida Jimenez,236,212,302,750
46768,2020-06-01,(12003) Ricaurte,316,204,168,688
46769,2020-03-22,(02001) Centro Comercial Santa Fe,62,42,45,149
46770,2020-04-14,(02001) Centro Comercial Santa Fe,199,130,152,481
46771,2020-04-03,(12002) CDS - Carrera 32,145,113,53,311
46772,2020-05-05,(07108) Av. El Dorado,75,45,61,181
46773,2020-08-16,(07108) Av. El Dorado,34,17,29,80
46774,2020-03-25,(04000) Cabecera Calle 80 - intermunicipal,89,61,99,249
46775,2020-02-23,(14004) Museo del Oro,0,142,362,504
46776,2020-09-28,(04001) Quirigua,423,286,334,1043
46777,2020-03-31,(09003) Socorro,232,108,158,498
46778,2020-07-12,(03009) Av. Suba- Calle 116,148,102,101,351
46779,2020-02-03,(07006) General Santander - alimentacion,1463,927,1001,3391
46780,2020-02-02,(02001) Centro Comercial Santa Fe,633,366,891,1890
46781,2020-09-04,(06105) Quinta Paredes,162,106,96,364
46782,2020-09-30,(07003) SEVILLANA,522,294,328,1144
46783,2020-06-30,(07008) NQS - Calle 30 Sur,331,186,216,733
46784,2020-07-28,(06001) Modelia,321,193,153,667
46785,2020-04-19,(02303) Calle 85,150,103,83,336
46786,2020-06-21,(10006) San Victorino,145,95,114,354
46787,2020-06-02,(03004) GRATAMIRA,28,16,24,68
46788,2020-05-24,(06101) El Tiempo,71,57,50,178
46789,2020-03-25,(04107) Escuela Militar,47,34,37,118
46790,2020-05-24,(10005) Bicentenario - alimentacion,42,30,57,129
46791,2020-03-31,(07506) DESPENSA,177,103,115,395
46792,2020-07-11,(05102) Av. Américas - Av. Boyacá,185,105,139,429
46793,2020-09-06,(02000) Cabecera Autopista Norte - intermunicipal,151,92,165,408
46794,2020-01-04,(12003) Ricaurte,302,247,278,827
46795,2020-04-04,(07008) NQS - Calle 30 Sur,107,54,53,214
46796,2020-05-31,(02304) Heroes,151,115,109,375
46797,2020-01-06,(12004) Carrera 22,66,68,101,235
46798,2020-07-07,(04105) Carrera 53,316,155,175,646
46799,2020-06-07,(03013) RIO NEGRO,68,47,65,180
46800,2020-03-27,(09111) Calle 19,179,129,185,493
46801,2020-06-21,(06106) Recinto Ferial,69,56,54,179
46802,2020-07-20,(06106) Recinto Ferial,56,36,40,132
46803,2020-07-19,(09101) Quiroga,124,60,130,314
46804,2020-07-05,(07003) SEVILLANA,132,61,101,294
46805,2020-06-28,(08002) Biblioteca,118,50,66,234
46806,2020-04-02,(07101) CASTELLANA,59,44,68,171
46807,2020-07-18,(07101) CASTELLANA,117,71,75,263
46808,2020-05-31,(10004) Policarpa,82,34,65,181
46809,2020-07-16,(05103) Marsella,381,211,185,777
46810,2020-06-04,(09105) Río Fucha,112,62,68,242
46811,2020-09-10,(09105) Río Fucha,0,68,139,207
46812,2020-08-09,(04106) Carrera 47,84,42,67,193
46813,2020-08-12,(06105) Quinta Paredes,123,79,77,279
46814,2020-03-31,(14005) Las Aguas,0,30,93,123
46815,2020-05-11,(07108) Av. El Dorado,86,59,50,195
46816,2020-07-19,(07003) SEVILLANA,91,42,79,212
46817,2020-04-26,(06104) Gobernación,42,30,13,85
46818,2020-04-30,(50002) Corral Calle 40 Sur,12,10,7,29
46819,2020-06-15,(50002) Corral Calle 40 Sur,6,3,8,17
46820,2020-07-29,(04000) Cabecera Calle 80 - alimentacion,3873,2166,2518,8557
46821,2020-09-14,(04000) Cabecera Calle 80 - alimentacion,4210,2486,3110,9806
46822,2020-08-26,(09002) Consuelo,457,244,287,988
46823,2020-01-09,(07504) TERREROS,14184,7980,7704,29868
46824,2020-01-30,(07504) TERREROS,17412,10572,9104,37088
46825,2020-02-19,(07504) TERREROS,18025,11094,9150,38269
46826,2020-02-03,(03000) Portal Suba - alimentacion,28048,16904,16771,61723
46827,2020-01-28,(02200) Alcalá,14503,9133,6467,30103
46828,2020-02-10,(02200) Alcalá,14972,9623,6705,31300
46829,2020-02-16,(14005) Las Aguas,268,248,586,1102
46830,2020-01-04,(10000) Portal 20 de Julio - alimentacion,5955,2416,4158,12529
46831,2020-07-11,(05000) Portal Américas - alimentacion,9014,4665,4895,18574
46832,2020-02-15,(05001) Patio Bonito,5115,2492,3114,10721
46833,2020-05-26,(02000) Cabecera Autopista Norte - alimentacion,4371,2493,2386,9250
46834,2020-02-29,(07010) Bosa,1513,715,1160,3388
46835,2020-02-19,(09104) Restrepo,5478,3270,4008,12756
46836,2020-07-18,(07503) SAN MATEO,7478,4077,3549,15104
46837,2020-01-27,(07009) SENA,3392,2015,1967,7374
46838,2020-03-18,(10005) Bicentenario - alimentacion,474,235,359,1068
46839,2020-01-31,(02000) Cabecera Autopista Norte,10859,6217,6268,23344
46840,2020-02-12,(09115) Calle 34,4658,2956,2539,10153
46841,2020-02-06,(06002) Normandía,2627,1612,1421,5660
46842,2020-03-27,(06002) Normandía,164,98,78,340
46843,2020-02-19,(12003) Ricaurte,1329,846,667,2842
46844,2020-02-25,(12003) Ricaurte,1328,834,644,2806
46845,2020-05-04,(09101) Quiroga,324,169,260,753
46846,2020-09-23,(07102) NQS - CALLE 75,495,339,306,1140
46847,2020-02-12,(09103) Olaya,4518,2662,2435,9615
46848,2020-03-10,(02302) Virrey,2269,142,498,2909
46849,2020-03-19,(09100) Calle 40 Sur,3896,2081,2272,8249
46850,2020-09-24,(09100) Calle 40 Sur,1808,1119,1394,4321
46851,2020-02-25,(02303) Calle 85,4010,2611,1931,8552
46852,2020-05-14,(07000) Portal Sur - alimentacion,6002,3314,2512,11828
46853,2020-07-23,(09103) Olaya,766,453,420,1639
46854,2020-02-27,(07002) MADELENA,5220,2925,2533,10678
46855,2020-04-21,(07111) NQS - RICAURTE,580,404,277,1261
46856,2020-04-17,(02000) Cabecera Autopista Norte - alimentacion,2799,1517,1331,5647
46857,2020-01-13,(07106) EL CAMPIN,1711,1110,1051,3872
46858,2020-09-27,(08000) Portal Tunal - alimentacion,2170,969,1786,4925
46859,2020-01-06,(09113) Calle 22,375,236,438,1049
46860,2020-01-27,(04105) Carrera 53,1357,755,709,2821
46861,2020-07-23,(09004) Santa Lucía,1744,916,981,3641
46862,2020-06-09,(04000) Cabecera Calle 80,1012,614,752,2378
46863,2020-08-15,(07010) Bosa,553,247,360,1160
46864,2020-06-09,(07112) COMUNEROS,781,447,415,1643
46865,2020-01-14,(05002) Tintal,9540,5461,5343,20344
46866,2020-03-10,(05002) Tintal,302,3384,2220,5906
46867,2020-07-31,(04100) Carrera 77,930,538,629,2097
46868,2020-02-24,(10006) San Victorino,2537,1281,1263,5081
46869,2020-06-30,(12001) Carrera 43,430,254,265,949
46870,2020-02-06,(03000) Portal Suba,8980,5555,5097,19632
46871,2020-07-30,(02000) Cabecera Autopista Norte - intermunicipal,513,326,345,1184
46872,2020-09-11,(02000) Cabecera Autopista Norte - intermunicipal,551,359,443,1353
46873,2020-03-06,(08001) Parque el Tunal,1712,942,992,3646
46874,2020-02-26,(06100) Av. Rojas,2815,1483,1282,5580
46875,2020-01-30,(09115) Calle 34,4141,2585,2242,8968
46876,2020-02-05,(09115) Calle 34,4772,2942,2442,10156
46877,2020-04-15,(09108) Hospital,39,24,26,89
46878,2020-02-12,(04001) Quirigua,2206,1365,1199,4770
46879,2020-01-05,(04002) Carrera 90,568,216,538,1322
46880,2020-05-09,(07503) SAN MATEO,5091,3133,2372,10596
46881,2020-08-31,(08001) Parque el Tunal,460,260,302,1022
46882,2020-02-07,(05102) Av. Américas - Av. Boyacá,2000,1099,1011,4110
46883,2020-05-31,(07007) NQS - Calle 38A Sur,107,70,77,254
46884,2020-04-06,(09004) Santa Lucía,1127,592,659,2378
46885,2020-04-03,(03003) 21 ANGELES,160,80,71,311
46886,2020-03-18,(09113) Calle 22,943,551,665,2159
46887,2020-04-30,(09120) Calle 63,669,484,428,1581
46888,2020-09-16,(14004) Museo del Oro,403,267,300,970
46889,2020-09-17,(06102) Salitre El Greco,286,141,174,601
46890,2020-06-12,(05002) Tintal,2131,1179,1149,4459
46891,2020-07-30,(05002) Tintal,2069,1174,1260,4503
46892,2020-09-21,(02103) Mazurén,179,123,152,454
46893,2020-09-01,(02201) Prado,882,586,519,1987
46894,2020-02-21,(04002) Carrera 90,3694,1978,1990,7662
46895,2020-02-25,(02300) Calle 100,7348,4747,3799,15894
46896,2020-08-30,(02300) Calle 100,219,234,312,765
46897,2020-03-19,(03012) SUBA - CALLE 95,702,464,477,1643
46898,2020-10-04,(02000) Cabecera Autopista Norte - alimentacion,2288,934,2018,5240
46899,2020-01-27,(07006) General Santander,2676,1613,1497,5786
46900,2020-06-06,(10010) San Bernardo,427,222,316,965
46901,2020-02-18,(08000) Portal Tunal,2369,1376,1078,4823
46902,2020-02-20,(08000) Portal Tunal,2146,1230,1066,4442
46903,2020-02-22,(07104) Simon Bolivar,1431,962,1024,3417
46904,2020-03-20,(09104) Restrepo,696,449,489,1634
46905,2020-08-16,(09104) Restrepo,455,251,357,1063
46906,2020-07-01,(05005) Transversal 86,0,204,503,707
46907,2020-02-15,(02202) Calle 127,3002,1935,2113,7050
46908,2020-09-09,(05105) Pradera,654,406,325,1385
46909,2020-10-05,(05105) Pradera,653,428,430,1511
46910,2020-02-26,(09106) Nariño,1996,1157,1396,4549
46911,2020-05-28,(02205) Calle 106,284,207,174,665
46912,2020-10-01,(02205) Calle 106,403,296,333,1032
46913,2020-09-12,(04108) El Polo,339,218,296,853
46914,2020-08-01,(07201) Guatoque -Veraguas,128,61,94,283
46915,2020-10-09,(07201) Guatoque -Veraguas,245,127,221,593
46916,2020-09-10,(07505) LEON XIII,0,943,2248,3191
46917,2020-09-26,(07010) Bosa,0,312,847,1159
46918,2020-09-24,(07113) SANTA ISABEL,407,242,362,1011
46919,2020-01-17,(03003) 21 ANGELES,1547,674,781,3002
46920,2020-06-21,(06111) Universidades,77,67,123,267
46921,2020-06-10,(04104) Avenida 68,595,302,292,1189
46922,2020-08-25,(08002) Biblioteca,291,162,185,638
46923,2020-10-08,(08002) Biblioteca,343,196,249,788
46924,2020-10-05,(04000) Cabecera Calle 80,1310,821,1209,3340
46925,2020-01-13,(05103) Marsella,2209,1289,1283,4781
46926,2020-05-01,(10000) Portal 20 de Julio,723,340,398,1461
46927,2020-05-22,(02000) Cabecera Autopista Norte - alimentacion,4252,2361,2028,8641
46928,2020-01-10,(04000) Cabecera Calle 80 - intermunicipal,1383,945,1629,3957
46929,2020-09-21,(07104) Simon Bolivar,494,344,268,1106
46930,2020-01-07,(04107) Escuela Militar,392,257,313,962
46931,2020-09-29,(07109) CAD,722,453,427,1602
46932,2020-01-08,(05103) Marsella,1813,1000,1021,3834
46933,2020-01-21,(02000) Cabecera Autopista Norte - intermunicipal,3298,2066,1959,7323
46934,2020-03-01,(03003) 21 ANGELES,360,126,346,832
46935,2020-06-25,(06111) Universidades,296,182,331,809
46936,2020-03-19,(06105) Quinta Paredes,359,203,217,779
46937,2020-10-06,(03002) SUBA - TV- 91,966,547,708,2221
46938,2020-07-19,(07505) LEON XIII,643,350,332,1325
46939,2020-05-24,(02205) Calle 106,53,47,32,132
46940,2020-02-01,(07005) ALQUERIA,1599,828,1137,3564
46941,2020-05-27,(03001) LA CAMPIÑA,936,505,480,1921
46942,2020-06-20,(02000) Cabecera Autopista Norte,1050,617,692,2359
46943,2020-08-23,(09116) Avenida 39,82,53,83,218
46944,2020-05-23,(02000) Cabecera Autopista Norte,744,468,441,1653
46945,2020-06-14,(07113) SANTA ISABEL,113,60,109,282
46946,2020-07-22,(02105) Calle 142,691,473,421,1585
46947,2020-09-11,(09120) Calle 63,1202,779,770,2751
46948,2020-07-04,(06100) Av. Rojas,164,90,147,401
46949,2020-04-24,(06000) Portal Eldorado,817,551,359,1727
46950,2020-06-06,(02302) Virrey,374,263,236,873
46951,2020-09-22,(12003) Ricaurte,438,288,241,967
46952,2020-06-10,(03010) PUENTE LARGO,343,214,191,748
46953,2020-04-09,(02302) Virrey,193,121,75,389
46954,2020-01-29,(07200) Tygua-San José,779,474,560,1813
46955,2020-06-21,(02105) Calle 142,181,140,155,476
46956,2020-02-20,(08002) Biblioteca,951,601,615,2167
46957,2020-05-04,(09109) Tercer Milenio,193,135,145,473
46958,2020-02-08,(05102) Av. Américas - Av. Boyacá,860,438,608,1906
46959,2020-02-23,(05102) Av. Américas - Av. Boyacá,241,113,257,611
46960,2020-05-26,(09122) Calle 72,990,708,640,2338
46961,2020-07-25,(03002) SUBA - TV- 91,441,236,268,945
46962,2020-05-18,(05107) Américas - Cr.53,359,227,193,779
46963,2020-09-27,(02104) Calle 146,284,172,340,796
46964,2020-08-02,(07103) AV. CHILE,137,107,137,381
46965,2020-03-13,(12007) Zona Industrial,423,52,124,599
46966,2020-02-01,(10005) Bicentenario,216,159,294,669
46967,2020-03-13,(10005) Bicentenario,242,39,82,363
46968,2020-05-01,(40002) Manitas,104,70,94,268
46969,2020-08-27,(40002) Manitas,390,257,247,894
46970,2020-06-24,(02304) Heroes,876,620,522,2018
46971,2020-06-20,(02300) Calle 100,853,580,615,2048
46972,2020-09-12,(02200) Alcalá,1556,969,1051,3576
46973,2020-08-28,(02304) Heroes,872,618,520,2010
46974,2020-07-08,(03011) SUBA - CALLE 100,552,269,245,1066
46975,2020-09-07,(03011) SUBA - CALLE 100,607,274,273,1154
46976,2020-04-05,(03000) Portal Suba - alimentacion,1240,706,681,2627
46977,2020-05-13,(04107) Escuela Militar,105,72,70,247
46978,2020-05-27,(10009) Museo Nacional,466,264,254,984
46979,2020-03-16,(10004) Policarpa,635,327,389,1351
46980,2020-07-12,(10005) Bicentenario - alimentacion,64,42,88,194
46981,2020-07-25,(06111) Universidades,189,111,188,488
46982,2020-04-06,(06100) Av. Rojas,109,76,77,262
46983,2020-06-02,(02104) Calle 146,664,434,417,1515
46984,2020-05-10,(09000) Cabecera Usme - alimentacion,1756,951,1049,3756
46985,2020-03-20,(06104) Gobernación,112,87,51,250
46986,2020-04-13,(06109) Centro Memoria,150,108,99,357
46987,2020-05-08,(09103) Olaya,682,376,353,1411
46988,2020-05-16,(07201) Guatoque -Veraguas,90,74,74,238
46989,2020-03-12,(07105) MOVISTAR ARENA,456,84,145,685
46990,2020-07-22,(03003) 21 ANGELES,303,144,170,617
46991,2020-09-29,(09110) Avenida Jimenez,1538,1058,982,3578
46992,2020-06-13,(10004) Policarpa,178,86,132,396
46993,2020-01-01,(40003) Mirador del Paraiso,780,389,804,1973
46994,2020-05-15,(09121) Las Flores,517,372,342,1231
46995,2020-06-16,(03009) Av. Suba- Calle 116,492,323,240,1055
46996,2020-10-07,(04104) Avenida 68,741,390,538,1669
46997,2020-01-12,(10004) Policarpa,207,81,265,553
46998,2020-10-12,(07106) EL CAMPIN,149,99,169,417
46999,2020-01-06,(03005) SUBA - AV. BOYACA,325,190,361,876
47000,2020-08-03,(09122) Calle 72,971,699,670,2340
47001,2020-09-14,(14005) Las Aguas,223,136,276,635
47002,2020-02-04,(07006) General Santander - alimentacion,1543,911,945,3399
47003,2020-03-28,(12000) Puente Aranda,32,22,18,72
47004,2020-05-19,(03005) SUBA - AV. BOYACA,360,226,206,792
47005,2020-06-07,(09003) Socorro,189,76,140,405
47006,2020-09-03,(02102) Calle 161,264,162,206,632
47007,2020-01-17,(12004) Carrera 22,593,367,459,1419
47008,2020-06-23,(12004) Carrera 22,284,138,153,575
47009,2020-10-02,(12004) Carrera 22,335,200,182,717
47010,2020-08-20,(06001) Modelia,350,214,196,760
47011,2020-06-02,(02300) Calle 100,1179,742,580,2501
47012,2020-04-18,(10009) Museo Nacional,148,108,117,373
47013,2020-09-28,(04106) Carrera 47,368,176,264,808
47014,2020-10-12,(04000) Cabecera Calle 80,368,215,483,1066
47015,2020-09-16,(07101) CASTELLANA,268,131,154,553
47016,2020-04-05,(10000) Portal 20 de Julio,453,198,183,834
47017,2020-07-17,(07008) NQS - Calle 30 Sur,282,159,152,593
47018,2020-05-18,(07200) Tygua-San José,194,97,132,423
47019,2020-05-15,(04003) Avenida Ciudad de Cali,822,495,545,1862
47020,2020-05-07,(02001) Centro Comercial Santa Fe,262,175,191,628
47021,2020-05-18,(03005) SUBA - AV. BOYACA,345,226,229,800
47022,2020-09-20,(04000) Cabecera Calle 80 - intermunicipal,86,50,153,289
47023,2020-06-03,(07108) Av. El Dorado,123,66,66,255
47024,2020-04-30,(06002) Normandía,193,116,109,418
47025,2020-08-29,(07506) DESPENSA,281,214,228,723
47026,2020-02-12,(09108) Hospital,268,168,194,630
47027,2020-05-25,(02204) Pepe Sierra,219,175,142,536
47028,2020-04-30,(09117) Calle 45,483,288,276,1047
47029,2020-07-24,(09117) Calle 45,603,344,340,1287
47030,2020-04-01,(02502) Terminal,117,99,136,352
47031,2020-08-08,(07005) ALQUERIA,401,195,264,860
47032,2020-08-02,(03009) Av. Suba- Calle 116,120,86,81,287
47033,2020-03-19,(07200) Tygua-San José,336,252,339,927
47034,2020-05-16,(06105) Quinta Paredes,87,60,45,192
47035,2020-09-09,(40002) Manitas,438,264,320,1022
47036,2020-06-13,(05107) Américas - Cr.53,320,188,195,703
47037,2020-08-28,(07001) PERDOMO,1000,547,657,2204
47038,2020-04-13,(09117) Calle 45,474,326,243,1043
47039,2020-10-12,(03007) HUMEDAL CORDOBA,45,52,31,128
47040,2020-05-19,(12007) Zona Industrial,285,185,120,590
47041,2020-07-10,(04101) Minuto de Dios,375,218,247,840
47042,2020-08-03,(09111) Calle 19,675,388,452,1515
47043,2020-09-04,(40002) Manitas,449,276,317,1042
47044,2020-06-21,(04001) Quirigua,153,92,109,354
47045,2020-09-12,(07105) MOVISTAR ARENA,197,117,196,510
47046,2020-04-08,(07103) AV. CHILE,408,282,238,928
47047,2020-04-15,(04103) Las Ferias,186,135,88,409
47048,2020-04-04,(07010) Bosa,214,124,143,481
47049,2020-06-15,(14005) Las Aguas,44,27,78,149
47050,2020-06-28,(06100) Av. Rojas,44,34,65,143
47051,2020-08-18,(06100) Av. Rojas,220,126,118,464
47052,2020-03-22,(03010) PUENTE LARGO,95,70,44,209
47053,2020-04-11,(08001) Parque el Tunal,134,70,59,263
47054,2020-09-20,(03012) SUBA - CALLE 95,88,51,109,248
47055,2020-04-13,(12004) Carrera 22,53,47,53,153
47056,2020-07-05,(03004) GRATAMIRA,13,6,9,28
47057,2020-06-02,(10005) Bicentenario,116,55,73,244
47058,2020-05-05,(04105) Carrera 53,190,115,106,411
47059,2020-04-05,(09105) Río Fucha,17,18,19,54
47060,2020-10-01,(07105) MOVISTAR ARENA,259,164,191,614
47061,2020-08-02,(07010) Bosa,168,74,139,381
47062,2020-08-26,(06108) Concejo de Bogotá,129,68,70,267
47063,2020-04-19,(09106) Nariño,79,56,51,186
47064,2020-04-25,(03013) RIO NEGRO,105,76,81,262
47065,2020-05-03,(04102) Avenida Boyaca,67,42,39,148
47066,2020-03-22,(07010) Bosa,105,72,105,282
47067,2020-07-05,(12003) Ricaurte,47,35,68,150
47068,2020-09-28,(03004) GRATAMIRA,0,27,49,76
47069,2020-01-06,(50006) Corral Carrera 77,5,2,8,15
47070,2020-02-27,(04000) Cabecera Calle 80 - alimentacion,24293,14608,14574,53475
47071,2020-02-28,(04000) Cabecera Calle 80 - alimentacion,24614,13618,15124,53356
47072,2020-08-18,(04000) Cabecera Calle 80 - alimentacion,3628,2093,2539,8260
47073,2020-08-26,(04000) Cabecera Calle 80 - alimentacion,3660,2046,2440,8146
47074,2020-03-06,(07005) ALQUERIA,2591,1386,1466,5443
47075,2020-01-28,(09119) Calle 57,3384,2140,1921,7445
47076,2020-02-11,(09119) Calle 57,3964,2433,2226,8623
47077,2020-02-28,(04106) Carrera 47,1536,785,916,3237
47078,2020-10-02,(03000) Portal Suba - alimentacion,7820,4096,5590,17506
47079,2020-02-20,(05000) Portal Américas - alimentacion,37069,21801,19493,78363
47080,2020-01-24,(02101) Toberín,13899,8090,7541,29530
47081,2020-03-05,(07503) SAN MATEO,40333,21880,17883,80096
47082,2020-08-25,(07503) SAN MATEO,10673,6031,5039,21743
47083,2020-03-11,(06000) Portal Eldorado - alimentacion,16871,9287,9216,35374
47084,2020-08-14,(09003) Socorro,534,287,311,1132
47085,2020-02-23,(05000) Portal Américas - alimentacion,9145,4100,6644,19889
47086,2020-01-17,(04101) Minuto de Dios,2211,1214,1588,5013
47087,2020-03-02,(04101) Minuto de Dios,3520,2148,1768,7436
47088,2020-01-08,(09001) Molinos,5939,3157,4534,13630
47089,2020-02-28,(09001) Molinos,7823,4420,5863,18106
47090,2020-08-19,(09001) Molinos,2294,1279,1712,5285
47091,2020-01-23,(05001) Patio Bonito,6515,3630,3586,13731
47092,2020-01-24,(05001) Patio Bonito,6639,3545,3499,13683
47093,2020-01-07,(05000) Portal Américas,10055,5773,6249,22077
47094,2020-09-10,(04103) Las Ferias,363,169,208,740
47095,2020-03-02,(02201) Prado,5819,3665,3021,12505
47096,2020-03-07,(07112) COMUNEROS,2310,1285,1774,5369
47097,2020-09-10,(07503) SAN MATEO,9,4336,10184,14529
47098,2020-02-01,(07002) MADELENA,2581,1131,1925,5637
47099,2020-02-14,(05100) Banderas P. Central,8380,4487,3924,16791
47100,2020-08-24,(10001) Country Sur,1022,432,604,2058
47101,2020-01-15,(40001) Juan Pablo II,1433,820,846,3099
47102,2020-05-19,(09115) Calle 34,551,386,290,1227
47103,2020-01-15,(07002) MADELENA,4147,2364,2392,8903
47104,2020-01-02,(09000) Cabecera Usme - alimentacion,12943,6630,9038,28611
47105,2020-06-02,(07001) PERDOMO,862,468,443,1773
47106,2020-01-07,(02000) Cabecera Autopista Norte,6267,3841,4253,14361
47107,2020-01-18,(40003) Mirador del Paraiso,3791,1855,2291,7937
47108,2020-08-13,(40003) Mirador del Paraiso,991,1001,1332,3324
47109,2020-05-22,(07505) LEON XIII,2172,1237,944,4353
47110,2020-09-28,(02101) Toberín,1791,1121,1511,4423
47111,2020-03-24,(06002) Normandía,265,178,199,642
47112,2020-01-09,(09110) Avenida Jimenez,3075,2256,2164,7495
47113,2020-01-24,(05002) Tintal,10460,5715,5636,21811
47114,2020-03-03,(02000) Cabecera Autopista Norte - alimentacion,23868,14013,13758,51639
47115,2020-02-17,(03009) Av. Suba- Calle 116,2629,1717,1424,5770
47116,2020-07-28,(07102) NQS - CALLE 75,424,252,211,887
47117,2020-03-03,(50003) Corral Molinos,2873,2421,3952,9246
47118,2020-05-21,(07000) Portal Sur - alimentacion,6321,3558,2696,12575
47119,2020-09-11,(07000) Portal Sur - alimentacion,8110,4558,4717,17385
47120,2020-08-15,(14001) La Sabana,130,89,87,306
47121,2020-09-15,(14001) La Sabana,160,94,121,375
47122,2020-01-11,(07106) EL CAMPIN,936,612,677,2225
47123,2020-01-19,(07106) EL CAMPIN,440,310,443,1193
47124,2020-09-10,(08000) Portal Tunal - alimentacion,6447,3314,3670,13431
47125,2020-10-07,(07112) COMUNEROS,905,536,772,2213
47126,2020-05-16,(09113) Calle 22,338,211,243,792
47127,2020-08-07,(50003) Corral Molinos,652,307,447,1406
47128,2020-08-10,(07010) Bosa,624,305,411,1340
47129,2020-04-23,(02000) Cabecera Autopista Norte - alimentacion,2766,1531,1347,5644
47130,2020-05-21,(09104) Restrepo,1224,748,850,2822
47131,2020-05-16,(08000) Portal Tunal - alimentacion,3959,2082,1983,8024
47132,2020-01-27,(05002) Tintal,10645,6309,6079,23033
47133,2020-01-28,(09120) Calle 63,5611,3731,3363,12705
47134,2020-07-07,(04100) Carrera 77,1346,796,881,3023
47135,2020-01-20,(12001) Carrera 43,1590,917,991,3498
47136,2020-06-27,(07000) Portal Sur - alimentacion,6626,3536,3544,13706
47137,2020-02-19,(09107) Hortúa,2521,1515,1531,5567
47138,2020-01-31,(09119) Calle 57,3443,2129,2073,7645
47139,2020-03-06,(02000) Cabecera Autopista Norte - intermunicipal,4810,3099,3081,10990
47140,2020-07-10,(02000) Cabecera Autopista Norte - intermunicipal,647,415,462,1524
47141,2020-09-14,(02000) Cabecera Autopista Norte - intermunicipal,597,382,484,1463
47142,2020-02-06,(08001) Parque el Tunal,1718,968,957,3643
47143,2020-06-09,(02303) Calle 85,650,459,296,1405
47144,2020-01-20,(07000) Portal Sur,7229,4318,4268,15815
47145,2020-01-07,(08002) Biblioteca,700,376,524,1600
47146,2020-02-16,(09004) Santa Lucía,2237,880,1764,4881
47147,2020-03-11,(09004) Santa Lucía,7386,4024,4032,15442
47148,2020-08-19,(09004) Santa Lucía,2317,1164,1325,4806
47149,2020-01-29,(06103) CAN,2534,1534,1119,5187
47150,2020-01-07,(06108) Concejo de Bogotá,557,291,301,1149
47151,2020-07-16,(02300) Calle 100,1058,689,550,2297
47152,2020-04-12,(04000) Cabecera Calle 80,137,112,104,353
47153,2020-06-11,(10001) Country Sur,1148,505,639,2292
47154,2020-03-17,(02202) Calle 127,2993,2178,1571,6742
47155,2020-02-25,(07007) NQS - Calle 38A Sur,2255,1306,1208,4769
47156,2020-08-02,(09000) Cabecera Usme,450,218,405,1073
47157,2020-01-05,(10000) Portal 20 de Julio,1619,599,1280,3498
47158,2020-04-01,(09107) Hortúa,413,291,224,928
47159,2020-07-30,(09107) Hortúa,546,328,319,1193
47160,2020-06-19,(09123) Calle 76,1057,745,661,2463
47161,2020-03-03,(10009) Museo Nacional,4611,2358,1916,8885
47162,2020-10-08,(10000) Portal 20 de Julio,2592,1210,1747,5549
47163,2020-07-14,(03012) SUBA - CALLE 95,319,194,168,681
47164,2020-07-31,(06109) Centro Memoria,237,143,126,506
47165,2020-05-05,(08000) Portal Tunal,518,215,167,900
47166,2020-08-28,(03009) Av. Suba- Calle 116,538,318,233,1089
47167,2020-03-08,(10002) Av. Primero de Mayo,1507,733,1722,3962
47168,2020-07-11,(12000) Puente Aranda,79,42,46,167
47169,2020-03-10,(09113) Calle 22,536,189,278,1003
47170,2020-04-28,(09101) Quiroga,354,174,227,755
47171,2020-10-03,(06000) Portal Eldorado - alimentacion,3445,1613,2767,7825
47172,2020-09-15,(04108) El Polo,550,328,286,1164
47173,2020-07-29,(03001) LA CAMPIÑA,1097,634,636,2367
47174,2020-05-24,(05000) Portal Américas - alimentacion,2726,1351,1258,5335
47175,2020-05-13,(02101) Toberín,1084,704,672,2460
47176,2020-06-01,(09103) Olaya,911,530,484,1925
47177,2020-03-15,(02304) Heroes,488,387,536,1411
47178,2020-07-10,(07104) Simon Bolivar,607,389,274,1270
47179,2020-01-20,(04107) Escuela Militar,577,368,400,1345
47180,2020-02-12,(04107) Escuela Militar,722,457,394,1573
47181,2020-02-25,(04003) Avenida Ciudad de Cali,5705,3430,3426,12561
47182,2020-10-12,(02000) Cabecera Autopista Norte - intermunicipal,156,103,184,443
47183,2020-01-06,(06001) Modelia,226,163,262,651
47184,2020-02-21,(02302) Virrey,3450,2538,1902,7890
47185,2020-08-27,(04104) Avenida 68,610,282,345,1237
47186,2020-08-14,(05001) Patio Bonito,1888,1077,1085,4050
47187,2020-06-14,(05000) Portal Américas - alimentacion,3077,1487,1506,6070
47188,2020-07-24,(40003) Mirador del Paraiso,1213,773,787,2773
47189,2020-09-27,(02200) Alcalá,608,427,614,1649
47190,2020-04-18,(02202) Calle 127,575,400,277,1252
47191,2020-02-05,(09121) Las Flores,3462,2150,2026,7638
47192,2020-06-20,(09120) Calle 63,936,623,695,2254
47193,2020-08-22,(04003) Avenida Ciudad de Cali,686,340,567,1593
47194,2020-03-01,(07003) SEVILLANA,366,165,376,907
47195,2020-03-01,(06100) Av. Rojas,190,149,341,680
47196,2020-03-08,(06100) Av. Rojas,217,129,324,670
47197,2020-08-02,(02302) Virrey,136,89,109,334
47198,2020-06-08,(07009) SENA,611,356,380,1347
47199,2020-02-29,(09122) Calle 72,3217,2285,3167,8669
47200,2020-06-18,(12003) Ricaurte,390,282,189,861
47201,2020-06-11,(03009) Av. Suba- Calle 116,512,303,218,1033
47202,2020-09-30,(07106) EL CAMPIN,492,319,336,1147
47203,2020-08-25,(07103) AV. CHILE,902,542,440,1884
47204,2020-04-18,(09002) Consuelo,189,84,98,371
47205,2020-01-06,(02105) Calle 142,693,396,795,1884
47206,2020-06-10,(02103) Mazurén,179,117,160,456
47207,2020-03-18,(07201) Guatoque -Veraguas,542,259,322,1123
47208,2020-03-10,(06109) Centro Memoria,584,100,148,832
47209,2020-06-13,(40002) Manitas,323,175,251,749
47210,2020-06-24,(40002) Manitas,423,248,282,953
47211,2020-03-04,(12002) CDS - Carrera 32,624,389,321,1334
47212,2020-09-16,(02304) Heroes,977,657,619,2253
47213,2020-04-25,(06108) Concejo de Bogotá,77,52,39,168
47214,2020-05-29,(06108) Concejo de Bogotá,152,80,74,306
47215,2020-02-16,(09100) Calle 40 Sur,1666,738,1543,3947
47216,2020-08-18,(08002) Biblioteca,298,173,192,663
47217,2020-01-12,(10006) San Victorino,284,247,398,929
47218,2020-08-11,(10009) Museo Nacional,476,266,262,1004
47219,2020-08-15,(09117) Calle 45,481,302,438,1221
47220,2020-08-28,(09003) Socorro,591,306,363,1260
47221,2020-05-29,(03006) NIZA - CALLE 127,390,237,195,822
47222,2020-06-04,(02104) Calle 146,670,441,413,1524
47223,2020-06-12,(02104) Calle 146,747,479,500,1726
47224,2020-05-13,(04003) Avenida Ciudad de Cali,799,469,489,1757
47225,2020-06-29,(07110) PALOQUEMAO,171,121,95,387
47226,2020-09-29,(03006) NIZA - CALLE 127,576,322,345,1243
47227,2020-08-06,(07200) Tygua-San José,225,120,148,493
47228,2020-05-30,(09123) Calle 76,535,426,428,1389
47229,2020-01-04,(08002) Biblioteca,400,187,309,896
47230,2020-02-16,(07111) NQS - RICAURTE,479,382,589,1450
47231,2020-09-02,(05103) Marsella,439,251,264,954
47232,2020-08-13,(09002) Consuelo,493,261,272,1026
47233,2020-09-25,(50003) Corral Molinos,1646,888,1345,3879
47234,2020-07-17,(07201) Guatoque -Veraguas,123,66,107,296
47235,2020-07-01,(07105) MOVISTAR ARENA,281,159,141,581
47236,2020-02-09,(50003) Corral Molinos,1008,518,1241,2767
47237,2020-05-02,(02200) Alcalá,854,565,387,1806
47238,2020-07-29,(06109) Centro Memoria,259,144,151,554
47239,2020-10-11,(07008) NQS - Calle 30 Sur,131,58,142,331
47240,2020-06-16,(40001) Juan Pablo II,576,362,326,1264
47241,2020-05-24,(02104) Calle 146,166,163,102,431
47242,2020-07-25,(07110) PALOQUEMAO,369,250,174,793
47243,2020-08-12,(07110) PALOQUEMAO,620,376,266,1262
47244,2020-04-27,(08000) Portal Tunal,145,105,48,298
47245,2020-07-31,(03011) SUBA - CALLE 100,406,184,187,777
47246,2020-03-19,(09119) Calle 57,1548,952,1001,3501
47247,2020-05-21,(09121) Las Flores,585,390,309,1284
47248,2020-07-02,(40001) Juan Pablo II,599,367,384,1350
47249,2020-08-16,(09110) Avenida Jimenez,204,194,259,657
47250,2020-01-23,(50002) Corral Calle 40 Sur,113,85,132,330
47251,2020-05-01,(09004) Santa Lucía,733,384,361,1478
47252,2020-08-29,(04000) Cabecera Calle 80 - intermunicipal,230,101,239,570
47253,2020-02-09,(10005) Bicentenario - alimentacion,141,94,260,495
47254,2020-05-19,(07006) General Santander - alimentacion,313,188,166,667
47255,2020-09-13,(04001) Quirigua,140,61,131,332
47256,2020-09-23,(07200) Tygua-San José,287,151,212,650
47257,2020-01-18,(09106) Nariño,1083,552,903,2538
47258,2020-04-11,(03006) NIZA - CALLE 127,168,125,61,354
47259,2020-08-21,(07006) General Santander,531,343,289,1163
47260,2020-05-04,(03002) SUBA - TV- 91,488,299,277,1064
47261,2020-09-23,(04000) Cabecera Calle 80 - intermunicipal,410,233,432,1075
47262,2020-08-14,(04105) Carrera 53,243,132,138,513
47263,2020-06-30,(07506) DESPENSA,525,279,291,1095
47264,2020-09-10,(04001) Quirigua,401,216,282,899
47265,2020-04-03,(02502) Terminal,129,107,145,381
47266,2020-07-19,(02502) Terminal,68,56,78,202
47267,2020-03-15,(09114) Calle 26,169,157,325,651
47268,2020-05-04,(04103) Las Ferias,231,139,104,474
47269,2020-05-06,(04103) Las Ferias,231,144,93,468
47270,2020-07-20,(07004) VENECIA,268,147,188,603
47271,2020-07-14,(09117) Calle 45,581,364,350,1295
47272,2020-09-12,(05005) Transversal 86,354,146,255,755
47273,2020-08-16,(04102) Avenida Boyaca,143,80,88,311
47274,2020-04-18,(04002) Carrera 90,253,150,100,503
47275,2020-09-05,(12002) CDS - Carrera 32,128,93,94,315
47276,2020-03-10,(10005) Bicentenario,406,44,91,541
47277,2020-03-31,(09117) Calle 45,463,326,222,1011
47278,2020-05-15,(07107) U. NACIONAL,287,172,139,598
47279,2020-05-13,(06102) Salitre El Greco,161,92,71,324
47280,2020-04-23,(03010) PUENTE LARGO,194,155,114,463
47281,2020-05-23,(06002) Normandía,177,106,111,394
47282,2020-03-12,(07506) DESPENSA,75,355,281,711
47283,2020-08-23,(12004) Carrera 22,61,50,53,164
47284,2020-04-16,(04001) Quirigua,180,113,95,388
47285,2020-01-12,(14005) Las Aguas,206,162,467,835
47286,2020-09-06,(07006) General Santander,200,107,172,479
47287,2020-07-29,(06101) El Tiempo,294,186,188,668
47288,2020-04-23,(06101) El Tiempo,200,140,81,421
47289,2020-07-12,(10007) Las Nieves,159,147,147,453
47290,2020-04-11,(02001) Centro Comercial Santa Fe,106,75,58,239
47291,2020-05-24,(05100) Banderas P. Central,109,56,83,248
47292,2020-04-19,(04106) Carrera 47,73,38,43,154
47293,2020-07-11,(05101) Mandalay - Cr.73,111,57,50,218
47294,2020-04-11,(08002) Biblioteca,91,58,59,208
47295,2020-09-30,(07101) CASTELLANA,264,165,199,628
47296,2020-06-15,(05105) Pradera,149,115,90,354
47297,2020-05-09,(06107) Ciudad Universitaria,99,71,52,222
47298,2020-04-12,(09106) Nariño,62,49,40,151
47299,2020-03-27,(07108) Av. El Dorado,59,46,58,163
47300,2020-06-13,(07108) Av. El Dorado,101,63,67,231
47301,2020-07-12,(06106) Recinto Ferial,73,49,72,194
47302,2019-12-31,(09000) Cabecera Usme,80,61,86,227
47303,2020-08-02,(06002) Normandía,63,52,67,182
47304,2020-03-25,(05101) Mandalay - Cr.73,69,34,38,141
47305,2020-09-26,(07003) SEVILLANA,426,182,304,912
47306,2020-07-26,(10003) Ciudad Jardín,65,23,56,144
47307,2020-08-26,(10003) Ciudad Jardín,188,84,126,398
47308,2020-04-20,(06105) Quinta Paredes,66,52,50,168
47309,2020-04-24,(12007) Zona Industrial,234,178,96,508
47310,2020-07-24,(07113) SANTA ISABEL,289,181,197,667
47311,2020-04-26,(12007) Zona Industrial,32,20,29,81
47312,2020-09-13,(12000) Puente Aranda,6,7,17,30
47313,2020-06-21,(50006) Corral Carrera 77,4,1,7,12
47314,2020-10-12,(50006) Corral Carrera 77,2,1,1,4
47315,2020-03-20,(50006) Corral Carrera 77,0,1,2,3
47316,2020-05-26,(04000) Cabecera Calle 80 - alimentacion,3492,2106,2245,7843
47317,2020-03-03,(07005) ALQUERIA,2573,1459,1535,5567
47318,2020-08-27,(05000) Portal Américas - alimentacion,10726,5782,5518,22026
47319,2020-02-22,(02101) Toberín,5960,2775,4703,13438
47320,2020-02-21,(02200) Alcalá,14320,8056,6579,28955
47321,2020-03-04,(05000) Portal Américas,14692,8148,7944,30784
47322,2020-01-17,(10000) Portal 20 de Julio - alimentacion,10522,4896,6839,22257
47323,2020-01-31,(09000) Cabecera Usme - alimentacion,25171,13472,15818,54461
47324,2020-09-18,(07503) SAN MATEO,13313,7087,7213,27613
47325,2020-04-09,(04000) Cabecera Calle 80 - alimentacion,615,351,292,1258
47326,2020-09-16,(06107) Ciudad Universitaria,203,121,142,466
47327,2020-08-04,(09001) Molinos,2306,1239,1664,5209
47328,2020-02-26,(05001) Patio Bonito,7298,3795,3777,14870
47329,2020-02-19,(05001) Patio Bonito,7418,4270,3665,15353
47330,2020-02-04,(02201) Prado,6033,3844,3009,12886
47331,2020-09-30,(04100) Carrera 77,1500,808,1142,3450
47332,2020-07-22,(05100) Banderas P. Central,704,385,467,1556
47333,2020-03-04,(02102) Calle 161,1936,1218,1164,4318
47334,2020-03-11,(09115) Calle 34,4275,2636,2404,9315
47335,2020-01-18,(07009) SENA,1944,1021,1349,4314
47336,2020-07-06,(07113) SANTA ISABEL,411,270,311,992
47337,2020-06-09,(09109) Tercer Milenio,342,194,217,753
47338,2020-04-26,(07505) LEON XIII,500,323,203,1026
47339,2020-05-09,(07505) LEON XIII,1205,736,624,2565
47340,2020-07-16,(07505) LEON XIII,2506,1340,1009,4855
47341,2020-02-15,(02101) Toberín,6393,2789,5162,14344
47342,2020-01-03,(09110) Avenida Jimenez,1929,1449,1523,4901
47343,2020-09-17,(02000) Cabecera Autopista Norte - alimentacion,5053,2641,3279,10973
47344,2020-05-06,(09101) Quiroga,289,165,235,689
47345,2020-03-05,(07102) NQS - CALLE 75,1496,944,935,3375
47346,2020-06-20,(03013) RIO NEGRO,195,136,157,488
47347,2020-03-06,(06001) Modelia,2472,1440,1397,5309
47348,2020-08-05,(50003) Corral Molinos,1374,705,990,3069
47349,2020-07-22,(07000) Portal Sur - alimentacion,7434,4118,3766,15318
47350,2020-06-18,(09103) Olaya,1049,616,591,2256
47351,2020-01-31,(07002) MADELENA,4896,2536,2682,10114
47352,2020-05-23,(07111) NQS - RICAURTE,674,407,266,1347
47353,2020-01-24,(09120) Calle 63,4489,3151,3172,10812
47354,2020-01-17,(09114) Calle 26,2316,1642,1610,5568
47355,2020-01-29,(09114) Calle 26,2906,1877,1755,6538
47356,2020-03-07,(09114) Calle 26,729,638,1144,2511
47357,2020-07-11,(09111) Calle 19,690,445,504,1639
47358,2020-09-14,(10005) Bicentenario - alimentacion,211,107,225,543
47359,2020-02-16,(10000) Portal 20 de Julio,2137,822,1674,4633
47360,2020-07-15,(07112) COMUNEROS,753,434,410,1597
47361,2020-04-06,(07000) Portal Sur - alimentacion,3823,1970,1605,7398
47362,2020-02-09,(09107) Hortúa,540,327,615,1482
47363,2020-08-26,(09003) Socorro,562,291,314,1167
47364,2020-08-14,(02101) Toberín,1222,831,890,2943
47365,2020-01-11,(09113) Calle 22,738,535,715,1988
47366,2020-01-21,(06103) CAN,1485,1016,746,3247
47367,2020-02-27,(06103) CAN,2652,1566,1174,5392
47368,2020-07-11,(04000) Cabecera Calle 80 - alimentacion,3276,1674,2304,7254
47369,2020-05-21,(40003) Mirador del Paraiso,1446,939,866,3251
47370,2020-03-25,(05000) Portal Américas,1378,906,1113,3397
47371,2020-09-22,(05002) Tintal,2888,1711,1877,6476
47372,2020-02-19,(03007) HUMEDAL CORDOBA,1031,684,555,2270
47373,2020-04-15,(09001) Molinos,1247,738,882,2867
47374,2020-02-10,(50002) Corral Calle 40 Sur,157,87,135,379
47375,2020-09-22,(50002) Corral Calle 40 Sur,35,14,44,93
47376,2020-05-26,(10010) San Bernardo,611,307,375,1293
47377,2020-03-08,(09000) Cabecera Usme - alimentacion,5660,2603,4889,13152
47378,2020-07-05,(08000) Portal Tunal,226,155,157,538
47379,2020-08-10,(05105) Pradera,588,334,261,1183
47380,2020-02-02,(04105) Carrera 53,329,187,347,863
47381,2020-06-01,(08000) Portal Tunal,667,291,252,1210
47382,2020-04-13,(02205) Calle 106,181,133,93,407
47383,2020-06-08,(02205) Calle 106,316,211,192,719
47384,2020-06-27,(02205) Calle 106,226,158,217,601
47385,2020-08-06,(10008) San Diego,299,168,182,649
47386,2020-03-06,(04003) Avenida Ciudad de Cali,5347,2988,3663,11998
47387,2020-03-09,(04003) Avenida Ciudad de Cali,253,1533,1088,2874
47388,2020-03-03,(12007) Zona Industrial,1231,742,611,2584
47389,2020-03-11,(10009) Museo Nacional,4338,2332,1915,8585
47390,2020-02-15,(07101) CASTELLANA,390,286,403,1079
47391,2020-06-19,(10006) San Victorino,640,313,383,1336
47392,2020-02-29,(09117) Calle 45,2702,1765,2307,6774
47393,2020-07-24,(02101) Toberín,1162,773,794,2729
47394,2020-02-11,(06105) Quinta Paredes,1120,685,501,2306
47395,2020-01-24,(14005) Las Aguas,2291,1567,1859,5717
47396,2020-04-20,(02304) Heroes,432,335,268,1035
47397,2020-06-24,(09100) Calle 40 Sur,1855,1050,1114,4019
47398,2020-04-04,(08000) Portal Tunal,284,144,131,559
47399,2020-04-07,(03000) Portal Suba - alimentacion,3099,1685,1719,6503
47400,2020-02-15,(05103) Marsella,1500,734,1023,3257
47401,2020-06-17,(09109) Tercer Milenio,361,206,257,824
47402,2020-09-29,(09100) Calle 40 Sur,1962,1108,1418,4488
47403,2020-07-10,(05001) Patio Bonito,1664,1075,1194,3933
47404,2020-03-08,(07004) VENECIA,1007,460,882,2349
47405,2020-08-11,(09117) Calle 45,670,406,434,1510
47406,2020-10-07,(02104) Calle 146,1022,649,854,2525
47407,2020-05-09,(09001) Molinos,1239,673,774,2686
47408,2020-01-28,(02202) Calle 127,5946,3864,2915,12725
47409,2020-05-31,(07503) SAN MATEO,2568,1494,1339,5401
47410,2020-06-03,(02204) Pepe Sierra,734,507,371,1612
47411,2020-02-26,(07101) CASTELLANA,950,600,632,2182
47412,2020-06-04,(03001) LA CAMPIÑA,946,549,564,2059
47413,2020-02-13,(07004) VENECIA,4905,2644,2499,10048
47414,2020-05-29,(03007) HUMEDAL CORDOBA,143,87,46,276
47415,2020-08-11,(06106) Recinto Ferial,217,138,112,467
47416,2020-10-03,(04101) Minuto de Dios,256,179,379,814
47417,2020-06-17,(03010) PUENTE LARGO,359,229,220,808
47418,2020-04-16,(07106) EL CAMPIN,164,113,112,389
47419,2020-04-06,(09104) Restrepo,718,509,583,1810
47420,2020-02-09,(10008) San Diego,202,134,282,618
47421,2020-03-08,(06002) Normandía,312,174,382,868
47422,2020-08-03,(03002) SUBA - TV- 91,569,351,379,1299
47423,2020-03-31,(05107) Américas - Cr.53,272,250,168,690
47424,2020-07-31,(10005) Bicentenario,87,48,72,207
47425,2020-01-18,(40002) Manitas,851,434,704,1989
47426,2020-02-18,(12002) CDS - Carrera 32,654,422,332,1408
47427,2020-07-31,(02304) Heroes,729,526,396,1651
47428,2020-02-01,(10003) Ciudad Jardín,585,284,490,1359
47429,2020-05-13,(07006) General Santander,385,239,225,849
47430,2020-05-27,(04105) Carrera 53,251,138,138,527
47431,2020-10-07,(07006) General Santander,616,384,467,1467
47432,2020-01-05,(03011) SUBA - CALLE 100,320,213,351,884
47433,2020-06-02,(09120) Calle 63,946,653,599,2198
47434,2020-08-08,(10009) Museo Nacional,188,161,238,587
47435,2020-01-19,(02303) Calle 85,393,372,646,1411
47436,2020-08-16,(40003) Mirador del Paraiso,606,282,478,1366
47437,2020-06-05,(06100) Av. Rojas,197,119,125,441
47438,2020-01-02,(04000) Cabecera Calle 80 - intermunicipal,829,567,920,2316
47439,2020-08-21,(03006) NIZA - CALLE 127,495,275,228,998
47440,2020-08-30,(09122) Calle 72,354,265,440,1059
47441,2020-05-19,(02204) Pepe Sierra,616,441,316,1373
47442,2020-10-08,(05105) Pradera,671,451,424,1546
47443,2020-08-31,(03013) RIO NEGRO,295,153,200,648
47444,2020-03-24,(07000) Portal Sur,1415,783,1084,3282
47445,2020-06-15,(07110) PALOQUEMAO,184,129,109,422
47446,2020-01-26,(07101) CASTELLANA,66,69,163,298
47447,2020-08-04,(07201) Guatoque -Veraguas,192,92,106,390
47448,2020-08-17,(09116) Avenida 39,77,41,77,195
47449,2020-05-09,(02104) Calle 146,365,248,239,852
47450,2020-03-29,(10000) Portal 20 de Julio - alimentacion,1059,382,427,1868
47451,2020-02-17,(04001) Quirigua,2138,1382,1194,4714
47452,2020-01-03,(09106) Nariño,946,523,775,2244
47453,2020-05-27,(09123) Calle 76,848,627,459,1934
47454,2020-08-19,(07110) PALOQUEMAO,629,374,252,1255
47455,2020-03-30,(06101) El Tiempo,231,162,128,521
47456,2020-05-13,(02303) Calle 85,506,356,232,1094
47457,2020-02-23,(06109) Centro Memoria,200,129,260,589
47458,2020-05-09,(07113) SANTA ISABEL,190,116,117,423
47459,2020-03-08,(07104) Simon Bolivar,344,216,485,1045
47460,2020-10-05,(07104) Simon Bolivar,606,372,416,1394
47461,2020-04-23,(40001) Juan Pablo II,269,152,152,573
47462,2020-05-18,(04001) Quirigua,300,199,191,690
47463,2020-09-25,(06102) Salitre El Greco,254,156,171,581
47464,2020-02-09,(03005) SUBA - AV. BOYACA,442,279,529,1250
47465,2020-05-05,(05005) Transversal 86,235,132,148,515
47466,2020-07-27,(10007) Las Nieves,608,349,336,1293
47467,2020-05-27,(09122) Calle 72,1012,694,620,2326
47468,2020-04-04,(12000) Puente Aranda,36,22,18,76
47469,2020-09-05,(04000) Cabecera Calle 80 - intermunicipal,249,105,268,622
47470,2020-04-02,(02102) Calle 161,81,62,65,208
47471,2020-04-21,(12004) Carrera 22,76,51,63,190
47472,2020-04-06,(09115) Calle 34,318,220,187,725
47473,2020-01-10,(09111) Calle 19,1399,1045,1320,3764
47474,2020-06-08,(03013) RIO NEGRO,258,167,201,626
47475,2020-09-06,(10004) Policarpa,114,46,109,269
47476,2020-04-25,(02201) Prado,361,221,208,790
47477,2020-06-12,(07109) CAD,642,403,310,1355
47478,2020-10-12,(10000) Portal 20 de Julio,874,337,737,1948
47479,2020-03-21,(40001) Juan Pablo II,158,82,80,320
47480,2020-08-24,(07108) Av. El Dorado,123,77,92,292
47481,2020-03-25,(06100) Av. Rojas,129,88,74,291
47482,2020-03-08,(14004) Museo del Oro,0,166,459,625
47483,2020-07-21,(07006) General Santander,475,281,212,968
47484,2020-05-23,(02204) Pepe Sierra,467,359,251,1077
47485,2020-03-23,(07101) CASTELLANA,12,27,31,70
47486,2020-09-27,(07000) Portal Sur,582,271,596,1449
47487,2020-08-09,(07000) Portal Sur,433,231,388,1052
47488,2020-07-22,(06105) Quinta Paredes,124,72,59,255
47489,2020-01-19,(05101) Mandalay - Cr.73,116,54,112,282
47490,2020-04-14,(12001) Carrera 43,280,195,138,613
47491,2020-04-23,(12001) Carrera 43,295,170,155,620
47492,2020-10-12,(12001) Carrera 43,75,58,124,257
47493,2020-06-29,(05107) Américas - Cr.53,133,89,102,324
47494,2020-04-22,(04003) Avenida Ciudad de Cali,557,339,365,1261
47495,2020-07-12,(04001) Quirigua,136,69,112,317
47496,2020-03-08,(07101) CASTELLANA,51,74,160,285
47497,2020-03-31,(07007) NQS - Calle 38A Sur,150,111,83,344
47498,2020-08-29,(07007) NQS - Calle 38A Sur,356,210,252,818
47499,2020-07-24,(07008) NQS - Calle 30 Sur,223,107,133,463
47500,2020-04-25,(07010) Bosa,268,154,175,597
47501,2020-04-11,(09121) Las Flores,219,181,162,562
47502,2020-04-21,(04106) Carrera 47,182,107,103,392
47503,2020-08-07,(04001) Quirigua,123,66,94,283
47504,2020-09-06,(04108) El Polo,114,68,123,305
47505,2020-05-01,(07009) SENA,163,110,92,365
47506,2020-04-06,(07007) NQS - Calle 38A Sur,146,98,89,333
47507,2020-05-14,(07007) NQS - Calle 38A Sur,264,151,159,574
47508,2020-08-24,(06103) CAN,303,194,164,661
47509,2020-04-12,(07005) ALQUERIA,102,51,61,214
47510,2020-06-11,(09106) Nariño,384,225,256,865
47511,2020-09-23,(06106) Recinto Ferial,296,190,204,690
47512,2020-05-01,(09111) Calle 19,189,117,179,485
47513,2020-04-18,(04101) Minuto de Dios,94,59,71,224
47514,2020-08-08,(03005) SUBA - AV. BOYACA,226,125,193,544
47515,2020-03-30,(07200) Tygua-San José,62,48,77,187
47516,2020-06-07,(03014) SAN MARTIN,9,3,13,25
47517,2020-04-25,(06104) Gobernación,81,52,53,186
47518,2020-07-26,(07113) SANTA ISABEL,86,49,77,212
47519,2020-05-10,(07003) SEVILLANA,80,47,51,178
47520,2020-04-19,(09101) Quiroga,103,45,84,232
47521,2019-12-31,(09122) Calle 72,58,30,73,161
47522,2020-05-02,(05101) Mandalay - Cr.73,36,16,21,73
47523,2020-02-03,(50006) Corral Carrera 77,36,22,46,104
47524,2020-09-17,(04000) Cabecera Calle 80 - alimentacion,4570,2633,3408,10611
47525,2020-10-06,(09002) Consuelo,511,276,406,1193
47526,2020-01-23,(07504) TERREROS,17095,10115,9161,36371
47527,2020-07-04,(07504) TERREROS,5192,2619,2801,10612
47528,2020-09-04,(09119) Calle 57,636,411,469,1516
47529,2020-01-14,(07111) NQS - RICAURTE,2815,1782,1617,6214
47530,2020-03-02,(05000) Portal Américas,14225,8273,8056,30554
47531,2020-02-18,(09114) Calle 26,3589,2262,1822,7673
47532,2020-02-06,(10000) Portal 20 de Julio - alimentacion,11156,5667,7578,24401
47533,2020-02-25,(02000) Cabecera Autopista Norte - alimentacion,24090,14332,13294,51716
47534,2020-03-01,(07111) NQS - RICAURTE,455,396,592,1443
47535,2020-03-08,(07503) SAN MATEO,8992,3903,6091,18986
47536,2020-05-29,(07503) SAN MATEO,9604,5646,4494,19744
47537,2020-02-11,(09118) Marly,8395,5403,4141,17939
47538,2020-01-13,(07112) COMUNEROS,3005,1788,2055,6848
47539,2020-02-04,(14004) Museo del Oro,4240,2477,2106,8823
47540,2020-01-30,(50006) Corral Carrera 77,29,18,44,91
47541,2020-05-29,(10000) Portal 20 de Julio - alimentacion,3862,1771,2206,7839
47542,2020-02-05,(07002) MADELENA,5264,2920,2782,10966
47543,2020-01-24,(09004) Santa Lucía,7092,3701,4008,14801
47544,2020-08-23,(09100) Calle 40 Sur,503,249,451,1203
47545,2020-08-27,(09100) Calle 40 Sur,1695,980,1164,3839
47546,2020-08-16,(05100) Banderas P. Central - alimentacion,852,345,543,1740
47547,2020-01-14,(07009) SENA,2894,1692,1859,6445
47548,2020-02-29,(04000) Cabecera Calle 80,3909,1820,3633,9362
47549,2020-10-12,(10000) Portal 20 de Julio - alimentacion,1668,617,1481,3766
47550,2020-10-04,(07005) ALQUERIA,198,109,249,556
47551,2020-05-29,(07001) PERDOMO,839,460,451,1750
47552,2020-06-26,(07001) PERDOMO,1015,562,580,2157
47553,2020-07-28,(09104) Restrepo,1420,833,1025,3278
47554,2020-08-24,(07505) LEON XIII,2575,1322,1096,4993
47555,2020-03-04,(05002) Tintal,11158,6477,5864,23499
47556,2020-02-11,(02000) Cabecera Autopista Norte - alimentacion,24729,14552,13929,53210
47557,2020-09-05,(12003) Ricaurte,300,229,218,747
47558,2020-02-25,(03009) Av. Suba- Calle 116,2749,1669,1366,5784
47559,2020-06-28,(03013) RIO NEGRO,79,45,65,189
47560,2020-06-24,(09000) Cabecera Usme - alimentacion,8582,4879,4960,18421
47561,2020-01-29,(03001) LA CAMPIÑA,6426,3814,4115,14355
47562,2020-06-11,(07106) EL CAMPIN,355,237,192,784
47563,2020-04-01,(02103) Mazurén,78,60,68,206
47564,2020-06-27,(02103) Mazurén,150,82,140,372
47565,2020-09-26,(05100) Banderas P. Central - alimentacion,2944,1198,2069,6211
47566,2020-08-06,(07002) MADELENA,699,390,473,1562
47567,2020-09-25,(07002) MADELENA,1088,595,889,2572
47568,2020-01-04,(07111) NQS - RICAURTE,909,688,725,2322
47569,2020-06-17,(07002) MADELENA,824,446,480,1750
47570,2020-10-08,(07002) MADELENA,1011,574,816,2401
47571,2020-01-31,(02104) Calle 146,9207,5209,4905,19321
47572,2020-08-29,(09113) Calle 22,413,223,308,944
47573,2020-04-18,(04105) Carrera 53,131,79,41,251
47574,2020-06-09,(50003) Corral Molinos,1387,764,992,3143
47575,2020-07-25,(05000) Portal Américas,1331,950,1172,3453
47576,2020-06-04,(08000) Portal Tunal - alimentacion,5940,3318,2933,12191
47577,2020-06-02,(04002) Carrera 90,614,348,338,1300
47578,2020-06-23,(03000) Portal Suba,1336,876,883,3095
47579,2020-01-24,(40003) Mirador del Paraiso,4710,2635,2461,9806
47580,2020-02-21,(07505) LEON XIII,8463,4747,3755,16965
47581,2020-02-13,(06111) Universidades,6147,3817,2573,12537
47582,2020-01-09,(10000) Portal 20 de Julio,6711,2946,3261,12918
47583,2020-03-09,(02304) Heroes,2601,165,486,3252
47584,2020-04-21,(03000) Portal Suba,654,400,410,1464
47585,2020-07-11,(03000) Portal Suba,1013,572,812,2397
47586,2020-09-16,(02000) Cabecera Autopista Norte - intermunicipal,599,373,450,1422
47587,2020-03-31,(08001) Parque el Tunal,202,128,115,445
47588,2020-01-06,(09100) Calle 40 Sur,1351,577,1191,3119
47589,2020-02-17,(10010) San Bernardo,1966,1078,1316,4360
47590,2020-04-08,(02000) Cabecera Autopista Norte - alimentacion,2704,1415,1219,5338
47591,2020-02-19,(06100) Av. Rojas,2853,1646,1338,5837
47592,2020-03-09,(09114) Calle 26,1792,231,381,2404
47593,2020-07-09,(07112) COMUNEROS,871,517,424,1812
47594,2020-06-30,(02303) Calle 85,756,513,411,1680
47595,2020-09-07,(02303) Calle 85,814,539,448,1801
47596,2020-03-01,(10002) Av. Primero de Mayo,1545,775,1787,4107
47597,2020-07-19,(09004) Santa Lucía,593,260,366,1219
47598,2020-02-12,(09105) Río Fucha,870,509,498,1877
47599,2020-09-15,(09000) Cabecera Usme - alimentacion,9048,4828,5520,19396
47600,2020-06-13,(03000) Portal Suba - alimentacion,4695,2442,2757,9894
47601,2020-09-05,(09116) Avenida 39,232,142,257,631
47602,2020-02-14,(05102) Av. Américas - Av. Boyacá,1974,1091,1028,4093
47603,2020-02-29,(02302) Virrey,1307,1078,1383,3768
47604,2020-05-30,(10002) Av. Primero de Mayo,1367,711,920,2998
47605,2020-02-02,(02101) Toberín,1888,937,2449,5274
47606,2020-08-17,(09107) Hortúa,228,148,182,558
47607,2020-08-31,(02300) Calle 100,1181,846,730,2757
47608,2020-06-20,(03012) SUBA - CALLE 95,234,168,157,559
47609,2020-03-05,(50002) Corral Calle 40 Sur,115,88,171,374
47610,2020-02-23,(07007) NQS - Calle 38A Sur,656,369,484,1509
47611,2020-04-02,(05005) Transversal 86,179,96,95,370
47612,2020-08-09,(05005) Transversal 86,81,35,86,202
47613,2020-01-17,(02202) Calle 127,4816,3276,2853,10945
47614,2020-06-04,(02202) Calle 127,1020,717,511,2248
47615,2020-04-06,(10002) Av. Primero de Mayo,1120,641,679,2440
47616,2020-01-21,(03006) NIZA - CALLE 127,1449,784,876,3109
47617,2020-01-06,(07113) SANTA ISABEL,366,221,435,1022
47618,2020-10-01,(07113) SANTA ISABEL,471,291,391,1153
47619,2020-10-05,(04003) Avenida Ciudad de Cali,1166,679,1063,2908
47620,2020-01-29,(04108) El Polo,1926,1168,1127,4221
47621,2020-07-02,(04108) El Polo,510,311,263,1084
47622,2020-10-01,(04108) El Polo,530,341,360,1231
47623,2020-09-05,(07113) SANTA ISABEL,326,191,323,840
47624,2020-03-26,(06000) Portal Eldorado,778,567,399,1744
47625,2020-07-01,(03003) 21 ANGELES,372,177,203,752
47626,2020-09-01,(02200) Alcalá,1843,1275,1034,4152
47627,2020-08-31,(04104) Avenida 68,640,323,354,1317
47628,2020-09-24,(09117) Calle 45,755,482,589,1826
47629,2020-04-01,(08000) Portal Tunal - alimentacion,3422,1694,1941,7057
47630,2020-08-21,(07000) Portal Sur,1827,1113,1159,4099
47631,2020-01-01,(10010) San Bernardo,208,122,337,667
47632,2020-01-08,(05107) Américas - Cr.53,1835,1065,1137,4037
47633,2020-03-22,(07110) PALOQUEMAO,105,83,68,256
47634,2020-07-13,(09100) Calle 40 Sur,1099,702,706,2507
47635,2020-07-16,(07104) Simon Bolivar,555,355,252,1162
47636,2020-07-27,(04107) Escuela Militar,138,74,75,287
47637,2020-05-03,(05000) Portal Américas - alimentacion,2511,1167,985,4663
47638,2020-02-15,(05000) Portal Américas,9345,4244,6255,19844
47639,2020-04-16,(08000) Portal Tunal - alimentacion,3499,1799,1897,7195
47640,2020-02-07,(07201) Guatoque -Veraguas,1033,495,686,2214
47641,2020-01-15,(03010) PUENTE LARGO,1833,1125,1070,4028
47642,2020-05-08,(05001) Patio Bonito,1374,677,730,2781
47643,2020-03-07,(09120) Calle 63,3765,2530,2918,9213
47644,2020-07-27,(04104) Avenida 68,587,303,290,1180
47645,2020-06-25,(02104) Calle 146,795,513,502,1810
47646,2020-09-05,(03002) SUBA - TV- 91,642,314,500,1456
47647,2020-08-07,(02202) Calle 127,446,323,245,1014
47648,2020-03-14,(02204) Pepe Sierra,1825,1214,1492,4531
47649,2020-08-23,(02205) Calle 106,46,53,53,152
47650,2020-09-30,(03007) HUMEDAL CORDOBA,164,120,128,412
47651,2020-03-08,(07009) SENA,898,389,793,2080
47652,2020-05-29,(06000) Portal Eldorado - alimentacion,3694,1800,1677,7171
47653,2020-05-18,(12003) Ricaurte,288,216,143,647
47654,2020-09-01,(12003) Ricaurte,400,264,200,864
47655,2020-02-01,(10010) San Bernardo,950,582,1105,2637
47656,2020-08-22,(05100) Banderas P. Central,529,224,384,1137
47657,2020-10-04,(05100) Banderas P. Central,232,126,307,665
47658,2020-03-08,(02105) Calle 142,872,449,1201,2522
47659,2020-09-05,(07103) AV. CHILE,634,403,506,1543
47660,2020-05-04,(05107) Américas - Cr.53,336,227,181,744
47661,2020-08-31,(05107) Américas - Cr.53,400,243,246,889
47662,2020-09-27,(10010) San Bernardo,218,126,260,604
47663,2020-10-03,(10010) San Bernardo,479,248,530,1257
47664,2020-02-14,(04000) Cabecera Calle 80 - intermunicipal,2351,1626,2178,6155
47665,2020-07-02,(02103) Mazurén,204,136,198,538
47666,2020-09-25,(07103) AV. CHILE,998,612,624,2234
47667,2020-01-23,(12002) CDS - Carrera 32,546,341,305,1192
47668,2020-07-24,(03001) LA CAMPIÑA,1025,573,545,2143
47669,2020-02-09,(02001) Centro Comercial Santa Fe,599,339,898,1836
47670,2020-05-28,(05100) Banderas P. Central - alimentacion,2584,1192,1287,5063
47671,2020-03-28,(02300) Calle 100,515,399,298,1212
47672,2020-06-23,(02300) Calle 100,1373,880,719,2972
47673,2020-07-24,(02102) Calle 161,226,119,123,468
47674,2020-08-26,(10008) San Diego,253,137,158,548
47675,2020-08-21,(03002) SUBA - TV- 91,685,374,453,1512
47676,2020-05-31,(09120) Calle 63,312,190,253,755
47677,2020-05-22,(05105) Pradera,469,289,180,938
47678,2020-03-13,(06105) Quinta Paredes,145,71,102,318
47679,2020-08-03,(02204) Pepe Sierra,711,508,369,1588
47680,2020-09-04,(02204) Pepe Sierra,931,630,529,2090
47681,2020-08-19,(07006) General Santander,514,316,284,1114
47682,2020-09-10,(07110) PALOQUEMAO,616,221,349,1186
47683,2020-03-26,(07006) General Santander,256,154,147,557
47684,2020-09-02,(06105) Quinta Paredes,146,95,103,344
47685,2020-05-07,(02201) Prado,553,356,314,1223
47686,2020-01-30,(12004) Carrera 22,658,437,472,1567
47687,2020-01-26,(09122) Calle 72,1064,764,1401,3229
47688,2020-08-15,(07001) PERDOMO,744,361,505,1610
47689,2020-06-04,(03010) PUENTE LARGO,323,214,167,704
47690,2020-03-13,(02205) Calle 106,712,118,242,1072
47691,2020-01-26,(07105) MOVISTAR ARENA,199,117,276,592
47692,2020-10-02,(50003) Corral Molinos,1599,850,1612,4061
47693,2020-05-13,(07105) MOVISTAR ARENA,202,112,106,420
47694,2020-07-02,(07003) SEVILLANA,468,257,269,994
47695,2020-07-11,(07107) U. NACIONAL,238,163,173,574
47696,2020-07-12,(04102) Avenida Boyaca,145,87,117,349
47697,2020-05-04,(04003) Avenida Ciudad de Cali,644,396,390,1430
47698,2020-08-16,(03001) LA CAMPIÑA,254,126,213,593
47699,2020-10-11,(09119) Calle 57,219,138,290,647
47700,2020-05-03,(06107) Ciudad Universitaria,36,22,36,94
47701,2020-07-06,(09121) Las Flores,765,464,463,1692
47702,2020-08-25,(09110) Avenida Jimenez,922,741,774,2437
47703,2020-05-16,(40002) Manitas,260,132,158,550
47704,2020-09-01,(07001) PERDOMO,971,551,647,2169
47705,2020-01-28,(12000) Puente Aranda,277,163,216,656
47706,2020-06-06,(07109) CAD,401,270,231,902
47707,2020-09-15,(09121) Las Flores,740,496,511,1747
47708,2020-10-01,(12004) Carrera 22,291,188,192,671
47709,2020-06-12,(09111) Calle 19,725,464,517,1706
47710,2020-07-12,(10000) Portal 20 de Julio,960,414,612,1986
47711,2020-04-13,(10004) Policarpa,125,80,66,271
47712,2020-04-18,(02201) Prado,336,223,156,715
47713,2020-09-26,(07200) Tygua-San José,218,123,210,551
47714,2020-04-16,(05001) Patio Bonito,941,525,555,2021
47715,2020-07-18,(03013) RIO NEGRO,173,101,127,401
47716,2020-10-04,(09001) Molinos,947,407,1013,2367
47717,2020-09-19,(40001) Juan Pablo II,501,265,414,1180
47718,2020-04-14,(07103) AV. CHILE,478,377,256,1111
47719,2020-06-15,(02303) Calle 85,177,142,148,467
47720,2020-04-12,(09122) Calle 72,224,169,120,513
47721,2020-08-08,(06106) Recinto Ferial,159,106,101,366
47722,2020-06-21,(02001) Centro Comercial Santa Fe,145,95,118,358
47723,2020-07-30,(07006) General Santander,467,297,271,1035
47724,2020-03-28,(40001) Juan Pablo II,180,92,94,366
47725,2020-05-04,(04000) Cabecera Calle 80 - intermunicipal,170,88,136,394
47726,2020-07-15,(04000) Cabecera Calle 80 - intermunicipal,285,169,273,727
47727,2020-09-28,(06103) CAN,416,251,235,902
47728,2020-09-08,(06002) Normandía,338,187,206,731
47729,2020-03-29,(04000) Cabecera Calle 80 - intermunicipal,18,8,25,51
47730,2020-07-26,(03012) SUBA - CALLE 95,66,40,56,162
47731,2020-08-21,(04000) Cabecera Calle 80 - intermunicipal,339,170,264,773
47732,2020-05-07,(06107) Ciudad Universitaria,127,78,76,281
47733,2020-03-22,(05001) Patio Bonito,324,179,203,706
47734,2020-01-12,(09108) Hospital,57,41,92,190
47735,2020-04-06,(09117) Calle 45,446,306,250,1002
47736,2020-05-24,(09117) Calle 45,248,140,144,532
47737,2020-08-23,(07109) CAD,162,126,123,411
47738,2020-05-26,(14004) Museo del Oro,0,91,240,331
47739,2020-09-22,(07201) Guatoque -Veraguas,198,135,179,512
47740,2020-09-27,(07201) Guatoque -Veraguas,36,33,71,140
47741,2020-09-26,(07506) DESPENSA,358,227,324,909
47742,2020-05-05,(07005) ALQUERIA,362,204,187,753
47743,2020-09-27,(04000) Cabecera Calle 80 - intermunicipal,84,48,120,252
47744,2020-05-20,(10004) Policarpa,194,99,139,432
47745,2020-06-06,(09108) Hospital,53,41,43,137
47746,2020-10-10,(04102) Avenida Boyaca,361,196,314,871
47747,2020-04-10,(09117) Calle 45,211,144,103,458
47748,2020-07-04,(07008) NQS - Calle 30 Sur,280,132,156,568
47749,2020-04-27,(07107) U. NACIONAL,35,104,54,193
47750,2020-07-27,(10005) Bicentenario - alimentacion,179,109,173,461
47751,2020-09-13,(02303) Calle 85,194,147,181,522
47752,2020-06-21,(06002) Normandía,70,53,58,181
47753,2020-05-14,(07006) General Santander,368,248,179,795
47754,2020-09-27,(10003) Ciudad Jardín,87,36,106,229
47755,2020-07-14,(03005) SUBA - AV. BOYACA,418,234,208,860
47756,2020-08-03,(14004) Museo del Oro,269,147,181,597
47757,2020-07-25,(09106) Nariño,229,119,189,537
47758,2020-08-31,(07009) SENA,608,376,410,1394
47759,2020-09-06,(04106) Carrera 47,122,58,98,278
47760,2020-05-01,(06001) Modelia,124,77,52,253
47761,2020-07-08,(10003) Ciudad Jardín,217,110,167,494
47762,2020-05-09,(14005) Las Aguas,0,28,98,126
47763,2020-01-07,(03014) SAN MARTIN,182,113,117,412
47764,2020-04-19,(02103) Mazurén,26,18,19,63
47765,2020-06-24,(05101) Mandalay - Cr.73,143,91,86,320
47766,2020-03-31,(10005) Bicentenario - alimentacion,154,68,116,338
47767,2020-07-02,(04001) Quirigua,417,260,251,928
47768,2020-10-02,(40002) Manitas,462,294,384,1140
47769,2020-05-06,(10003) Ciudad Jardín,132,71,79,282
47770,2020-04-13,(40002) Manitas,165,85,119,369
47771,2020-04-06,(07104) Simon Bolivar,194,152,123,469
47772,2020-10-12,(12004) Carrera 22,52,56,71,179
47773,2020-05-23,(06100) Av. Rojas,108,60,68,236
47774,2020-04-19,(04000) Cabecera Calle 80,160,98,110,368
47775,2020-05-25,(09105) Río Fucha,36,15,20,71
47776,2019-12-31,(10010) San Bernardo,28,17,33,78
47777,2020-08-02,(03014) SAN MARTIN,0,2,8,10
47778,2020-08-23,(03014) SAN MARTIN,0,7,20,27
47779,2020-09-22,(12000) Puente Aranda,87,57,66,210
47780,2020-05-08,(14004) Museo del Oro,0,65,138,203
47781,2020-01-19,(50006) Corral Carrera 77,7,3,8,18
47782,2020-04-25,(04000) Cabecera Calle 80 - alimentacion,1365,779,851,2995
47783,2020-10-05,(07005) ALQUERIA,627,375,512,1514
47784,2020-03-16,(09002) Consuelo,1112,592,634,2338
47785,2020-03-02,(08000) Portal Tunal - alimentacion,23420,13091,12033,48544
47786,2020-01-16,(02101) Toberín,12532,7053,7018,26603
47787,2020-08-24,(07503) SAN MATEO,10460,5713,4712,20885
47788,2020-01-31,(06000) Portal Eldorado - alimentacion,17469,8929,9647,36045
47789,2020-01-30,(07003) SEVILLANA,2073,1115,1131,4319
47790,2020-01-28,(09114) Calle 26,2740,1939,1669,6348
47791,2020-01-16,(10000) Portal 20 de Julio - alimentacion,10198,4778,6750,21726
47792,2020-05-17,(04000) Cabecera Calle 80 - alimentacion,779,433,545,1757
47793,2020-09-04,(06107) Ciudad Universitaria,211,102,167,480
47794,2020-03-06,(09001) Molinos,7554,4286,6057,17897
47795,2020-01-10,(10004) Policarpa,602,304,521,1427
47796,2020-01-20,(05100) Banderas P. Central,6909,4118,3558,14585
47797,2020-06-01,(10001) Country Sur,1088,496,663,2247
47798,2020-05-22,(09100) Calle 40 Sur,1448,868,869,3185
47799,2020-03-27,(06000) Portal Eldorado - alimentacion,2247,1019,901,4167
47800,2020-04-19,(07001) PERDOMO,135,75,84,294
47801,2020-06-21,(07001) PERDOMO,279,137,203,619
47802,2020-09-14,(09000) Cabecera Usme - alimentacion,8896,4708,5344,18948
47803,2020-05-22,(09109) Tercer Milenio,302,190,169,661
47804,2020-01-28,(04000) Cabecera Calle 80 - intermunicipal,2111,1527,2019,5657
47805,2020-01-29,(04000) Cabecera Calle 80 - intermunicipal,2115,1486,2004,5605
47806,2020-09-07,(09104) Restrepo,1655,935,1216,3806
47807,2020-01-13,(04104) Avenida 68,2791,1410,1539,5740
47808,2020-01-07,(09110) Avenida Jimenez,2820,1981,2087,6888
47809,2020-08-29,(02000) Cabecera Autopista Norte - alimentacion,4035,1957,2551,8543
47810,2020-02-21,(03009) Av. Suba- Calle 116,2499,1580,1333,5412
47811,2020-06-12,(09101) Quiroga,605,291,372,1268
47812,2020-01-01,(07503) SAN MATEO,3314,1668,3611,8593
47813,2020-02-29,(03013) RIO NEGRO,720,430,665,1815
47814,2020-04-30,(03013) RIO NEGRO,200,117,130,447
47815,2020-05-14,(03013) RIO NEGRO,228,145,145,518
47816,2020-08-01,(03013) RIO NEGRO,147,92,117,356
47817,2020-01-17,(03001) LA CAMPIÑA,5829,3093,3696,12618
47818,2020-02-11,(03001) LA CAMPIÑA,6889,4325,4342,15556
47819,2020-02-15,(50003) Corral Molinos,2588,1585,2846,7019
47820,2020-07-27,(50003) Corral Molinos,1386,736,1001,3123
47821,2020-01-09,(02303) Calle 85,2727,1880,1374,5981
47822,2020-02-03,(09119) Calle 57,3671,2262,2084,8017
47823,2020-03-02,(09103) Olaya,3997,2456,2405,8858
47824,2020-02-03,(14001) La Sabana,606,371,407,1384
47825,2020-03-19,(14001) La Sabana,266,187,207,660
47826,2020-04-22,(07111) NQS - RICAURTE,538,409,215,1162
47827,2020-05-14,(07002) MADELENA,581,338,307,1226
47828,2020-02-21,(04102) Avenida Boyaca,2946,1645,1655,6246
47829,2020-03-11,(10007) Las Nieves,1969,1204,1207,4380
47830,2020-01-20,(50003) Corral Molinos,3401,1910,3276,8587
47831,2020-08-31,(04000) Cabecera Calle 80,1058,671,869,2598
47832,2020-06-18,(02000) Cabecera Autopista Norte - alimentacion,4810,2782,2594,10186
47833,2020-06-22,(09110) Avenida Jimenez,348,264,293,905
47834,2020-01-14,(07506) DESPENSA,1462,827,866,3155
47835,2020-08-15,(10001) Country Sur,991,423,701,2115
47836,2020-06-13,(04002) Carrera 90,527,273,315,1115
47837,2020-09-19,(10006) San Victorino,587,331,428,1346
47838,2020-09-28,(10006) San Victorino,805,423,433,1661
47839,2020-07-21,(10000) Portal 20 de Julio - alimentacion,3053,1447,1852,6352
47840,2020-02-06,(40003) Mirador del Paraiso,4950,2814,2761,10525
47841,2020-08-21,(08000) Portal Tunal - alimentacion,5845,3162,3282,12289
47842,2020-01-15,(07113) SANTA ISABEL,1788,1059,1313,4160
47843,2020-01-28,(06101) El Tiempo,2935,1640,1250,5825
47844,2020-06-04,(02000) Cabecera Autopista Norte - intermunicipal,467,304,299,1070
47845,2020-01-28,(09101) Quiroga,1513,985,1254,3752
47846,2020-02-12,(06100) Av. Rojas,2931,1635,1302,5868
47847,2020-05-08,(07112) COMUNEROS,534,309,266,1109
47848,2020-05-26,(10007) Las Nieves,511,306,312,1129
47849,2020-02-11,(09105) Río Fucha,875,516,535,1926
47850,2020-08-20,(04100) Carrera 77,1104,619,709,2432
47851,2020-03-09,(07008) NQS - Calle 30 Sur,136,470,358,964
47852,2020-01-16,(06103) CAN,2102,1230,1047,4379
47853,2020-07-06,(07010) Bosa,767,384,428,1579
47854,2020-04-20,(09004) Santa Lucía,1200,661,718,2579
47855,2020-08-21,(07001) PERDOMO,923,549,536,2008
47856,2020-02-11,(03005) SUBA - AV. BOYACA,2915,1722,1595,6232
47857,2020-02-23,(40003) Mirador del Paraiso,1745,825,1211,3781
47858,2020-10-09,(06102) Salitre El Greco,260,169,200,629
47859,2020-02-19,(10009) Museo Nacional,4822,2426,1973,9221
47860,2020-03-27,(10000) Portal 20 de Julio,1153,528,470,2151
47861,2020-06-22,(09107) Hortúa,242,146,170,558
47862,2020-06-27,(09107) Hortúa,450,261,317,1028
47863,2020-01-01,(04002) Carrera 90,227,87,328,642
47864,2020-01-21,(03012) SUBA - CALLE 95,836,470,603,1909
47865,2020-06-07,(05005) Transversal 86,92,41,60,193
47866,2020-10-02,(05005) Transversal 86,522,263,412,1197
47867,2020-06-19,(05105) Pradera,630,401,303,1334
47868,2020-09-29,(07007) NQS - Calle 38A Sur,450,284,377,1111
47869,2020-02-24,(09106) Nariño,2106,1257,1332,4695
47870,2020-05-20,(03009) Av. Suba- Calle 116,416,286,208,910
47871,2020-06-19,(03009) Av. Suba- Calle 116,485,331,257,1073
47872,2020-04-21,(02205) Calle 106,173,116,89,378
47873,2020-08-12,(09101) Quiroga,451,257,372,1080
47874,2020-08-03,(04003) Avenida Ciudad de Cali,761,427,570,1758
47875,2020-06-17,(04108) El Polo,488,302,242,1032
47876,2020-02-14,(10009) Museo Nacional,4413,2429,2146,8988
47877,2020-03-10,(07103) AV. CHILE,1655,299,431,2385
47878,2020-08-16,(07113) SANTA ISABEL,99,50,109,258
47879,2020-03-31,(09004) Santa Lucía,1052,507,564,2123
47880,2020-04-21,(08002) Biblioteca,181,100,106,387
47881,2020-01-16,(07108) Av. El Dorado,559,478,655,1692
47882,2020-01-12,(10010) San Bernardo,435,265,530,1230
47883,2020-02-20,(14005) Las Aguas,3442,2089,1802,7333
47884,2020-01-03,(04102) Avenida Boyaca,1240,732,876,2848
47885,2020-08-19,(07104) Simon Bolivar,584,370,245,1199
47886,2020-06-12,(09004) Santa Lucía,2584,1346,1286,5216
47887,2020-01-08,(09121) Las Flores,2331,1453,1507,5291
47888,2020-07-12,(04003) Avenida Ciudad de Cali,329,170,313,812
47889,2020-01-12,(09106) Nariño,356,215,436,1007
47890,2020-03-13,(02104) Calle 146,524,1305,1033,2862
47891,2020-01-23,(04108) El Polo,1799,1151,1124,4074
47892,2020-06-01,(04103) Las Ferias,335,198,151,684
47893,2020-10-03,(09117) Calle 45,556,371,630,1557
47894,2020-03-02,(07109) CAD,2861,1737,1496,6094
47895,2020-08-26,(03001) LA CAMPIÑA,1111,655,605,2371
47896,2020-08-10,(02104) Calle 146,622,424,418,1464
47897,2020-09-14,(03002) SUBA - TV- 91,810,532,549,1891
47898,2020-03-24,(06100) Av. Rojas,240,169,159,568
47899,2020-04-27,(02202) Calle 127,170,348,158,676
47900,2020-08-04,(02202) Calle 127,996,681,509,2186
47901,2020-04-23,(05002) Tintal,1336,743,630,2709
47902,2020-01-20,(06104) Gobernación,1251,769,601,2621
47903,2020-05-26,(02204) Pepe Sierra,709,507,365,1581
47904,2020-07-23,(02204) Pepe Sierra,684,469,316,1469
47905,2020-08-18,(07101) CASTELLANA,210,122,134,466
47906,2020-04-17,(03001) LA CAMPIÑA,532,304,317,1153
47907,2020-05-09,(04108) El Polo,210,144,133,487
47908,2020-08-13,(04108) El Polo,359,235,217,811
47909,2020-01-08,(04101) Minuto de Dios,1515,934,1241,3690
47910,2020-05-09,(06100) Av. Rojas,86,56,74,216
47911,2020-10-11,(02302) Virrey,159,126,205,490
47912,2020-02-02,(02105) Calle 142,918,490,1189,2597
47913,2020-03-27,(02105) Calle 142,382,292,234,908
47914,2020-03-19,(10008) San Diego,676,422,448,1546
47915,2020-04-23,(09002) Consuelo,224,124,143,491
47916,2020-05-16,(09002) Consuelo,276,126,179,581
47917,2020-05-18,(09002) Consuelo,396,215,223,834
47918,2020-08-31,(03002) SUBA - TV- 91,802,486,515,1803
47919,2020-06-30,(07007) NQS - Calle 38A Sur,401,261,241,903
47920,2020-07-06,(02104) Calle 146,819,528,521,1868
47921,2020-08-31,(09113) Calle 22,378,227,263,868
47922,2020-06-09,(10008) San Diego,259,141,160,560
47923,2020-05-18,(10009) Museo Nacional,421,276,249,946
47924,2020-07-02,(09003) Socorro,661,362,349,1372
47925,2020-06-27,(12007) Zona Industrial,261,191,171,623
47926,2020-08-24,(40001) Juan Pablo II,485,269,288,1042
47927,2020-05-07,(02204) Pepe Sierra,495,346,253,1094
47928,2020-07-02,(07110) PALOQUEMAO,695,410,289,1394
47929,2020-07-11,(02304) Heroes,620,475,431,1526
47930,2020-02-14,(12004) Carrera 22,722,414,505,1641
47931,2020-04-04,(02304) Heroes,299,218,164,681
47932,2020-04-23,(03012) SUBA - CALLE 95,193,127,92,412
47933,2020-04-07,(10000) Portal 20 de Julio,1134,540,550,2224
47934,2020-07-12,(07111) NQS - RICAURTE,292,215,201,708
47935,2020-04-03,(09123) Calle 76,441,351,323,1115
47936,2020-04-02,(06102) Salitre El Greco,162,109,77,348
47937,2020-04-28,(02302) Virrey,401,274,213,888
47938,2020-05-01,(04003) Avenida Ciudad de Cali,246,178,188,612
47939,2020-03-18,(07506) DESPENSA,791,512,511,1814
47940,2020-07-09,(14005) Las Aguas,199,137,210,546
47941,2020-09-30,(09114) Calle 26,384,277,350,1011
47942,2020-06-23,(10007) Las Nieves,722,410,389,1521
47943,2020-09-07,(07004) VENECIA,1019,635,690,2344
47944,2020-06-10,(06107) Ciudad Universitaria,180,101,118,399
47945,2020-04-21,(12000) Puente Aranda,47,29,21,97
47946,2020-07-19,(07109) CAD,154,106,81,341
47947,2020-08-12,(07109) CAD,610,340,258,1208
47948,2020-08-08,(07107) U. NACIONAL,188,119,135,442
47949,2020-01-19,(09111) Calle 19,311,309,565,1185
47950,2020-08-06,(09111) Calle 19,752,422,459,1633
47951,2020-10-08,(09111) Calle 19,802,479,617,1898
47952,2020-06-30,(06001) Modelia,403,252,222,877
47953,2020-03-09,(04001) Quirigua,112,599,358,1069
47954,2020-05-09,(06002) Normandía,148,77,100,325
47955,2020-07-31,(02001) Centro Comercial Santa Fe,403,239,272,914
47956,2020-08-02,(02001) Centro Comercial Santa Fe,84,70,111,265
47957,2020-01-30,(12002) CDS - Carrera 32,573,374,291,1238
47958,2020-02-12,(12002) CDS - Carrera 32,692,400,354,1446
47959,2020-08-08,(07006) General Santander,340,195,222,757
47960,2020-07-10,(06101) El Tiempo,346,221,203,770
47961,2020-07-15,(04102) Avenida Boyaca,300,180,213,693
47962,2020-08-02,(03011) SUBA - CALLE 100,127,63,92,282
47963,2020-09-06,(07108) Av. El Dorado,38,34,59,131
47964,2020-09-25,(07108) Av. El Dorado,177,120,129,426
47965,2020-06-02,(04101) Minuto de Dios,310,183,203,696
47966,2020-04-05,(04000) Cabecera Calle 80 - intermunicipal,22,12,21,55
47967,2020-06-11,(09108) Hospital,86,52,59,197
47968,2020-08-10,(07006) General Santander,476,335,254,1065
47969,2020-02-21,(03014) SAN MARTIN,230,143,163,536
47970,2020-05-23,(02502) Terminal,186,126,156,468
47971,2020-10-01,(12003) Ricaurte,457,306,248,1011
47972,2020-03-08,(05101) Mandalay - Cr.73,134,46,120,300
47973,2020-04-26,(05102) Av. Américas - Av. Boyacá,48,30,21,99
47974,2020-09-10,(09108) Hospital,58,32,43,133
47975,2020-06-03,(06102) Salitre El Greco,200,112,100,412
47976,2020-04-14,(06102) Salitre El Greco,137,98,84,319
47977,2020-06-19,(10004) Policarpa,225,122,141,488
47978,2020-07-21,(07506) DESPENSA,456,248,240,944
47979,2020-07-28,(04001) Quirigua,395,245,227,867
47980,2020-07-10,(03004) GRATAMIRA,42,16,35,93
47981,2020-02-23,(10008) San Diego,189,154,259,602
47982,2020-09-27,(07007) NQS - Calle 38A Sur,221,124,190,535
47983,2020-05-14,(09116) Avenida 39,262,186,150,598
47984,2020-09-29,(07003) SEVILLANA,500,262,353,1115
47985,2020-06-26,(07108) Av. El Dorado,139,96,98,333
47986,2020-04-14,(09121) Las Flores,396,291,265,952
47987,2020-06-07,(09101) Quiroga,129,75,134,338
47988,2020-10-09,(12004) Carrera 22,279,183,170,632
47989,2020-07-24,(06103) CAN,326,193,129,648
47990,2020-07-18,(12004) Carrera 22,85,52,85,222
47991,2020-06-07,(04001) Quirigua,130,85,87,302
47992,2020-07-05,(09002) Consuelo,158,71,115,344
47993,2020-07-18,(10003) Ciudad Jardín,139,56,115,310
47994,2020-05-04,(07101) CASTELLANA,121,97,77,295
47995,2020-04-10,(08001) Parque el Tunal,66,40,44,150
47996,2020-03-31,(04001) Quirigua,180,113,97,390
47997,2020-05-05,(07101) CASTELLANA,118,81,87,286
47998,2020-06-10,(07101) CASTELLANA,197,107,101,405
47999,2020-08-02,(07201) Guatoque -Veraguas,24,28,50,102
48000,2020-06-01,(12004) Carrera 22,181,90,123,394
48001,2020-03-23,(03005) SUBA - AV. BOYACA,84,63,52,199
48002,2020-08-05,(09105) Río Fucha,0,47,139,186
48003,2020-04-13,(03013) RIO NEGRO,159,90,112,361
48004,2020-04-17,(05102) Av. Américas - Av. Boyacá,116,79,67,262
48005,2020-07-24,(06108) Concejo de Bogotá,112,62,54,228
48006,2020-06-15,(09105) Río Fucha,58,17,42,117
48007,2020-06-17,(03014) SAN MARTIN,29,9,33,71
48008,2020-04-18,(07010) Bosa,226,151,166,543
48009,2020-02-04,(50006) Corral Carrera 77,31,31,39,101
48010,2020-09-07,(50006) Corral Carrera 77,4,4,16,24
48011,2020-05-01,(07101) CASTELLANA,31,26,36,93
48012,2020-01-19,(03014) SAN MARTIN,40,27,78,145
48013,2020-04-20,(05101) Mandalay - Cr.73,49,31,27,107
48014,2020-04-09,(12004) Carrera 22,15,10,14,39
48015,2020-09-09,(03014) SAN MARTIN,0,13,29,42
48016,2020-04-04,(03004) GRATAMIRA,13,8,15,36
48017,2020-09-12,(03004) GRATAMIRA,0,19,30,49
48018,2020-04-27,(03004) GRATAMIRA,7,12,1,20
48019,2020-09-26,(04000) Cabecera Calle 80 - alimentacion,3719,1718,3287,8724
48020,2020-02-17,(07005) ALQUERIA,2699,1549,1377,5625
48021,2020-08-24,(09002) Consuelo,437,239,239,915
48022,2020-03-01,(09118) Marly,1460,899,1491,3850
48023,2020-07-21,(05000) Portal Américas - alimentacion,10086,5411,4849,20346
48024,2020-02-27,(10000) Portal 20 de Julio - alimentacion,10652,5787,7540,23979
48025,2020-09-11,(09119) Calle 57,601,381,430,1412
48026,2020-01-25,(05000) Portal Américas - alimentacion,24013,12417,15327,51757
48027,2020-02-13,(07505) LEON XIII,8717,4648,3899,17264
48028,2020-03-05,(14005) Las Aguas,3395,2085,1894,7374
48029,2020-03-16,(05000) Portal Américas,11019,6036,5673,22728
48030,2020-09-25,(05000) Portal Américas,4087,2120,2773,8980
48031,2020-01-13,(07003) SEVILLANA,1673,889,1027,3589
48032,2020-01-15,(07003) SEVILLANA,1832,979,1053,3864
48033,2020-01-18,(10000) Portal 20 de Julio - alimentacion,8335,3594,5732,17661
48034,2020-02-09,(05000) Portal Américas - alimentacion,9494,3998,7047,20539
48035,2020-07-08,(09000) Cabecera Usme - alimentacion,9121,5030,5233,19384
48036,2020-06-04,(05000) Portal Américas - alimentacion,9664,5086,4636,19386
48037,2020-02-10,(07000) Portal Sur - alimentacion,29543,17463,14446,61452
48038,2020-01-28,(08000) Portal Tunal - alimentacion,23190,12616,11330,47136
48039,2020-02-28,(05100) Banderas P. Central,8297,4291,3977,16565
48040,2020-04-16,(10001) Country Sur,555,242,362,1159
48041,2020-06-20,(05100) Banderas P. Central - alimentacion,2113,1070,1307,4490
48042,2020-03-14,(07009) SENA,1983,1050,1413,4446
48043,2020-02-24,(10003) Ciudad Jardín,1075,606,676,2357
48044,2020-01-22,(02205) Calle 106,2542,1616,1279,5437
48045,2020-01-30,(02205) Calle 106,2643,1697,1317,5657
48046,2020-04-30,(07001) PERDOMO,536,293,305,1134
48047,2020-05-21,(07001) PERDOMO,714,416,424,1554
48048,2020-02-20,(07113) SANTA ISABEL,2124,1280,1308,4712
48049,2020-01-22,(40003) Mirador del Paraiso,4489,2607,2472,9568
48050,2020-10-11,(40003) Mirador del Paraiso,676,307,563,1546
48051,2020-03-16,(06002) Normandía,1473,894,782,3149
48052,2020-07-06,(05002) Tintal,0,1124,2751,3875
48053,2020-06-25,(03013) RIO NEGRO,284,184,188,656
48054,2020-04-23,(07111) NQS - RICAURTE,578,410,248,1236
48055,2020-06-08,(07111) NQS - RICAURTE,1090,695,405,2190
48056,2020-01-24,(04105) Carrera 53,1323,734,745,2802
48057,2020-05-13,(09001) Molinos,1855,1069,1136,4060
48058,2020-06-26,(09001) Molinos,2642,1436,1828,5906
48059,2020-02-17,(07007) NQS - Calle 38A Sur,2185,1335,1117,4637
48060,2020-09-24,(04000) Cabecera Calle 80,1251,798,1066,3115
48061,2020-01-03,(07112) COMUNEROS,1673,939,1293,3905
48062,2020-01-18,(09111) Calle 19,1014,833,1149,2996
48063,2020-03-03,(06000) Portal Eldorado,6734,3829,2861,13424
48064,2020-02-02,(09000) Cabecera Usme - alimentacion,6062,2775,5465,14302
48065,2020-09-25,(03000) Portal Suba,1697,1007,1333,4037
48066,2020-10-10,(03000) Portal Suba,1144,580,1206,2930
48067,2020-01-12,(08001) Parque el Tunal,351,156,318,825
48068,2020-01-21,(06100) Av. Rojas,1586,812,785,3183
48069,2020-03-16,(10000) Portal 20 de Julio,6805,3082,2915,12802
48070,2020-09-04,(08002) Biblioteca,356,175,227,758
48071,2020-09-27,(05000) Portal Américas,929,500,1028,2457
48072,2020-09-22,(10000) Portal 20 de Julio,2469,1218,1532,5219
48073,2020-01-25,(07000) Portal Sur,4674,2317,3379,10370
48074,2020-04-01,(09116) Avenida 39,175,137,132,444
48075,2020-01-29,(07004) VENECIA,4568,2710,2423,9701
48076,2020-04-09,(07504) TERREROS,952,521,466,1939
48077,2020-07-05,(09000) Cabecera Usme - alimentacion,2595,1276,1828,5699
48078,2020-01-27,(07008) NQS - Calle 30 Sur,1821,1041,1061,3923
48079,2020-10-09,(02101) Toberín,1914,1114,1692,4720
48080,2020-09-28,(06108) Concejo de Bogotá,161,81,124,366
48081,2020-06-19,(03003) 21 ANGELES,338,167,182,687
48082,2020-01-07,(14004) Museo del Oro,1599,1075,1123,3797
48083,2020-06-24,(02101) Toberín,1565,1022,969,3556
48084,2020-03-15,(06001) Modelia,217,137,263,617
48085,2020-01-03,(06106) Recinto Ferial,601,393,432,1426
48086,2020-08-22,(06102) Salitre El Greco,143,93,101,337
48087,2020-03-08,(10000) Portal 20 de Julio,2034,793,1560,4387
48088,2020-08-14,(09123) Calle 76,968,665,581,2214
48089,2020-02-05,(05101) Mandalay - Cr.73,1289,735,547,2571
48090,2020-04-01,(05002) Tintal,1115,640,650,2405
48091,2020-05-26,(05002) Tintal,2100,1117,1142,4359
48092,2020-06-04,(03012) SUBA - CALLE 95,310,205,165,680
48093,2020-06-10,(03012) SUBA - CALLE 95,319,215,169,703
48094,2020-09-22,(03012) SUBA - CALLE 95,383,223,232,838
48095,2020-09-25,(03012) SUBA - CALLE 95,391,232,279,902
48096,2020-02-05,(07006) General Santander,3016,1780,1641,6437
48097,2020-03-03,(08000) Portal Tunal,2253,1282,1085,4620
48098,2020-05-13,(09104) Restrepo,1130,671,817,2618
48099,2020-10-04,(09104) Restrepo,577,310,701,1588
48100,2020-07-30,(02202) Calle 127,1015,743,565,2323
48101,2020-08-19,(03009) Av. Suba- Calle 116,525,334,259,1118
48102,2020-01-07,(04108) El Polo,1244,785,911,2940
48103,2020-01-30,(02202) Calle 127,5896,3912,2900,12708
48104,2020-02-24,(02202) Calle 127,6002,3823,2987,12812
48105,2020-01-29,(07201) Guatoque -Veraguas,989,479,635,2103
48106,2020-06-17,(02201) Prado,920,635,539,2094
48107,2020-08-10,(07113) SANTA ISABEL,336,211,261,808
48108,2020-09-09,(04100) Carrera 77,1339,786,982,3107
48109,2020-03-19,(03007) HUMEDAL CORDOBA,341,224,188,753
48110,2020-08-04,(03007) HUMEDAL CORDOBA,92,70,59,221
48111,2020-01-03,(03011) SUBA - CALLE 100,1246,613,750,2609
48112,2020-08-28,(07000) Portal Sur,2032,1249,1337,4618
48113,2020-08-13,(02101) Toberín,1232,799,862,2893
48114,2020-01-13,(02202) Calle 127,4743,3160,2504,10407
48115,2020-07-11,(07104) Simon Bolivar,520,321,283,1124
48116,2020-04-15,(10005) Bicentenario - alimentacion,132,70,109,311
48117,2020-07-03,(10005) Bicentenario - alimentacion,227,107,205,539
48118,2020-01-28,(04003) Avenida Ciudad de Cali,5193,3052,3358,11603
48119,2020-05-14,(04108) El Polo,346,211,166,723
48120,2020-01-09,(07002) MADELENA,3461,1950,2074,7485
48121,2020-09-30,(09110) Avenida Jimenez,1673,1160,1033,3866
48122,2020-01-12,(02104) Calle 146,1091,450,1208,2749
48123,2020-06-14,(02202) Calle 127,360,270,208,838
48124,2020-09-21,(06104) Gobernación,207,136,112,455
48125,2020-03-25,(03001) LA CAMPIÑA,515,310,298,1123
48126,2020-03-26,(03001) LA CAMPIÑA,520,303,276,1099
48127,2020-04-03,(04108) El Polo,212,141,111,464
48128,2020-06-13,(06100) Av. Rojas,136,80,129,345
48129,2020-08-09,(06100) Av. Rojas,22,27,50,99
48130,2020-06-20,(06000) Portal Eldorado,671,501,505,1677
48131,2020-07-22,(12003) Ricaurte,240,189,142,571
48132,2020-10-03,(12003) Ricaurte,295,227,251,773
48133,2020-02-23,(12007) Zona Industrial,161,147,173,481
48134,2020-01-27,(03013) RIO NEGRO,1218,731,809,2758
48135,2020-02-01,(03010) PUENTE LARGO,927,579,760,2266
48136,2020-03-01,(03010) PUENTE LARGO,293,185,376,854
48137,2020-07-07,(10010) San Bernardo,629,363,456,1448
48138,2020-08-05,(10010) San Bernardo,612,293,422,1327
48139,2020-05-20,(05100) Banderas P. Central,520,301,335,1156
48140,2020-03-02,(07200) Tygua-San José,809,488,608,1905
48141,2020-10-10,(06103) CAN,215,163,200,578
48142,2020-08-12,(02105) Calle 142,724,451,449,1624
48143,2020-06-06,(03006) NIZA - CALLE 127,320,187,173,680
48144,2020-02-22,(50003) Corral Molinos,2652,1450,2646,6748
48145,2020-07-07,(02103) Mazurén,200,132,189,521
48146,2020-05-14,(05100) Banderas P. Central - alimentacion,2088,1019,1024,4131
48147,2020-09-16,(12007) Zona Industrial,428,260,236,924
48148,2020-03-18,(07111) NQS - RICAURTE,2002,1504,1064,4570
48149,2020-01-25,(07006) General Santander - alimentacion,922,516,694,2132
48150,2020-04-02,(05100) Banderas P. Central - alimentacion,1502,668,714,2884
48151,2020-07-17,(09004) Santa Lucía,1853,984,1076,3913
48152,2020-08-04,(07004) VENECIA,883,525,509,1917
48153,2020-05-26,(10008) San Diego,241,172,158,571
48154,2020-08-13,(02304) Heroes,794,550,417,1761
48155,2020-09-15,(09120) Calle 63,1124,769,824,2717
48156,2020-08-13,(03011) SUBA - CALLE 100,419,202,191,812
48157,2020-08-25,(06111) Universidades,322,181,328,831
48158,2020-08-16,(09115) Calle 34,129,109,127,365
48159,2020-01-19,(12001) Carrera 43,176,127,304,607
48160,2020-04-24,(09111) Calle 19,298,176,228,702
48161,2020-08-14,(09104) Restrepo,1477,861,1125,3463
48162,2020-06-18,(09122) Calle 72,1228,861,765,2854
48163,2020-06-10,(07201) Guatoque -Veraguas,175,90,107,372
48164,2020-06-10,(07200) Tygua-San José,218,109,142,469
48165,2020-07-06,(09118) Marly,1533,997,836,3366
48166,2020-04-20,(09103) Olaya,515,302,252,1069
48167,2020-07-21,(02303) Calle 85,572,395,295,1262
48168,2020-01-20,(50002) Corral Calle 40 Sur,110,94,112,316
48169,2020-05-15,(09114) Calle 26,228,178,147,553
48170,2020-04-16,(07105) MOVISTAR ARENA,158,104,86,348
48171,2020-04-20,(07105) MOVISTAR ARENA,150,101,80,331
48172,2020-04-02,(09123) Calle 76,426,353,276,1055
48173,2020-10-07,(03003) 21 ANGELES,412,221,290,923
48174,2020-06-03,(10007) Las Nieves,560,326,319,1205
48175,2020-08-12,(40001) Juan Pablo II,533,303,357,1193
48176,2020-05-06,(06107) Ciudad Universitaria,136,96,68,300
48177,2020-07-16,(03011) SUBA - CALLE 100,513,235,197,945
48178,2020-08-02,(09121) Las Flores,156,97,153,406
48179,2020-06-07,(07001) PERDOMO,210,99,153,462
48180,2020-05-11,(09110) Avenida Jimenez,682,543,538,1763
48181,2020-06-07,(40001) Juan Pablo II,145,76,120,341
48182,2020-03-25,(06111) Universidades,0,88,239,327
48183,2020-08-26,(03005) SUBA - AV. BOYACA,448,275,254,977
48184,2020-05-01,(07007) NQS - Calle 38A Sur,108,61,69,238
48185,2020-02-04,(50002) Corral Calle 40 Sur,142,91,133,366
48186,2020-09-04,(07006) General Santander - alimentacion,401,230,322,953
48187,2020-03-01,(12003) Ricaurte,131,117,187,435
48188,2020-03-20,(02201) Prado,465,316,229,1010
48189,2020-09-29,(07104) Simon Bolivar,599,381,351,1331
48190,2020-09-13,(07200) Tygua-San José,89,45,101,235
48191,2020-09-16,(07200) Tygua-San José,272,145,195,612
48192,2020-02-01,(09105) Río Fucha,440,237,408,1085
48193,2020-07-13,(10006) San Victorino,375,191,213,779
48194,2020-04-07,(09122) Calle 72,541,420,333,1294
48195,2020-07-12,(12003) Ricaurte,82,72,84,238
48196,2020-06-07,(02101) Toberín,222,169,242,633
48197,2020-08-31,(04102) Avenida Boyaca,345,209,279,833
48198,2020-04-30,(06103) CAN,302,213,128,643
48199,2020-10-02,(06103) CAN,426,301,292,1019
48200,2020-08-08,(04000) Cabecera Calle 80 - intermunicipal,143,72,107,322
48201,2020-04-24,(06100) Av. Rojas,116,69,87,272
48202,2020-07-28,(07200) Tygua-San José,224,128,154,506
48203,2020-03-22,(07109) CAD,196,136,94,426
48204,2020-10-10,(03010) PUENTE LARGO,249,176,296,721
48205,2020-04-25,(06102) Salitre El Greco,117,76,85,278
48206,2020-05-27,(09117) Calle 45,643,411,373,1427
48207,2020-01-05,(09108) Hospital,38,33,71,142
48208,2020-07-02,(03011) SUBA - CALLE 100,571,266,266,1103
48209,2020-04-26,(03006) NIZA - CALLE 127,120,80,50,250
48210,2020-10-10,(04106) Carrera 47,292,127,226,645
48211,2020-07-23,(07006) General Santander,402,263,208,873
48212,2020-07-10,(04001) Quirigua,426,263,258,947
48213,2020-05-27,(10004) Policarpa,217,90,153,460
48214,2020-07-23,(07008) NQS - Calle 30 Sur,229,121,133,483
48215,2020-07-02,(07006) General Santander,569,349,328,1246
48216,2020-04-26,(07506) DESPENSA,88,51,52,191
48217,2020-04-13,(03005) SUBA - AV. BOYACA,211,135,153,499
48218,2020-10-12,(09111) Calle 19,189,131,256,576
48219,2020-04-03,(09106) Nariño,171,120,136,427
48220,2020-06-29,(12004) Carrera 22,58,44,41,143
48221,2020-04-29,(07007) NQS - Calle 38A Sur,220,112,149,481
48222,2020-03-29,(04108) El Polo,38,27,27,92
48223,2020-05-10,(06107) Ciudad Universitaria,34,27,38,99
48224,2020-04-07,(02000) Cabecera Autopista Norte - intermunicipal,129,88,99,316
48225,2020-08-26,(09116) Avenida 39,333,174,239,746
48226,2020-05-22,(04105) Carrera 53,230,125,133,488
48227,2020-09-01,(03005) SUBA - AV. BOYACA,490,261,289,1040
48228,2020-04-11,(07105) MOVISTAR ARENA,85,63,44,192
48229,2020-05-10,(07107) U. NACIONAL,104,78,50,232
48230,2020-04-27,(06106) Recinto Ferial,26,76,30,132
48231,2020-01-01,(03003) 21 ANGELES,114,46,155,315
48232,2020-07-17,(07006) General Santander - alimentacion,296,183,196,675
48233,2020-05-13,(06107) Ciudad Universitaria,147,98,82,327
48234,2020-10-04,(06107) Ciudad Universitaria,56,29,91,176
48235,2020-04-10,(06001) Modelia,88,71,44,203
48236,2020-04-24,(06106) Recinto Ferial,164,103,75,342
48237,2020-04-23,(12002) CDS - Carrera 32,200,131,51,382
48238,2020-03-19,(03014) SAN MARTIN,103,61,88,252
48239,2020-04-12,(10005) Bicentenario - alimentacion,42,24,42,108
48240,2020-06-29,(06107) Ciudad Universitaria,67,42,64,173
48241,2020-04-26,(09113) Calle 22,155,86,123,364
48242,2020-07-12,(06101) El Tiempo,106,83,86,275
48243,2020-05-30,(10005) Bicentenario,80,41,59,180
48244,2020-09-24,(50006) Corral Carrera 77,2,5,7,14
48245,2020-06-07,(07107) U. NACIONAL,84,68,58,210
48246,2020-04-27,(14005) Las Aguas,0,20,35,55
48247,2020-04-05,(07102) NQS - CALLE 75,35,34,30,99
48248,2020-06-02,(03014) SAN MARTIN,26,8,25,59
48249,2020-07-20,(02102) Calle 161,53,42,50,145
